ID,Closest,No. True,No. Prediction,TP,FN,FP,TN,Precision,Accuracy,Hit Rate,MCC,No. Consensus Prediction,Consensus TP,Consensus FN,Consensus FP,Consensus TN,Consensus Precision,Consensus Accuracy,Consensus Hit Rate,Consensus MCC
PF16690,PF15390:PF14822:PF05512,3,5,0,3,5,1010,0.0,0.99,0.0,-0.0,0,0,3,0,1015,0,1.0,0.0,0
PF07004,PF04693:PF08535:PF12201,13,1,0,13,1,1004,0.0,0.99,0.0,-0.0,0,0,13,0,1005,0,0.99,0.0,0
PF13325,PF15276:PF15308:PF16508,5,13,3,2,10,1003,0.23,0.99,0.6,0.37,2,2,3,0,1013,1.0,1.0,0.4,0.63
PF07582,PF02058:PF10106:PF01292,0,8,0,0,8,1010,0.0,0.99,0,0,0,0,0,0,1018,0,1.0,0,0
PF08421,PF08484:PF11967:PF07409,2,2,2,0,0,1016,1.0,1.0,1.0,1.0,0,0,2,0,1016,0,1.0,0.0,0
PF03083,PF14811:PF04819:PF07985,15,18,5,10,13,990,0.28,0.98,0.33,0.29,1,1,14,0,1003,1.0,0.99,0.07,0.26
PF13012,PF12134:PF08084:PF01398,24,51,23,1,28,966,0.45,0.97,0.96,0.65,14,4,20,10,984,0.29,0.97,0.17,0.2
PF00731,PF02222:PF01259:PF04248,11,21,7,4,14,993,0.33,0.98,0.64,0.45,1,1,10,0,1007,1.0,0.99,0.09,0.3
PF09803,PF11093:PF06907:PF12494,10,6,1,9,5,1003,0.17,0.99,0.1,0.12,0,0,10,0,1008,0,0.99,0.0,0
PF03457,PF08426:PF04546:PF03458,6,5,1,5,4,1008,0.2,0.99,0.17,0.18,0,0,6,0,1012,0,0.99,0.0,0
PF08940,PF03428:PF14842:PF10139,0,0,0,0,0,1018,0,1.0,0,0,0,0,0,0,1018,0,1.0,0,0
PF01010,PF06455:PF00662:PF12612,1,15,1,0,14,1003,0.07,0.99,1.0,0.26,3,1,0,2,1015,0.33,1.0,1.0,0.58
PF12716,PF06912:PF09056:PF11029,0,9,0,0,9,1009,0.0,0.99,0,0,0,0,0,0,1018,0,1.0,0,0
PF08375,PF09440:PF05470:PF10602,8,30,4,4,26,984,0.13,0.97,0.5,0.25,5,1,7,4,1006,0.2,0.99,0.12,0.15
PF02447,PF07963:PF01228:PF07476,8,4,2,6,2,1008,0.5,0.99,0.25,0.35,0,0,8,0,1010,0,0.99,0.0,0
PF06508,PF08252:PF00697:PF00958,3,22,3,0,19,996,0.14,0.98,1.0,0.37,0,0,3,0,1015,0,1.0,0.0,0
PF00386,PF00229:PF12287:PF03523,24,9,3,21,6,988,0.33,0.97,0.12,0.19,1,0,24,1,993,0.0,0.98,0.0,-0.0
PF09874,PF06007:PF11876:PF07495,1,3,0,1,3,1014,0.0,1.0,0.0,-0.0,0,0,1,0,1017,0,1.0,0.0,0
PF13206,PF00913:PF10659:PF07939,0,3,0,0,3,1015,0.0,1.0,0,0,0,0,0,0,1018,0,1.0,0,0
PF17003,PF00895:PF16851:PF03379,0,2,0,0,2,1016,0.0,1.0,0,0,0,0,0,0,1018,0,1.0,0,0
PF06937,PF10856:PF15703:PF09187,0,0,0,0,0,1018,0,1.0,0,0,0,0,0,0,1018,0,1.0,0,0
PF03097,PF13949:PF02185:PF12215,33,45,29,4,16,969,0.64,0.98,0.88,0.74,5,5,28,0,985,1.0,0.97,0.15,0.38
PF10250,PF09335:PF04570:PF13695,36,27,5,31,22,960,0.19,0.95,0.14,0.13,1,1,35,0,982,1.0,0.97,0.03,0.16
PF14238,PF13390:PF03845:PF09829,0,8,0,0,8,1010,0.0,0.99,0,0,0,0,0,0,1018,0,1.0,0,0
PF02748,PF03135:PF05100:PF11751,2,5,0,2,5,1011,0.0,0.99,0.0,-0.0,0,0,2,0,1016,0,1.0,0.0,0
PF00959,PF14099:PF02361:PF06500,5,8,1,4,7,1006,0.12,0.99,0.2,0.15,0,0,5,0,1013,0,1.0,0.0,0
PF14669,PF15082:PF08183:PF04610,0,6,0,0,6,1012,0.0,0.99,0,0,0,0,0,0,1018,0,1.0,0,0
PF00262,PF10595:PF03647:PF04729,21,20,6,15,14,983,0.3,0.97,0.29,0.28,3,2,19,1,996,0.67,0.98,0.1,0.25
PF07488,PF07477:PF03648:PF16126,4,4,4,0,0,1014,1.0,1.0,1.0,1.0,3,3,1,0,1014,1.0,1.0,0.75,0.87
PF01191,PF03871:PF03868:PF00993,10,21,10,0,11,997,0.48,0.99,1.0,0.69,4,3,7,1,1007,0.75,0.99,0.3,0.47
PF14331,PF07491:PF00262:PF10345,0,30,0,0,30,988,0.0,0.97,0,0,4,0,0,4,1014,0.0,1.0,0,0
PF05715,PF15914:PF14465:PF15030,3,4,1,2,3,1012,0.25,1.0,0.33,0.29,2,1,2,1,1014,0.5,1.0,0.33,0.41
PF09723,PF15175:PF09074:PF11369,0,0,0,0,0,1018,0,1.0,0,0,0,0,0,0,1018,0,1.0,0,0
PF00709,PF05212:PF05458:PF03671,12,22,7,5,15,991,0.32,0.98,0.58,0.42,3,2,10,1,1005,0.67,0.99,0.17,0.33
PF09030,PF08214:PF02135:PF06001,11,26,9,2,17,990,0.35,0.98,0.82,0.53,19,8,3,11,996,0.42,0.99,0.73,0.55
PF05840,PF11019:PF12477:PF03745,0,0,0,0,0,1018,0,1.0,0,0,0,0,0,0,1018,0,1.0,0,0
PF00879,PF00323:PF04643:PF05436,0,3,0,0,3,1015,0.0,1.0,0,0,0,0,0,0,1018,0,1.0,0,0
PF14721,PF16020:PF14962:PF14759,4,8,2,2,6,1008,0.25,0.99,0.5,0.35,2,2,2,0,1014,1.0,1.0,0.5,0.71
PF05279,PF13174:PF05118:PF09295,1,20,1,0,19,998,0.05,0.98,1.0,0.22,3,1,0,2,1015,0.33,1.0,1.0,0.58
PF17206,PF03592:PF08497:PF08708,1,0,0,1,0,1017,0,1.0,0.0,0,0,0,1,0,1017,0,1.0,0.0,0
PF10671,PF13269:PF14113:PF02951,0,4,0,0,4,1014,0.0,1.0,0,0,0,0,0,0,1018,0,1.0,0,0
PF11325,PF14877:PF15046:PF17015,0,7,0,0,7,1011,0.0,0.99,0,0,0,0,0,0,1018,0,1.0,0,0
PF11229,PF12530:PF10487:PF08158,2,13,1,1,12,1004,0.08,0.99,0.5,0.19,3,0,2,3,1013,0.0,1.0,0.0,-0.0
PF07712,PF06404:PF00197:PF14476,0,3,0,0,3,1015,0.0,1.0,0,0,0,0,0,0,1018,0,1.0,0,0
PF07074,PF14290:PF07495:PF07881,8,2,0,8,2,1008,0.0,0.99,0.0,-0.0,0,0,8,0,1010,0,0.99,0.0,0
PF02713,PF04949:PF06271:PF15264,1,11,0,1,11,1006,0.0,0.99,0.0,-0.0,2,0,1,2,1015,0.0,1.0,0.0,-0.0
PF03720,PF00984:PF03721:PF03483,6,24,6,0,18,994,0.25,0.98,1.0,0.5,7,6,0,1,1011,0.86,1.0,1.0,0.93
PF00271,PF16203:PF13625:PF07999,232,16,16,216,0,786,1.0,0.79,0.07,0.23,11,11,221,0,786,1.0,0.78,0.05,0.19
PF06487,PF03760:PF04852:PF15003,4,6,0,4,6,1008,0.0,0.99,0.0,-0.0,1,0,4,1,1013,0.0,1.0,0.0,-0.0
PF07779,PF03385:PF04083:PF10022,11,36,4,7,32,975,0.11,0.96,0.36,0.19,0,0,11,0,1007,0,0.99,0.0,0
PF14022,PF15093:PF12600:PF07891,2,3,0,2,3,1013,0.0,1.0,0.0,-0.0,0,0,2,0,1016,0,1.0,0.0,0
PF08773,PF08127:PF12131:PF08246,1,35,1,0,34,983,0.03,0.97,1.0,0.17,3,1,0,2,1015,0.33,1.0,1.0,0.58
PF07912,PF07749:PF07449:PF15928,3,7,2,1,5,1010,0.29,0.99,0.67,0.43,1,0,3,1,1014,0.0,1.0,0.0,-0.0
PF08430,PF09354:PF16675:PF16676,5,7,4,1,3,1010,0.57,1.0,0.8,0.67,3,2,3,1,1012,0.67,1.0,0.4,0.51
PF09170,PF08784:PF02938:PF14579,2,28,1,1,27,989,0.04,0.97,0.5,0.13,5,1,1,4,1012,0.2,1.0,0.5,0.31
PF04690,PF04720:PF06206:PF07911,2,11,0,2,11,1005,0.0,0.99,0.0,-0.0,0,0,2,0,1016,0,1.0,0.0,0
PF04158,PF16699:PF08145:PF04494,7,14,1,6,13,998,0.07,0.98,0.14,0.09,3,1,6,2,1009,0.33,0.99,0.14,0.21
PF04463,PF06403:PF13995:PF01752,2,3,1,1,2,1014,0.33,1.0,0.5,0.41,0,0,2,0,1016,0,1.0,0.0,0
PF13613,PF12596:PF05485:PF13359,8,86,8,0,78,932,0.09,0.92,1.0,0.29,19,5,3,14,996,0.26,0.98,0.62,0.4
PF02954,PF00158:PF04397:PF01339,7,12,6,1,6,1005,0.5,0.99,0.86,0.65,6,3,4,3,1008,0.5,0.99,0.43,0.46
PF16523,PF15441:PF15720:PF12026,2,5,2,0,3,1013,0.4,1.0,1.0,0.63,2,2,0,0,1016,1.0,1.0,1.0,1.0
PF15903,PF15917:PF09743:PF10744,3,7,0,3,7,1008,0.0,0.99,0.0,-0.0,1,0,3,1,1014,0.0,1.0,0.0,-0.0
PF15818,PF14926:PF15467:PF12264,0,5,0,0,5,1013,0.0,1.0,0,0,0,0,0,0,1018,0,1.0,0,0
PF08748,PF04848:PF11124:PF10951,0,3,0,0,3,1015,0.0,1.0,0,0,0,0,0,0,1018,0,1.0,0,0
PF12190,PF08026:PF09611:PF15186,0,1,0,0,1,1017,0.0,1.0,0,0,0,0,0,0,1018,0,1.0,0,0
PF17223,PF01269:PF04422:PF14861,1,15,0,1,15,1002,0.0,0.98,0.0,-0.0,0,0,1,0,1017,0,1.0,0.0,0
PF09797,PF10022:PF06662:PF14764,10,15,3,7,12,996,0.2,0.98,0.3,0.24,0,0,10,0,1008,0,0.99,0.0,0
PF06699,PF06218:PF02961:PF01234,14,11,4,10,7,997,0.36,0.98,0.29,0.31,3,3,11,0,1004,1.0,0.99,0.21,0.46
PF08298,PF14841:PF03241:PF07411,0,1,0,0,1,1017,0.0,1.0,0,0,0,0,0,0,1018,0,1.0,0,0
PF03153,PF01521:PF02744:PF12016,11,25,6,5,19,988,0.24,0.98,0.55,0.35,3,0,11,3,1004,0.0,0.99,0.0,-0.01
PF05514,PF09781:PF15786:PF15667,0,2,0,0,2,1016,0.0,1.0,0,0,0,0,0,0,1018,0,1.0,0,0
PF03917,PF03199:PF13553:PF01080,8,19,4,4,15,995,0.21,0.98,0.5,0.32,1,1,7,0,1010,1.0,0.99,0.12,0.35
PF02181,PF06345:PF06367:PF06371,39,24,22,17,2,977,0.92,0.98,0.56,0.71,23,21,18,2,977,0.91,0.98,0.54,0.69
PF05007,PF04790:PF00590:PF14823,9,24,4,5,20,989,0.17,0.98,0.44,0.26,6,3,6,3,1006,0.5,0.99,0.33,0.4
PF05386,PF05731:PF13271:PF15512,2,10,2,0,8,1008,0.2,0.99,1.0,0.45,3,2,0,1,1015,0.67,1.0,1.0,0.82
PF13505,PF17164:PF06505:PF06744,0,0,0,0,0,1018,0,1.0,0,0,0,0,0,0,1018,0,1.0,0,0
PF02313,PF07755:PF10418:PF05541,0,1,0,0,1,1017,0.0,1.0,0,0,0,0,0,0,1018,0,1.0,0,0
PF08364,PF16658:PF11987:PF14492,5,53,5,0,48,965,0.09,0.95,1.0,0.3,10,4,1,6,1007,0.4,0.99,0.8,0.56
PF08635,PF09166:PF02894:PF01041,2,29,2,0,27,989,0.07,0.97,1.0,0.26,3,1,1,2,1014,0.33,1.0,0.5,0.41
PF11690,PF12855:PF08653:PF15863,0,3,0,0,3,1015,0.0,1.0,0,0,1,0,0,1,1017,0.0,1.0,0,0
PF10092,PF04421:PF04992:PF01141,0,13,0,0,13,1005,0.0,0.99,0,0,1,0,0,1,1017,0.0,1.0,0,0
PF09507,PF14621:PF06824:PF00454,8,69,4,4,65,945,0.06,0.93,0.5,0.15,6,2,6,4,1006,0.33,0.99,0.25,0.28
PF00977,PF00697:PF04715:PF00425,16,22,4,12,18,984,0.18,0.97,0.25,0.2,12,3,13,9,993,0.25,0.98,0.19,0.21
PF06431,PF02217:PF00669:PF14251,3,6,3,0,3,1012,0.5,1.0,1.0,0.71,0,0,3,0,1015,0,1.0,0.0,0
PF01189,PF17125:PF01029:PF01472,28,25,14,14,11,979,0.56,0.98,0.5,0.52,4,4,24,0,990,1.0,0.98,0.14,0.37
PF11905,PF03647:PF05859:PF03851,32,22,6,26,16,970,0.27,0.96,0.19,0.21,6,4,28,2,984,0.67,0.97,0.12,0.28
PF10105,PF11230:PF11842:PF12345,2,2,2,0,0,1016,1.0,1.0,1.0,1.0,2,2,0,0,1016,1.0,1.0,1.0,1.0
PF10366,PF10367:PF00637:PF17122,14,35,12,2,23,981,0.34,0.98,0.86,0.53,12,6,8,6,998,0.5,0.99,0.43,0.46
PF02175,PF03488:PF14747:PF09057,1,1,0,1,1,1016,0.0,1.0,0.0,-0.0,0,0,1,0,1017,0,1.0,0.0,0
PF04082,PF11951:PF16846:PF08493,154,81,56,98,25,839,0.69,0.88,0.36,0.44,3,3,151,0,864,1.0,0.85,0.02,0.13
PF00019,PF00688:PF10156:PF09771,20,17,16,4,1,997,0.94,1.0,0.8,0.87,6,6,14,0,998,1.0,0.99,0.3,0.54
PF08944,PF16621:PF03700:PF12828,2,5,2,0,3,1013,0.4,1.0,1.0,0.63,1,1,1,0,1016,1.0,1.0,0.5,0.71
PF15133,PF17076:PF15281:PF14290,1,3,0,1,3,1014,0.0,1.0,0.0,-0.0,0,0,1,0,1017,0,1.0,0.0,0
PF12444,PF09667:PF16090:PF13775,0,5,0,0,5,1013,0.0,1.0,0,0,0,0,0,0,1018,0,1.0,0,0
PF03044,PF05445:PF00004:PF00400,0,312,0,0,312,706,0.0,0.69,0,0,104,0,0,104,914,0.0,0.9,0,0
PF01555,PF09461:PF03553:PF08945,7,1,0,7,1,1010,0.0,0.99,0.0,-0.0,0,0,7,0,1011,0,0.99,0.0,0
PF04343,PF06724:PF04076:PF15202,0,0,0,0,0,1018,0,1.0,0,0,0,0,0,0,1018,0,1.0,0,0
PF12760,PF03831:PF05913:PF03539,0,2,0,0,2,1016,0.0,1.0,0,0,0,0,0,0,1018,0,1.0,0,0
PF00689,PF08282:PF12409:PF16212,62,64,31,31,33,923,0.48,0.94,0.5,0.46,13,9,53,4,952,0.69,0.94,0.15,0.3
PF13840,PF10000:PF00742:PF03447,11,19,3,8,16,991,0.16,0.98,0.27,0.2,8,3,8,5,1002,0.38,0.99,0.27,0.31
PF15982,PF14360:PF09822:PF10022,2,21,0,2,21,995,0.0,0.98,0.0,-0.01,1,0,2,1,1015,0.0,1.0,0.0,-0.0
PF13006,PF05671:PF01254:PF11924,3,4,1,2,3,1012,0.25,1.0,0.33,0.29,0,0,3,0,1015,0,1.0,0.0,0
PF08358,PF03498:PF15756:PF04966,1,2,0,1,2,1015,0.0,1.0,0.0,-0.0,1,0,1,1,1016,0.0,1.0,0.0,-0.0
PF02885,PF07831:PF00591:PF05683,6,11,5,1,6,1006,0.45,0.99,0.83,0.61,2,2,4,0,1012,1.0,1.0,0.33,0.58
PF00228,PF04916:PF08369:PF10261,4,12,3,1,9,1005,0.25,0.99,0.75,0.43,1,1,3,0,1014,1.0,1.0,0.25,0.5
PF03229,PF17110:PF12891:PF05808,2,3,1,1,2,1014,0.33,1.0,0.5,0.41,0,0,2,0,1016,0,1.0,0.0,0
PF14295,PF00024:PF08277:PF08562,38,53,25,13,28,952,0.47,0.96,0.66,0.54,8,4,34,4,976,0.5,0.96,0.11,0.22
PF10292,PF02115:PF03125:PF08617,12,26,2,10,24,982,0.08,0.97,0.17,0.1,3,2,10,1,1005,0.67,0.99,0.17,0.33
PF10241,PF03604:PF05162:PF08122,5,14,2,3,12,1001,0.14,0.99,0.4,0.23,4,1,4,3,1010,0.25,0.99,0.2,0.22
PF00643,PF03915:PF12126:PF13445,55,62,37,18,25,938,0.6,0.96,0.67,0.61,6,5,50,1,962,0.83,0.95,0.09,0.27
PF15486,PF04296:PF13751:PF11217,1,3,0,1,3,1014,0.0,1.0,0.0,-0.0,1,0,1,1,1016,0.0,1.0,0.0,-0.0
PF07084,PF07956:PF04710:PF15993,2,11,1,1,10,1006,0.09,0.99,0.5,0.21,1,0,2,1,1015,0.0,1.0,0.0,-0.0
PF08291,PF05962:PF15775:PF05894,0,1,0,0,1,1017,0.0,1.0,0,0,0,0,0,0,1018,0,1.0,0,0
PF15108,PF01943:PF15483:PF05326,2,1,0,2,1,1015,0.0,1.0,0.0,-0.0,0,0,2,0,1016,0,1.0,0.0,0
PF03930,PF15518:PF04865:PF00915,0,2,0,0,2,1016,0.0,1.0,0,0,0,0,0,0,1018,0,1.0,0,0
PF00217,PF02807:PF14868:PF12078,19,22,16,3,6,993,0.73,0.99,0.84,0.78,2,2,17,0,999,1.0,0.98,0.11,0.32
PF05435,PF08485:PF03832:PF04285,4,5,0,4,5,1009,0.0,0.99,0.0,-0.0,0,0,4,0,1014,0,1.0,0.0,0
PF14087,PF07327:PF09252:PF08576,9,4,1,8,3,1006,0.25,0.99,0.11,0.16,0,0,9,0,1009,0,0.99,0.0,0
PF11251,PF16968:PF14258:PF13036,0,0,0,0,0,1018,0,1.0,0,0,0,0,0,0,1018,0,1.0,0,0
PF11702,PF07573:PF08550:PF10671,1,13,1,0,12,1005,0.08,0.99,1.0,0.28,4,0,1,4,1013,0.0,1.0,0.0,-0.0
PF09363,PF09364:PF03894:PF08369,2,3,2,0,1,1015,0.67,1.0,1.0,0.82,2,2,0,0,1016,1.0,1.0,1.0,1.0
PF15746,PF15480:PF15729:PF15107,0,2,0,0,2,1016,0.0,1.0,0,0,0,0,0,0,1018,0,1.0,0,0
PF08091,PF11312:PF12840:PF01303,0,1,0,0,1,1017,0.0,1.0,0,0,0,0,0,0,1018,0,1.0,0,0
PF04008,PF06239:PF11051:PF12018,0,19,0,0,19,999,0.0,0.98,0,0,3,0,0,3,1015,0.0,1.0,0,0
PF11104,PF01292:PF07075:PF06355,0,10,0,0,10,1008,0.0,0.99,0,0,0,0,0,0,1018,0,1.0,0,0
PF06258,PF15699:PF06521:PF17032,4,1,0,4,1,1013,0.0,1.0,0.0,-0.0,0,0,4,0,1014,0,1.0,0.0,0
PF16966,PF11471:PF10106:PF10057,0,1,0,0,1,1017,0.0,1.0,0,0,0,0,0,0,1018,0,1.0,0,0
PF11145,PF04674:PF04525:PF04535,2,12,2,0,10,1006,0.17,0.99,1.0,0.41,2,2,0,0,1016,1.0,1.0,1.0,1.0
PF00073,PF00548:PF12381:PF08762,12,12,12,0,0,1006,1.0,1.0,1.0,1.0,4,4,8,0,1006,1.0,0.99,0.33,0.58
PF10780,PF01097:PF00159:PF06127,0,9,0,0,9,1009,0.0,0.99,0,0,0,0,0,0,1018,0,1.0,0,0
PF09822,PF14764:PF02449:PF11698,5,24,1,4,23,990,0.04,0.97,0.2,0.08,2,0,5,2,1011,0.0,0.99,0.0,-0.0
PF13225,PF00468:PF02915:PF13092,3,13,1,2,12,1003,0.08,0.99,0.33,0.16,1,0,3,1,1014,0.0,1.0,0.0,-0.0
PF01929,PF01777:PF17136:PF00900,17,31,6,11,25,976,0.19,0.96,0.35,0.24,8,4,13,4,997,0.5,0.98,0.24,0.34
PF00026,PF07966:PF14543:PF00759,59,37,19,40,18,941,0.51,0.94,0.32,0.38,11,9,50,2,957,0.82,0.95,0.15,0.34
PF00932,PF16208:PF04732:PF00038,6,22,5,1,17,995,0.23,0.98,0.83,0.43,7,2,4,5,1007,0.29,0.99,0.33,0.3
PF08879,PF08880:PF10497:PF02928,4,25,3,1,22,992,0.12,0.98,0.75,0.29,4,2,2,2,1012,0.5,1.0,0.5,0.5
PF02825,PF12174:PF00644:PF06012,26,49,15,11,34,958,0.31,0.96,0.58,0.4,6,5,21,1,991,0.83,0.98,0.19,0.39
PF08169,PF12031:PF01388:PF02928,5,33,5,0,28,985,0.15,0.97,1.0,0.38,15,2,3,13,1000,0.13,0.98,0.4,0.22
PF09924,PF03741:PF11690:PF08653,5,8,3,2,5,1008,0.38,0.99,0.6,0.47,0,0,5,0,1013,0,1.0,0.0,0
PF11714,PF00618:PF02966:PF00520,0,110,0,0,110,908,0.0,0.89,0,0,27,0,0,27,991,0.0,0.97,0,0
PF15813,PF02200:PF09038:PF14977,4,7,1,3,6,1008,0.14,0.99,0.25,0.18,0,0,4,0,1014,0,1.0,0.0,0
PF02992,PF13960:PF13963:PF13952,13,13,9,4,4,1001,0.69,0.99,0.69,0.69,3,3,10,0,1005,1.0,0.99,0.23,0.48
PF02108,PF05164:PF16872:PF11291,0,0,0,0,0,1018,0,1.0,0,0,0,0,0,0,1018,0,1.0,0,0
PF09751,PF15388:PF07767:PF15390,7,12,4,3,8,1003,0.33,0.99,0.57,0.43,2,2,5,0,1011,1.0,1.0,0.29,0.53
PF12744,PF16577:PF04586:PF06586,1,4,1,0,3,1014,0.25,1.0,1.0,0.5,0,0,1,0,1017,0,1.0,0.0,0
PF09372,PF09310:PF16553:PF15898,1,3,1,0,2,1015,0.33,1.0,1.0,0.58,0,0,1,0,1017,0,1.0,0.0,0
PF02472,PF06586:PF05974:PF03389,1,1,0,1,1,1016,0.0,1.0,0.0,-0.0,0,0,1,0,1017,0,1.0,0.0,0
PF00580,PF13361:PF12859:PF11781,18,22,16,2,6,994,0.73,0.99,0.89,0.8,5,5,13,0,1000,1.0,0.99,0.28,0.52
PF15687,PF15688:PF15690:PF15689,0,0,0,0,0,1018,0,1.0,0,0,0,0,0,0,1018,0,1.0,0,0
PF14323,PF08483:PF10109:PF02565,0,1,0,0,1,1017,0.0,1.0,0,0,0,0,0,0,1018,0,1.0,0,0
PF10252,PF01632:PF10218:PF09597,1,6,0,1,6,1011,0.0,0.99,0.0,-0.0,0,0,1,0,1017,0,1.0,0.0,0
PF00455,PF07476:PF08483:PF08299,3,2,0,3,2,1013,0.0,1.0,0.0,-0.0,1,0,3,1,1014,0.0,1.0,0.0,-0.0
PF12010,PF01339:PF04397:PF12532,1,7,1,0,6,1011,0.14,0.99,1.0,0.38,0,0,1,0,1017,0,1.0,0.0,0
PF09029,PF07706:PF00155:PF00392,2,111,2,0,109,907,0.02,0.89,1.0,0.13,11,1,1,10,1006,0.09,0.99,0.5,0.21
PF01087,PF02744:PF12243:PF01729,8,20,8,0,12,998,0.4,0.99,1.0,0.63,1,0,8,1,1009,0.0,0.99,0.0,-0.0
PF02182,PF12148:PF14051:PF12165,18,13,7,11,6,994,0.54,0.98,0.39,0.45,2,2,16,0,1000,1.0,0.98,0.11,0.33
PF15412,PF11116:PF14971:PF08439,6,2,0,6,2,1010,0.0,0.99,0.0,-0.0,0,0,6,0,1012,0,0.99,0.0,0
PF10596,PF10597:PF12134:PF08082,18,17,17,1,0,1000,1.0,1.0,0.94,0.97,15,15,3,0,1000,1.0,1.0,0.83,0.91
PF05391,PF07807:PF10378:PF15861,1,12,1,0,11,1006,0.08,0.99,1.0,0.29,1,1,0,0,1017,1.0,1.0,1.0,1.0
PF04502,PF00836:PF03360:PF13593,23,26,11,12,15,980,0.42,0.97,0.48,0.44,4,3,20,1,994,0.75,0.98,0.13,0.31
PF04762,PF16940:PF02219:PF07034,8,15,2,6,13,997,0.13,0.98,0.25,0.17,3,1,7,2,1008,0.33,0.99,0.12,0.2
PF03255,PF12297:PF07926:PF03801,12,14,4,8,10,996,0.29,0.98,0.33,0.3,4,3,9,1,1005,0.75,0.99,0.25,0.43
PF00904,PF10583:PF00879:PF05436,0,1,0,0,1,1017,0.0,1.0,0,0,0,0,0,0,1018,0,1.0,0,0
PF09980,PF15114:PF03050:PF15207,0,1,0,0,1,1017,0.0,1.0,0,0,0,0,0,0,1018,0,1.0,0,0
PF03196,PF11860:PF06744:PF13421,0,0,0,0,0,1018,0,1.0,0,0,0,0,0,0,1018,0,1.0,0,0
PF04136,PF04048:PF10441:PF14952,13,18,6,7,12,993,0.33,0.98,0.46,0.38,0,0,13,0,1005,0,0.99,0.0,0
PF08083,PF08084:PF08082:PF12134,13,17,13,0,4,1001,0.76,1.0,1.0,0.87,13,13,0,0,1005,1.0,1.0,1.0,1.0
PF02498,PF05272:PF06761:PF15976,0,0,0,0,0,1018,0,1.0,0,0,0,0,0,0,1018,0,1.0,0,0
PF04598,PF15718:PF15148:PF00837,3,5,1,2,4,1011,0.2,0.99,0.33,0.26,1,1,2,0,1015,1.0,1.0,0.33,0.58
PF13236,PF15044:PF12807:PF05303,11,10,6,5,4,1003,0.6,0.99,0.55,0.57,5,5,6,0,1007,1.0,0.99,0.45,0.67
PF10222,PF14308:PF00684:PF05207,8,23,3,5,20,990,0.13,0.98,0.38,0.21,4,2,6,2,1008,0.5,0.99,0.25,0.35
PF03414,PF06951:PF12301:PF09777,5,14,3,2,11,1002,0.21,0.99,0.6,0.35,0,0,5,0,1013,0,1.0,0.0,0
PF02616,PF07409:PF07157:PF14882,0,0,0,0,0,1018,0,1.0,0,0,0,0,0,0,1018,0,1.0,0,0
PF15003,PF03760:PF03823:PF13564,1,11,0,1,11,1006,0.0,0.99,0.0,-0.0,2,0,1,2,1015,0.0,1.0,0.0,-0.0
PF00496,PF12911:PF12800:PF06808,14,9,3,11,6,998,0.33,0.98,0.21,0.26,3,3,11,0,1004,1.0,0.99,0.21,0.46
PF16546,PF07219:PF11998:PF04049,12,16,4,8,12,994,0.25,0.98,0.33,0.28,2,2,10,0,1006,1.0,0.99,0.17,0.41
PF05869,PF02160:PF15435:PF03539,3,1,0,3,1,1014,0.0,1.0,0.0,-0.0,1,0,3,1,1014,0.0,1.0,0.0,-0.0
PF11740,PF08291:PF08857:PF15496,0,1,0,0,1,1017,0.0,1.0,0,0,0,0,0,0,1018,0,1.0,0,0
PF06039,PF05564:PF13164:PF15578,2,3,1,1,2,1014,0.33,1.0,0.5,0.41,1,1,1,0,1016,1.0,1.0,0.5,0.71
PF12349,PF16414:PF02460:PF03176,21,53,18,3,35,962,0.34,0.96,0.86,0.53,19,10,11,9,988,0.53,0.98,0.48,0.49
PF15431,PF06834:PF10139:PF07805,0,1,0,0,1,1017,0.0,1.0,0,0,0,0,0,0,1018,0,1.0,0,0
PF09695,PF01753:PF00613:PF00575,0,93,0,0,93,925,0.0,0.91,0,0,29,0,0,29,989,0.0,0.97,0,0
PF10329,PF05704:PF08386:PF06441,4,34,2,2,32,982,0.06,0.97,0.5,0.16,3,1,3,2,1012,0.33,1.0,0.25,0.29
PF08221,PF10644:PF05645:PF08158,8,22,6,2,16,994,0.27,0.98,0.75,0.45,1,1,7,0,1010,1.0,0.99,0.12,0.35
PF10067,PF08058:PF02683:PF15346,1,5,1,0,4,1013,0.2,1.0,1.0,0.45,0,0,1,0,1017,0,1.0,0.0,0
PF08888,PF15212:PF06573:PF01303,0,2,0,0,2,1016,0.0,1.0,0,0,0,0,0,0,1018,0,1.0,0,0
PF10063,PF06695:PF12646:PF15062,3,0,0,3,0,1015,0,1.0,0.0,0,0,0,3,0,1015,0,1.0,0.0,0
PF02311,PF06249:PF06339:PF02502,8,14,1,7,13,997,0.07,0.98,0.12,0.09,1,0,8,1,1009,0.0,0.99,0.0,-0.0
PF07508,PF13408:PF00239:PF08461,2,3,2,0,1,1015,0.67,1.0,1.0,0.82,2,2,0,0,1016,1.0,1.0,1.0,1.0
PF09132,PF15685:PF07149:PF04223,0,1,0,0,1,1017,0.0,1.0,0,0,0,0,0,0,1018,0,1.0,0,0
PF00585,PF00290:PF14821:PF01418,4,13,0,4,13,1001,0.0,0.98,0.0,-0.01,0,0,4,0,1014,0,1.0,0.0,0
PF04053,PF06957:PF15512:PF04192,24,17,12,12,5,989,0.71,0.98,0.5,0.59,3,3,21,0,994,1.0,0.98,0.12,0.35
PF09013,PF07334:PF11952:PF05743,2,17,1,1,16,1000,0.06,0.98,0.5,0.17,1,0,2,1,1015,0.0,1.0,0.0,-0.0
PF04885,PF04674:PF07966:PF09478,1,13,0,1,13,1004,0.0,0.99,0.0,-0.0,3,0,1,3,1014,0.0,1.0,0.0,-0.0
PF07701,PF00211:PF08376:PF12849,19,64,19,0,45,954,0.3,0.96,1.0,0.53,7,5,14,2,997,0.71,0.98,0.26,0.43
PF11084,PF09732:PF02304:PF11128,0,11,0,0,11,1007,0.0,0.99,0,0,0,0,0,0,1018,0,1.0,0,0
PF02260,PF11865:PF02259:PF08771,24,30,18,6,12,982,0.6,0.98,0.75,0.66,10,10,14,0,994,1.0,0.99,0.42,0.64
PF04922,PF06172:PF02089:PF10266,9,15,3,6,12,997,0.2,0.98,0.33,0.25,0,0,9,0,1009,0,0.99,0.0,0
PF02412,PF05735:PF12947:PF13442,3,32,3,0,29,986,0.09,0.97,1.0,0.3,5,3,0,2,1013,0.6,1.0,1.0,0.77
PF01375,PF12726:PF15030:PF11672,2,7,0,2,7,1009,0.0,0.99,0.0,-0.0,0,0,2,0,1016,0,1.0,0.0,0
PF06623,PF00195:PF08344:PF14365,1,29,1,0,28,989,0.03,0.97,1.0,0.18,4,0,1,4,1013,0.0,1.0,0.0,-0.0
PF00464,PF02284:PF09439:PF01625,25,30,11,14,19,974,0.37,0.97,0.44,0.39,2,1,24,1,992,0.5,0.98,0.04,0.14
PF02467,PF14552:PF13366:PF07996,0,4,0,0,4,1014,0.0,1.0,0,0,0,0,0,0,1018,0,1.0,0,0
PF04833,PF06830:PF06880:PF04859,2,5,0,2,5,1011,0.0,0.99,0.0,-0.0,0,0,2,0,1016,0,1.0,0.0,0
PF01335,PF13820:PF00531:PF09034,13,39,11,2,28,977,0.28,0.97,0.85,0.48,3,2,11,1,1004,0.67,0.99,0.15,0.32
PF04212,PF16565:PF09336:PF06480,35,29,10,25,19,964,0.34,0.96,0.29,0.29,3,2,33,1,982,0.67,0.97,0.06,0.19
PF08819,PF08189:PF12201:PF09394,0,0,0,0,0,1018,0,1.0,0,0,0,0,0,0,1018,0,1.0,0,0
PF06990,PF01244:PF02245:PF04006,13,25,2,11,23,982,0.08,0.97,0.15,0.1,2,1,12,1,1004,0.5,0.99,0.08,0.19
PF08026,PF15085:PF07327:PF15186,0,4,0,0,4,1014,0.0,1.0,0,0,0,0,0,0,1018,0,1.0,0,0
PF00383,PF01872:PF08719:PF08211,51,31,19,32,12,955,0.61,0.96,0.37,0.46,5,5,46,0,967,1.0,0.95,0.1,0.31
PF02671,PF08295:PF16879:PF02761,29,19,16,13,3,986,0.84,0.98,0.55,0.67,16,16,13,0,989,1.0,0.99,0.55,0.74
PF00887,PF00651:PF16553:PF00378,46,160,31,15,129,843,0.19,0.86,0.67,0.31,40,19,27,21,951,0.47,0.95,0.41,0.42
PF04695,PF14922:PF10998:PF06428,12,13,3,9,10,996,0.23,0.98,0.25,0.23,2,1,11,1,1005,0.5,0.99,0.08,0.2
PF16586,PF07409:PF10566:PF07157,0,0,0,0,0,1018,0,1.0,0,0,0,0,0,0,1018,0,1.0,0,0
PF07114,PF10244:PF03980:PF05915,3,12,3,0,9,1006,0.25,0.99,1.0,0.5,1,0,3,1,1014,0.0,1.0,0.0,-0.0
PF08831,PF09307:PF10511:PF02961,3,6,3,0,3,1012,0.5,1.0,1.0,0.71,1,0,3,1,1014,0.0,1.0,0.0,-0.0
PF07034,PF14779:PF02219:PF14764,5,15,3,2,12,1001,0.2,0.99,0.6,0.34,0,0,5,0,1013,0,1.0,0.0,0
PF03272,PF05034:PF08886:PF02572,0,2,0,0,2,1016,0.0,1.0,0,0,0,0,0,0,1018,0,1.0,0,0
PF10547,PF06699:PF04023:PF03747,0,24,0,0,24,994,0.0,0.98,0,0,3,0,0,3,1015,0.0,1.0,0,0
PF15234,PF15851:PF15079:PF01254,0,1,0,0,1,1017,0.0,1.0,0,0,0,0,0,0,1018,0,1.0,0,0
PF04048,PF08638:PF14649:PF14952,11,15,2,9,13,994,0.13,0.98,0.18,0.14,0,0,11,0,1007,0,0.99,0.0,0
PF03185,PF09051:PF09049:PF09050,7,0,0,7,0,1011,0,0.99,0.0,0,0,0,7,0,1011,0,0.99,0.0,0
PF06316,PF00849:PF01747:PF12569,0,58,0,0,58,960,0.0,0.94,0,0,7,0,0,7,1011,0.0,0.99,0,0
PF03531,PF08512:PF13775:PF08644,10,19,10,0,9,999,0.53,0.99,1.0,0.72,7,2,8,5,1003,0.29,0.99,0.2,0.23
PF07856,PF12824:PF06026:PF01470,7,21,3,4,18,993,0.14,0.98,0.43,0.24,4,1,6,3,1008,0.25,0.99,0.14,0.18
PF15186,PF03548:PF03050:PF11697,1,3,0,1,3,1014,0.0,1.0,0.0,-0.0,0,0,1,0,1017,0,1.0,0.0,0
PF16213,PF16206:PF12783:PF09324,22,24,16,6,8,988,0.67,0.99,0.73,0.69,17,15,7,2,994,0.88,0.99,0.68,0.77
PF15721,PF01303:PF15041:PF15085,1,3,0,1,3,1014,0.0,1.0,0.0,-0.0,0,0,1,0,1017,0,1.0,0.0,0
PF03884,PF02886:PF13300:PF07808,1,27,1,0,26,991,0.04,0.97,1.0,0.19,4,0,1,4,1013,0.0,1.0,0.0,-0.0
PF16159,PF09354:PF08430:PF16675,4,6,2,2,4,1010,0.33,0.99,0.5,0.41,4,2,2,2,1012,0.5,1.0,0.5,0.5
PF10221,PF11277:PF08158:PF10479,7,16,3,4,13,998,0.19,0.98,0.43,0.28,5,1,6,4,1007,0.2,0.99,0.14,0.16
PF05653,PF03619:PF14719:PF02301,21,37,7,14,30,967,0.19,0.96,0.33,0.23,4,2,19,2,995,0.5,0.98,0.1,0.21
PF00668,PF16177:PF00975:PF13193,35,92,28,7,64,919,0.3,0.93,0.8,0.47,20,12,23,8,975,0.6,0.97,0.34,0.44
PF03265,PF05148:PF01833:PF00240,18,106,13,5,93,907,0.12,0.9,0.72,0.27,28,12,6,16,984,0.43,0.98,0.67,0.52
PF12740,PF04414:PF11264:PF01128,8,7,2,6,5,1005,0.29,0.99,0.25,0.26,1,1,7,0,1010,1.0,0.99,0.12,0.35
PF03181,PF03514:PF05687:PF08314,5,25,3,2,22,991,0.12,0.98,0.6,0.26,5,0,5,5,1008,0.0,0.99,0.0,-0.0
PF00220,PF15690:PF15689:PF04644,2,1,0,2,1,1015,0.0,1.0,0.0,-0.0,0,0,2,0,1016,0,1.0,0.0,0
PF01770,PF14778:PF05719:PF10317,6,16,1,5,15,997,0.06,0.98,0.17,0.09,1,0,6,1,1011,0.0,0.99,0.0,-0.0
PF00066,PF06816:PF17101:PF17103,13,10,8,5,2,1003,0.8,0.99,0.62,0.7,4,4,9,0,1005,1.0,0.99,0.31,0.55
PF13841,PF01099:PF09777:PF06373,0,3,0,0,3,1015,0.0,1.0,0,0,0,0,0,0,1018,0,1.0,0,0
PF10722,PF04222:PF08479:PF00308,0,5,0,0,5,1013,0.0,1.0,0,0,0,0,0,0,1018,0,1.0,0,0
PF00243,PF01731:PF07258:PF10420,5,18,1,4,17,996,0.06,0.98,0.2,0.1,1,0,5,1,1012,0.0,0.99,0.0,-0.0
PF14413,PF04446:PF00794:PF10785,10,26,10,0,16,992,0.38,0.98,1.0,0.62,11,8,2,3,1005,0.73,1.0,0.8,0.76
PF06728,PF10246:PF10266:PF03932,10,30,3,7,27,981,0.1,0.97,0.3,0.16,3,0,10,3,1005,0.0,0.99,0.0,-0.01
PF12398,PF11883:PF08917:PF08276,4,22,4,0,18,996,0.18,0.98,1.0,0.42,5,4,0,1,1013,0.8,1.0,1.0,0.89
PF03668,PF06070:PF13247:PF08299,5,3,1,4,2,1011,0.33,0.99,0.2,0.26,0,0,5,0,1013,0,1.0,0.0,0
PF17013,PF04370:PF07192:PF08291,0,0,0,0,0,1018,0,1.0,0,0,0,0,0,0,1018,0,1.0,0,0
PF08117,PF06134:PF08267:PF03116,1,5,0,1,5,1012,0.0,0.99,0.0,-0.0,0,0,1,0,1017,0,1.0,0.0,0
PF02080,PF02254:PF08619:PF06826,3,14,2,1,12,1003,0.14,0.99,0.67,0.3,2,1,2,1,1014,0.5,1.0,0.33,0.41
PF08708,PF17206:PF10566:PF03090,0,1,0,0,1,1017,0.0,1.0,0,0,0,0,0,0,1018,0,1.0,0,0
PF02446,PF08536:PF16594:PF01922,2,12,1,1,11,1005,0.08,0.99,0.5,0.2,1,0,2,1,1015,0.0,1.0,0.0,-0.0
PF04479,PF12296:PF11807:PF06609,25,20,12,13,8,985,0.6,0.98,0.48,0.53,10,7,18,3,990,0.7,0.98,0.28,0.43
PF01422,PF13902:PF02195:PF03946,11,34,6,5,28,979,0.18,0.97,0.55,0.3,5,3,8,2,1005,0.6,0.99,0.27,0.4
PF11597,PF06333:PF15927:PF08167,5,15,5,0,10,1003,0.33,0.99,1.0,0.57,3,3,2,0,1013,1.0,1.0,0.6,0.77
PF09104,PF09103:PF09169:PF09121,1,6,1,0,5,1012,0.17,1.0,1.0,0.41,5,1,0,4,1013,0.2,1.0,1.0,0.45
PF03484,PF03483:PF01409:PF03147,14,29,14,0,15,989,0.48,0.99,1.0,0.69,20,11,3,9,995,0.55,0.99,0.79,0.65
PF01125,PF09784:PF01878:PF13933,11,10,2,9,8,999,0.2,0.98,0.18,0.18,0,0,11,0,1007,0,0.99,0.0,0
PF09811,PF07816:PF13225:PF01632,6,8,0,6,8,1004,0.0,0.99,0.0,-0.01,0,0,6,0,1012,0,0.99,0.0,0
PF11227,PF17086:PF01042:PF13906,0,35,0,0,35,983,0.0,0.97,0,0,6,0,0,6,1012,0.0,0.99,0,0
PF00191,PF08378:PF13344:PF10151,24,30,10,14,20,974,0.33,0.97,0.42,0.36,3,3,21,0,994,1.0,0.98,0.12,0.35
PF00095,PF00086:PF10511:PF02961,30,25,11,19,14,974,0.44,0.97,0.37,0.39,3,3,27,0,988,1.0,0.97,0.1,0.31
PF06863,PF06742:PF07364:PF02884,0,7,0,0,7,1011,0.0,0.99,0,0,0,0,0,0,1018,0,1.0,0,0
PF15924,PF13439:PF12038:PF04413,5,25,2,3,23,990,0.08,0.97,0.4,0.17,1,1,4,0,1013,1.0,1.0,0.2,0.45
PF02270,PF17223:PF16972:PF11069,17,6,1,16,5,996,0.17,0.98,0.06,0.09,0,0,17,0,1001,0,0.98,0.0,0
PF15360,PF15550:PF15107:PF01316,2,2,0,2,2,1014,0.0,1.0,0.0,-0.0,0,0,2,0,1016,0,1.0,0.0,0
PF11134,PF02979:PF15817:PF04860,0,5,0,0,5,1013,0.0,1.0,0,0,0,0,0,0,1018,0,1.0,0,0
PF10506,PF11559:PF15784:PF15368,4,7,0,4,7,1007,0.0,0.99,0.0,-0.01,0,0,4,0,1014,0,1.0,0.0,0
PF12411,PF16347:PF12548:PF08019,1,12,1,0,11,1006,0.08,0.99,1.0,0.29,2,1,0,1,1016,0.5,1.0,1.0,0.71
PF01996,PF11403:PF10816:PF07934,0,15,0,0,15,1003,0.0,0.99,0,0,0,0,0,0,1018,0,1.0,0,0
PF06672,PF06832:PF07804:PF04355,0,2,0,0,2,1016,0.0,1.0,0,0,0,0,0,0,1018,0,1.0,0,0
PF06826,PF10554:PF13722:PF03090,1,0,0,1,0,1017,0,1.0,0.0,0,0,0,1,0,1017,0,1.0,0.0,0
PF15844,PF08116:PF00732:PF00106,0,203,0,0,203,815,0.0,0.8,0,0,40,0,0,40,978,0.0,0.96,0,0
PF12689,PF09778:PF12223:PF16954,11,5,1,10,4,1003,0.2,0.99,0.09,0.13,0,0,11,0,1007,0,0.99,0.0,0
PF03739,PF17193:PF15281:PF06798,5,3,0,5,3,1010,0.0,0.99,0.0,-0.0,0,0,5,0,1013,0,1.0,0.0,0
PF01255,PF02089:PF00810:PF02284,22,26,4,18,22,974,0.15,0.96,0.18,0.15,5,3,19,2,994,0.6,0.98,0.14,0.28
PF03872,PF04314:PF15732:PF02830,1,0,0,1,0,1017,0,1.0,0.0,0,0,0,1,0,1017,0,1.0,0.0,0
PF02212,PF00350:PF01031:PF11698,34,76,34,0,42,942,0.45,0.96,1.0,0.65,42,29,5,13,971,0.69,0.98,0.85,0.76
PF03472,PF09614:PF15529:PF13722,0,0,0,0,0,1018,0,1.0,0,0,0,0,0,0,1018,0,1.0,0,0
PF03963,PF07559:PF06429:PF07499,1,4,1,0,3,1014,0.25,1.0,1.0,0.5,1,1,0,0,1017,1.0,1.0,1.0,1.0
PF00213,PF00210:PF02284:PF01625,16,32,6,10,26,976,0.19,0.96,0.38,0.25,6,3,13,3,999,0.5,0.98,0.19,0.3
PF01092,PF10234:PF09282:PF15301,11,8,3,8,5,1002,0.38,0.99,0.27,0.31,1,1,10,0,1007,1.0,0.99,0.09,0.3
PF02070,PF12153:PF15762:PF06681,0,0,0,0,0,1018,0,1.0,0,0,0,0,0,0,1018,0,1.0,0,0
PF15096,PF15623:PF04624:PF00997,0,1,0,0,1,1017,0.0,1.0,0,0,0,0,0,0,1018,0,1.0,0,0
PF00955,PF07565:PF00359:PF02735,20,32,9,11,23,975,0.28,0.97,0.45,0.34,1,1,19,0,998,1.0,0.98,0.05,0.22
PF00878,PF00040:PF00039:PF15149,4,20,3,1,17,997,0.15,0.98,0.75,0.33,3,1,3,2,1012,0.33,1.0,0.25,0.29
PF14991,PF14659:PF01514:PF04754,0,2,0,0,2,1016,0.0,1.0,0,0,1,0,0,1,1017,0.0,1.0,0,0
PF04414,PF10340:PF10868:PF08058,3,0,0,3,0,1015,0,1.0,0.0,0,0,0,3,0,1015,0,1.0,0.0,0
PF04716,PF01632:PF08561:PF10218,13,10,2,11,8,997,0.2,0.98,0.15,0.17,0,0,13,0,1005,0,0.99,0.0,0
PF03978,PF13618:PF13785:PF12105,0,5,0,0,5,1013,0.0,1.0,0,0,0,0,0,0,1018,0,1.0,0,0
PF17085,PF15060:PF15231:PF15741,0,1,0,0,1,1017,0.0,1.0,0,0,0,0,0,0,1018,0,1.0,0,0
PF00779,PF00616:PF00017:PF08916,7,83,7,0,76,935,0.08,0.93,1.0,0.28,12,4,3,8,1003,0.33,0.99,0.57,0.43
PF17027,PF10618:PF08453:PF03428,0,2,0,0,2,1016,0.0,1.0,0,0,0,0,0,0,1018,0,1.0,0,0
PF02784,PF00278:PF01536:PF00481,19,82,17,2,65,934,0.21,0.93,0.89,0.41,16,9,10,7,992,0.56,0.98,0.47,0.51
PF16674,PF14836:PF11522:PF09247,1,13,1,0,12,1005,0.08,0.99,1.0,0.28,1,0,1,1,1016,0.0,1.0,0.0,-0.0
PF01520,PF03244:PF08334:PF08411,3,2,0,3,2,1013,0.0,1.0,0.0,-0.0,0,0,3,0,1015,0,1.0,0.0,0
PF07093,PF09751:PF05653:PF14719,4,28,1,3,27,987,0.04,0.97,0.25,0.09,3,1,3,2,1012,0.33,1.0,0.25,0.29
PF00427,PF00502:PF01383:PF12853,0,6,0,0,6,1012,0.0,0.99,0,0,0,0,0,0,1018,0,1.0,0,0
PF06047,PF07222:PF06869:PF13824,8,5,2,6,3,1007,0.4,0.99,0.25,0.31,1,1,7,0,1010,1.0,0.99,0.12,0.35
PF07165,PF02284:PF14935:PF08584,2,11,0,2,11,1005,0.0,0.99,0.0,-0.0,1,0,2,1,1015,0.0,1.0,0.0,-0.0
PF13202,PF13833:PF13405:PF00036,68,78,44,24,34,916,0.56,0.94,0.65,0.57,31,26,42,5,945,0.84,0.95,0.38,0.55
PF14728,PF14727:PF13725:PF15006,5,21,5,0,16,997,0.24,0.98,1.0,0.48,2,2,3,0,1013,1.0,1.0,0.4,0.63
PF00227,PF10584:PF12465:PF03357,87,67,45,42,22,909,0.67,0.94,0.52,0.56,13,13,74,0,931,1.0,0.93,0.15,0.37
PF13388,PF12240:PF15866:PF15248,0,8,0,0,8,1010,0.0,0.99,0,0,3,0,0,3,1015,0.0,1.0,0,0
PF10988,PF13722:PF06890:PF05488,0,0,0,0,0,1018,0,1.0,0,0,0,0,0,0,1018,0,1.0,0,0
PF16014,PF04632:PF07610:PF03534,0,1,0,0,1,1017,0.0,1.0,0,0,0,0,0,0,1018,0,1.0,0,0
PF08675,PF04857:PF08636:PF07798,4,28,4,0,24,990,0.14,0.98,1.0,0.37,5,1,3,4,1010,0.2,0.99,0.25,0.22
PF15111,PF07520:PF14983:PF02530,1,3,0,1,3,1014,0.0,1.0,0.0,-0.0,0,0,1,0,1017,0,1.0,0.0,0
PF09469,PF12516:PF15778:PF08729,2,7,0,2,7,1009,0.0,0.99,0.0,-0.0,0,0,2,0,1016,0,1.0,0.0,0
PF10153,PF11291:PF15122:PF07197,5,1,0,5,1,1012,0.0,0.99,0.0,-0.0,0,0,5,0,1013,0,1.0,0.0,0
PF00821,PF08925:PF16062:PF03932,3,27,1,2,26,989,0.04,0.97,0.33,0.1,2,0,3,2,1013,0.0,1.0,0.0,-0.0
PF14564,PF06761:PF07149:PF03963,1,1,0,1,1,1016,0.0,1.0,0.0,-0.0,0,0,1,0,1017,0,1.0,0.0,0
PF00184,PF02740:PF09050:PF09051,2,1,0,2,1,1015,0.0,1.0,0.0,-0.0,0,0,2,0,1016,0,1.0,0.0,0
PF01108,PF09294:PF07140:PF06736,3,4,2,1,2,1013,0.5,1.0,0.67,0.58,1,1,2,0,1015,1.0,1.0,0.33,0.58
PF14952,PF12372:PF12231:PF15912,2,11,0,2,11,1005,0.0,0.99,0.0,-0.0,0,0,2,0,1016,0,1.0,0.0,0
PF08526,PF03068:PF08527:PF02971,4,12,4,0,8,1006,0.33,0.99,1.0,0.58,4,4,0,0,1014,1.0,1.0,1.0,1.0
PF03051,PF07096:PF05351:PF08661,10,19,4,6,15,993,0.21,0.98,0.4,0.28,1,1,9,0,1008,1.0,0.99,0.1,0.31
PF01937,PF03630:PF06888:PF05742,17,18,7,10,11,990,0.39,0.98,0.41,0.39,5,4,13,1,1000,0.8,0.99,0.24,0.43
PF01314,PF15708:PF02503:PF06890,4,2,0,4,2,1012,0.0,0.99,0.0,-0.0,0,0,4,0,1014,0,1.0,0.0,0
PF05149,PF05551:PF14988:PF15311,2,7,0,2,7,1009,0.0,0.99,0.0,-0.0,2,0,2,2,1014,0.0,1.0,0.0,-0.0
PF16524,PF07695:PF16448:PF08918,2,5,2,0,3,1013,0.4,1.0,1.0,0.63,1,1,1,0,1016,1.0,1.0,0.5,0.71
PF08267,PF01717:PF14577:PF08207,3,21,3,0,18,997,0.14,0.98,1.0,0.37,2,0,3,2,1013,0.0,1.0,0.0,-0.0
PF03980,PF08561:PF06127:PF01097,4,12,1,3,11,1003,0.08,0.99,0.25,0.14,0,0,4,0,1014,0,1.0,0.0,0
PF01095,PF04043:PF01397:PF00215,29,49,19,10,30,959,0.39,0.96,0.66,0.49,9,8,21,1,988,0.89,0.98,0.28,0.49
PF04617,PF10525:PF13293:PF03867,1,4,1,0,3,1014,0.25,1.0,1.0,0.5,1,1,0,0,1017,1.0,1.0,1.0,1.0
PF06417,PF02936:PF03587:PF04923,8,18,4,4,14,996,0.22,0.98,0.5,0.33,2,2,6,0,1010,1.0,0.99,0.25,0.5
PF05666,PF14659:PF05939:PF01913,0,3,0,0,3,1015,0.0,1.0,0,0,0,0,0,0,1018,0,1.0,0,0
PF06339,PF14323:PF15272:PF15935,5,0,0,5,0,1013,0,1.0,0.0,0,0,0,5,0,1013,0,1.0,0.0,0
PF00716,PF01314:PF09798:PF15482,1,4,0,1,4,1013,0.0,1.0,0.0,-0.0,0,0,1,0,1017,0,1.0,0.0,0
PF08833,PF16646:PF00778:PF00631,2,26,2,0,24,992,0.08,0.98,1.0,0.27,2,0,2,2,1014,0.0,1.0,0.0,-0.0
PF08780,PF13645:PF01111:PF09793,0,12,0,0,12,1006,0.0,0.99,0,0,2,0,0,2,1016,0.0,1.0,0,0
PF16326,PF01032:PF09383:PF12857,5,5,2,3,3,1010,0.4,0.99,0.4,0.4,2,2,3,0,1013,1.0,1.0,0.4,0.63
PF02906,PF12617:PF02256:PF12139,13,4,4,9,0,1005,1.0,0.99,0.31,0.55,0,0,13,0,1005,0,0.99,0.0,0
PF11618,PF16056:PF15625:PF09457,4,14,2,2,12,1002,0.14,0.99,0.5,0.26,1,1,3,0,1014,1.0,1.0,0.25,0.5
PF08099,PF01668:PF05754:PF17002,1,2,0,1,2,1015,0.0,1.0,0.0,-0.0,0,0,1,0,1017,0,1.0,0.0,0
PF15823,PF07157:PF11751:PF06403,0,1,0,0,1,1017,0.0,1.0,0,0,0,0,0,0,1018,0,1.0,0,0
PF02329,PF08127:PF05534:PF02550,1,13,0,1,13,1004,0.0,0.99,0.0,-0.0,0,0,1,0,1017,0,1.0,0.0,0
PF04565,PF04561:PF00562:PF10385,19,22,18,1,4,995,0.82,1.0,0.95,0.88,6,5,14,1,998,0.83,0.99,0.26,0.46
PF03386,PF06825:PF05512:PF01176,0,16,0,0,16,1002,0.0,0.98,0,0,4,0,0,4,1014,0.0,1.0,0,0
PF13634,PF12110:PF04096:PF05064,19,21,13,6,8,991,0.62,0.99,0.68,0.64,10,6,13,4,995,0.6,0.98,0.32,0.43
PF09238,PF15914:PF14726:PF11261,2,12,1,1,11,1005,0.08,0.99,0.5,0.2,1,0,2,1,1015,0.0,1.0,0.0,-0.0
PF06882,PF09829:PF08724:PF11026,2,0,0,2,0,1016,0,1.0,0.0,0,0,0,2,0,1016,0,1.0,0.0,0
PF02945,PF03175:PF13251:PF15995,6,15,6,0,9,1003,0.4,0.99,1.0,0.63,0,0,6,0,1012,0,0.99,0.0,0
PF00974,PF02465:PF08497:PF11019,0,0,0,0,0,1018,0,1.0,0,0,0,0,0,0,1018,0,1.0,0,0
PF05437,PF05904:PF13960:PF15412,0,10,0,0,10,1008,0.0,0.99,0,0,1,0,0,1,1017,0.0,1.0,0,0
PF00694,PF00330:PF11791:PF06434,31,36,28,3,8,979,0.78,0.99,0.9,0.83,2,1,30,1,986,0.5,0.97,0.03,0.12
PF09398,PF06541:PF07281:PF10839,6,4,0,6,4,1008,0.0,0.99,0.0,-0.0,0,0,6,0,1012,0,0.99,0.0,0
PF00505,PF09011:PF13017:PF08347,61,18,16,45,2,955,0.89,0.95,0.26,0.47,1,1,60,0,957,1.0,0.94,0.02,0.12
PF11699,PF15622:PF07394:PF15395,6,4,0,6,4,1008,0.0,0.99,0.0,-0.0,0,0,6,0,1012,0,0.99,0.0,0
PF02001,PF13739:PF07937:PF13011,0,0,0,0,0,1018,0,1.0,0,0,0,0,0,0,1018,0,1.0,0,0
PF12045,PF12284:PF03529:PF03867,1,2,1,0,1,1016,0.5,1.0,1.0,0.71,1,1,0,0,1017,1.0,1.0,1.0,1.0
PF12304,PF15003:PF03823:PF15744,1,4,0,1,4,1013,0.0,1.0,0.0,-0.0,0,0,1,0,1017,0,1.0,0.0,0
PF04880,PF11831:PF13870:PF15934,3,14,1,2,13,1002,0.07,0.99,0.33,0.15,1,0,3,1,1014,0.0,1.0,0.0,-0.0
PF08707,PF08453:PF17164:PF11751,1,2,0,1,2,1015,0.0,1.0,0.0,-0.0,0,0,1,0,1017,0,1.0,0.0,0
PF03632,PF03636:PF03633:PF04935,8,12,4,4,8,1002,0.33,0.99,0.5,0.4,1,1,7,0,1010,1.0,0.99,0.12,0.35
PF07492,PF01204:PF02268:PF02751,9,32,9,0,23,986,0.28,0.98,1.0,0.52,14,3,6,11,998,0.21,0.98,0.33,0.26
PF07394,PF09462:PF15082:PF01660,4,10,0,4,10,1004,0.0,0.99,0.0,-0.01,1,0,4,1,1013,0.0,1.0,0.0,-0.0
PF16191,PF16190:PF10585:PF16195,4,5,3,1,2,1012,0.6,1.0,0.75,0.67,3,3,1,0,1014,1.0,1.0,0.75,0.87
PF00536,PF07647:PF10534:PF09246,62,42,28,34,14,942,0.67,0.95,0.45,0.53,2,2,60,0,956,1.0,0.94,0.03,0.17
PF07350,PF02284:PF11779:PF12296,2,16,1,1,15,1001,0.06,0.98,0.5,0.17,2,0,2,2,1014,0.0,1.0,0.0,-0.0
PF00995,PF06783:PF15433:PF13932,31,26,13,18,13,974,0.5,0.97,0.42,0.44,3,3,28,0,987,1.0,0.97,0.1,0.31
PF07391,PF13876:PF12603:PF07494,0,3,0,0,3,1015,0.0,1.0,0,0,0,0,0,0,1018,0,1.0,0,0
PF04108,PF03468:PF15246:PF10377,1,11,1,0,10,1007,0.09,0.99,1.0,0.3,0,0,1,0,1017,0,1.0,0.0,0
PF05257,PF06324:PF12138:PF15289,2,4,1,1,3,1013,0.25,1.0,0.5,0.35,0,0,2,0,1016,0,1.0,0.0,0
PF10037,PF10167:PF05308:PF14857,3,12,0,3,12,1003,0.0,0.99,0.0,-0.01,0,0,3,0,1015,0,1.0,0.0,0
PF08789,PF11515:PF04023:PF00486,0,19,0,0,19,999,0.0,0.98,0,0,1,0,0,1,1017,0.0,1.0,0,0
PF00888,PF10557:PF08672:PF03256,39,44,34,5,10,969,0.77,0.99,0.87,0.81,9,9,30,0,979,1.0,0.97,0.23,0.47
PF11804,PF04338:PF07914:PF02873,0,14,0,0,14,1004,0.0,0.99,0,0,0,0,0,0,1018,0,1.0,0,0
PF15398,PF15467:PF16829:PF15872,1,0,0,1,0,1017,0,1.0,0.0,0,0,0,1,0,1017,0,1.0,0.0,0
PF03694,PF07281:PF05039:PF03980,7,8,0,7,8,1003,0.0,0.99,0.0,-0.01,0,0,7,0,1011,0,0.99,0.0,0
PF10311,PF13390:PF04625:PF13694,5,1,0,5,1,1012,0.0,0.99,0.0,-0.0,0,0,5,0,1013,0,1.0,0.0,0
PF06701,PF11515:PF07738:PF03256,16,40,11,5,29,973,0.28,0.97,0.69,0.42,9,7,9,2,1000,0.78,0.99,0.44,0.58
PF11617,PF16754:PF12034:PF06668,1,3,0,1,3,1014,0.0,1.0,0.0,-0.0,0,0,1,0,1017,0,1.0,0.0,0
PF02654,PF01752:PF05939:PF01514,3,2,0,3,2,1013,0.0,1.0,0.0,-0.0,0,0,3,0,1015,0,1.0,0.0,0
PF05927,PF07294:PF11638:PF04151,1,3,0,1,3,1014,0.0,1.0,0.0,-0.0,0,0,1,0,1017,0,1.0,0.0,0
PF10502,PF13911:PF15907:PF01726,4,18,1,3,17,997,0.06,0.98,0.25,0.11,0,0,4,0,1014,0,1.0,0.0,0
PF00149,PF02872:PF14008:PF16656,122,37,37,85,0,896,1.0,0.92,0.3,0.53,22,22,100,0,896,1.0,0.9,0.18,0.4
PF04089,PF12483:PF13225:PF13092,7,13,3,4,10,1001,0.23,0.99,0.43,0.31,0,0,7,0,1011,0,0.99,0.0,0
PF09019,PF15427:PF04451:PF14925,2,4,0,2,4,1012,0.0,0.99,0.0,-0.0,0,0,2,0,1016,0,1.0,0.0,0
PF03360,PF00992:PF12483:PF01746,15,24,6,9,18,985,0.25,0.97,0.4,0.3,2,1,14,1,1002,0.5,0.99,0.07,0.18
PF03736,PF01463:PF12534:PF01462,9,9,3,6,6,1003,0.33,0.99,0.33,0.33,7,3,6,4,1005,0.43,0.99,0.33,0.37
PF08987,PF15775:PF03845:PF15340,0,10,0,0,10,1008,0.0,0.99,0,0,0,0,0,0,1018,0,1.0,0,0
PF15458,PF10377:PF01465:PF06345,4,20,1,3,19,995,0.05,0.98,0.25,0.1,3,1,3,2,1012,0.33,1.0,0.25,0.29
PF01619,PF14748:PF03807:PF16077,22,21,10,12,11,985,0.48,0.98,0.45,0.45,7,6,16,1,995,0.86,0.98,0.27,0.48
PF10867,PF05817:PF05049:PF01229,0,23,0,0,23,995,0.0,0.98,0,0,2,0,0,2,1016,0.0,1.0,0,0
PF05428,PF04452:PF15289:PF09991,1,2,0,1,2,1015,0.0,1.0,0.0,-0.0,0,0,1,0,1017,0,1.0,0.0,0
PF02568,PF07494:PF04466:PF12538,2,1,0,2,1,1015,0.0,1.0,0.0,-0.0,0,0,2,0,1016,0,1.0,0.0,0
PF06240,PF04290:PF08402:PF08352,7,12,6,1,6,1005,0.5,0.99,0.86,0.65,3,3,4,0,1011,1.0,1.0,0.43,0.65
PF10295,PF13810:PF15696:PF05841,3,1,0,3,1,1014,0.0,1.0,0.0,-0.0,0,0,3,0,1015,0,1.0,0.0,0
PF03436,PF02343:PF05075:PF15362,1,3,1,0,2,1015,0.33,1.0,1.0,0.58,0,0,1,0,1017,0,1.0,0.0,0
PF12924,PF02177:PF03494:PF12925,8,10,8,0,2,1008,0.8,1.0,1.0,0.89,8,8,0,0,1010,1.0,1.0,1.0,1.0
PF06003,PF04144:PF11357:PF10173,6,23,3,3,20,992,0.13,0.98,0.5,0.25,4,1,5,3,1009,0.25,0.99,0.17,0.2
PF03096,PF16969:PF00375:PF05197,3,26,1,2,25,990,0.04,0.97,0.33,0.11,1,1,2,0,1015,1.0,1.0,0.33,0.58
PF13720,PF06426:PF12464:PF04613,2,27,1,1,26,990,0.04,0.97,0.5,0.13,4,1,1,3,1013,0.25,1.0,0.5,0.35
PF15055,PF14986:PF15109:PF04691,0,1,0,0,1,1017,0.0,1.0,0,0,0,0,0,0,1018,0,1.0,0,0
PF05915,PF04716:PF08561:PF06376,2,17,1,1,16,1000,0.06,0.98,0.5,0.17,3,1,1,2,1014,0.33,1.0,0.5,0.41
PF09757,PF08997:PF00850:PF12203,6,49,4,2,45,967,0.08,0.95,0.67,0.22,7,1,5,6,1006,0.14,0.99,0.17,0.15
PF02762,PF02761:PF02262:PF08295,4,19,3,1,16,998,0.16,0.98,0.75,0.34,6,3,1,3,1011,0.5,1.0,0.75,0.61
PF14706,PF16968:PF05513:PF02557,2,3,1,1,2,1014,0.33,1.0,0.5,0.41,0,0,2,0,1016,0,1.0,0.0,0
PF13271,PF05386:PF11816:PF15512,7,17,4,3,13,998,0.24,0.98,0.57,0.36,2,2,5,0,1011,1.0,1.0,0.29,0.53
PF17010,PF01668:PF03238:PF06681,0,2,0,0,2,1016,0.0,1.0,0,0,0,0,0,0,1018,0,1.0,0,0
PF00156,PF00215:PF04043:PF14572,33,44,18,15,26,959,0.41,0.96,0.55,0.45,8,6,27,2,983,0.75,0.97,0.18,0.36
PF06445,PF09397:PF09677:PF16325,5,6,1,4,5,1008,0.17,0.99,0.2,0.18,0,0,5,0,1013,0,1.0,0.0,0
PF03140,PF02519:PF04535:PF00314,18,26,9,9,17,983,0.35,0.97,0.5,0.4,10,7,11,3,997,0.7,0.99,0.39,0.52
PF02791,PF15612:PF15613:PF10537,21,24,20,1,4,993,0.83,1.0,0.95,0.89,15,15,6,0,997,1.0,0.99,0.71,0.84
PF01029,PF17125:PF17126:PF01189,5,28,3,2,25,988,0.11,0.97,0.6,0.25,10,2,3,8,1005,0.2,0.99,0.4,0.28
PF16173,PF16116:PF07085:PF11958,0,10,0,0,10,1008,0.0,0.99,0,0,1,0,0,1,1017,0.0,1.0,0,0
PF12785,PF16704:PF07202:PF17213,0,11,0,0,11,1007,0.0,0.99,0,0,1,0,0,1,1017,0.0,1.0,0,0
PF07522,PF13691:PF04516:PF15996,21,25,7,14,18,979,0.28,0.97,0.33,0.29,5,2,19,3,994,0.4,0.98,0.1,0.19
PF15467,PF15398:PF03842:PF15060,0,1,0,0,1,1017,0.0,1.0,0,0,0,0,0,0,1018,0,1.0,0,0
PF03922,PF11736:PF01752:PF17206,0,7,0,0,7,1011,0.0,0.99,0,0,0,0,0,0,1018,0,1.0,0,0
PF03745,PF03238:PF06681:PF05448,0,2,0,0,2,1016,0.0,1.0,0,0,0,0,0,0,1018,0,1.0,0,0
PF03810,PF08767:PF03378:PF08389,48,46,28,20,18,952,0.61,0.96,0.58,0.58,13,12,36,1,969,0.92,0.96,0.25,0.47
PF17031,PF07413:PF12634:PF04801,0,16,0,0,16,1002,0.0,0.98,0,0,0,0,0,0,1018,0,1.0,0,0
PF11960,PF08557:PF00173:PF10559,2,91,0,2,91,925,0.0,0.91,0.0,-0.01,7,0,2,7,1009,0.0,0.99,0.0,-0.0
PF01022,PF01710:PF12760:PF06821,2,3,0,2,3,1013,0.0,1.0,0.0,-0.0,0,0,2,0,1016,0,1.0,0.0,0
PF06140,PF05308:PF14822:PF15388,6,6,1,5,5,1007,0.17,0.99,0.17,0.16,1,1,5,0,1012,1.0,1.0,0.17,0.41
PF03432,PF13750:PF10618:PF01913,0,1,0,0,1,1017,0.0,1.0,0,0,0,0,0,0,1018,0,1.0,0,0
PF14999,PF05425:PF04355:PF17188,0,0,0,0,0,1018,0,1.0,0,0,0,0,0,0,1018,0,1.0,0,0
PF02925,PF13639:PF00544:PF00097,0,158,0,0,158,860,0.0,0.84,0,0,47,0,0,47,971,0.0,0.95,0,0
PF16484,PF00755:PF04587:PF15824,6,36,6,0,30,982,0.17,0.97,1.0,0.4,8,5,1,3,1009,0.62,1.0,0.83,0.72
PF16315,PF01475:PF02654:PF04501,0,8,0,0,8,1010,0.0,0.99,0,0,0,0,0,0,1018,0,1.0,0,0
PF12819,PF11721:PF12799:PF15904,16,52,8,8,44,958,0.15,0.95,0.5,0.26,9,5,11,4,998,0.56,0.99,0.31,0.41
PF03494,PF10515:PF02177:PF12925,4,9,3,1,6,1008,0.33,0.99,0.75,0.5,8,3,1,5,1009,0.38,0.99,0.75,0.53
PF10825,PF15833:PF15753:PF10412,0,4,0,0,4,1014,0.0,1.0,0,0,0,0,0,0,1018,0,1.0,0,0
PF02557,PF06724:PF02277:PF03525,2,3,0,2,3,1013,0.0,1.0,0.0,-0.0,0,0,2,0,1016,0,1.0,0.0,0
PF00631,PF08833:PF00778:PF16646,22,6,2,20,4,992,0.33,0.98,0.09,0.17,2,0,22,2,994,0.0,0.98,0.0,-0.01
PF13234,PF11648:PF08061:PF03368,10,19,4,6,15,993,0.21,0.98,0.4,0.28,5,4,6,1,1007,0.8,0.99,0.4,0.56
PF12868,PF15856:PF10618:PF04355,1,1,0,1,1,1016,0.0,1.0,0.0,-0.0,0,0,1,0,1017,0,1.0,0.0,0
PF03155,PF04493:PF01722:PF14031,18,28,9,9,19,981,0.32,0.97,0.5,0.39,3,3,15,0,1000,1.0,0.99,0.17,0.41
PF04018,PF11811:PF12878:PF16980,0,0,0,0,0,1018,0,1.0,0,0,0,0,0,0,1018,0,1.0,0,0
PF01483,PF16470:PF12580:PF15913,21,18,12,9,6,991,0.67,0.99,0.57,0.61,7,7,14,0,997,1.0,0.99,0.33,0.57
PF08801,PF03177:PF15979:PF08631,17,26,14,3,12,989,0.54,0.99,0.82,0.66,6,6,11,0,1001,1.0,0.99,0.35,0.59
PF00629,PF01033:PF11980:PF12714,35,28,13,22,15,968,0.46,0.96,0.37,0.4,3,2,33,1,982,0.67,0.97,0.06,0.19
PF10104,PF04090:PF15045:PF02116,8,4,2,6,2,1008,0.5,0.99,0.25,0.35,0,0,8,0,1010,0,0.99,0.0,0
PF15266,PF06428:PF12606:PF14922,3,12,1,2,11,1004,0.08,0.99,0.33,0.16,2,1,2,1,1014,0.5,1.0,0.33,0.41
PF08088,PF15676:PF14512:PF10974,0,0,0,0,0,1018,0,1.0,0,0,0,0,0,0,1018,0,1.0,0,0
PF04889,PF13954:PF08657:PF13953,12,7,1,11,6,1000,0.14,0.98,0.08,0.1,3,1,11,2,1004,0.33,0.99,0.08,0.16
PF05856,PF11017:PF13550:PF15668,6,2,0,6,2,1010,0.0,0.99,0.0,-0.0,0,0,6,0,1012,0,0.99,0.0,0
PF02310,PF01642:PF02965:PF02607,7,7,7,0,0,1011,1.0,1.0,1.0,1.0,5,5,2,0,1011,1.0,1.0,0.71,0.84
PF09976,PF14308:PF00684:PF14901,7,15,1,6,14,997,0.07,0.98,0.14,0.09,0,0,7,0,1011,0,0.99,0.0,0
PF08627,PF08137:PF03350:PF10276,0,2,0,0,2,1016,0.0,1.0,0,0,0,0,0,0,1018,0,1.0,0,0
PF08202,PF13230:PF14475:PF10253,9,8,2,7,6,1003,0.25,0.99,0.22,0.23,0,0,9,0,1009,0,0.99,0.0,0
PF00579,PF16714:PF01588:PF00849,41,53,17,24,36,941,0.32,0.94,0.41,0.33,15,10,31,5,972,0.67,0.96,0.24,0.39
PF12251,PF09816:PF08634:PF05334,7,8,4,3,4,1007,0.5,0.99,0.57,0.53,1,1,6,0,1011,1.0,0.99,0.14,0.38
PF13566,PF08886:PF08345:PF08186,1,2,0,1,2,1015,0.0,1.0,0.0,-0.0,0,0,1,0,1017,0,1.0,0.0,0
PF01693,PF00075:PF03020:PF09337,23,53,14,9,39,956,0.26,0.95,0.61,0.38,9,6,17,3,992,0.67,0.98,0.26,0.41
PF02704,PF05498:PF01097:PF16541,6,11,1,5,10,1002,0.09,0.99,0.17,0.12,1,1,5,0,1012,1.0,1.0,0.17,0.41
PF17008,PF11162:PF15485:PF15337,0,3,0,0,3,1015,0.0,1.0,0,0,0,0,0,0,1018,0,1.0,0,0
PF09297,PF09296:PF15916:PF14803,6,12,6,0,6,1006,0.5,0.99,1.0,0.71,3,1,5,2,1010,0.33,0.99,0.17,0.23
PF10946,PF16108:PF06476:PF02718,0,1,0,0,1,1017,0.0,1.0,0,0,0,0,0,0,1018,0,1.0,0,0
PF13936,PF11427:PF16087:PF09339,6,32,4,2,28,984,0.12,0.97,0.67,0.28,8,3,3,5,1007,0.38,0.99,0.5,0.43
PF11675,PF15775:PF08808:PF15340,0,2,0,0,2,1016,0.0,1.0,0,0,0,0,0,0,1018,0,1.0,0,0
PF09792,PF12351:PF07961:PF07444,2,3,0,2,3,1013,0.0,1.0,0.0,-0.0,0,0,2,0,1016,0,1.0,0.0,0
PF05361,PF15359:PF05039:PF15370,4,5,1,3,4,1010,0.2,0.99,0.25,0.22,0,0,4,0,1014,0,1.0,0.0,0
PF09121,PF09169:PF09103:PF09104,0,6,0,0,6,1012,0.0,0.99,0,0,5,0,0,5,1013,0.0,1.0,0,0
PF04643,PF00323:PF04644:PF02740,2,2,1,1,1,1015,0.5,1.0,0.5,0.5,0,0,2,0,1016,0,1.0,0.0,0
PF04445,PF05939:PF03238:PF15312,2,0,0,2,0,1016,0,1.0,0.0,0,0,0,2,0,1016,0,1.0,0.0,0
PF09488,PF01338:PF14985:PF10974,1,2,0,1,2,1015,0.0,1.0,0.0,-0.0,0,0,1,0,1017,0,1.0,0.0,0
PF10154,PF05529:PF01981:PF09288,4,22,2,2,20,994,0.09,0.98,0.5,0.21,4,1,3,3,1011,0.25,0.99,0.25,0.25
PF11886,PF04548:PF03673:PF00735,3,45,3,0,42,973,0.07,0.96,1.0,0.25,9,1,2,8,1007,0.11,0.99,0.33,0.19
PF06314,PF07976:PF12831:PF13761,11,22,5,6,17,990,0.23,0.98,0.45,0.31,5,4,7,1,1006,0.8,0.99,0.36,0.54
PF15357,PF04754:PF14539:PF15041,0,2,0,0,2,1016,0.0,1.0,0,0,0,0,0,0,1018,0,1.0,0,0
PF02529,PF05466:PF03613:PF14328,0,0,0,0,0,1018,0,1.0,0,0,0,0,0,0,1018,0,1.0,0,0
PF02100,PF08559:PF04367:PF04839,5,5,1,4,4,1009,0.2,0.99,0.2,0.2,0,0,5,0,1013,0,1.0,0.0,0
PF03186,PF06725:PF06082:PF09684,1,2,0,1,2,1015,0.0,1.0,0.0,-0.0,0,0,1,0,1017,0,1.0,0.0,0
PF01366,PF05343:PF03122:PF08247,0,11,0,0,11,1007,0.0,0.99,0,0,0,0,0,0,1018,0,1.0,0,0
PF15707,PF05418:PF12724:PF08497,0,1,0,0,1,1017,0.0,1.0,0,0,0,0,0,0,1018,0,1.0,0,0
PF09164,PF00273:PF17187:PF12470,0,5,0,0,5,1013,0.0,1.0,0,0,1,0,0,1,1017,0.0,1.0,0,0
PF06346,PF06345:PF06371:PF06367,3,24,2,1,22,993,0.08,0.98,0.67,0.23,23,2,1,21,994,0.09,0.98,0.67,0.24
PF12196,PF08081:PF12220:PF08143,1,5,1,0,4,1013,0.2,1.0,1.0,0.45,1,1,0,0,1017,1.0,1.0,1.0,1.0
PF15275,PF16043:PF04576:PF08634,5,15,1,4,14,999,0.07,0.98,0.2,0.11,0,0,5,0,1013,0,1.0,0.0,0
PF06108,PF06912:PF12716:PF09597,6,4,0,6,4,1008,0.0,0.99,0.0,-0.0,0,0,6,0,1012,0,0.99,0.0,0
PF15165,PF15302:PF09367:PF03437,0,2,0,0,2,1016,0.0,1.0,0,0,0,0,0,0,1018,0,1.0,0,0
PF02592,PF15775:PF08026:PF07209,3,1,0,3,1,1014,0.0,1.0,0.0,-0.0,0,0,3,0,1015,0,1.0,0.0,0
PF00674,PF00799:PF16576:PF07958,0,7,0,0,7,1011,0.0,0.99,0,0,1,0,0,1,1017,0.0,1.0,0,0
PF06476,PF10118:PF07399:PF04225,1,12,0,1,12,1005,0.0,0.99,0.0,-0.0,0,0,1,0,1017,0,1.0,0.0,0
PF01832,PF14600:PF02863:PF12571,2,2,0,2,2,1014,0.0,1.0,0.0,-0.0,0,0,2,0,1016,0,1.0,0.0,0
PF09110,PF09111:PF13892:PF11648,14,24,14,0,10,994,0.58,0.99,1.0,0.76,12,12,2,0,1004,1.0,1.0,0.86,0.92
PF01071,PF02843:PF02844:PF00586,16,18,13,3,5,997,0.72,0.99,0.81,0.76,13,13,3,0,1002,1.0,1.0,0.81,0.9
PF10607,PF13765:PF13019:PF16906,23,29,8,15,21,974,0.28,0.96,0.35,0.29,7,4,19,3,992,0.57,0.98,0.17,0.31
PF11221,PF14748:PF07253:PF02464,4,12,1,3,11,1003,0.08,0.99,0.25,0.14,1,1,3,0,1014,1.0,1.0,0.25,0.5
PF17050,PF15556:PF16647:PF14534,1,1,0,1,1,1016,0.0,1.0,0.0,-0.0,0,0,1,0,1017,0,1.0,0.0,0
PF15185,PF05840:PF00419:PF06890,2,1,0,2,1,1015,0.0,1.0,0.0,-0.0,0,0,2,0,1016,0,1.0,0.0,0
PF12479,PF06805:PF05939:PF04965,0,0,0,0,0,1018,0,1.0,0,0,0,0,0,0,1018,0,1.0,0,0
PF17109,PF12770:PF14420:PF06424,6,21,2,4,19,993,0.1,0.98,0.33,0.17,7,2,4,5,1007,0.29,0.99,0.33,0.3
PF00078,PF05380:PF00075:PF07245,218,60,47,171,13,787,0.78,0.82,0.22,0.35,15,15,203,0,800,1.0,0.8,0.07,0.23
PF14353,PF10380:PF07010:PF03640,0,1,0,0,1,1017,0.0,1.0,0,0,0,0,0,0,1018,0,1.0,0,0
PF03134,PF01215:PF13664:PF03162,25,19,8,17,11,982,0.42,0.97,0.32,0.35,3,2,23,1,992,0.67,0.98,0.08,0.23
PF03891,PF15052:PF04681:PF06756,0,7,0,0,7,1011,0.0,0.99,0,0,1,0,0,1,1017,0.0,1.0,0,0
PF11751,PF03090:PF07157:PF13742,0,2,0,0,2,1016,0.0,1.0,0,0,0,0,0,0,1018,0,1.0,0,0
PF00513,PF08719:PF01872:PF06911,1,43,0,1,43,974,0.0,0.96,0.0,-0.01,9,0,1,9,1008,0.0,0.99,0.0,-0.0
PF01217,PF09786:PF00928:PF12016,45,42,28,17,14,959,0.67,0.97,0.62,0.63,3,2,43,1,972,0.67,0.96,0.04,0.16
PF07162,PF01757:PF07971:PF01755,14,52,2,12,50,954,0.04,0.94,0.14,0.05,7,1,13,6,998,0.14,0.98,0.07,0.09
PF08645,PF00645:PF08063:PF05406,13,37,4,9,33,972,0.11,0.96,0.31,0.16,10,4,9,6,999,0.4,0.99,0.31,0.34
PF09686,PF15168:PF04384:PF12255,0,3,0,0,3,1015,0.0,1.0,0,0,0,0,0,0,1018,0,1.0,0,0
PF04949,PF07939:PF12926:PF07052,9,13,3,6,10,999,0.23,0.98,0.33,0.27,1,0,9,1,1008,0.0,0.99,0.0,-0.0
PF02497,PF10380:PF07927:PF06379,2,4,1,1,3,1013,0.25,1.0,0.5,0.35,0,0,2,0,1016,0,1.0,0.0,0
PF10208,PF05529:PF07933:PF09288,7,18,3,4,15,996,0.17,0.98,0.43,0.26,4,2,5,2,1009,0.5,0.99,0.29,0.37
PF03805,PF01194:PF00489:PF11771,0,5,0,0,5,1013,0.0,1.0,0,0,0,0,0,0,1018,0,1.0,0,0
PF08824,PF12026:PF08397:PF07815,1,14,1,0,13,1004,0.07,0.99,1.0,0.27,3,1,0,2,1015,0.33,1.0,1.0,0.58
PF02574,PF02607:PF00809:PF02310,17,15,7,10,8,993,0.47,0.98,0.41,0.43,6,5,12,1,1000,0.83,0.99,0.29,0.49
PF01021,PF13929:PF08744:PF04233,1,0,0,1,0,1017,0,1.0,0.0,0,0,0,1,0,1017,0,1.0,0.0,0
PF08030,PF08022:PF01794:PF00036,51,66,43,8,23,944,0.65,0.97,0.84,0.73,41,40,11,1,966,0.98,0.99,0.78,0.87
PF08216,PF15627:PF08640:PF11374,5,25,3,2,22,991,0.12,0.98,0.6,0.26,2,2,3,0,1013,1.0,1.0,0.4,0.63
PF08479,PF01514:PF04865:PF15518,0,1,0,0,1,1017,0.0,1.0,0,0,0,0,0,0,1018,0,1.0,0,0
PF10495,PF15456:PF16574:PF12726,5,7,1,4,6,1007,0.14,0.99,0.2,0.16,2,0,5,2,1011,0.0,0.99,0.0,-0.0
PF16347,PF12411:PF12548:PF08019,8,6,2,6,4,1006,0.33,0.99,0.25,0.28,1,1,7,0,1010,1.0,0.99,0.12,0.35
PF06219,PF03214:PF05238:PF15722,2,3,0,2,3,1013,0.0,1.0,0.0,-0.0,0,0,2,0,1016,0,1.0,0.0,0
PF16737,PF14061:PF12269:PF03172,1,12,1,0,11,1006,0.08,0.99,1.0,0.29,2,1,0,1,1016,0.5,1.0,1.0,0.71
PF00781,PF00609:PF08652:PF00788,47,58,31,16,27,944,0.53,0.96,0.66,0.57,15,14,33,1,970,0.93,0.97,0.3,0.52
PF00553,PF09478:PF16030:PF02927,3,16,3,0,13,1002,0.19,0.99,1.0,0.43,3,3,0,0,1015,1.0,1.0,1.0,1.0
PF02888,PF03530:PF15113:PF07885,9,64,9,0,55,954,0.14,0.95,1.0,0.36,14,8,1,6,1003,0.57,0.99,0.89,0.71
PF03243,PF01316:PF15555:PF10994,3,3,0,3,3,1012,0.0,0.99,0.0,-0.0,0,0,3,0,1015,0,1.0,0.0,0
PF14382,PF14875:PF10447:PF08327,11,24,8,3,16,991,0.33,0.98,0.73,0.48,2,2,9,0,1007,1.0,0.99,0.18,0.42
PF12600,PF15073:PF04428:PF07282,0,5,0,0,5,1013,0.0,1.0,0,0,1,0,0,1,1017,0.0,1.0,0,0
PF17136,PF01777:PF16121:PF08071,10,26,3,7,23,985,0.12,0.97,0.3,0.17,13,2,8,11,997,0.15,0.98,0.2,0.17
PF01863,PF06114:PF05016:PF11614,7,7,3,4,4,1007,0.43,0.99,0.43,0.42,0,0,7,0,1011,0,0.99,0.0,0
PF06972,PF07001:PF13945:PF15624,2,10,0,2,10,1006,0.0,0.99,0.0,-0.0,0,0,2,0,1016,0,1.0,0.0,0
PF06999,PF11927:PF01977:PF09791,25,22,4,21,18,975,0.18,0.96,0.16,0.15,3,3,22,0,993,1.0,0.98,0.12,0.34
PF13805,PF03760:PF05532:PF04468,9,9,0,9,9,1000,0.0,0.98,0.0,-0.01,0,0,9,0,1009,0,0.99,0.0,0
PF14539,PF05962:PF15680:PF03713,0,1,0,0,1,1017,0.0,1.0,0,0,0,0,0,0,1018,0,1.0,0,0
PF01080,PF04184:PF08577:PF16839,12,5,1,11,4,1002,0.2,0.99,0.08,0.12,0,0,12,0,1006,0,0.99,0.0,0
PF04692,PF14554:PF15800:PF03128,1,3,1,0,2,1015,0.33,1.0,1.0,0.58,1,1,0,0,1017,1.0,1.0,1.0,1.0
PF07262,PF05838:PF15556:PF15199,0,0,0,0,0,1018,0,1.0,0,0,0,0,0,0,1018,0,1.0,0,0
PF10908,PF10566:PF08497:PF02465,0,0,0,0,0,1018,0,1.0,0,0,0,0,0,0,1018,0,1.0,0,0
PF00081,PF02777:PF07258:PF16196,22,34,22,0,12,984,0.65,0.99,1.0,0.8,3,3,19,0,996,1.0,0.98,0.14,0.37
PF02207,PF02617:PF05048:PF13764,12,14,7,5,7,999,0.5,0.99,0.58,0.53,3,3,9,0,1006,1.0,0.99,0.25,0.5
PF11929,PF09372:PF16553:PF09310,3,1,1,2,0,1015,1.0,1.0,0.33,0.58,1,1,2,0,1015,1.0,1.0,0.33,0.58
PF00432,PF13249:PF13243:PF03404,26,31,6,20,25,967,0.19,0.96,0.23,0.19,17,5,21,12,980,0.29,0.97,0.19,0.22
PF00817,PF11798:PF11799:PF13438,27,25,25,2,0,991,1.0,1.0,0.93,0.96,6,6,21,0,991,1.0,0.98,0.22,0.47
PF07526,PF16493:PF12737:PF05722,4,1,1,3,0,1014,1.0,1.0,0.25,0.5,1,1,3,0,1014,1.0,1.0,0.25,0.5
PF10318,PF10319:PF10327:PF10317,14,15,6,8,9,995,0.4,0.98,0.43,0.41,0,0,14,0,1004,0,0.99,0.0,0
PF03719,PF00333:PF09285:PF01132,22,25,20,2,5,991,0.8,0.99,0.91,0.85,6,3,19,3,993,0.5,0.98,0.14,0.25
PF02611,PF05488:PF03065:PF10279,1,1,0,1,1,1016,0.0,1.0,0.0,-0.0,0,0,1,0,1017,0,1.0,0.0,0
PF02308,PF07392:PF14877:PF10563,2,5,0,2,5,1011,0.0,0.99,0.0,-0.0,0,0,2,0,1016,0,1.0,0.0,0
PF01687,PF13419:PF00475:PF12311,12,61,6,6,55,951,0.1,0.94,0.5,0.2,7,2,10,5,1001,0.29,0.99,0.17,0.21
PF17203,PF09239:PF08918:PF07730,5,12,0,5,12,1001,0.0,0.98,0.0,-0.01,1,0,5,1,1012,0.0,0.99,0.0,-0.0
PF07842,PF12457:PF13821:PF01585,15,65,10,5,55,948,0.15,0.94,0.67,0.3,10,8,7,2,1001,0.8,0.99,0.53,0.65
PF00438,PF02773:PF02772:PF14365,5,6,4,1,2,1011,0.67,1.0,0.8,0.73,4,4,1,0,1013,1.0,1.0,0.8,0.89
PF01966,PF02541:PF14360:PF04616,25,41,11,14,30,963,0.27,0.96,0.44,0.32,7,6,19,1,992,0.86,0.98,0.24,0.45
PF16054,PF11032:PF06907:PF13933,4,5,2,2,3,1011,0.4,1.0,0.5,0.44,0,0,4,0,1014,0,1.0,0.0,0
PF10174,PF09457:PF08172:PF10195,10,14,1,9,13,995,0.07,0.98,0.1,0.07,0,0,10,0,1008,0,0.99,0.0,0
PF02655,PF06890:PF08334:PF08795,2,1,0,2,1,1015,0.0,1.0,0.0,-0.0,0,0,2,0,1016,0,1.0,0.0,0
PF02189,PF16680:PF11628:PF09191,2,6,1,1,5,1011,0.17,0.99,0.5,0.29,1,1,1,0,1016,1.0,1.0,0.5,0.71
PF05592,PF08531:PF14200:PF00754,20,57,20,0,37,961,0.35,0.96,1.0,0.58,8,6,14,2,996,0.75,0.98,0.3,0.47
PF10660,PF09360:PF00525:PF16205,2,28,2,0,26,990,0.07,0.97,1.0,0.26,3,1,1,2,1014,0.33,1.0,0.5,0.41
PF03460,PF01077:PF13806:PF01855,15,25,15,0,10,993,0.6,0.99,1.0,0.77,13,13,2,0,1003,1.0,1.0,0.87,0.93
PF08709,PF01365:PF02026:PF15012,12,13,8,4,5,1001,0.62,0.99,0.67,0.64,5,5,7,0,1006,1.0,0.99,0.42,0.64
PF05788,PF09493:PF15214:PF15826,2,2,0,2,2,1014,0.0,1.0,0.0,-0.0,0,0,2,0,1016,0,1.0,0.0,0
PF12226,PF15222:PF16859:PF03630,0,14,0,0,14,1004,0.0,0.99,0,0,0,0,0,0,1018,0,1.0,0,0
PF16353,PF02929:PF02837:PF02836,5,22,5,0,17,996,0.23,0.98,1.0,0.47,12,5,0,7,1006,0.42,0.99,1.0,0.64
PF06560,PF06295:PF09932:PF02404,1,1,0,1,1,1016,0.0,1.0,0.0,-0.0,0,0,1,0,1017,0,1.0,0.0,0
PF02517,PF09335:PF11735:PF04769,13,31,2,11,29,976,0.06,0.96,0.15,0.08,2,1,12,1,1004,0.5,0.99,0.08,0.19
PF07988,PF08558:PF16496:PF09316,1,14,1,0,13,1004,0.07,0.99,1.0,0.27,2,0,1,2,1015,0.0,1.0,0.0,-0.0
PF07662,PF07670:PF01773:PF07664,17,16,12,5,4,997,0.75,0.99,0.71,0.72,5,4,13,1,1000,0.8,0.99,0.24,0.43
PF08837,PF16071:PF04233:PF10933,0,0,0,0,0,1018,0,1.0,0,0,0,0,0,0,1018,0,1.0,0,0
PF02153,PF00800:PF05439:PF00155,14,106,8,6,98,906,0.08,0.9,0.57,0.18,15,6,8,9,995,0.4,0.98,0.43,0.41
PF07143,PF17186:PF02649:PF10116,1,5,0,1,5,1012,0.0,0.99,0.0,-0.0,0,0,1,0,1017,0,1.0,0.0,0
PF17012,PF04290:PF08352:PF02694,0,8,0,0,8,1010,0.0,0.99,0,0,2,0,0,2,1016,0.0,1.0,0,0
PF00777,PF03062:PF09335:PF01758,22,58,9,13,49,947,0.16,0.94,0.41,0.23,8,3,19,5,991,0.38,0.98,0.14,0.22
PF14380,PF08488:PF13947:PF16579,10,28,6,4,22,986,0.21,0.97,0.6,0.35,7,5,5,2,1006,0.71,0.99,0.5,0.59
PF12240,PF15248:PF13870:PF15866,1,9,0,1,9,1008,0.0,0.99,0.0,-0.0,4,0,1,4,1013,0.0,1.0,0.0,-0.0
PF17052,PF16265:PF11217:PF15039,0,2,0,0,2,1016,0.0,1.0,0,0,0,0,0,0,1018,0,1.0,0,0
PF07939,PF04367:PF09805:PF10276,2,11,1,1,10,1006,0.09,0.99,0.5,0.21,1,1,1,0,1016,1.0,1.0,0.5,0.71
PF11989,PF06248:PF17005:PF07352,1,10,1,0,9,1008,0.1,0.99,1.0,0.31,1,1,0,0,1017,1.0,1.0,1.0,1.0
PF03299,PF15929:PF04801:PF06991,10,20,4,6,16,992,0.2,0.98,0.4,0.27,1,1,9,0,1008,1.0,0.99,0.1,0.31
PF10210,PF02237:PF10437:PF09825,6,5,1,5,4,1008,0.2,0.99,0.17,0.18,1,0,6,1,1011,0.0,0.99,0.0,-0.0
PF12139,PF12617:PF12800:PF11953,0,2,0,0,2,1016,0.0,1.0,0,0,0,0,0,0,1018,0,1.0,0,0
PF09086,PF04339:PF12903:PF15681,0,5,0,0,5,1013,0.0,1.0,0,0,0,0,0,0,1018,0,1.0,0,0
PF07822,PF04811:PF09325:PF15951,1,40,0,1,40,977,0.0,0.96,0.0,-0.01,7,0,1,7,1010,0.0,0.99,0.0,-0.0
PF16488,PF16487:PF02171:PF16486,31,52,31,0,21,966,0.6,0.98,1.0,0.76,32,30,1,2,985,0.94,1.0,0.97,0.95
PF09807,PF05497:PF10261:PF01234,4,12,1,3,11,1003,0.08,0.99,0.25,0.14,1,0,4,1,1013,0.0,1.0,0.0,-0.0
PF08997,PF09757:PF00850:PF12203,7,50,6,1,44,967,0.12,0.96,0.86,0.31,5,1,6,4,1007,0.2,0.99,0.14,0.16
PF03640,PF15709:PF15185:PF08964,0,2,0,0,2,1016,0.0,1.0,0,0,0,0,0,0,1018,0,1.0,0,0
PF00275,PF01761:PF01487:PF08501,16,22,11,5,11,991,0.5,0.98,0.69,0.58,12,11,5,1,1001,0.92,0.99,0.69,0.79
PF13020,PF14908:PF13320:PF12726,5,8,1,4,7,1006,0.12,0.99,0.2,0.15,1,0,5,1,1012,0.0,0.99,0.0,-0.0
PF12140,PF17208:PF12618:PF02820,7,23,7,0,16,995,0.3,0.98,1.0,0.55,4,3,4,1,1010,0.75,1.0,0.43,0.56
PF01201,PF06658:PF15251:PF07106,12,10,4,8,6,1000,0.4,0.99,0.33,0.36,2,1,11,1,1005,0.5,0.99,0.08,0.2
PF02079,PF14903:PF10554:PF16861,1,3,0,1,3,1014,0.0,1.0,0.0,-0.0,0,0,1,0,1017,0,1.0,0.0,0
PF08581,PF17005:PF10647:PF14077,3,6,2,1,4,1011,0.33,1.0,0.67,0.47,1,1,2,0,1015,1.0,1.0,0.33,0.58
PF04527,PF15955:PF05497:PF15868,0,12,0,0,12,1006,0.0,0.99,0,0,0,0,0,0,1018,0,1.0,0,0
PF16071,PF10933:PF08744:PF04562,0,0,0,0,0,1018,0,1.0,0,0,0,0,0,0,1018,0,1.0,0,0
PF05355,PF15119:PF02087:PF17124,3,3,1,2,2,1013,0.33,1.0,0.33,0.33,0,0,3,0,1015,0,1.0,0.0,0
PF03807,PF14748:PF01794:PF08022,12,47,8,4,39,967,0.17,0.96,0.67,0.32,39,5,7,34,972,0.13,0.96,0.42,0.22
PF05943,PF03428:PF05947:PF05591,0,0,0,0,0,1018,0,1.0,0,0,0,0,0,0,1018,0,1.0,0,0
PF02874,PF07497:PF08216:PF14906,41,9,4,37,5,972,0.44,0.96,0.1,0.19,2,2,39,0,977,1.0,0.96,0.05,0.22
PF06369,PF09056:PF07464:PF16851,1,5,0,1,5,1012,0.0,0.99,0.0,-0.0,0,0,1,0,1017,0,1.0,0.0,0
PF05399,PF15333:PF15664:PF15550,0,0,0,0,0,1018,0,1.0,0,0,0,0,0,0,1018,0,1.0,0,0
PF00687,PF15998:PF00301:PF01786,19,19,3,16,16,983,0.16,0.97,0.16,0.14,3,1,18,2,997,0.33,0.98,0.05,0.13
PF17135,PF01268:PF00763:PF10376,12,26,7,5,19,987,0.27,0.98,0.58,0.39,12,6,6,6,1000,0.5,0.99,0.5,0.49
PF02936,PF06417:PF05995:PF02284,9,19,3,6,16,993,0.16,0.98,0.33,0.22,4,1,8,3,1006,0.25,0.99,0.11,0.16
PF17028,PF07540:PF11231:PF14876,0,4,0,0,4,1014,0.0,1.0,0,0,0,0,0,0,1018,0,1.0,0,0
PF05281,PF05361:PF15370:PF06232,2,10,2,0,8,1008,0.2,0.99,1.0,0.45,1,0,2,1,1015,0.0,1.0,0.0,-0.0
PF14040,PF10295:PF13094:PF13810,0,5,0,0,5,1013,0.0,1.0,0,0,0,0,0,0,1018,0,1.0,0,0
PF00476,PF01927:PF01612:PF08066,15,55,13,2,42,961,0.24,0.96,0.87,0.44,13,2,13,11,992,0.15,0.98,0.13,0.13
PF08653,PF06485:PF06989:PF12855,1,6,0,1,6,1011,0.0,0.99,0.0,-0.0,0,0,1,0,1017,0,1.0,0.0,0
PF09423,PF16655:PF08689:PF03085,14,8,6,8,2,1002,0.75,0.99,0.43,0.56,0,0,14,0,1004,0,0.99,0.0,0
PF05697,PF05698:PF15350:PF16669,3,8,1,2,7,1008,0.12,0.99,0.33,0.2,0,0,3,0,1015,0,1.0,0.0,0
PF00561,PF12146:PF12697:PF01636,82,113,56,26,57,879,0.5,0.92,0.68,0.54,41,33,49,8,928,0.8,0.94,0.4,0.55
PF05482,PF13810:PF11581:PF11179,2,3,0,2,3,1013,0.0,1.0,0.0,-0.0,0,0,2,0,1016,0,1.0,0.0,0
PF07555,PF02838:PF15912:PF14952,3,13,1,2,12,1003,0.08,0.99,0.33,0.16,0,0,3,0,1015,0,1.0,0.0,0
PF02049,PF12724:PF02072:PF09673,2,0,0,2,0,1016,0,1.0,0.0,0,0,0,2,0,1016,0,1.0,0.0,0
PF04720,PF06749:PF05910:PF04690,8,13,3,5,10,1000,0.23,0.99,0.38,0.29,6,2,6,4,1006,0.33,0.99,0.25,0.28
PF07959,PF10509:PF08544:PF00288,6,47,5,1,42,970,0.11,0.96,0.83,0.29,35,4,2,31,981,0.11,0.97,0.67,0.27
PF01814,PF04405:PF05495:PF13436,14,11,2,12,9,995,0.18,0.98,0.14,0.15,2,2,12,0,1004,1.0,0.99,0.14,0.38
PF12281,PF09341:PF05529:PF06457,0,16,0,0,16,1002,0.0,0.98,0,0,4,0,0,4,1014,0.0,1.0,0,0
PF04931,PF10257:PF09736:PF08728,13,17,4,9,13,992,0.24,0.98,0.31,0.26,3,2,11,1,1004,0.67,0.99,0.15,0.32
PF05929,PF02495:PF12276:PF12156,0,2,0,0,2,1016,0.0,1.0,0,0,0,0,0,0,1018,0,1.0,0,0
PF04485,PF15212:PF15135:PF15472,0,1,0,0,1,1017,0.0,1.0,0,0,0,0,0,0,1018,0,1.0,0,0
PF10018,PF07939:PF09419:PF04839,16,14,4,12,10,992,0.29,0.98,0.25,0.26,0,0,16,0,1002,0,0.98,0.0,0
PF07058,PF02057:PF06683:PF03331,5,2,0,5,2,1011,0.0,0.99,0.0,-0.0,0,0,5,0,1013,0,1.0,0.0,0
PF01216,PF02267:PF05283:PF12301,5,8,2,3,6,1007,0.25,0.99,0.4,0.31,0,0,5,0,1013,0,1.0,0.0,0
PF01696,PF13005:PF13362:PF08856,0,0,0,0,0,1018,0,1.0,0,0,0,0,0,0,1018,0,1.0,0,0
PF02275,PF15985:PF16682:PF09770,8,17,4,4,13,997,0.24,0.98,0.5,0.34,0,0,8,0,1010,0,0.99,0.0,0
PF06057,PF12191:PF15771:PF05621,0,0,0,0,0,1018,0,1.0,0,0,0,0,0,0,1018,0,1.0,0,0
PF03902,PF00172:PF02679:PF10703,4,139,4,0,135,879,0.03,0.87,1.0,0.16,5,3,1,2,1012,0.6,1.0,0.75,0.67
PF09028,PF11162:PF09510:PF03525,1,0,0,1,0,1017,0,1.0,0.0,0,0,0,1,0,1017,0,1.0,0.0,0
PF16834,PF05613:PF06054:PF05523,0,0,0,0,0,1018,0,1.0,0,0,0,0,0,0,1018,0,1.0,0,0
PF17164,PF17206:PF15775:PF01580,0,5,0,0,5,1013,0.0,1.0,0,0,1,0,0,1,1017,0.0,1.0,0,0
PF16493,PF07526:PF12737:PF05722,1,4,1,0,3,1014,0.25,1.0,1.0,0.5,1,1,0,0,1017,1.0,1.0,1.0,1.0
PF16036,PF11652:PF15460:PF15553,4,2,0,4,2,1012,0.0,0.99,0.0,-0.0,0,0,4,0,1014,0,1.0,0.0,0
PF15394,PF08432:PF07149:PF02748,2,2,0,2,2,1014,0.0,1.0,0.0,-0.0,0,0,2,0,1016,0,1.0,0.0,0
PF03596,PF10330:PF06485:PF08653,0,7,0,0,7,1011,0.0,0.99,0,0,0,0,0,0,1018,0,1.0,0,0
PF08016,PF02010:PF01477:PF00151,28,57,15,13,42,948,0.26,0.95,0.54,0.35,16,8,20,8,982,0.5,0.97,0.29,0.37
PF06451,PF02025:PF14862:PF07192,0,2,0,0,2,1016,0.0,1.0,0,0,0,0,0,0,1018,0,1.0,0,0
PF01679,PF04729:PF10276:PF03095,12,18,2,10,16,990,0.11,0.97,0.17,0.12,1,0,12,1,1005,0.0,0.99,0.0,-0.0
PF15744,PF03823:PF15829:PF15839,0,4,0,0,4,1014,0.0,1.0,0,0,1,0,0,1,1017,0.0,1.0,0,0
PF15214,PF03241:PF05974:PF06834,2,0,0,2,0,1016,0,1.0,0.0,0,0,0,2,0,1016,0,1.0,0.0,0
PF03456,PF02141:PF03455:PF12335,27,38,27,0,11,980,0.71,0.99,1.0,0.84,18,14,13,4,987,0.78,0.98,0.52,0.63
PF09421,PF14474:PF15378:PF01358,4,5,0,4,5,1009,0.0,0.99,0.0,-0.0,0,0,4,0,1014,0,1.0,0.0,0
PF17022,PF15334:PF01668:PF15343,0,2,0,0,2,1016,0.0,1.0,0,0,0,0,0,0,1018,0,1.0,0,0
PF02826,PF00389:PF00800:PF03088,27,61,21,6,40,951,0.34,0.95,0.78,0.5,14,7,20,7,984,0.5,0.97,0.26,0.35
PF12708,PF06964:PF14498:PF11915,13,37,8,5,29,976,0.22,0.97,0.62,0.35,7,3,10,4,1001,0.43,0.99,0.23,0.31
PF07308,PF03090:PF06082:PF12081,0,0,0,0,0,1018,0,1.0,0,0,0,0,0,0,1018,0,1.0,0,0
PF17062,PF10664:PF15343:PF17015,0,1,0,0,1,1017,0.0,1.0,0,0,0,0,0,0,1018,0,1.0,0,0
PF06384,PF13096:PF06211:PF02083,4,4,0,4,4,1010,0.0,0.99,0.0,-0.0,0,0,4,0,1014,0,1.0,0.0,0
PF08631,PF15979:PF12612:PF11915,7,36,6,1,30,981,0.17,0.97,0.86,0.37,7,3,4,4,1007,0.43,0.99,0.43,0.42
PF00302,PF00566:PF02990:PF11730,1,97,0,1,97,920,0.0,0.9,0.0,-0.01,16,0,1,16,1001,0.0,0.98,0.0,-0.0
PF01896,PF04588:PF04819:PF00830,8,16,3,5,13,997,0.19,0.98,0.38,0.26,3,2,6,1,1009,0.67,0.99,0.25,0.41
PF00755,PF16484:PF04430:PF01112,30,41,12,18,29,959,0.29,0.95,0.4,0.32,8,6,24,2,986,0.75,0.97,0.2,0.38
PF00117,PF00988:PF00958:PF06418,68,42,40,28,2,948,0.95,0.97,0.59,0.74,9,9,59,0,950,1.0,0.94,0.13,0.35
PF05366,PF05541:PF01361:PF05937,1,4,0,1,4,1013,0.0,1.0,0.0,-0.0,0,0,1,0,1017,0,1.0,0.0,0
PF05088,PF02812:PF00208:PF06146,8,21,8,0,13,997,0.38,0.99,1.0,0.61,14,4,4,10,1000,0.29,0.99,0.5,0.37
PF14781,PF14782:PF14783:PF14944,4,11,4,0,7,1007,0.36,0.99,1.0,0.6,6,4,0,2,1012,0.67,1.0,1.0,0.82
PF04908,PF07797:PF08528:PF16072,10,9,1,9,8,1000,0.11,0.98,0.1,0.1,1,0,10,1,1007,0.0,0.99,0.0,-0.0
PF14197,PF12757:PF15368:PF17045,6,0,0,6,0,1012,0,0.99,0.0,0,0,0,6,0,1012,0,0.99,0.0,0
PF07670,PF07662:PF01773:PF07664,7,19,5,2,14,997,0.26,0.98,0.71,0.43,12,4,3,8,1003,0.33,0.99,0.57,0.43
PF15775,PF14251:PF11124:PF17164,0,2,0,0,2,1016,0.0,1.0,0,0,0,0,0,0,1018,0,1.0,0,0
PF03770,PF01513:PF02517:PF04117,25,52,12,13,40,953,0.23,0.95,0.48,0.31,12,8,17,4,989,0.67,0.98,0.32,0.45
PF04697,PF04783:PF03017:PF12887,1,10,0,1,10,1007,0.0,0.99,0.0,-0.0,0,0,1,0,1017,0,1.0,0.0,0
PF00917,PF03000:PF09494:PF12436,27,27,12,15,15,976,0.44,0.97,0.44,0.43,8,7,20,1,990,0.88,0.98,0.26,0.47
PF06923,PF00766:PF08025:PF01512,0,19,0,0,19,999,0.0,0.98,0,0,0,0,0,0,1018,0,1.0,0,0
PF02561,PF13722:PF03865:PF04984,0,0,0,0,0,1018,0,1.0,0,0,0,0,0,0,1018,0,1.0,0,0
PF11540,PF04494:PF08159:PF12490,1,21,1,0,20,997,0.05,0.98,1.0,0.22,4,1,0,3,1014,0.25,1.0,1.0,0.5
PF07249,PF01241:PF06581:PF07444,3,0,0,3,0,1015,0,1.0,0.0,0,0,0,3,0,1015,0,1.0,0.0,0
PF05678,PF07939:PF03195:PF02234,9,15,4,5,11,998,0.27,0.98,0.44,0.34,3,2,7,1,1008,0.67,0.99,0.22,0.38
PF15972,PF16649:PF08194:PF15047,0,1,0,0,1,1017,0.0,1.0,0,0,0,0,0,0,1018,0,1.0,0,0
PF05131,PF12451:PF17122:PF10366,5,18,3,2,15,998,0.17,0.98,0.6,0.31,7,2,3,5,1008,0.29,0.99,0.4,0.33
PF01544,PF14441:PF00924:PF10505,34,23,8,26,15,969,0.35,0.96,0.24,0.27,2,2,32,0,984,1.0,0.97,0.06,0.24
PF01182,PF02585:PF02872:PF00479,18,34,10,8,24,976,0.29,0.97,0.56,0.39,7,4,14,3,997,0.57,0.98,0.22,0.35
PF14586,PF15667:PF08591:PF15828,1,2,0,1,2,1015,0.0,1.0,0.0,-0.0,0,0,1,0,1017,0,1.0,0.0,0
PF14031,PF00842:PF01168:PF08661,7,19,7,0,12,999,0.37,0.99,1.0,0.6,5,1,6,4,1007,0.2,0.99,0.14,0.16
PF00015,PF02203:PF00563:PF00672,12,24,10,2,14,992,0.42,0.98,0.83,0.58,8,5,7,3,1003,0.62,0.99,0.42,0.51
PF07993,PF03015:PF13360:PF00501,48,135,41,7,94,876,0.3,0.9,0.85,0.47,30,19,29,11,959,0.63,0.96,0.4,0.48
PF02820,PF17208:PF12140:PF12618,22,9,8,14,1,995,0.89,0.99,0.36,0.56,3,3,19,0,996,1.0,0.98,0.14,0.37
PF11303,PF12328:PF15316:PF15503,1,7,0,1,7,1010,0.0,0.99,0.0,-0.0,0,0,1,0,1017,0,1.0,0.0,0
PF16065,PF01933:PF13349:PF10218,7,6,1,6,5,1006,0.17,0.99,0.14,0.15,0,0,7,0,1011,0,0.99,0.0,0
PF02072,PF15088:PF13094:PF12724,0,1,0,0,1,1017,0.0,1.0,0,0,0,0,0,0,1018,0,1.0,0,0
PF01448,PF08558:PF01426:PF07988,17,44,8,9,36,965,0.18,0.96,0.47,0.27,1,1,16,0,1001,1.0,0.98,0.06,0.24
PF04616,PF06439:PF03422:PF13813,35,26,15,20,11,972,0.58,0.97,0.43,0.48,3,3,32,0,983,1.0,0.97,0.09,0.29
PF06798,PF07499:PF03241:PF02572,0,3,0,0,3,1015,0.0,1.0,0,0,1,0,0,1,1017,0.0,1.0,0,0
PF00704,PF14856:PF03427:PF05938,58,19,16,42,3,957,0.84,0.96,0.28,0.47,3,3,55,0,960,1.0,0.95,0.05,0.22
PF02322,PF13721:PF01297:PF01706,1,8,0,1,8,1009,0.0,0.99,0.0,-0.0,0,0,1,0,1017,0,1.0,0.0,0
PF01184,PF01300:PF02284:PF00810,21,30,9,12,21,976,0.3,0.97,0.43,0.34,5,4,17,1,996,0.8,0.98,0.19,0.39
PF00305,PF01477:PF02010:PF00151,19,57,17,2,40,959,0.3,0.96,0.89,0.5,16,8,11,8,991,0.5,0.98,0.42,0.45
PF08365,PF00049:PF16276:PF09303,1,12,1,0,11,1006,0.08,0.99,1.0,0.29,0,0,1,0,1017,0,1.0,0.0,0
PF03906,PF08278:PF11387:PF09867,0,4,0,0,4,1014,0.0,1.0,0,0,0,0,0,0,1018,0,1.0,0,0
PF16185,PF08352:PF12399:PF14396,7,12,3,4,9,1002,0.25,0.99,0.43,0.32,2,2,5,0,1011,1.0,1.0,0.29,0.53
PF11743,PF13811:PF14078:PF05616,0,0,0,0,0,1018,0,1.0,0,0,0,0,0,0,1018,0,1.0,0,0
PF00208,PF02812:PF05088:PF14365,21,18,18,3,0,997,1.0,1.0,0.86,0.92,4,4,17,0,997,1.0,0.98,0.19,0.43
PF02519,PF04535:PF06749:PF05617,12,12,3,9,9,997,0.25,0.98,0.25,0.24,3,2,10,1,1005,0.67,0.99,0.17,0.33
PF00441,PF02770:PF02771:PF08028,60,68,59,1,9,949,0.87,0.99,0.98,0.92,57,56,4,1,957,0.98,1.0,0.93,0.96
PF10218,PF01632:PF04716:PF09597,0,19,0,0,19,999,0.0,0.98,0,0,0,0,0,0,1018,0,1.0,0,0
PF07655,PF10079:PF13435:PF10106,1,1,0,1,1,1016,0.0,1.0,0.0,-0.0,0,0,1,0,1017,0,1.0,0.0,0
PF14260,PF03104:PF00136:PF08996,18,38,18,0,20,980,0.47,0.98,1.0,0.68,35,17,1,18,982,0.49,0.98,0.94,0.67
PF16334,PF17168:PF08760:PF16335,1,5,1,0,4,1013,0.2,1.0,1.0,0.45,4,1,0,3,1014,0.25,1.0,1.0,0.5
PF03007,PF06974:PF02065:PF06863,8,10,5,3,5,1005,0.5,0.99,0.62,0.56,3,3,5,0,1010,1.0,1.0,0.38,0.61
PF03106,PF07887:PF10533:PF05553,18,15,9,9,6,994,0.6,0.99,0.5,0.54,6,6,12,0,1000,1.0,0.99,0.33,0.57
PF07531,PF08729:PF10309:PF15996,11,18,2,9,16,991,0.11,0.98,0.18,0.13,2,0,11,2,1005,0.0,0.99,0.0,-0.0
PF09162,PF03943:PF02136:PF05620,4,21,3,1,18,996,0.14,0.98,0.75,0.32,6,3,1,3,1011,0.5,1.0,0.75,0.61
PF11016,PF06695:PF15062:PF12646,0,0,0,0,0,1018,0,1.0,0,0,0,0,0,0,1018,0,1.0,0,0
PF08474,PF01530:PF17208:PF01853,4,37,4,0,33,981,0.11,0.97,1.0,0.32,9,3,1,6,1008,0.33,0.99,0.75,0.5
PF13057,PF10057:PF08691:PF06403,0,1,0,0,1,1017,0.0,1.0,0,0,0,0,0,0,1018,0,1.0,0,0
PF02803,PF00108:PF02036:PF02737,39,66,38,1,28,951,0.58,0.97,0.97,0.74,21,17,22,4,975,0.81,0.97,0.44,0.58
PF01585,PF12457:PF07842:PF07713,63,22,17,46,5,950,0.77,0.95,0.27,0.44,9,9,54,0,955,1.0,0.95,0.14,0.37
PF02439,PF02124:PF09291:PF10570,2,1,0,2,1,1015,0.0,1.0,0.0,-0.0,0,0,2,0,1016,0,1.0,0.0,0
PF17186,PF07143:PF10116:PF05494,0,2,0,0,2,1016,0.0,1.0,0,0,0,0,0,0,1018,0,1.0,0,0
PF10462,PF08744:PF11775:PF15271,3,0,0,3,0,1015,0,1.0,0.0,0,0,0,3,0,1015,0,1.0,0.0,0
PF05904,PF09284:PF14683:PF14576,1,17,1,0,16,1001,0.06,0.98,1.0,0.24,8,0,1,8,1009,0.0,0.99,0.0,-0.0
PF03143,PF09173:PF16658:PF09107,25,7,3,22,4,989,0.43,0.97,0.12,0.22,1,1,24,0,993,1.0,0.98,0.04,0.2
PF15509,PF05177:PF14926:PF11699,2,10,0,2,10,1006,0.0,0.99,0.0,-0.0,1,0,2,1,1015,0.0,1.0,0.0,-0.0
PF15816,PF15829:PF15003:PF09784,1,2,0,1,2,1015,0.0,1.0,0.0,-0.0,0,0,1,0,1017,0,1.0,0.0,0
PF02840,PF07039:PF08954:PF01092,11,19,7,4,12,995,0.37,0.98,0.64,0.48,1,1,10,0,1007,1.0,0.99,0.09,0.3
PF10061,PF12087:PF02577:PF04204,0,2,0,0,2,1016,0.0,1.0,0,0,0,0,0,0,1018,0,1.0,0,0
PF06227,PF15775:PF01514:PF04355,0,0,0,0,0,1018,0,1.0,0,0,0,0,0,0,1018,0,1.0,0,0
PF15319,PF05025:PF12256:PF08411,0,7,0,0,7,1011,0.0,0.99,0,0,0,0,0,0,1018,0,1.0,0,0
PF10096,PF08545:PF00970:PF13405,0,62,0,0,62,956,0.0,0.94,0,0,13,0,0,13,1005,0.0,0.99,0,0
PF14279,PF02576:PF11255:PF03703,0,1,0,0,1,1017,0.0,1.0,0,0,0,0,0,0,1018,0,1.0,0,0
PF00732,PF05199:PF16010:PF02897,56,74,54,2,20,942,0.73,0.98,0.96,0.83,18,15,41,3,959,0.83,0.96,0.27,0.46
PF10815,PF06751:PF09951:PF16325,0,2,0,0,2,1016,0.0,1.0,0,0,0,0,0,0,1018,0,1.0,0,0
PF01041,PF08635:PF09166:PF02311,11,11,2,9,9,998,0.18,0.98,0.18,0.17,1,1,10,0,1007,1.0,0.99,0.09,0.3
PF03991,PF07276:PF06753:PF03578,0,1,0,0,1,1017,0.0,1.0,0,0,0,0,0,0,1018,0,1.0,0,0
PF10974,PF01514:PF01752:PF05857,0,2,0,0,2,1016,0.0,1.0,0,0,0,0,0,0,1018,0,1.0,0,0
PF05790,PF09191:PF12104:PF11465,2,3,1,1,2,1014,0.33,1.0,0.5,0.41,0,0,2,0,1016,0,1.0,0.0,0
PF12002,PF16193:PF05496:PF16565,14,20,14,0,6,998,0.7,0.99,1.0,0.83,5,5,9,0,1004,1.0,0.99,0.36,0.59
PF08173,PF16327:PF03351:PF03104,0,47,0,0,47,971,0.0,0.95,0,0,8,0,0,8,1010,0.0,0.99,0,0
PF05015,PF14655:PF14656:PF00583,0,90,0,0,90,928,0.0,0.91,0,0,10,0,0,10,1008,0.0,0.99,0,0
PF15934,PF15821:PF13096:PF13870,0,3,0,0,3,1015,0.0,1.0,0,0,0,0,0,0,1018,0,1.0,0,0
PF13762,PF08334:PF04347:PF01475,0,5,0,0,5,1013,0.0,1.0,0,0,0,0,0,0,1018,0,1.0,0,0
PF10375,PF15453:PF11291:PF05164,1,0,0,1,0,1017,0,1.0,0.0,0,0,0,1,0,1017,0,1.0,0.0,0
PF02394,PF05324:PF08023:PF00837,2,3,0,2,3,1013,0.0,1.0,0.0,-0.0,0,0,2,0,1016,0,1.0,0.0,0
PF00948,PF01206:PF13769:PF05929,4,1,0,4,1,1013,0.0,1.0,0.0,-0.0,0,0,4,0,1014,0,1.0,0.0,0
PF13301,PF16218:PF15062:PF11016,2,0,0,2,0,1016,0,1.0,0.0,0,0,0,2,0,1016,0,1.0,0.0,0
PF04976,PF05018:PF04876:PF09606,0,19,0,0,19,999,0.0,0.98,0,0,2,0,0,2,1016,0.0,1.0,0,0
PF14705,PF09419:PF15503:PF12319,4,13,0,4,13,1001,0.0,0.98,0.0,-0.01,0,0,4,0,1014,0,1.0,0.0,0
PF08151,PF16165:PF08150:PF08165,6,10,6,0,4,1008,0.6,1.0,1.0,0.77,5,4,2,1,1011,0.8,1.0,0.67,0.73
PF01857,PF11934:PF08934:PF01858,1,3,1,0,2,1015,0.33,1.0,1.0,0.58,1,1,0,0,1017,1.0,1.0,1.0,1.0
PF08839,PF16679:PF05224:PF16019,7,18,6,1,12,999,0.33,0.99,0.86,0.53,1,0,7,1,1010,0.0,0.99,0.0,-0.0
PF03350,PF07816:PF14159:PF07896,1,5,0,1,5,1012,0.0,0.99,0.0,-0.0,0,0,1,0,1017,0,1.0,0.0,0
PF00571,PF01595:PF00654:PF00291,59,91,44,15,47,912,0.48,0.94,0.75,0.57,13,13,46,0,959,1.0,0.95,0.22,0.46
PF13606,PF00710:PF12796:PF00023,49,251,47,2,204,765,0.19,0.8,0.96,0.37,105,36,13,69,900,0.34,0.92,0.73,0.47
PF14023,PF05556:PF10995:PF11019,3,5,1,2,4,1011,0.2,0.99,0.33,0.26,0,0,3,0,1015,0,1.0,0.0,0
PF02948,PF09394:PF12201:PF11493,4,0,0,4,0,1014,0,1.0,0.0,0,0,0,4,0,1014,0,1.0,0.0,0
PF12938,PF16608:PF10427:PF15861,4,7,1,3,6,1008,0.14,0.99,0.25,0.18,1,1,3,0,1014,1.0,1.0,0.25,0.5
PF15158,PF15055:PF15333:PF14986,0,0,0,0,0,1018,0,1.0,0,0,0,0,0,0,1018,0,1.0,0,0
PF00250,PF16159:PF02701:PF04109,45,20,10,35,10,963,0.5,0.96,0.22,0.31,3,3,42,0,973,1.0,0.96,0.07,0.25
PF17084,PF04612:PF11369:PF02741,0,2,0,0,2,1016,0.0,1.0,0,0,0,0,0,0,1018,0,1.0,0,0
PF15088,PF14866:PF08843:PF15119,0,1,0,0,1,1017,0.0,1.0,0,0,0,0,0,0,1018,0,1.0,0,0
PF01284,PF07303:PF03096:PF03195,26,18,10,16,8,984,0.56,0.98,0.38,0.45,2,2,24,0,992,1.0,0.98,0.08,0.27
PF10672,PF12955:PF13396:PF16091,3,5,0,3,5,1010,0.0,0.99,0.0,-0.0,0,0,3,0,1015,0,1.0,0.0,0
PF11712,PF07412:PF10276:PF15910,8,6,2,6,4,1006,0.33,0.99,0.25,0.28,0,0,8,0,1010,0,0.99,0.0,0
PF14258,PF03241:PF13722:PF07499,0,2,0,0,2,1016,0.0,1.0,0,0,0,0,0,0,1018,0,1.0,0,0
PF14760,PF01706:PF16325:PF02465,1,2,0,1,2,1015,0.0,1.0,0.0,-0.0,0,0,1,0,1017,0,1.0,0.0,0
PF09243,PF02357:PF16493:PF12298,13,9,1,12,8,997,0.11,0.98,0.08,0.08,0,0,13,0,1005,0,0.99,0.0,0
PF04750,PF03972:PF01115:PF07096,5,14,3,2,11,1002,0.21,0.99,0.6,0.35,3,1,4,2,1011,0.33,0.99,0.2,0.26
PF16556,PF16742:PF15037:PF07923,1,8,0,1,8,1009,0.0,0.99,0.0,-0.0,0,0,1,0,1017,0,1.0,0.0,0
PF15691,PF15741:PF15703:PF17085,1,1,0,1,1,1016,0.0,1.0,0.0,-0.0,0,0,1,0,1017,0,1.0,0.0,0
PF02701,PF09816:PF06886:PF04109,10,18,4,6,14,994,0.22,0.98,0.4,0.29,3,1,9,2,1006,0.33,0.99,0.1,0.18
PF08760,PF16335:PF17168:PF16334,5,4,4,1,0,1013,1.0,1.0,0.8,0.89,4,4,1,0,1013,1.0,1.0,0.8,0.89
PF11526,PF15912:PF07001:PF04357,7,7,1,6,6,1005,0.14,0.99,0.14,0.14,0,0,7,0,1011,0,0.99,0.0,0
PF09444,PF09967:PF03344:PF09931,1,4,0,1,4,1013,0.0,1.0,0.0,-0.0,0,0,1,0,1017,0,1.0,0.0,0
PF08249,PF04333:PF07679:PF09519,0,93,0,0,93,925,0.0,0.91,0,0,1,0,0,1,1017,0.0,1.0,0,0
PF07489,PF01776:PF00014:PF13648,0,52,0,0,52,966,0.0,0.95,0,0,2,0,0,2,1016,0.0,1.0,0,0
PF08217,PF02765:PF16418:PF06025,12,23,3,9,20,986,0.13,0.97,0.25,0.17,3,2,10,1,1005,0.67,0.99,0.17,0.33
PF05189,PF01137:PF01523:PF01658,3,21,3,0,18,997,0.14,0.98,1.0,0.37,2,1,2,1,1014,0.5,1.0,0.33,0.41
PF13550,PF17050:PF14534:PF10994,0,1,0,0,1,1017,0.0,1.0,0,0,0,0,0,0,1018,0,1.0,0,0
PF15423,PF04500:PF06903:PF10532,0,23,0,0,23,995,0.0,0.98,0,0,3,0,0,3,1015,0.0,1.0,0,0
PF17185,PF16888:PF09498:PF03241,0,0,0,0,0,1018,0,1.0,0,0,0,0,0,0,1018,0,1.0,0,0
PF04570,PF10248:PF08536:PF03195,2,13,0,2,13,1003,0.0,0.99,0.0,-0.01,2,0,2,2,1014,0.0,1.0,0.0,-0.0
PF10591,PF09289:PF00050:PF09307,9,24,5,4,19,990,0.21,0.98,0.56,0.33,2,2,7,0,1009,1.0,0.99,0.22,0.47
PF16864,PF02545:PF08100:PF04093,11,24,4,7,20,987,0.17,0.97,0.36,0.23,3,2,9,1,1006,0.67,0.99,0.18,0.34
PF04840,PF04841:PF12215:PF04685,14,15,9,5,6,998,0.6,0.99,0.64,0.62,5,2,12,3,1001,0.4,0.99,0.14,0.23
PF13759,PF09187:PF10138:PF04562,9,2,0,9,2,1007,0.0,0.99,0.0,-0.0,0,0,9,0,1009,0,0.99,0.0,0
PF10095,PF08251:PF02933:PF15191,0,10,0,0,10,1008,0.0,0.99,0,0,0,0,0,0,1018,0,1.0,0,0
PF09190,PF01406:PF05622:PF09635,5,28,5,0,23,990,0.18,0.98,1.0,0.42,5,3,2,2,1011,0.6,1.0,0.6,0.6
PF00025,PF15840:PF14634:PF12273,65,23,12,53,11,942,0.52,0.94,0.18,0.28,4,4,61,0,953,1.0,0.94,0.06,0.24
PF02827,PF14672:PF15724:PF08738,1,0,0,1,0,1017,0,1.0,0.0,0,0,0,1,0,1017,0,1.0,0.0,0
PF12457,PF07713:PF07842:PF13821,7,25,7,0,18,993,0.28,0.98,1.0,0.52,5,2,5,3,1008,0.4,0.99,0.29,0.33
PF01887,PF04222:PF14985:PF13689,0,2,0,0,2,1016,0.0,1.0,0,0,0,0,0,0,1018,0,1.0,0,0
PF14647,PF14648:PF09494:PF09324,3,22,3,0,19,996,0.14,0.98,1.0,0.37,3,1,2,2,1013,0.33,1.0,0.33,0.33
PF03916,PF13689:PF03317:PF15192,0,5,0,0,5,1013,0.0,1.0,0,0,0,0,0,0,1018,0,1.0,0,0
PF11074,PF09677:PF12477:PF11775,0,0,0,0,0,1018,0,1.0,0,0,0,0,0,0,1018,0,1.0,0,0
PF02152,PF01288:PF00809:PF02607,11,18,9,2,9,998,0.5,0.99,0.82,0.63,10,5,6,5,1002,0.5,0.99,0.45,0.47
PF13446,PF14533:PF14836:PF06337,4,23,2,2,21,993,0.09,0.98,0.5,0.2,7,2,2,5,1009,0.29,0.99,0.5,0.37
PF11569,PF04731:PF10525:PF04617,1,5,1,0,4,1013,0.2,1.0,1.0,0.45,1,1,0,0,1017,1.0,1.0,1.0,1.0
PF00216,PF08194:PF15713:PF08713,5,2,0,5,2,1011,0.0,0.99,0.0,-0.0,0,0,5,0,1013,0,1.0,0.0,0
PF14398,PF07902:PF16463:PF16732,0,1,0,0,1,1017,0.0,1.0,0,0,0,0,0,0,1018,0,1.0,0,0
PF02198,PF12310:PF04621:PF11620,16,5,2,14,3,999,0.4,0.98,0.12,0.22,2,2,14,0,1002,1.0,0.99,0.12,0.35
PF07498,PF07497:PF11421:PF16886,12,20,5,7,15,991,0.25,0.98,0.42,0.31,1,1,11,0,1006,1.0,0.99,0.08,0.29
PF11421,PF07497:PF07498:PF16886,3,25,1,2,24,991,0.04,0.97,0.33,0.11,5,1,2,4,1011,0.2,0.99,0.33,0.26
PF12539,PF06887:PF01580:PF17206,8,5,1,7,4,1006,0.2,0.99,0.12,0.15,1,1,7,0,1010,1.0,0.99,0.12,0.35
PF13639,PF12678:PF17123:PF00097,122,82,45,77,37,859,0.55,0.89,0.37,0.39,19,17,105,2,894,0.89,0.89,0.14,0.33
PF12537,PF12430:PF14958:PF01237,1,41,1,0,40,977,0.02,0.96,1.0,0.15,1,1,0,0,1017,1.0,1.0,1.0,1.0
PF13568,PF06798:PF03971:PF12241,0,2,0,0,2,1016,0.0,1.0,0,0,0,0,0,0,1018,0,1.0,0,0
PF00514,PF16689:PF01749:PF05956,63,23,20,43,3,952,0.87,0.95,0.32,0.51,3,3,60,0,955,1.0,0.94,0.05,0.21
PF09719,PF00112:PF03520:PF08246,0,65,0,0,65,953,0.0,0.94,0,0,33,0,0,33,985,0.0,0.97,0,0
PF05270,PF09206:PF08742:PF09175,7,31,5,2,26,985,0.16,0.97,0.71,0.33,3,2,5,1,1010,0.67,0.99,0.29,0.43
PF15368,PF11577:PF15784:PF16574,0,6,0,0,6,1012,0.0,0.99,0,0,0,0,0,0,1018,0,1.0,0,0
PF00617,PF00618:PF00620:PF00611,46,104,43,3,61,911,0.41,0.94,0.93,0.6,30,24,22,6,966,0.8,0.97,0.52,0.63
PF08956,PF10933:PF15337:PF09361,0,3,0,0,3,1015,0.0,1.0,0,0,0,0,0,0,1018,0,1.0,0,0
PF03325,PF15909:PF10571:PF05991,1,7,0,1,7,1010,0.0,0.99,0.0,-0.0,0,0,1,0,1017,0,1.0,0.0,0
PF15897,PF07996:PF08889:PF15716,0,3,0,0,3,1015,0.0,1.0,0,0,0,0,0,0,1018,0,1.0,0,0
PF13095,PF07444:PF00737:PF15503,2,2,0,2,2,1014,0.0,1.0,0.0,-0.0,0,0,2,0,1016,0,1.0,0.0,0
PF09773,PF00076:PF06495:PF08050,9,245,8,1,237,772,0.03,0.77,0.89,0.14,3,1,8,2,1007,0.33,0.99,0.11,0.19
PF08439,PF06719:PF13280:PF09179,1,7,0,1,7,1010,0.0,0.99,0.0,-0.0,0,0,1,0,1017,0,1.0,0.0,0
PF05466,PF15128:PF07804:PF13995,0,1,0,0,1,1017,0.0,1.0,0,0,0,0,0,0,1018,0,1.0,0,0
PF09090,PF09088:PF02854:PF02847,11,38,11,0,27,980,0.29,0.97,1.0,0.53,21,9,2,12,995,0.43,0.99,0.82,0.59
PF09149,PF03724:PF00648:PF01067,3,51,2,1,49,966,0.04,0.95,0.67,0.15,31,2,1,29,986,0.06,0.97,0.67,0.2
PF10497,PF02375:PF02928:PF08879,11,20,3,8,17,990,0.15,0.98,0.27,0.19,11,3,8,8,999,0.27,0.98,0.27,0.26
PF16526,PF13545:PF08412:PF11879,7,11,1,6,10,1001,0.09,0.98,0.14,0.11,2,1,6,1,1010,0.5,0.99,0.14,0.26
PF13889,PF15557:PF04118:PF12129,5,11,2,3,9,1004,0.18,0.99,0.4,0.26,0,0,5,0,1013,0,1.0,0.0,0
PF16368,PF16366:PF16367:PF04961,3,17,3,0,14,1001,0.18,0.99,1.0,0.42,12,3,0,9,1006,0.25,0.99,1.0,0.5
PF01218,PF04107:PF14159:PF02186,7,17,2,5,15,996,0.12,0.98,0.29,0.17,2,0,7,2,1009,0.0,0.99,0.0,-0.0
PF17175,PF09687:PF13908:PF04769,11,4,1,10,3,1004,0.25,0.99,0.09,0.15,0,0,11,0,1007,0,0.99,0.0,0
PF01251,PF16739:PF16203:PF13625,21,20,7,14,13,984,0.35,0.97,0.33,0.33,11,7,14,4,993,0.64,0.98,0.33,0.45
PF12795,PF10473:PF10979:PF02108,4,4,0,4,4,1010,0.0,0.99,0.0,-0.0,0,0,4,0,1014,0,1.0,0.0,0
PF15194,PF05939:PF14494:PF10974,1,0,0,1,0,1017,0,1.0,0.0,0,0,0,1,0,1017,0,1.0,0.0,0
PF00815,PF01502:PF01503:PF06276,15,21,8,7,13,990,0.38,0.98,0.53,0.44,11,8,7,3,1000,0.73,0.99,0.53,0.62
PF08567,PF03909:PF04376:PF05422,8,23,8,0,15,995,0.35,0.99,1.0,0.59,6,3,5,3,1007,0.5,0.99,0.38,0.43
PF10382,PF14383:PF07529:PF12552,6,20,4,2,16,996,0.2,0.98,0.67,0.36,4,1,5,3,1009,0.25,0.99,0.17,0.2
PF09314,PF07310:PF05969:PF07022,0,2,0,0,2,1016,0.0,1.0,0,0,0,0,0,0,1018,0,1.0,0,0
PF00942,PF02927:PF07476:PF13726,2,2,1,1,1,1015,0.5,1.0,0.5,0.5,0,0,2,0,1016,0,1.0,0.0,0
PF08013,PF01580:PF09611:PF07980,1,5,0,1,5,1012,0.0,0.99,0.0,-0.0,0,0,1,0,1017,0,1.0,0.0,0
PF08641,PF09631:PF09597:PF10780,4,11,3,1,8,1006,0.27,0.99,0.75,0.45,0,0,4,0,1014,0,1.0,0.0,0
PF11891,PF03479:PF02234:PF11489,6,14,0,6,14,998,0.0,0.98,0.0,-0.01,0,0,6,0,1012,0,0.99,0.0,0
PF09966,PF11907:PF13089:PF15830,1,1,1,0,0,1017,1.0,1.0,1.0,1.0,1,1,0,0,1017,1.0,1.0,1.0,1.0
PF02330,PF06749:PF01791:PF01625,7,35,5,2,30,981,0.14,0.97,0.71,0.31,3,2,5,1,1010,0.67,0.99,0.29,0.43
PF05853,PF15050:PF17015:PF15036,1,3,0,1,3,1014,0.0,1.0,0.0,-0.0,0,0,1,0,1017,0,1.0,0.0,0
PF08132,PF01536:PF03858:PF11693,2,11,1,1,10,1006,0.09,0.99,0.5,0.21,0,0,2,0,1016,0,1.0,0.0,0
PF04734,PF17048:PF02268:PF02751,8,22,8,0,14,996,0.36,0.99,1.0,0.6,12,1,7,11,999,0.08,0.98,0.12,0.09
PF01119,PF10699:PF10257:PF15996,24,19,5,19,14,980,0.26,0.97,0.21,0.22,1,1,23,0,994,1.0,0.98,0.04,0.2
PF10261,PF02560:PF00590:PF04790,3,22,1,2,21,994,0.05,0.98,0.33,0.12,5,0,3,5,1010,0.0,0.99,0.0,-0.0
PF00124,PF00119:PF00507:PF00499,2,12,0,2,12,1004,0.0,0.99,0.0,-0.0,4,0,2,4,1012,0.0,0.99,0.0,-0.0
PF10491,PF10492:PF15999:PF00853,3,7,1,2,6,1009,0.14,0.99,0.33,0.21,0,0,3,0,1015,0,1.0,0.0,0
PF02172,PF08941:PF09030:PF16207,13,22,9,4,13,992,0.41,0.98,0.69,0.52,7,4,9,3,1002,0.57,0.99,0.31,0.41
PF07225,PF04736:PF15171:PF10868,4,2,0,4,2,1012,0.0,0.99,0.0,-0.0,0,0,4,0,1014,0,1.0,0.0,0
PF02185,PF03097:PF13949:PF15796,22,34,12,10,22,974,0.35,0.97,0.55,0.42,22,5,17,17,979,0.23,0.97,0.23,0.21
PF00642,PF15815:PF10453:PF08941,71,13,7,64,6,941,0.54,0.93,0.1,0.21,2,2,69,0,947,1.0,0.93,0.03,0.16
PF07707,PF00016:PF02788:PF09494,63,16,11,52,5,950,0.69,0.94,0.17,0.33,2,1,62,1,954,0.5,0.94,0.02,0.08
PF03406,PF09498:PF07805:PF14882,0,1,0,0,1,1017,0.0,1.0,0,0,0,0,0,0,1018,0,1.0,0,0
PF12456,PF07092:PF08952:PF02383,10,38,9,1,29,979,0.24,0.97,0.9,0.45,6,2,8,4,1004,0.33,0.99,0.2,0.25
PF02861,PF02577:PF10431:PF02151,9,36,9,0,27,982,0.25,0.97,1.0,0.49,8,4,5,4,1005,0.5,0.99,0.44,0.47
PF01357,PF03330:PF01731:PF07258,14,34,13,1,21,983,0.38,0.98,0.93,0.59,4,3,11,1,1003,0.75,0.99,0.21,0.4
PF16686,PF02765:PF03315:PF07171,3,15,3,0,12,1003,0.2,0.99,1.0,0.44,1,0,3,1,1014,0.0,1.0,0.0,-0.0
PF15395,PF11713:PF15491:PF09249,0,3,0,0,3,1015,0.0,1.0,0,0,0,0,0,0,1018,0,1.0,0,0
PF00079,PF04045:PF16038:PF01182,29,33,6,23,27,962,0.18,0.95,0.21,0.17,4,1,28,3,986,0.25,0.97,0.03,0.08
PF01471,PF00045:PF00413:PF08924,32,37,26,6,11,975,0.7,0.98,0.81,0.75,24,22,10,2,984,0.92,0.99,0.69,0.79
PF15240,PF05238:PF15710:PF14654,2,0,0,2,0,1016,0,1.0,0.0,0,0,0,2,0,1016,0,1.0,0.0,0
PF02782,PF00370:PF02550:PF01144,38,62,36,2,26,954,0.58,0.97,0.95,0.73,8,7,31,1,979,0.88,0.97,0.18,0.39
PF00281,PF00673:PF09285:PF13259,22,27,18,4,9,987,0.67,0.99,0.82,0.73,5,5,17,0,996,1.0,0.98,0.23,0.47
PF08574,PF15247:PF02045:PF13864,5,16,3,2,13,1000,0.19,0.99,0.6,0.33,2,2,3,0,1013,1.0,1.0,0.4,0.63
PF13873,PF16064:PF04189:PF10226,19,19,7,12,12,987,0.37,0.98,0.37,0.36,3,3,16,0,999,1.0,0.98,0.16,0.39
PF00001,PF13306:PF01348:PF08983,133,46,28,105,18,867,0.61,0.88,0.21,0.31,4,4,129,0,885,1.0,0.87,0.03,0.16
PF05124,PF10129:PF02653:PF10414,0,13,0,0,13,1005,0.0,0.99,0,0,0,0,0,0,1018,0,1.0,0,0
PF03230,PF04964:PF08105:PF01674,0,8,0,0,8,1010,0.0,0.99,0,0,0,0,0,0,1018,0,1.0,0,0
PF16715,PF06161:PF16654:PF13009,1,0,0,1,0,1017,0,1.0,0.0,0,0,0,1,0,1017,0,1.0,0.0,0
PF04869,PF14932:PF09822:PF14779,14,10,4,10,6,998,0.4,0.98,0.29,0.33,1,1,13,0,1004,1.0,0.99,0.07,0.27
PF11071,PF17010:PF08691:PF14985,0,2,0,0,2,1016,0.0,1.0,0,0,0,0,0,0,1018,0,1.0,0,0
PF07292,PF07334:PF04921:PF14766,2,13,2,0,11,1005,0.15,0.99,1.0,0.39,2,1,1,1,1015,0.5,1.0,0.5,0.5
PF07123,PF05936:PF07338:PF06834,6,5,2,4,3,1009,0.4,0.99,0.33,0.36,2,2,4,0,1012,1.0,1.0,0.33,0.58
PF05716,PF10522:PF14047:PF14049,4,5,2,2,3,1011,0.4,1.0,0.5,0.44,0,0,4,0,1014,0,1.0,0.0,0
PF06042,PF06681:PF05962:PF09962,1,2,0,1,2,1015,0.0,1.0,0.0,-0.0,0,0,1,0,1017,0,1.0,0.0,0
PF00690,PF16209:PF00689:PF12515,63,85,58,5,27,928,0.68,0.97,0.92,0.78,23,22,41,1,954,0.96,0.96,0.35,0.56
PF03428,PF08345:PF05939:PF04740,0,1,0,0,1,1017,0.0,1.0,0,0,0,0,0,0,1018,0,1.0,0,0
PF04179,PF17184:PF08369:PF09363,3,6,3,0,3,1012,0.5,1.0,1.0,0.71,1,1,2,0,1015,1.0,1.0,0.33,0.58
PF02798,PF13409:PF13417:PF00647,47,64,23,24,41,930,0.36,0.94,0.49,0.39,13,8,39,5,966,0.62,0.96,0.17,0.31
PF09227,PF00796:PF05728:PF08040,0,5,0,0,5,1013,0.0,1.0,0,0,0,0,0,0,1018,0,1.0,0,0
PF02895,PF08707:PF12081:PF03241,2,1,0,2,1,1015,0.0,1.0,0.0,-0.0,0,0,2,0,1016,0,1.0,0.0,0
PF03498,PF05100:PF13742:PF06805,1,2,0,1,2,1015,0.0,1.0,0.0,-0.0,0,0,1,0,1017,0,1.0,0.0,0
PF12734,PF06127:PF06376:PF03980,2,10,1,1,9,1007,0.1,0.99,0.5,0.22,0,0,2,0,1016,0,1.0,0.0,0
PF13493,PF07730:PF06580:PF16359,0,15,0,0,15,1003,0.0,0.99,0,0,2,0,0,2,1016,0.0,1.0,0,0
PF06185,PF10938:PF11380:PF17103,0,8,0,0,8,1010,0.0,0.99,0,0,4,0,0,4,1014,0.0,1.0,0,0
PF01323,PF06288:PF00274:PF06585,21,23,6,15,17,980,0.26,0.97,0.29,0.26,2,2,19,0,997,1.0,0.98,0.1,0.31
PF02155,PF02161:PF02159:PF12577,6,11,5,1,6,1006,0.45,0.99,0.83,0.61,5,5,1,0,1012,1.0,1.0,0.83,0.91
PF08154,PF16699:PF12265:PF04158,12,15,5,7,10,996,0.33,0.98,0.42,0.36,2,2,10,0,1006,1.0,0.99,0.17,0.41
PF07063,PF12900:PF06108:PF07333,6,12,1,5,11,1001,0.08,0.98,0.17,0.11,0,0,6,0,1012,0,0.99,0.0,0
PF00677,PF05173:PF14693:PF10356,4,10,0,4,10,1004,0.0,0.99,0.0,-0.01,0,0,4,0,1014,0,1.0,0.0,0
PF09827,PF01258:PF02412:PF08516,0,29,0,0,29,989,0.0,0.97,0,0,4,0,0,4,1014,0.0,1.0,0,0
PF08297,PF07282:PF12600:PF01057,1,3,0,1,3,1014,0.0,1.0,0.0,-0.0,1,0,1,1,1016,0.0,1.0,0.0,-0.0
PF04056,PF07975:PF04704:PF15350,9,6,5,4,1,1008,0.83,1.0,0.56,0.68,0,0,9,0,1009,0,0.99,0.0,0
PF05250,PF16037:PF00489:PF15715,3,1,0,3,1,1014,0.0,1.0,0.0,-0.0,0,0,3,0,1015,0,1.0,0.0,0
PF01410,PF01391:PF00386:PF02210,15,94,11,4,83,920,0.12,0.91,0.73,0.27,32,7,8,25,978,0.22,0.97,0.47,0.31
PF07011,PF11947:PF15063:PF10839,0,3,0,0,3,1015,0.0,1.0,0,0,0,0,0,0,1018,0,1.0,0,0
PF05600,PF12139:PF14817:PF06449,9,7,1,8,6,1003,0.14,0.99,0.11,0.12,0,0,9,0,1009,0,0.99,0.0,0
PF16588,PF10490:PF05164:PF02108,3,4,0,3,4,1011,0.0,0.99,0.0,-0.0,0,0,3,0,1015,0,1.0,0.0,0
PF01085,PF01079:PF04424:PF12470,8,26,7,1,19,991,0.27,0.98,0.88,0.48,7,3,5,4,1006,0.43,0.99,0.38,0.4
PF12327,PF02491:PF03953:PF15245,5,50,2,3,48,965,0.04,0.95,0.4,0.11,2,2,3,0,1013,1.0,1.0,0.4,0.63
PF15098,PF13466:PF04627:PF08367,1,19,1,0,18,999,0.05,0.98,1.0,0.23,1,0,1,1,1016,0.0,1.0,0.0,-0.0
PF08269,PF16836:PF14985:PF01337,0,2,0,0,2,1016,0.0,1.0,0,0,0,0,0,0,1018,0,1.0,0,0
PF01152,PF00537:PF07740:PF01241,7,1,0,7,1,1010,0.0,0.99,0.0,-0.0,1,0,7,1,1010,0.0,0.99,0.0,-0.0
PF08276,PF00954:PF01453:PF11883,20,42,19,1,23,975,0.45,0.98,0.95,0.65,23,17,3,6,992,0.74,0.99,0.85,0.79
PF05223,PF14344:PF10951:PF07209,1,1,0,1,1,1016,0.0,1.0,0.0,-0.0,0,0,1,0,1017,0,1.0,0.0,0
PF06729,PF15119:PF02977:PF15041,0,2,0,0,2,1016,0.0,1.0,0,0,0,0,0,0,1018,0,1.0,0,0
PF09954,PF00359:PF13438:PF02756,0,3,0,0,3,1015,0.0,1.0,0,0,0,0,0,0,1018,0,1.0,0,0
PF12518,PF08792:PF09967:PF05309,0,2,0,0,2,1016,0.0,1.0,0,0,1,0,0,1,1017,0.0,1.0,0,0
PF00706,PF15119:PF02950:PF07327,0,3,0,0,3,1015,0.0,1.0,0,0,0,0,0,0,1018,0,1.0,0,0
PF07500,PF08711:PF15694:PF06881,16,28,12,4,16,986,0.43,0.98,0.75,0.56,3,2,14,1,1001,0.67,0.99,0.12,0.28
PF04219,PF15835:PF15859:PF07413,0,0,0,0,0,1018,0,1.0,0,0,0,0,0,0,1018,0,1.0,0,0
PF05985,PF03900:PF10834:PF07343,1,16,0,1,16,1001,0.0,0.98,0.0,-0.0,0,0,1,0,1017,0,1.0,0.0,0
PF08241,PF13847:PF02353:PF00328,78,79,39,39,40,900,0.49,0.92,0.5,0.45,16,14,64,2,938,0.88,0.94,0.18,0.38
PF06925,PF08660:PF04101:PF03033,4,33,4,0,29,985,0.12,0.97,1.0,0.34,8,2,2,6,1008,0.25,0.99,0.5,0.35
PF15506,PF11697:PF01668:PF12318,0,2,0,0,2,1016,0.0,1.0,0,0,0,0,0,0,1018,0,1.0,0,0
PF07529,PF15790:PF14619:PF06465,17,17,8,9,9,992,0.47,0.98,0.47,0.46,2,2,15,0,1001,1.0,0.99,0.12,0.34
PF02183,PF16878:PF03792:PF00157,6,18,4,2,14,998,0.22,0.98,0.67,0.38,6,4,2,2,1010,0.67,1.0,0.67,0.66
PF15419,PF13441:PF06547:PF04363,2,3,2,0,1,1015,0.67,1.0,1.0,0.82,2,2,0,0,1016,1.0,1.0,1.0,1.0
PF07353,PF08093:PF05611:PF10563,2,2,0,2,2,1014,0.0,1.0,0.0,-0.0,0,0,2,0,1016,0,1.0,0.0,0
PF12934,PF12933:PF05683:PF14920,0,6,0,0,6,1012,0.0,0.99,0,0,0,0,0,0,1018,0,1.0,0,0
PF04800,PF07896:PF01097:PF07816,9,8,2,7,6,1003,0.25,0.99,0.22,0.23,0,0,9,0,1009,0,0.99,0.0,0
PF01202,PF01761:PF01487:PF08501,11,22,11,0,11,996,0.5,0.99,1.0,0.7,12,11,0,1,1006,0.92,1.0,1.0,0.96
PF07057,PF08291:PF17148:PF15729,4,1,0,4,1,1013,0.0,1.0,0.0,-0.0,0,0,4,0,1014,0,1.0,0.0,0
PF08161,PF14952:PF12432:PF12169,5,7,2,3,5,1008,0.29,0.99,0.4,0.33,0,0,5,0,1013,0,1.0,0.0,0
PF16851,PF10868:PF06369:PF09057,0,1,0,0,1,1017,0.0,1.0,0,0,0,0,0,0,1018,0,1.0,0,0
PF00351,PF10369:PF01842:PF12549,22,31,7,15,24,972,0.23,0.96,0.32,0.25,5,3,19,2,994,0.6,0.98,0.14,0.28
PF16485,PF01447:PF02868:PF00073,1,13,1,0,12,1005,0.08,0.99,1.0,0.28,1,1,0,0,1017,1.0,1.0,1.0,1.0
PF06434,PF11791:PF00694:PF00330,2,39,2,0,37,979,0.05,0.96,1.0,0.22,29,2,0,27,989,0.07,0.97,1.0,0.26
PF03151,PF04230:PF05019:PF00244,31,30,11,20,19,968,0.37,0.96,0.35,0.34,5,4,27,1,986,0.8,0.97,0.13,0.31
PF03861,PF08093:PF15001:PF04370,1,2,0,1,2,1015,0.0,1.0,0.0,-0.0,0,0,1,0,1017,0,1.0,0.0,0
PF10324,PF10413:PF10328:PF05823,31,18,8,23,10,977,0.44,0.97,0.26,0.32,2,2,29,0,987,1.0,0.97,0.06,0.25
PF12871,PF14849:PF11567:PF10576,5,5,0,5,5,1008,0.0,0.99,0.0,-0.0,0,0,5,0,1013,0,1.0,0.0,0
PF00059,PF08016:PF00801:PF15481,80,34,18,62,16,922,0.53,0.92,0.23,0.31,7,6,74,1,937,0.86,0.93,0.07,0.24
PF08685,PF01681:PF05986:PF08686,6,18,3,3,15,997,0.17,0.98,0.5,0.28,7,3,3,4,1008,0.43,0.99,0.5,0.46
PF09298,PF01557:PF08530:PF10370,25,46,23,2,23,970,0.5,0.98,0.92,0.67,15,12,13,3,990,0.8,0.98,0.48,0.61
PF09204,PF10106:PF15212:PF05115,1,3,0,1,3,1014,0.0,1.0,0.0,-0.0,0,0,1,0,1017,0,1.0,0.0,0
PF07473,PF05939:PF12615:PF04451,0,1,0,0,1,1017,0.0,1.0,0,0,0,0,0,0,1018,0,1.0,0,0
PF07470,PF03583:PF09995:PF04140,19,26,8,11,18,981,0.31,0.97,0.42,0.35,2,2,17,0,999,1.0,0.98,0.11,0.32
PF03203,PF15713:PF14877:PF17015,0,6,0,0,6,1012,0.0,0.99,0,0,0,0,0,0,1018,0,1.0,0,0
PF11793,PF09765:PF07453:PF07460,7,16,7,0,9,1002,0.44,0.99,1.0,0.66,5,3,4,2,1009,0.6,0.99,0.43,0.5
PF01454,PF12440:PF03074:PF03040,13,13,3,10,10,995,0.23,0.98,0.23,0.22,0,0,13,0,1005,0,0.99,0.0,0
PF14432,PF03178:PF06957:PF14498,41,38,16,25,22,955,0.42,0.95,0.39,0.38,8,8,33,0,977,1.0,0.97,0.2,0.43
PF01034,PF06365:PF15369:PF15290,4,8,1,3,7,1007,0.12,0.99,0.25,0.17,1,1,3,0,1014,1.0,1.0,0.25,0.5
PF11630,PF08194:PF15211:PF09117,0,0,0,0,0,1018,0,1.0,0,0,0,0,0,0,1018,0,1.0,0,0
PF10471,PF02044:PF10310:PF04852,6,5,2,4,3,1009,0.4,0.99,0.33,0.36,2,1,5,1,1011,0.5,0.99,0.17,0.29
PF00039,PF00040:PF09396:PF00878,3,21,3,0,18,997,0.14,0.98,1.0,0.37,5,2,1,3,1012,0.4,1.0,0.67,0.51
PF02617,PF02207:PF05048:PF13764,6,18,5,1,13,999,0.28,0.99,0.83,0.48,5,3,3,2,1010,0.6,1.0,0.5,0.55
PF04664,PF04090:PF02116:PF15045,1,4,0,1,4,1013,0.0,1.0,0.0,-0.0,0,0,1,0,1017,0,1.0,0.0,0
PF11992,PF11932:PF04515:PF03074,0,18,0,0,18,1000,0.0,0.98,0,0,3,0,0,3,1015,0.0,1.0,0,0
PF03568,PF08638:PF14649:PF15246,11,13,2,9,11,996,0.15,0.98,0.18,0.16,0,0,11,0,1007,0,0.99,0.0,0
PF11856,PF11019:PF14052:PF09611,0,0,0,0,0,1018,0,1.0,0,0,0,0,0,0,1018,0,1.0,0,0
PF02399,PF11751:PF12080:PF13247,2,0,0,2,0,1016,0,1.0,0.0,0,0,0,2,0,1016,0,1.0,0.0,0
PF08628,PF02194:PF03700:PF09325,15,33,15,0,18,985,0.45,0.98,1.0,0.67,5,5,10,0,1003,1.0,0.99,0.33,0.57
PF04718,PF16158:PF08939:PF15454,9,18,6,3,12,997,0.33,0.99,0.67,0.47,4,3,6,1,1008,0.75,0.99,0.33,0.5
PF09906,PF09860:PF01109:PF12805,0,2,0,0,2,1016,0.0,1.0,0,0,0,0,0,0,1018,0,1.0,0,0
PF08138,PF17201:PF06134:PF05298,1,2,0,1,2,1015,0.0,1.0,0.0,-0.0,0,0,1,0,1017,0,1.0,0.0,0
PF06873,PF04820:PF07645:PF08119,0,65,0,0,65,953,0.0,0.94,0,0,5,0,0,5,1013,0.0,1.0,0,0
PF13826,PF08656:PF02202:PF14021,0,2,0,0,2,1016,0.0,1.0,0,0,0,0,0,0,1018,0,1.0,0,0
PF10532,PF00872:PF03108:PF04434,3,27,3,0,24,991,0.11,0.98,1.0,0.33,13,2,1,11,1004,0.15,0.99,0.67,0.32
PF15547,PF11402:PF15207:PF15085,0,3,0,0,3,1015,0.0,1.0,0,0,0,0,0,0,1018,0,1.0,0,0
PF10772,PF05251:PF08190:PF03348,0,37,0,0,37,981,0.0,0.96,0,0,5,0,0,5,1013,0.0,1.0,0,0
PF10168,PF16840:PF15318:PF00022,2,60,1,1,59,957,0.02,0.94,0.5,0.08,0,0,2,0,1016,0,1.0,0.0,0
PF06961,PF17017:PF09365:PF17015,0,2,0,0,2,1016,0.0,1.0,0,0,0,0,0,0,1018,0,1.0,0,0
PF14232,PF14231:PF08283:PF01228,0,3,0,0,3,1015,0.0,1.0,0,0,0,0,0,0,1018,0,1.0,0,0
PF16803,PF05093:PF02912:PF01617,6,25,6,0,19,993,0.24,0.98,1.0,0.49,7,1,5,6,1006,0.14,0.99,0.17,0.15
PF01578,PF00421:PF00253:PF00223,4,32,3,1,29,985,0.09,0.97,0.75,0.26,7,1,3,6,1008,0.14,0.99,0.25,0.18
PF00136,PF03104:PF14260:PF12254,37,37,36,1,1,980,0.97,1.0,0.97,0.97,24,24,13,0,981,1.0,0.99,0.65,0.8
PF04774,PF13339:PF02750:PF03479,7,18,4,3,14,997,0.22,0.98,0.57,0.35,3,2,5,1,1010,0.67,0.99,0.29,0.43
PF06026,PF05915:PF06376:PF07896,6,8,1,5,7,1005,0.12,0.99,0.17,0.14,1,0,6,1,1011,0.0,0.99,0.0,-0.0
PF06500,PF06108:PF12900:PF01933,2,14,0,2,14,1002,0.0,0.98,0.0,-0.01,2,0,2,2,1014,0.0,1.0,0.0,-0.0
PF04245,PF11832:PF07924:PF01717,0,14,0,0,14,1004,0.0,0.99,0,0,0,0,0,0,1018,0,1.0,0,0
PF15173,PF06875:PF02427:PF14653,0,0,0,0,0,1018,0,1.0,0,0,0,0,0,0,1018,0,1.0,0,0
PF02746,PF08288:PF02789:PF10022,22,32,5,17,27,969,0.16,0.96,0.23,0.17,3,3,19,0,996,1.0,0.98,0.14,0.37
PF08504,PF15827:PF10846:PF10492,2,8,2,0,6,1010,0.25,0.99,1.0,0.5,1,0,2,1,1015,0.0,1.0,0.0,-0.0
PF11817,PF07919:PF12742:PF10487,5,11,4,1,7,1006,0.36,0.99,0.8,0.54,2,2,3,0,1013,1.0,1.0,0.4,0.63
PF15366,PF08404:PF10106:PF13247,0,1,0,0,1,1017,0.0,1.0,0,0,0,0,0,0,1018,0,1.0,0,0
PF09462,PF10407:PF15082:PF15407,2,3,0,2,3,1013,0.0,1.0,0.0,-0.0,0,0,2,0,1016,0,1.0,0.0,0
PF09746,PF07217:PF10477:PF06886,9,14,1,8,13,996,0.07,0.98,0.11,0.08,0,0,9,0,1009,0,0.99,0.0,0
PF12156,PF09040:PF02130:PF12515,2,14,2,0,12,1004,0.14,0.99,1.0,0.38,4,2,0,2,1014,0.5,1.0,1.0,0.71
PF05195,PF15801:PF01321:PF16188,18,18,6,12,12,988,0.33,0.98,0.33,0.32,5,2,16,3,997,0.4,0.98,0.11,0.2
PF11870,PF02589:PF10554:PF07523,0,6,0,0,6,1012,0.0,0.99,0,0,0,0,0,0,1018,0,1.0,0,0
PF09103,PF09169:PF09121:PF09104,6,5,5,1,0,1012,1.0,1.0,0.83,0.91,1,1,5,0,1012,1.0,1.0,0.17,0.41
PF04338,PF02609:PF15423:PF10683,0,3,0,0,3,1015,0.0,1.0,0,0,0,0,0,0,1018,0,1.0,0,0
PF12596,PF12017:PF05485:PF14949,5,67,4,1,63,950,0.06,0.94,0.8,0.21,18,4,1,14,999,0.22,0.99,0.8,0.42
PF10604,PF06749:PF04520:PF00197,17,8,2,15,6,995,0.25,0.98,0.12,0.16,0,0,17,0,1001,0,0.98,0.0,0
PF16066,PF07227:PF12453:PF09240,1,6,1,0,5,1012,0.17,1.0,1.0,0.41,1,1,0,0,1017,1.0,1.0,1.0,1.0
PF02213,PF14738:PF14722:PF10377,16,15,2,14,13,989,0.13,0.97,0.12,0.12,1,1,15,0,1002,1.0,0.99,0.06,0.25
PF17169,PF09050:PF09049:PF09051,0,0,0,0,0,1018,0,1.0,0,0,0,0,0,0,1018,0,1.0,0,0
PF06161,PF15832:PF06070:PF02621,0,1,0,0,1,1017,0.0,1.0,0,0,0,0,0,0,1018,0,1.0,0,0
PF04417,PF05100:PF15888:PF15856,2,1,0,2,1,1015,0.0,1.0,0.0,-0.0,0,0,2,0,1016,0,1.0,0.0,0
PF17078,PF06485:PF03907:PF09962,1,6,0,1,6,1011,0.0,0.99,0.0,-0.0,0,0,1,0,1017,0,1.0,0.0,0
PF15838,PF05151:PF03379:PF15754,0,1,0,0,1,1017,0.0,1.0,0,0,0,0,0,0,1018,0,1.0,0,0
PF04983,PF00623:PF04992:PF04997,31,30,29,2,1,986,0.97,1.0,0.94,0.95,29,29,2,0,987,1.0,1.0,0.94,0.97
PF01771,PF17053:PF04848:PF08453,1,5,1,0,4,1013,0.2,1.0,1.0,0.45,0,0,1,0,1017,0,1.0,0.0,0
PF01869,PF10294:PF14904:PF05721,14,68,9,5,59,945,0.13,0.94,0.64,0.27,11,6,8,5,999,0.55,0.99,0.43,0.48
PF10807,PF11231:PF09675:PF09704,0,0,0,0,0,1018,0,1.0,0,0,0,0,0,0,1018,0,1.0,0,0
PF13116,PF00116:PF05735:PF02790,9,18,8,1,10,999,0.44,0.99,0.89,0.62,12,8,1,4,1005,0.67,1.0,0.89,0.77
PF11268,PF15482:PF15895:PF15553,0,0,0,0,0,1018,0,1.0,0,0,0,0,0,0,1018,0,1.0,0,0
PF03822,PF12605:PF08332:PF16579,4,18,3,1,15,999,0.17,0.98,0.75,0.35,5,2,2,3,1011,0.4,1.0,0.5,0.44
PF04378,PF09611:PF02621:PF01345,2,0,0,2,0,1016,0,1.0,0.0,0,0,0,2,0,1016,0,1.0,0.0,0
PF04629,PF09007:PF10608:PF09058,6,4,1,5,3,1009,0.25,0.99,0.17,0.2,1,1,5,0,1012,1.0,1.0,0.17,0.41
PF10565,PF04069:PF10562:PF00497,2,32,2,0,30,986,0.06,0.97,1.0,0.25,7,2,0,5,1011,0.29,1.0,1.0,0.53
PF14324,PF13864:PF02891:PF04278,9,19,9,0,10,999,0.47,0.99,1.0,0.68,4,4,5,0,1009,1.0,1.0,0.44,0.67
PF16413,PF08676:PF17203:PF17065,15,35,7,8,28,975,0.2,0.96,0.47,0.29,6,5,10,1,1002,0.83,0.99,0.33,0.52
PF12633,PF16449:PF03865:PF04453,3,0,0,3,0,1015,0,1.0,0.0,0,0,0,3,0,1015,0,1.0,0.0,0
PF06324,PF17056:PF15972:PF14866,1,0,0,1,0,1017,0,1.0,0.0,0,0,0,1,0,1017,0,1.0,0.0,0
PF00249,PF14379:PF08558:PF16772,89,11,7,82,4,925,0.64,0.92,0.08,0.2,2,2,87,0,929,1.0,0.91,0.02,0.14
PF07386,PF06581:PF11317:PF10716,5,1,0,5,1,1012,0.0,0.99,0.0,-0.0,0,0,5,0,1013,0,1.0,0.0,0
PF02073,PF15834:PF02565:PF14539,1,0,0,1,0,1017,0,1.0,0.0,0,0,0,1,0,1017,0,1.0,0.0,0
PF07953,PF15394:PF08374:PF00028,4,49,3,1,46,968,0.06,0.95,0.75,0.21,1,1,3,0,1014,1.0,1.0,0.25,0.5
PF09374,PF13722:PF05947:PF05974,0,0,0,0,0,1018,0,1.0,0,0,0,0,0,0,1018,0,1.0,0,0
PF07650,PF16897:PF06071:PF16360,14,20,7,7,13,991,0.35,0.98,0.5,0.41,2,2,12,0,1004,1.0,0.99,0.14,0.38
PF14933,PF15444:PF15130:PF10856,2,1,0,2,1,1015,0.0,1.0,0.0,-0.0,0,0,2,0,1016,0,1.0,0.0,0
PF03020,PF08198:PF00554:PF16553,6,18,3,3,15,997,0.17,0.98,0.5,0.28,2,2,4,0,1012,1.0,1.0,0.33,0.58
PF02875,PF01225:PF03533:PF07361,17,12,10,7,2,999,0.83,0.99,0.59,0.7,7,7,10,0,1001,1.0,0.99,0.41,0.64
PF16453,PF12783:PF09324:PF01369,14,47,13,1,34,970,0.28,0.97,0.93,0.5,21,6,8,15,989,0.29,0.98,0.43,0.34
PF04857,PF08675:PF15019:PF01866,23,18,7,16,11,984,0.39,0.97,0.3,0.33,1,1,22,0,995,1.0,0.98,0.04,0.21
PF09365,PF08093:PF14877:PF17017,2,5,0,2,5,1011,0.0,0.99,0.0,-0.0,0,0,2,0,1016,0,1.0,0.0,0
PF15928,PF07449:PF10961:PF05903,1,22,1,0,21,996,0.05,0.98,1.0,0.21,3,0,1,3,1014,0.0,1.0,0.0,-0.0
PF07478,PF01820:PF05965:PF11764,11,23,4,7,19,988,0.17,0.97,0.36,0.24,4,3,8,1,1006,0.75,0.99,0.27,0.45
PF11116,PF05202:PF04671:PF16325,0,2,0,0,2,1016,0.0,1.0,0,0,0,0,0,0,1018,0,1.0,0,0
PF16512,PF01846:PF15151:PF02172,3,31,3,0,28,987,0.1,0.97,1.0,0.31,5,1,2,4,1011,0.2,0.99,0.33,0.26
PF05470,PF08375:PF10602:PF09440,16,23,5,11,18,984,0.22,0.97,0.31,0.25,4,1,15,3,999,0.25,0.98,0.06,0.12
PF05630,PF01774:PF02284:PF04176,4,17,1,3,16,998,0.06,0.98,0.25,0.11,5,0,4,5,1009,0.0,0.99,0.0,-0.0
PF07335,PF06912:PF07544:PF10681,1,11,1,0,10,1007,0.09,0.99,1.0,0.3,0,0,1,0,1017,0,1.0,0.0,0
PF02362,PF06507:PF00847:PF02309,30,37,17,13,20,968,0.46,0.97,0.57,0.49,10,8,22,2,986,0.8,0.98,0.27,0.45
PF04419,PF01907:PF07911:PF13564,11,17,5,6,12,995,0.29,0.98,0.45,0.36,3,2,9,1,1006,0.67,0.99,0.18,0.34
PF04424,PF01085:PF01079:PF15299,16,21,4,12,17,985,0.19,0.97,0.25,0.2,7,2,14,5,997,0.29,0.98,0.12,0.18
PF04023,PF10547:PF00018:PF09932,1,98,0,1,98,919,0.0,0.9,0.0,-0.01,0,0,1,0,1017,0,1.0,0.0,0
PF11023,PF02635:PF13530:PF10279,0,2,0,0,2,1016,0.0,1.0,0,0,0,0,0,0,1018,0,1.0,0,0
PF07477,PF07488:PF03648:PF16126,4,4,4,0,0,1014,1.0,1.0,1.0,1.0,3,3,1,0,1014,1.0,1.0,0.75,0.87
PF13164,PF06039:PF05754:PF03238,2,2,1,1,1,1015,0.5,1.0,0.5,0.5,0,0,2,0,1016,0,1.0,0.0,0
PF07882,PF02952:PF07881:PF05974,1,1,1,0,0,1017,1.0,1.0,1.0,1.0,1,1,0,0,1017,1.0,1.0,1.0,1.0
PF07343,PF14232:PF01228:PF02526,0,2,0,0,2,1016,0.0,1.0,0,0,0,0,0,0,1018,0,1.0,0,0
PF05091,PF00244:PF05129:PF05512,19,31,8,11,23,976,0.26,0.97,0.42,0.31,5,3,16,2,997,0.6,0.98,0.16,0.3
PF16825,PF10924:PF15485:PF13094,0,1,0,0,1,1017,0.0,1.0,0,0,0,0,0,0,1018,0,1.0,0,0
PF14732,PF16191:PF16190:PF10585,7,5,1,6,4,1007,0.2,0.99,0.14,0.16,3,1,6,2,1009,0.33,0.99,0.14,0.21
PF11532,PF15861:PF13355:PF15027,1,5,1,0,4,1013,0.2,1.0,1.0,0.45,0,0,1,0,1017,0,1.0,0.0,0
PF13863,PF04880:PF14922:PF10226,7,7,3,4,4,1007,0.43,0.99,0.43,0.42,2,2,5,0,1011,1.0,1.0,0.29,0.53
PF06121,PF06482:PF01534:PF01392,2,28,2,0,26,990,0.07,0.97,1.0,0.26,7,2,0,5,1011,0.29,1.0,1.0,0.53
PF09849,PF06681:PF02557:PF15837,0,2,0,0,2,1016,0.0,1.0,0,0,0,0,0,0,1018,0,1.0,0,0
PF03553,PF11214:PF15680:PF00669,1,1,0,1,1,1016,0.0,1.0,0.0,-0.0,0,0,1,0,1017,0,1.0,0.0,0
PF02706,PF04085:PF02108:PF05065,1,1,0,1,1,1016,0.0,1.0,0.0,-0.0,0,0,1,0,1017,0,1.0,0.0,0
PF03450,PF00941:PF01315:PF02738,22,24,22,0,2,994,0.92,1.0,1.0,0.96,23,22,0,1,995,0.96,1.0,1.0,0.98
PF06875,PF14653:PF15173:PF15550,0,0,0,0,0,1018,0,1.0,0,0,0,0,0,0,1018,0,1.0,0,0
PF03958,PF07963:PF00263:PF16416,2,3,2,0,1,1015,0.67,1.0,1.0,0.82,2,2,0,0,1016,1.0,1.0,1.0,1.0
PF13869,PF01680:PF09468:PF06388,13,16,3,10,13,992,0.19,0.98,0.23,0.2,1,1,12,0,1005,1.0,0.99,0.08,0.28
PF06533,PF02753:PF15768:PF00482,1,4,0,1,4,1013,0.0,1.0,0.0,-0.0,0,0,1,0,1017,0,1.0,0.0,0
PF12778,PF17206:PF04466:PF03831,1,1,0,1,1,1016,0.0,1.0,0.0,-0.0,0,0,1,0,1017,0,1.0,0.0,0
PF08157,PF00524:PF13005:PF14917,4,5,1,3,4,1010,0.2,0.99,0.25,0.22,0,0,4,0,1014,0,1.0,0.0,0
PF00246,PF02244:PF09759:PF07810,47,31,26,21,5,966,0.84,0.97,0.55,0.67,8,8,39,0,971,1.0,0.96,0.17,0.4
PF03145,PF08511:PF03878:PF07896,15,16,7,8,9,994,0.44,0.98,0.47,0.44,4,3,12,1,1002,0.75,0.99,0.2,0.38
PF10608,PF10600:PF09058:PF09007,1,5,1,0,4,1013,0.2,1.0,1.0,0.45,1,1,0,0,1017,1.0,1.0,1.0,1.0
PF04549,PF08204:PF01114:PF00865,0,1,0,0,1,1017,0.0,1.0,0,0,0,0,0,0,1018,0,1.0,0,0
PF12032,PF16030:PF09272:PF02983,8,13,1,7,12,998,0.08,0.98,0.12,0.09,1,1,7,0,1010,1.0,0.99,0.12,0.35
PF10428,PF15904:PF11921:PF14914,4,3,1,3,2,1012,0.33,1.0,0.25,0.29,1,1,3,0,1014,1.0,1.0,0.25,0.5
PF05496,PF12002:PF16193:PF14532,10,15,5,5,10,998,0.33,0.99,0.5,0.4,14,5,5,9,999,0.36,0.99,0.5,0.42
PF04237,PF03840:PF15943:PF06543,0,1,0,0,1,1017,0.0,1.0,0,0,0,0,0,0,1018,0,1.0,0,0
PF04738,PF07409:PF01752:PF07157,0,2,0,0,2,1016,0.0,1.0,0,0,0,0,0,0,1018,0,1.0,0,0
PF10513,PF12064:PF12157:PF11467,24,15,7,17,8,986,0.47,0.98,0.29,0.36,1,1,23,0,994,1.0,0.98,0.04,0.2
PF15821,PF15934:PF11831:PF15453,0,12,0,0,12,1006,0.0,0.99,0,0,0,0,0,0,1018,0,1.0,0,0
PF15280,PF08624:PF09736:PF15862,2,10,0,2,10,1006,0.0,0.99,0.0,-0.0,1,0,2,1,1015,0.0,1.0,0.0,-0.0
PF10737,PF15107:PF03238:PF17112,0,0,0,0,0,1018,0,1.0,0,0,0,0,0,0,1018,0,1.0,0,0
PF05587,PF05586:PF16754:PF06668,6,5,4,2,1,1011,0.8,1.0,0.67,0.73,0,0,6,0,1012,0,0.99,0.0,0
PF04574,PF02146:PF16815:PF08157,6,51,6,0,45,967,0.12,0.96,1.0,0.34,8,1,5,7,1005,0.12,0.99,0.17,0.14
PF05876,PF07409:PF10279:PF07484,4,0,0,4,0,1014,0,1.0,0.0,0,0,0,4,0,1014,0,1.0,0.0,0
PF08110,PF07440:PF16048:PF08018,0,0,0,0,0,1018,0,1.0,0,0,0,0,0,0,1018,0,1.0,0,0
PF04860,PF05135:PF09690:PF01312,1,0,0,1,0,1017,0,1.0,0.0,0,0,0,1,0,1017,0,1.0,0.0,0
PF02341,PF16974:PF06799:PF10674,4,4,2,2,2,1012,0.5,1.0,0.5,0.5,0,0,4,0,1014,0,1.0,0.0,0
PF15159,PF01316:PF12158:PF15505,1,3,0,1,3,1014,0.0,1.0,0.0,-0.0,0,0,1,0,1017,0,1.0,0.0,0
PF03473,PF03476:PF00266:PF03475,16,56,16,0,40,962,0.29,0.96,1.0,0.52,9,9,7,0,1002,1.0,0.99,0.56,0.75
PF16748,PF13320:PF15793:PF15027,0,0,0,0,0,1018,0,1.0,0,0,0,0,0,0,1018,0,1.0,0,0
PF00354,PF10393:PF00194:PF07593,17,27,5,12,22,979,0.19,0.97,0.29,0.22,3,3,14,0,1001,1.0,0.99,0.18,0.42
PF01681,PF05986:PF05642:PF08685,0,19,0,0,19,999,0.0,0.98,0,0,3,0,0,3,1015,0.0,1.0,0,0
PF10271,PF15867:PF09295:PF06372,4,8,1,3,7,1007,0.12,0.99,0.25,0.17,1,1,3,0,1014,1.0,1.0,0.25,0.5
PF13322,PF14028:PF06798:PF16449,0,0,0,0,0,1018,0,1.0,0,0,0,0,0,0,1018,0,1.0,0,0
PF07059,PF10457:PF08923:PF01852,7,32,5,2,27,984,0.16,0.97,0.71,0.33,6,2,5,4,1007,0.33,0.99,0.29,0.3
PF00298,PF14853:PF00283:PF01381,22,14,6,16,8,988,0.43,0.98,0.27,0.33,1,1,21,0,996,1.0,0.98,0.05,0.21
PF08275,PF01807:PF10410:PF09327,4,6,4,0,2,1012,0.67,1.0,1.0,0.82,4,4,0,0,1014,1.0,1.0,1.0,1.0
PF04431,PF02789:PF03425:PF07975,4,22,2,2,20,994,0.09,0.98,0.5,0.21,2,0,4,2,1012,0.0,0.99,0.0,-0.0
PF15155,PF15662:PF15128:PF08751,4,4,0,4,4,1010,0.0,0.99,0.0,-0.0,0,0,4,0,1014,0,1.0,0.0,0
PF12351,PF09056:PF03576:PF12716,3,4,0,3,4,1011,0.0,0.99,0.0,-0.0,0,0,3,0,1015,0,1.0,0.0,0
PF02376,PF16534:PF16557:PF16719,8,7,3,5,4,1006,0.43,0.99,0.38,0.4,2,2,6,0,1010,1.0,0.99,0.25,0.5
PF04648,PF05436:PF01114:PF00323,1,2,1,0,1,1016,0.5,1.0,1.0,0.71,0,0,1,0,1017,0,1.0,0.0,0
PF07415,PF08020:PF08686:PF06558,0,12,0,0,12,1006,0.0,0.99,0,0,0,0,0,0,1018,0,1.0,0,0
PF02272,PF01411:PF07973:PF01695,16,39,11,5,28,974,0.28,0.97,0.69,0.43,17,11,5,6,996,0.65,0.99,0.69,0.66
PF05506,PF13007:PF13746:PF03180,2,7,0,2,7,1009,0.0,0.99,0.0,-0.0,0,0,2,0,1016,0,1.0,0.0,0
PF08655,PF09463:PF05508:PF10446,5,2,0,5,2,1011,0.0,0.99,0.0,-0.0,0,0,5,0,1013,0,1.0,0.0,0
PF04295,PF08275:PF16976:PF00816,7,5,0,7,5,1006,0.0,0.99,0.0,-0.01,1,0,7,1,1010,0.0,0.99,0.0,-0.0
PF06588,PF10102:PF09118:PF02676,3,17,1,2,16,999,0.06,0.98,0.33,0.13,2,1,2,1,1014,0.5,1.0,0.33,0.41
PF16952,PF12437:PF04909:PF03951,2,45,2,0,43,973,0.04,0.96,1.0,0.21,3,1,1,2,1014,0.33,1.0,0.5,0.41
PF12793,PF05710:PF14871:PF04170,0,1,0,0,1,1017,0.0,1.0,0,0,0,0,0,0,1018,0,1.0,0,0
PF01433,PF11838:PF11940:PF09127,52,43,41,11,2,964,0.95,0.99,0.79,0.86,4,4,48,0,966,1.0,0.95,0.08,0.27
PF05075,PF03436:PF10322:PF15252,0,1,0,0,1,1017,0.0,1.0,0,0,0,0,0,0,1018,0,1.0,0,0
PF16997,PF08497:PF03525:PF17206,0,1,0,0,1,1017,0.0,1.0,0,0,0,0,0,0,1018,0,1.0,0,0
PF03330,PF01357:PF00166:PF07258,20,36,15,5,21,977,0.42,0.97,0.75,0.55,7,6,14,1,997,0.86,0.99,0.3,0.5
PF08188,PF09707:PF12777:PF03373,1,39,1,0,38,979,0.03,0.96,1.0,0.16,0,0,1,0,1017,0,1.0,0.0,0
PF05014,PF06581:PF07544:PF04856,3,6,0,3,6,1009,0.0,0.99,0.0,-0.0,0,0,3,0,1015,0,1.0,0.0,0
PF03123,PF13876:PF06406:PF07523,2,1,0,2,1,1015,0.0,1.0,0.0,-0.0,0,0,2,0,1016,0,1.0,0.0,0
PF02670,PF13288:PF08436:PF09328,11,14,11,0,3,1004,0.79,1.0,1.0,0.89,5,4,7,1,1006,0.8,0.99,0.36,0.54
PF01592,PF01774:PF02284:PF00444,10,17,4,6,13,995,0.24,0.98,0.4,0.3,3,1,9,2,1006,0.33,0.99,0.1,0.18
PF10917,PF07411:PF05840:PF03428,1,0,0,1,0,1017,0,1.0,0.0,0,0,0,1,0,1017,0,1.0,0.0,0
PF05760,PF10488:PF10472:PF15374,0,1,0,0,1,1017,0.0,1.0,0,0,0,0,0,0,1018,0,1.0,0,0
PF09055,PF16843:PF05162:PF04758,5,14,2,3,12,1001,0.14,0.99,0.4,0.23,2,1,4,1,1012,0.5,1.0,0.2,0.31
PF14108,PF10868:PF08576:PF15699,2,3,0,2,3,1013,0.0,1.0,0.0,-0.0,0,0,2,0,1016,0,1.0,0.0,0
PF13099,PF09074:PF14376:PF09673,0,3,0,0,3,1015,0.0,1.0,0,0,0,0,0,0,1018,0,1.0,0,0
PF07392,PF15120:PF07259:PF15046,0,5,0,0,5,1013,0.0,1.0,0,0,0,0,0,0,1018,0,1.0,0,0
PF09220,PF07409:PF14690:PF04865,0,0,0,0,0,1018,0,1.0,0,0,0,0,0,0,1018,0,1.0,0,0
PF03699,PF08681:PF05874:PF06681,0,2,0,0,2,1016,0.0,1.0,0,0,0,0,0,0,1018,0,1.0,0,0
PF11947,PF07011:PF15699:PF00537,3,1,0,3,1,1014,0.0,1.0,0.0,-0.0,0,0,3,0,1015,0,1.0,0.0,0
PF10343,PF01509:PF01472:PF11720,15,28,6,9,22,981,0.21,0.97,0.4,0.28,7,3,12,4,999,0.43,0.98,0.2,0.29
PF16474,PF08687:PF08688:PF16646,11,4,1,10,3,1004,0.25,0.99,0.09,0.15,2,1,10,1,1006,0.5,0.99,0.09,0.21
PF06986,PF01867:PF15226:PF04487,0,6,0,0,6,1012,0.0,0.99,0,0,0,0,0,0,1018,0,1.0,0,0
PF05039,PF15359:PF00236:PF01097,0,6,0,0,6,1012,0.0,0.99,0,0,0,0,0,0,1018,0,1.0,0,0
PF08892,PF08411:PF07964:PF16449,1,2,0,1,2,1015,0.0,1.0,0.0,-0.0,0,0,1,0,1017,0,1.0,0.0,0
PF00616,PF00779:PF12004:PF03836,20,10,9,11,1,997,0.9,0.99,0.45,0.63,2,2,18,0,998,1.0,0.98,0.1,0.31
PF03608,PF03829:PF03612:PF08220,2,5,2,0,3,1013,0.4,1.0,1.0,0.63,2,2,0,0,1016,1.0,1.0,1.0,1.0
PF02737,PF00725:PF00378:PF02803,29,86,27,2,59,930,0.31,0.94,0.93,0.52,28,20,9,8,981,0.71,0.98,0.69,0.69
PF17025,PF07472:PF08218:PF00551,0,25,0,0,25,993,0.0,0.98,0,0,0,0,0,0,1018,0,1.0,0,0
PF12511,PF15311:PF04090:PF12606,8,9,4,4,5,1005,0.44,0.99,0.5,0.47,1,1,7,0,1010,1.0,0.99,0.12,0.35
PF09983,PF09664:PF05109:PF09498,3,3,3,0,0,1015,1.0,1.0,1.0,1.0,0,0,3,0,1015,0,1.0,0.0,0
PF03306,PF15703:PF17085:PF10856,6,0,0,6,0,1012,0,0.99,0.0,0,0,0,6,0,1012,0,0.99,0.0,0
PF11641,PF12827:PF05728:PF01316,0,6,0,0,6,1012,0.0,0.99,0,0,0,0,0,0,1018,0,1.0,0,0
PF08140,PF03769:PF17054:PF12853,1,12,0,1,12,1005,0.0,0.99,0.0,-0.0,0,0,1,0,1017,0,1.0,0.0,0
PF09416,PF13625:PF16203:PF04313,11,16,5,6,11,996,0.31,0.98,0.45,0.37,11,5,6,6,1001,0.45,0.99,0.45,0.45
PF02015,PF03664:PF01341:PF00457,7,13,4,3,9,1002,0.31,0.99,0.57,0.41,4,2,5,2,1009,0.5,0.99,0.29,0.37
PF13284,PF06406:PF13876:PF10035,0,3,0,0,3,1015,0.0,1.0,0,0,0,0,0,0,1018,0,1.0,0,0
PF01393,PF17218:PF06781:PF00385,11,68,10,1,58,949,0.15,0.94,0.91,0.35,3,1,10,2,1005,0.33,0.99,0.09,0.17
PF12606,PF11831:PF07557:PF15742,2,22,0,2,22,994,0.0,0.98,0.0,-0.01,0,0,2,0,1016,0,1.0,0.0,0
PF16764,PF08604:PF17219:PF00641,2,48,2,0,46,970,0.04,0.95,1.0,0.2,7,2,0,5,1011,0.29,1.0,1.0,0.53
PF07337,PF10988:PF08808:PF08744,0,0,0,0,0,1018,0,1.0,0,0,0,0,0,0,1018,0,1.0,0,0
PF13403,PF08093:PF09361:PF05453,0,2,0,0,2,1016,0.0,1.0,0,0,0,0,0,0,1018,0,1.0,0,0
PF02232,PF05167:PF04868:PF03244,1,3,0,1,3,1014,0.0,1.0,0.0,-0.0,0,0,1,0,1017,0,1.0,0.0,0
PF16544,PF16274:PF16568:PF16551,4,2,1,3,1,1013,0.5,1.0,0.25,0.35,1,1,3,0,1014,1.0,1.0,0.25,0.5
PF09588,PF15299:PF16064:PF14291,15,33,10,5,23,980,0.3,0.97,0.67,0.44,5,5,10,0,1003,1.0,0.99,0.33,0.57
PF00712,PF02768:PF08275:PF07963,7,11,7,0,4,1007,0.64,1.0,1.0,0.8,2,2,5,0,1011,1.0,1.0,0.29,0.53
PF04404,PF11863:PF16325:PF14842,1,1,0,1,1,1016,0.0,1.0,0.0,-0.0,0,0,1,0,1017,0,1.0,0.0,0
PF05005,PF15884:PF14935:PF02195,11,11,2,9,9,998,0.18,0.98,0.18,0.17,2,1,10,1,1006,0.5,0.99,0.09,0.21
PF06067,PF10517:PF01175:PF11793,0,14,0,0,14,1004,0.0,0.99,0,0,2,0,0,2,1016,0.0,1.0,0,0
PF02789,PF00883:PF06974:PF10396,18,40,17,1,23,977,0.42,0.98,0.94,0.63,6,5,13,1,999,0.83,0.99,0.28,0.48
PF11787,PF11786:PF11785:PF12498,4,4,4,0,0,1014,1.0,1.0,1.0,1.0,3,3,1,0,1014,1.0,1.0,0.75,0.87
PF05167,PF06890:PF09498:PF01752,1,2,0,1,2,1015,0.0,1.0,0.0,-0.0,0,0,1,0,1017,0,1.0,0.0,0
PF04995,PF03260:PF14305:PF15101,0,1,0,0,1,1017,0.0,1.0,0,0,0,0,0,0,1018,0,1.0,0,0
PF02572,PF06798:PF13722:PF01580,2,5,1,1,4,1012,0.2,1.0,0.5,0.31,0,0,2,0,1016,0,1.0,0.0,0
PF15898,PF09310:PF16553:PF09372,2,1,0,2,1,1015,0.0,1.0,0.0,-0.0,1,0,2,1,1015,0.0,1.0,0.0,-0.0
PF09836,PF06001:PF06546:PF05911,0,15,0,0,15,1003,0.0,0.99,0,0,1,0,0,1,1017,0.0,1.0,0,0
PF15182,PF15680:PF13094:PF09962,0,2,0,0,2,1016,0.0,1.0,0,0,0,0,0,0,1018,0,1.0,0,0
PF14797,PF09066:PF14796:PF06375,0,12,0,0,12,1006,0.0,0.99,0,0,4,0,0,4,1014,0.0,1.0,0,0
PF11052,PF15622:PF16448:PF14607,1,1,0,1,1,1016,0.0,1.0,0.0,-0.0,0,0,1,0,1017,0,1.0,0.0,0
PF16086,PF04845:PF04063:PF03219,0,11,0,0,11,1007,0.0,0.99,0,0,3,0,0,3,1015,0.0,1.0,0,0
PF00416,PF00411:PF03973:PF09749,20,30,9,11,21,977,0.3,0.97,0.45,0.35,3,2,18,1,997,0.67,0.98,0.1,0.25
PF04151,PF14841:PF08795:PF15312,0,1,0,0,1,1017,0.0,1.0,0,0,0,0,0,0,1018,0,1.0,0,0
PF04236,PF09026:PF09607:PF04218,4,22,2,2,20,994,0.09,0.98,0.5,0.21,5,1,3,4,1010,0.2,0.99,0.25,0.22
PF05758,PF10350:PF16327:PF10493,3,13,1,2,12,1003,0.08,0.99,0.33,0.16,3,1,2,2,1013,0.33,1.0,0.33,0.33
PF09012,PF11975:PF16216:PF10035,3,9,0,3,9,1006,0.0,0.99,0.0,-0.01,1,0,3,1,1014,0.0,1.0,0.0,-0.0
PF08670,PF02563:PF10481:PF04813,6,8,1,5,7,1005,0.12,0.99,0.17,0.14,0,0,6,0,1012,0,0.99,0.0,0
PF07741,PF08271:PF00382:PF11521,9,22,8,1,14,995,0.36,0.99,0.89,0.56,12,3,6,9,1000,0.25,0.99,0.33,0.28
PF14575,PF01404:PF12398:PF06760,6,8,5,1,3,1009,0.62,1.0,0.83,0.72,2,2,4,0,1012,1.0,1.0,0.33,0.58
PF01623,PF16850:PF13276:PF09299,1,8,0,1,8,1009,0.0,0.99,0.0,-0.0,0,0,1,0,1017,0,1.0,0.0,0
PF01122,PF14478:PF12934:PF09230,5,5,2,3,3,1010,0.4,0.99,0.4,0.4,0,0,5,0,1013,0,1.0,0.0,0
PF07217,PF16019:PF15279:PF16944,6,2,0,6,2,1010,0.0,0.99,0.0,-0.0,0,0,6,0,1012,0,0.99,0.0,0
PF03938,PF03090:PF08411:PF10793,6,1,0,6,1,1011,0.0,0.99,0.0,-0.0,0,0,6,0,1012,0,0.99,0.0,0
PF03200,PF16923:PF08158:PF09511,10,21,8,2,13,995,0.38,0.99,0.8,0.55,4,4,6,0,1008,1.0,0.99,0.4,0.63
PF04193,PF10171:PF04577:PF00561,27,89,19,8,70,921,0.21,0.92,0.7,0.36,18,8,19,10,981,0.44,0.97,0.3,0.35
PF00876,PF04658:PF03297:PF05197,24,19,5,19,14,980,0.26,0.97,0.21,0.22,2,2,22,0,994,1.0,0.98,0.08,0.29
PF07994,PF01327:PF01680:PF01997,4,22,0,4,22,992,0.0,0.97,0.0,-0.01,2,0,4,2,1012,0.0,0.99,0.0,-0.0
PF10991,PF17056:PF02393:PF15673,0,1,0,0,1,1017,0.0,1.0,0,0,0,0,0,0,1018,0,1.0,0,0
PF02653,PF12399:PF13732:PF08402,11,13,9,2,4,1003,0.69,0.99,0.82,0.75,5,5,6,0,1007,1.0,0.99,0.45,0.67
PF08725,PF07965:PF17205:PF00362,9,11,9,0,2,1007,0.82,1.0,1.0,0.9,4,4,5,0,1009,1.0,1.0,0.44,0.67
PF08657,PF14232:PF09051:PF14654,2,0,0,2,0,1016,0,1.0,0.0,0,0,0,2,0,1016,0,1.0,0.0,0
PF15995,PF15994:PF01043:PF12733,0,3,0,0,3,1015,0.0,1.0,0,0,1,0,0,1,1017,0.0,1.0,0,0
PF06746,PF12470:PF08426:PF07943,0,9,0,0,9,1009,0.0,0.99,0,0,1,0,0,1,1017,0.0,1.0,0,0
PF10995,PF01913:PF03831:PF17206,0,2,0,0,2,1016,0.0,1.0,0,0,0,0,0,0,1018,0,1.0,0,0
PF11141,PF00906:PF13313:PF11863,0,1,0,0,1,1017,0.0,1.0,0,0,0,0,0,0,1018,0,1.0,0,0
PF16830,PF16574:PF12297:PF07926,0,10,0,0,10,1008,0.0,0.99,0,0,1,0,0,1,1017,0.0,1.0,0,0
PF04051,PF10247:PF00118:PF01912,21,59,11,10,48,949,0.19,0.94,0.52,0.29,5,3,18,2,995,0.6,0.98,0.14,0.29
PF12481,PF04690:PF08315:PF00733,8,31,4,4,27,983,0.13,0.97,0.5,0.24,4,1,7,3,1007,0.25,0.99,0.12,0.17
PF03023,PF08343:PF14220:PF17154,8,5,1,7,4,1006,0.2,0.99,0.12,0.15,0,0,8,0,1010,0,0.99,0.0,0
PF01739,PF00770:PF02087:PF15091,4,3,0,4,3,1011,0.0,0.99,0.0,-0.0,0,0,4,0,1014,0,1.0,0.0,0
PF01874,PF03592:PF02572:PF08479,2,2,1,1,1,1015,0.5,1.0,0.5,0.5,0,0,2,0,1016,0,1.0,0.0,0
PF16719,PF00157:PF03792:PF12413,6,8,3,3,5,1007,0.38,0.99,0.5,0.43,4,2,4,2,1010,0.5,0.99,0.33,0.41
PF10351,PF10344:PF10359:PF10305,8,4,4,4,0,1010,1.0,1.0,0.5,0.71,4,4,4,0,1010,1.0,1.0,0.5,0.71
PF05808,PF12855:PF08693:PF16060,1,8,1,0,7,1010,0.12,0.99,1.0,0.35,0,0,1,0,1017,0,1.0,0.0,0
PF10148,PF15929:PF15328:PF09789,4,4,1,3,3,1011,0.25,0.99,0.25,0.25,0,0,4,0,1014,0,1.0,0.0,0
PF00201,PF00328:PF03033:PF04859,66,62,32,34,30,922,0.52,0.94,0.48,0.47,11,10,56,1,951,0.91,0.94,0.15,0.36
PF07651,PF16515:PF09788:PF11498,20,12,8,12,4,994,0.67,0.98,0.4,0.51,3,3,17,0,998,1.0,0.98,0.15,0.38
PF00565,PF00567:PF16093:PF01055,16,61,8,8,53,949,0.13,0.94,0.5,0.23,13,4,12,9,993,0.31,0.98,0.25,0.27
PF00237,PF00902:PF00329:PF01084,23,30,10,13,20,975,0.33,0.97,0.43,0.36,7,3,20,4,991,0.43,0.98,0.13,0.23
PF02872,PF16656:PF14008:PF05011,15,37,7,8,30,973,0.19,0.96,0.47,0.28,22,6,9,16,987,0.27,0.98,0.4,0.32
PF15025,PF15146:PF12432:PF15016,3,5,2,1,3,1012,0.4,1.0,0.67,0.51,1,1,2,0,1015,1.0,1.0,0.33,0.58
PF16680,PF11628:PF02189:PF00049,3,12,1,2,11,1004,0.08,0.99,0.33,0.16,2,1,2,1,1014,0.5,1.0,0.33,0.41
PF08894,PF05509:PF07178:PF03729,1,1,0,1,1,1016,0.0,1.0,0.0,-0.0,1,0,1,1,1016,0.0,1.0,0.0,-0.0
PF01328,PF09949:PF13813:PF02449,15,31,9,6,22,981,0.29,0.97,0.6,0.41,2,1,14,1,1002,0.5,0.99,0.07,0.18
PF09783,PF14565:PF15316:PF15173,17,3,1,16,2,999,0.33,0.98,0.06,0.13,0,0,17,0,1001,0,0.98,0.0,0
PF03458,PF16829:PF15234:PF17085,1,0,0,1,0,1017,0,1.0,0.0,0,0,0,1,0,1017,0,1.0,0.0,0
PF05266,PF16097:PF16098:PF16096,0,5,0,0,5,1013,0.0,1.0,0,0,1,0,0,1,1017,0.0,1.0,0,0
PF00419,PF02277:PF06890:PF10554,1,3,0,1,3,1014,0.0,1.0,0.0,-0.0,0,0,1,0,1017,0,1.0,0.0,0
PF07841,PF01758:PF07542:PF03022,4,26,0,4,26,988,0.0,0.97,0.0,-0.01,2,0,4,2,1012,0.0,0.99,0.0,-0.0
PF13547,PF06403:PF13753:PF08479,0,1,0,0,1,1017,0.0,1.0,0,0,0,0,0,0,1018,0,1.0,0,0
PF00193,PF09291:PF10570:PF02439,10,3,1,9,2,1006,0.33,0.99,0.1,0.18,0,0,10,0,1008,0,0.99,0.0,0
PF11977,PF05030:PF09736:PF14611,10,14,4,6,10,998,0.29,0.98,0.4,0.33,1,0,10,1,1007,0.0,0.99,0.0,-0.0
PF00063,PF01576:PF02736:PF06017,73,45,37,36,8,937,0.82,0.96,0.51,0.63,18,17,56,1,944,0.94,0.94,0.23,0.45
PF05918,PF15808:PF16179:PF16700,3,18,1,2,17,998,0.06,0.98,0.33,0.13,3,1,2,2,1013,0.33,1.0,0.33,0.33
PF08690,PF05824:PF17050:PF08738,2,3,1,1,2,1014,0.33,1.0,0.5,0.41,0,0,2,0,1016,0,1.0,0.0,0
PF05717,PF03613:PF08036:PF10079,0,0,0,0,0,1018,0,1.0,0,0,0,0,0,0,1018,0,1.0,0,0
PF15066,PF10506:PF11496:PF17045,0,13,0,0,13,1005,0.0,0.99,0,0,0,0,0,0,1018,0,1.0,0,0
PF17182,PF14418:PF01936:PF11608,0,12,0,0,12,1006,0.0,0.99,0,0,3,0,0,3,1015,0.0,1.0,0,0
PF07429,PF13808:PF02056:PF15272,1,9,0,1,9,1008,0.0,0.99,0.0,-0.0,1,0,1,1,1016,0.0,1.0,0.0,-0.0
PF03103,PF15973:PF02520:PF01269,7,16,1,6,15,996,0.06,0.98,0.14,0.09,2,0,7,2,1009,0.0,0.99,0.0,-0.0
PF02830,PF08274:PF17092:PF10139,0,1,0,0,1,1017,0.0,1.0,0,0,0,0,0,0,1018,0,1.0,0,0
PF06249,PF05899:PF02502:PF12973,3,13,3,0,10,1005,0.23,0.99,1.0,0.48,2,1,2,1,1014,0.5,1.0,0.33,0.41
PF10577,PF06484:PF14763:PF14761,6,4,1,5,3,1009,0.25,0.99,0.17,0.2,0,0,6,0,1012,0,0.99,0.0,0
PF16974,PF12046:PF06206:PF10674,0,2,0,0,2,1016,0.0,1.0,0,0,0,0,0,0,1018,0,1.0,0,0
PF09848,PF07778:PF12470:PF06863,9,8,2,7,6,1003,0.25,0.99,0.22,0.23,2,1,8,1,1008,0.5,0.99,0.11,0.23
PF05291,PF03491:PF02234:PF00301,9,11,3,6,8,1001,0.27,0.99,0.33,0.29,1,1,8,0,1009,1.0,0.99,0.11,0.33
PF12390,PF14376:PF03548:PF16861,0,8,0,0,8,1010,0.0,0.99,0,0,1,0,0,1,1017,0.0,1.0,0,0
PF02119,PF11794:PF04391:PF03831,2,0,0,2,0,1016,0,1.0,0.0,0,0,0,2,0,1016,0,1.0,0.0,0
PF06297,PF12315:PF04487:PF12371,6,10,2,4,8,1004,0.2,0.99,0.33,0.25,2,2,4,0,1012,1.0,1.0,0.33,0.58
PF02489,PF13414:PF09295:PF01408,0,71,0,0,71,947,0.0,0.93,0,0,10,0,0,10,1008,0.0,0.99,0,0
PF14103,PF15756:PF15340:PF05836,0,3,0,0,3,1015,0.0,1.0,0,0,0,0,0,0,1018,0,1.0,0,0
PF03101,PF04434:PF10551:PF10532,30,59,20,10,39,949,0.34,0.95,0.67,0.45,21,12,18,9,979,0.57,0.97,0.4,0.47
PF12580,PF12583:PF01483:PF12245,4,21,2,2,19,995,0.1,0.98,0.5,0.21,3,1,3,2,1012,0.33,1.0,0.25,0.29
PF07928,PF10474:PF10475:PF06662,9,6,4,5,2,1007,0.67,0.99,0.44,0.54,2,2,7,0,1009,1.0,0.99,0.22,0.47
PF02434,PF05679:PF06246:PF00884,28,56,22,6,34,956,0.39,0.96,0.79,0.54,13,12,16,1,989,0.92,0.98,0.43,0.62
PF01312,PF17193:PF03244:PF06798,0,0,0,0,0,1018,0,1.0,0,0,0,0,0,0,1018,0,1.0,0,0
PF08224,PF07899:PF09787:PF04783,2,15,1,1,14,1002,0.07,0.99,0.5,0.18,4,0,2,4,1012,0.0,0.99,0.0,-0.0
PF13396,PF10295:PF14040:PF08208,0,7,0,0,7,1011,0.0,0.99,0,0,1,0,0,1,1017,0.0,1.0,0,0
PF15786,PF13933:PF15831:PF02202,1,0,0,1,0,1017,0,1.0,0.0,0,0,0,1,0,1017,0,1.0,0.0,0
PF04446,PF14413:PF00794:PF03700,11,25,10,1,15,992,0.4,0.98,0.91,0.6,8,8,3,0,1007,1.0,1.0,0.73,0.85
PF14684,PF11818:PF15153:PF12571,2,2,2,0,0,1016,1.0,1.0,1.0,1.0,0,0,2,0,1016,0,1.0,0.0,0
PF14661,PF15678:PF09429:PF13836,1,9,0,1,9,1008,0.0,0.99,0.0,-0.0,0,0,1,0,1017,0,1.0,0.0,0
PF16233,PF16899:PF12428:PF04874,0,19,0,0,19,999,0.0,0.98,0,0,1,0,0,1,1017,0.0,1.0,0,0
PF03032,PF10583:PF00879:PF01387,3,0,0,3,0,1015,0,1.0,0.0,0,0,0,3,0,1015,0,1.0,0.0,0
PF00225,PF16540:PF13931:PF16796,102,16,15,87,1,915,0.94,0.91,0.15,0.35,5,5,97,0,916,1.0,0.9,0.05,0.21
PF15190,PF01668:PF06573:PF03050,1,4,1,0,3,1014,0.25,1.0,1.0,0.5,0,0,1,0,1017,0,1.0,0.0,0
PF16833,PF04865:PF15150:PF02501,0,2,0,0,2,1016,0.0,1.0,0,0,0,0,0,0,1018,0,1.0,0,0
PF01035,PF01910:PF13741:PF15006,15,7,0,15,7,996,0.0,0.98,0.0,-0.01,0,0,15,0,1003,0,0.99,0.0,0
PF02949,PF07035:PF00141:PF00685,41,66,17,24,49,928,0.26,0.93,0.41,0.29,16,8,33,8,969,0.5,0.96,0.2,0.3
PF01381,PF08523:PF08752:PF16381,9,9,6,3,3,1006,0.67,0.99,0.67,0.66,5,2,7,3,1006,0.4,0.99,0.22,0.29
PF12829,PF05685:PF12351:PF05824,1,6,0,1,6,1011,0.0,0.99,0.0,-0.0,0,0,1,0,1017,0,1.0,0.0,0
PF00356,PF00532:PF02604:PF00455,13,8,6,7,2,1003,0.75,0.99,0.46,0.58,0,0,13,0,1005,0,0.99,0.0,0
PF03366,PF08123:PF03941:PF16529,11,25,5,6,20,987,0.2,0.97,0.45,0.29,3,3,8,0,1007,1.0,0.99,0.27,0.52
PF07022,PF06934:PF05939:PF06805,1,0,0,1,0,1017,0,1.0,0.0,0,0,0,1,0,1017,0,1.0,0.0,0
PF00391,PF02896:PF01326:PF05524,12,20,8,4,12,994,0.4,0.98,0.67,0.51,14,8,4,6,1000,0.57,0.99,0.67,0.61
PF10477,PF09746:PF00853:PF07217,3,17,1,2,16,999,0.06,0.98,0.33,0.13,2,0,3,2,1013,0.0,1.0,0.0,-0.0
PF02091,PF02092:PF09370:PF17167,5,13,4,1,9,1004,0.31,0.99,0.8,0.49,3,1,4,2,1011,0.33,0.99,0.2,0.26
PF13443,PF03238:PF14258:PF08258,1,0,0,1,0,1017,0,1.0,0.0,0,0,0,1,0,1017,0,1.0,0.0,0
PF01914,PF13995:PF06798:PF03729,0,0,0,0,0,1018,0,1.0,0,0,0,0,0,0,1018,0,1.0,0,0
PF01109,PF03745:PF03238:PF15856,2,1,0,2,1,1015,0.0,1.0,0.0,-0.0,0,0,2,0,1016,0,1.0,0.0,0
PF07517,PF01043:PF08216:PF10350,5,15,3,2,12,1001,0.2,0.99,0.6,0.34,2,2,3,0,1013,1.0,1.0,0.4,0.63
PF15110,PF15849:PF15120:PF15829,4,1,1,3,0,1014,1.0,1.0,0.25,0.5,1,1,3,0,1014,1.0,1.0,0.25,0.5
PF03461,PF03880:PF10927:PF07652,3,10,2,1,8,1007,0.2,0.99,0.67,0.36,1,1,2,0,1015,1.0,1.0,0.33,0.58
PF15476,PF09327:PF01660:PF12256,0,6,0,0,6,1012,0.0,0.99,0,0,0,0,0,0,1018,0,1.0,0,0
PF09239,PF07730:PF06580:PF16359,2,15,0,2,15,1001,0.0,0.98,0.0,-0.01,2,0,2,2,1014,0.0,1.0,0.0,-0.0
PF11152,PF06549:PF16851:PF10868,2,1,1,1,0,1016,1.0,1.0,0.5,0.71,0,0,2,0,1016,0,1.0,0.0,0
PF15806,PF16027:PF07051:PF07260,1,2,0,1,2,1015,0.0,1.0,0.0,-0.0,0,0,1,0,1017,0,1.0,0.0,0
PF04086,PF00448:PF02881:PF02978,11,39,10,1,29,978,0.26,0.97,0.91,0.47,32,7,4,25,982,0.22,0.97,0.64,0.36
PF02678,PF16912:PF05726:PF01729,17,19,11,6,8,993,0.58,0.99,0.65,0.61,1,1,16,0,1001,1.0,0.98,0.06,0.24
PF04756,PF05434:PF00143:PF11779,11,10,3,8,7,1000,0.3,0.99,0.27,0.28,3,2,9,1,1006,0.67,0.99,0.18,0.34
PF11919,PF16507:PF16547:PF13001,8,22,8,0,14,996,0.36,0.99,1.0,0.6,4,4,4,0,1010,1.0,1.0,0.5,0.71
PF11976,PF01150:PF06179:PF08511,23,29,7,16,22,973,0.24,0.96,0.3,0.25,6,4,19,2,993,0.67,0.98,0.17,0.33
PF03298,PF15003:PF03760:PF01922,3,10,0,3,10,1005,0.0,0.99,0.0,-0.01,0,0,3,0,1015,0,1.0,0.0,0
PF00054,PF02210:PF01049:PF06009,15,41,13,2,28,975,0.32,0.97,0.87,0.51,8,3,12,5,998,0.38,0.98,0.2,0.27
PF01969,PF07411:PF14882:PF05326,0,0,0,0,0,1018,0,1.0,0,0,0,0,0,0,1018,0,1.0,0,0
PF05902,PF04382:PF11819:PF09141,5,24,5,0,19,994,0.21,0.98,1.0,0.45,1,1,4,0,1013,1.0,1.0,0.2,0.45
PF04195,PF11500:PF02040:PF15871,8,11,0,8,11,999,0.0,0.98,0.0,-0.01,0,0,8,0,1010,0,0.99,0.0,0
PF12548,PF12411:PF16347:PF08019,3,10,1,2,9,1006,0.1,0.99,0.33,0.18,2,1,2,1,1014,0.5,1.0,0.33,0.41
PF05172,PF07051:PF04367:PF07809,10,3,0,10,3,1005,0.0,0.99,0.0,-0.01,0,0,10,0,1008,0,0.99,0.0,0
PF01788,PF00882:PF13400:PF08291,0,0,0,0,0,1018,0,1.0,0,0,0,0,0,0,1018,0,1.0,0,0
PF04265,PF04263:PF03868:PF04248,14,32,14,0,18,986,0.44,0.98,1.0,0.66,4,2,12,2,1002,0.5,0.99,0.14,0.26
PF04153,PF04959:PF13914:PF08209,12,25,4,8,21,985,0.16,0.97,0.33,0.22,7,3,9,4,1002,0.43,0.99,0.25,0.32
PF10356,PF10303:PF12243:PF00165,2,9,1,1,8,1008,0.11,0.99,0.5,0.23,0,0,2,0,1016,0,1.0,0.0,0
PF07331,PF08334:PF06745:PF08479,0,1,0,0,1,1017,0.0,1.0,0,0,0,0,0,0,1018,0,1.0,0,0
PF12550,PF16787:PF10979:PF11496,5,23,4,1,19,994,0.17,0.98,0.8,0.37,4,1,4,3,1010,0.25,0.99,0.2,0.22
PF10690,PF11061:PF07906:PF14452,0,0,0,0,0,1018,0,1.0,0,0,0,0,0,0,1018,0,1.0,0,0
PF02624,PF06798:PF10856:PF07157,0,0,0,0,0,1018,0,1.0,0,0,0,0,0,0,1018,0,1.0,0,0
PF04225,PF08437:PF10118:PF14685,6,7,0,6,7,1005,0.0,0.99,0.0,-0.01,0,0,6,0,1012,0,0.99,0.0,0
PF10393,PF16754:PF12034:PF06668,3,3,2,1,1,1014,0.67,1.0,0.67,0.67,0,0,3,0,1015,0,1.0,0.0,0
PF01643,PF12590:PF08523:PF02747,1,17,1,0,16,1001,0.06,0.98,1.0,0.24,1,0,1,1,1016,0.0,1.0,0.0,-0.0
PF15312,PF15482:PF15762:PF03238,0,0,0,0,0,1018,0,1.0,0,0,0,0,0,0,1018,0,1.0,0,0
PF14836,PF06337:PF13446:PF16674,9,19,7,2,12,997,0.37,0.99,0.78,0.53,2,2,7,0,1009,1.0,0.99,0.22,0.47
PF00384,PF09326:PF10588:PF04879,23,21,18,5,3,992,0.86,0.99,0.78,0.82,14,14,9,0,995,1.0,0.99,0.61,0.78
PF16804,PF17017:PF13750:PF08093,0,1,0,0,1,1017,0.0,1.0,0,0,0,0,0,0,1018,0,1.0,0,0
PF04854,PF16784:PF14541:PF12437,2,28,1,1,27,989,0.04,0.97,0.5,0.13,1,0,2,1,1015,0.0,1.0,0.0,-0.0
PF14027,PF11807:PF07350:PF04199,16,26,10,6,16,986,0.38,0.98,0.62,0.48,8,6,10,2,1000,0.75,0.99,0.38,0.53
PF02263,PF02841:PF02176:PF04871,21,34,16,5,18,979,0.47,0.98,0.76,0.59,6,6,15,0,997,1.0,0.99,0.29,0.53
PF10420,PF01731:PF01160:PF00243,1,10,1,0,9,1008,0.1,0.99,1.0,0.31,0,0,1,0,1017,0,1.0,0.0,0
PF05008,PF01980:PF04706:PF03908,5,13,1,4,12,1001,0.08,0.98,0.2,0.12,5,0,5,5,1008,0.0,0.99,0.0,-0.0
PF13341,PF03089:PF01134:PF04113,1,26,1,0,25,992,0.04,0.98,1.0,0.19,4,1,0,3,1014,0.25,1.0,1.0,0.5
PF17191,PF12105:PF05223:PF08848,5,6,5,0,1,1012,0.83,1.0,1.0,0.91,0,0,5,0,1013,0,1.0,0.0,0
PF04182,PF10264:PF14545:PF13945,6,8,1,5,7,1005,0.12,0.99,0.17,0.14,1,0,6,1,1011,0.0,0.99,0.0,-0.0
PF15856,PF14251:PF17049:PF15775,1,3,0,1,3,1014,0.0,1.0,0.0,-0.0,0,0,1,0,1017,0,1.0,0.0,0
PF06626,PF06724:PF05939:PF10566,1,0,0,1,0,1017,0,1.0,0.0,0,0,0,1,0,1017,0,1.0,0.0,0
PF11161,PF04559:PF05489:PF02086,0,2,0,0,2,1016,0.0,1.0,0,0,0,0,0,0,1018,0,1.0,0,0
PF04015,PF05930:PF09856:PF03831,3,0,0,3,0,1015,0,1.0,0.0,0,0,0,3,0,1015,0,1.0,0.0,0
PF00626,PF04810:PF12799:PF02209,48,63,35,13,28,942,0.56,0.96,0.73,0.62,14,14,34,0,970,1.0,0.97,0.29,0.53
PF03935,PF14240:PF12751:PF10236,8,12,3,5,9,1001,0.25,0.99,0.38,0.3,1,0,8,1,1009,0.0,0.99,0.0,-0.0
PF04947,PF07882:PF03775:PF07195,0,1,0,0,1,1017,0.0,1.0,0,0,0,0,0,0,1018,0,1.0,0,0
PF16698,PF00200:PF01562:PF08516,3,40,3,0,37,978,0.07,0.96,1.0,0.27,26,2,1,24,991,0.08,0.98,0.67,0.22
PF02129,PF08530:PF02065:PF09298,20,31,17,3,14,984,0.55,0.98,0.85,0.68,13,12,8,1,997,0.92,0.99,0.6,0.74
PF05111,PF15064:PF15467:PF01114,1,3,0,1,3,1014,0.0,1.0,0.0,-0.0,0,0,1,0,1017,0,1.0,0.0,0
PF04120,PF05953:PF00871:PF16740,0,10,0,0,10,1008,0.0,0.99,0,0,0,0,0,0,1018,0,1.0,0,0
PF14545,PF04182:PF10264:PF15678,2,11,1,1,10,1006,0.09,0.99,0.5,0.21,1,0,2,1,1015,0.0,1.0,0.0,-0.0
PF02953,PF04119:PF07706:PF06388,26,5,4,22,1,991,0.8,0.98,0.15,0.34,1,1,25,0,992,1.0,0.98,0.04,0.19
PF05251,PF03348:PF02652:PF07745,2,23,2,0,21,995,0.09,0.98,1.0,0.29,4,0,2,4,1012,0.0,0.99,0.0,-0.0
PF12296,PF04667:PF01987:PF07350,6,12,3,3,9,1003,0.25,0.99,0.5,0.35,1,0,6,1,1011,0.0,0.99,0.0,-0.0
PF13751,PF05947:PF15976:PF03888,2,0,0,2,0,1016,0,1.0,0.0,0,0,0,2,0,1016,0,1.0,0.0,0
PF14224,PF15984:PF01618:PF05962,0,4,0,0,4,1014,0.0,1.0,0,0,0,0,0,0,1018,0,1.0,0,0
PF00853,PF12540:PF06031:PF05178,4,11,1,3,10,1004,0.09,0.99,0.25,0.15,3,1,3,2,1012,0.33,1.0,0.25,0.29
PF04227,PF00294:PF09863:PF01380,7,49,6,1,43,968,0.12,0.96,0.86,0.31,6,2,5,4,1007,0.33,0.99,0.29,0.3
PF16808,PF16579:PF12063:PF14593,3,19,2,1,17,998,0.11,0.98,0.67,0.26,5,2,1,3,1012,0.4,1.0,0.67,0.51
PF05656,PF15224:PF16168:PF12446,0,0,0,0,0,1018,0,1.0,0,0,0,0,0,0,1018,0,1.0,0,0
PF14674,PF14677:PF14680:PF14676,0,1,0,0,1,1017,0.0,1.0,0,0,1,0,0,1,1017,0.0,1.0,0,0
PF05772,PF05925:PF02311:PF05694,0,16,0,0,16,1002,0.0,0.98,0,0,0,0,0,0,1018,0,1.0,0,0
PF15434,PF03745:PF17076:PF09669,1,1,0,1,1,1016,0.0,1.0,0.0,-0.0,0,0,1,0,1017,0,1.0,0.0,0
PF08045,PF09991:PF15289:PF05428,3,1,0,3,1,1014,0.0,1.0,0.0,-0.0,0,0,3,0,1015,0,1.0,0.0,0
PF10247,PF04051:PF00118:PF06825,4,62,2,2,60,954,0.03,0.94,0.5,0.12,13,1,3,12,1002,0.08,0.99,0.25,0.13
PF10167,PF10037:PF14857:PF14822,5,9,0,5,9,1004,0.0,0.99,0.0,-0.01,0,0,5,0,1013,0,1.0,0.0,0
PF10436,PF09239:PF07730:PF00183,16,38,5,11,33,969,0.13,0.96,0.31,0.18,4,2,14,2,1000,0.5,0.98,0.12,0.24
PF00326,PF02897:PF00930:PF07676,47,39,29,18,10,961,0.74,0.97,0.62,0.66,9,9,38,0,971,1.0,0.96,0.19,0.43
PF07749,PF07912:PF06201:PF07449,7,21,4,3,17,994,0.19,0.98,0.57,0.32,0,0,7,0,1011,0,0.99,0.0,0
PF15170,PF14251:PF15775:PF00669,1,3,0,1,3,1014,0.0,1.0,0.0,-0.0,0,0,1,0,1017,0,1.0,0.0,0
PF12835,PF04375:PF04740:PF05509,1,3,1,0,2,1015,0.33,1.0,1.0,0.58,0,0,1,0,1017,0,1.0,0.0,0
PF15164,PF02543:PF16861:PF12241,0,4,0,0,4,1014,0.0,1.0,0,0,3,0,0,3,1015,0.0,1.0,0,0
PF16182,PF02209:PF16923:PF08158,6,24,3,3,21,991,0.12,0.98,0.5,0.24,3,1,5,2,1010,0.33,0.99,0.17,0.23
PF02621,PF05939:PF08497:PF09498,0,0,0,0,0,1018,0,1.0,0,0,0,0,0,0,1018,0,1.0,0,0
PF07954,PF05448:PF10445:PF09962,1,4,0,1,4,1013,0.0,1.0,0.0,-0.0,0,0,1,0,1017,0,1.0,0.0,0
PF14244,PF13976:PF03732:PF08284,28,100,21,7,79,911,0.21,0.92,0.75,0.37,28,11,17,17,973,0.39,0.97,0.39,0.38
PF15888,PF12478:PF08291:PF04417,0,7,0,0,7,1011,0.0,0.99,0,0,0,0,0,0,1018,0,1.0,0,0
PF03726,PF16097:PF16098:PF01138,9,61,9,0,52,957,0.15,0.95,1.0,0.37,4,1,8,3,1006,0.25,0.99,0.11,0.16
PF12430,PF12537:PF01237:PF01028,1,43,1,0,42,975,0.02,0.96,1.0,0.15,5,1,0,4,1013,0.2,1.0,1.0,0.45
PF07096,PF04110:PF06172:PF14954,5,9,1,4,8,1005,0.11,0.99,0.2,0.14,1,0,5,1,1012,0.0,0.99,0.0,-0.0
PF03022,PF03417:PF07542:PF04819,6,20,1,5,19,993,0.05,0.98,0.17,0.08,1,0,6,1,1011,0.0,0.99,0.0,-0.0
PF13632,PF08174:PF03552:PF01031,15,57,7,8,50,953,0.12,0.94,0.47,0.22,8,4,11,4,999,0.5,0.99,0.27,0.36
PF14722,PF16043:PF10309:PF14662,7,13,1,6,12,999,0.08,0.98,0.14,0.1,0,0,7,0,1011,0,0.99,0.0,0
PF17064,PF02448:PF11805:PF14986,6,0,0,6,0,1012,0,0.99,0.0,0,0,0,6,0,1012,0,0.99,0.0,0
PF05923,PF05924:PF05972:PF05956,8,9,7,1,2,1008,0.78,1.0,0.88,0.82,7,7,1,0,1010,1.0,1.0,0.88,0.93
PF03063,PF01402:PF03406:PF10974,2,1,1,1,0,1016,1.0,1.0,0.5,0.71,0,0,2,0,1016,0,1.0,0.0,0
PF00445,PF04603:PF02284:PF01775,20,13,4,16,9,989,0.31,0.98,0.2,0.24,5,3,17,2,996,0.6,0.98,0.15,0.29
PF16448,PF12191:PF04552:PF11109,1,2,0,1,2,1015,0.0,1.0,0.0,-0.0,0,0,1,0,1017,0,1.0,0.0,0
PF09784,PF15744:PF15829:PF02202,0,1,0,0,1,1017,0.0,1.0,0,0,0,0,0,0,1018,0,1.0,0,0
PF15311,PF17098:PF10361:PF11727,6,6,0,6,6,1006,0.0,0.99,0.0,-0.01,0,0,6,0,1012,0,0.99,0.0,0
PF03401,PF13247:PF08404:PF01514,1,0,0,1,0,1017,0,1.0,0.0,0,0,0,1,0,1017,0,1.0,0.0,0
PF08774,PF13892:PF08797:PF15790,6,29,4,2,25,987,0.14,0.97,0.67,0.3,7,3,3,4,1008,0.43,0.99,0.5,0.46
PF13495,PF00524:PF05065:PF05685,1,6,1,0,5,1012,0.17,1.0,1.0,0.41,0,0,1,0,1017,0,1.0,0.0,0
PF09240,PF07227:PF16066:PF09067,4,3,1,3,2,1012,0.33,1.0,0.25,0.29,1,1,3,0,1014,1.0,1.0,0.25,0.5
PF12144,PF15778:PF12478:PF09596,5,9,0,5,9,1004,0.0,0.99,0.0,-0.01,0,0,5,0,1013,0,1.0,0.0,0
PF08031,PF04030:PF09265:PF02913,41,52,18,23,34,943,0.35,0.94,0.44,0.36,9,6,35,3,974,0.67,0.96,0.15,0.3
PF14464,PF15160:PF08331:PF03389,5,0,0,5,0,1013,0,1.0,0.0,0,0,0,5,0,1013,0,1.0,0.0,0
PF03716,PF12384:PF07962:PF13340,2,9,2,0,7,1009,0.22,0.99,1.0,0.47,2,2,0,0,1016,1.0,1.0,1.0,1.0
PF03160,PF07965:PF14312:PF08725,14,11,2,12,9,995,0.18,0.98,0.14,0.15,4,2,12,2,1002,0.5,0.99,0.14,0.26
PF02267,PF12301:PF00277:PF00726,4,2,0,4,2,1012,0.0,0.99,0.0,-0.0,0,0,4,0,1014,0,1.0,0.0,0
PF15820,PF15990:PF04359:PF06989,0,5,0,0,5,1013,0.0,1.0,0,0,0,0,0,0,1018,0,1.0,0,0
PF16498,PF16495:PF16496:PF14379,6,15,5,1,10,1002,0.33,0.99,0.83,0.52,7,4,2,3,1009,0.57,1.0,0.67,0.61
PF08034,PF11282:PF16007:PF12926,0,3,0,0,3,1015,0.0,1.0,0,0,0,0,0,0,1018,0,1.0,0,0
PF04749,PF03162:PF00436:PF03595,25,40,8,17,32,961,0.2,0.95,0.32,0.23,6,4,21,2,991,0.67,0.98,0.16,0.32
PF07422,PF13307:PF13968:PF00305,0,47,0,0,47,971,0.0,0.95,0,0,10,0,0,10,1008,0.0,0.99,0,0
PF15906,PF11571:PF04641:PF10496,9,29,5,4,24,985,0.17,0.97,0.56,0.3,5,2,7,3,1006,0.4,0.99,0.22,0.29
PF07753,PF02955:PF15143:PF08021,0,4,0,0,4,1014,0.0,1.0,0,0,0,0,0,0,1018,0,1.0,0,0
PF15313,PF13097:PF14988:PF10173,8,11,2,6,9,1001,0.18,0.99,0.25,0.21,1,1,7,0,1010,1.0,0.99,0.12,0.35
PF03866,PF13089:PF11892:PF09556,0,2,0,0,2,1016,0.0,1.0,0,0,0,0,0,0,1018,0,1.0,0,0
PF04342,PF13742:PF11751:PF13722,0,2,0,0,2,1016,0.0,1.0,0,0,0,0,0,0,1018,0,1.0,0,0
PF08393,PF12780:PF08385:PF12777,36,43,33,3,10,972,0.77,0.99,0.92,0.83,38,31,5,7,975,0.82,0.99,0.86,0.83
PF03881,PF10282:PF11807:PF08881,13,27,7,6,20,985,0.26,0.97,0.54,0.36,7,3,10,4,1001,0.43,0.99,0.23,0.31
PF10680,PF08744:PF13929:PF16967,8,0,0,8,0,1010,0,0.99,0.0,0,0,0,8,0,1010,0,0.99,0.0,0
PF05043,PF11975:PF02056:PF05513,5,8,2,3,6,1007,0.25,0.99,0.4,0.31,8,2,3,6,1007,0.25,0.99,0.4,0.31
PF10615,PF10590:PF02132:PF10785,5,13,2,3,11,1002,0.15,0.99,0.4,0.24,0,0,5,0,1013,0,1.0,0.0,0
PF08050,PF12220:PF12353:PF08081,1,19,1,0,18,999,0.05,0.98,1.0,0.23,4,1,0,3,1014,0.25,1.0,1.0,0.5
PF07039,PF01980:PF04706:PF09282,9,8,2,7,6,1003,0.25,0.99,0.22,0.23,2,1,8,1,1008,0.5,0.99,0.11,0.23
PF03176,PF13323:PF02460:PF16414,12,44,3,9,41,965,0.07,0.95,0.25,0.11,19,0,12,19,987,0.0,0.97,0.0,-0.02
PF08995,PF11934:PF01857:PF08934,0,2,0,0,2,1016,0.0,1.0,0,0,1,0,0,1,1017,0.0,1.0,0,0
PF13679,PF04577:PF13417:PF02798,24,88,15,9,73,921,0.17,0.92,0.62,0.3,24,10,14,14,980,0.42,0.97,0.42,0.4
PF05152,PF11130:PF09669:PF06725,0,2,0,0,2,1016,0.0,1.0,0,0,0,0,0,0,1018,0,1.0,0,0
PF17017,PF05939:PF08093:PF12628,0,1,0,0,1,1017,0.0,1.0,0,0,0,0,0,0,1018,0,1.0,0,0
PF04679,PF01068:PF10345:PF14743,18,19,18,0,1,999,0.95,1.0,1.0,0.97,6,5,13,1,999,0.83,0.99,0.28,0.48
PF04450,PF04690:PF06404:PF06206,2,4,0,2,4,1012,0.0,0.99,0.0,-0.0,0,0,2,0,1016,0,1.0,0.0,0
PF02907,PF10801:PF02121:PF02862,1,22,0,1,22,995,0.0,0.98,0.0,-0.0,6,0,1,6,1011,0.0,0.99,0.0,-0.0
PF16600,PF16632:PF16553:PF12485,1,1,1,0,0,1017,1.0,1.0,1.0,1.0,1,1,0,0,1017,1.0,1.0,1.0,1.0
PF06251,PF06082:PF11902:PF04865,0,0,0,0,0,1018,0,1.0,0,0,0,0,0,0,1018,0,1.0,0,0
PF05147,PF12239:PF00797:PF03972,13,21,1,12,20,985,0.05,0.97,0.08,0.05,6,1,12,5,1000,0.17,0.98,0.08,0.11
PF00552,PF02022:PF13276:PF01141,5,12,5,0,7,1006,0.42,0.99,1.0,0.64,4,4,1,0,1013,1.0,1.0,0.8,0.89
PF06567,PF06566:PF10630:PF15467,1,1,1,0,0,1017,1.0,1.0,1.0,1.0,0,0,1,0,1017,0,1.0,0.0,0
PF01554,PF14667:PF04833:PF12928,28,12,7,21,5,985,0.58,0.97,0.25,0.37,1,1,27,0,990,1.0,0.97,0.04,0.19
PF15054,PF10868:PF15173:PF17032,5,0,0,5,0,1013,0,1.0,0.0,0,0,0,5,0,1013,0,1.0,0.0,0
PF08437,PF04225:PF10118:PF14685,2,11,0,2,11,1005,0.0,0.99,0.0,-0.0,0,0,2,0,1016,0,1.0,0.0,0
PF06808,PF00950:PF03150:PF05936,8,10,5,3,5,1005,0.5,0.99,0.62,0.56,2,2,6,0,1010,1.0,0.99,0.25,0.5
PF04341,PF01458:PF07522:PF08609,0,25,0,0,25,993,0.0,0.98,0,0,3,0,0,3,1015,0.0,1.0,0,0
PF05631,PF03847:PF00782:PF00999,14,106,10,4,96,908,0.09,0.9,0.71,0.24,25,7,7,18,986,0.28,0.98,0.5,0.36
PF03793,PF03241:PF14842:PF07499,3,2,1,2,1,1014,0.5,1.0,0.33,0.41,0,0,3,0,1015,0,1.0,0.0,0
PF00641,PF08604:PF16764:PF17219,48,7,7,41,0,970,1.0,0.96,0.15,0.37,2,2,46,0,970,1.0,0.95,0.04,0.2
PF12442,PF11264:PF00543:PF11347,5,5,1,4,4,1009,0.2,0.99,0.2,0.2,1,1,4,0,1013,1.0,1.0,0.2,0.45
PF07408,PF04999:PF03746:PF03135,1,6,0,1,6,1011,0.0,0.99,0.0,-0.0,1,0,1,1,1016,0.0,1.0,0.0,-0.0
PF10507,PF10239:PF00233:PF00812,5,29,2,3,27,986,0.07,0.97,0.4,0.16,3,1,4,2,1011,0.33,0.99,0.2,0.26
PF14714,PF15086:PF09269:PF05128,3,6,1,2,5,1010,0.17,0.99,0.33,0.23,1,1,2,0,1015,1.0,1.0,0.33,0.58
PF09594,PF09834:PF05164:PF00524,1,4,0,1,4,1013,0.0,1.0,0.0,-0.0,0,0,1,0,1017,0,1.0,0.0,0
PF08900,PF01778:PF03900:PF06936,0,31,0,0,31,987,0.0,0.97,0,0,6,0,0,6,1012,0.0,0.99,0,0
PF02702,PF10412:PF07881:PF15050,2,3,0,2,3,1013,0.0,1.0,0.0,-0.0,0,0,2,0,1016,0,1.0,0.0,0
PF07833,PF05939:PF06798:PF05202,6,0,0,6,0,1012,0,0.99,0.0,0,0,0,6,0,1012,0,0.99,0.0,0
PF16091,PF15759:PF05841:PF14040,1,0,0,1,0,1017,0,1.0,0.0,0,0,0,1,0,1017,0,1.0,0.0,0
PF02433,PF12139:PF14983:PF01959,4,5,0,4,5,1009,0.0,0.99,0.0,-0.0,0,0,4,0,1014,0,1.0,0.0,0
PF03384,PF14922:PF13694:PF11727,3,4,1,2,3,1012,0.25,1.0,0.33,0.29,0,0,3,0,1015,0,1.0,0.0,0
PF01294,PF00048:PF04690:PF14798,5,16,4,1,12,1001,0.25,0.99,0.8,0.44,1,1,4,0,1013,1.0,1.0,0.2,0.45
PF05708,PF00171:PF00465:PF00696,2,124,1,1,123,893,0.01,0.88,0.5,0.05,36,1,1,35,981,0.03,0.96,0.5,0.11
PF00024,PF08277:PF14295:PF00051,52,61,34,18,27,939,0.56,0.96,0.65,0.58,17,16,36,1,965,0.94,0.96,0.31,0.53
PF01289,PF07157:PF13722:PF12241,1,1,0,1,1,1016,0.0,1.0,0.0,-0.0,0,0,1,0,1017,0,1.0,0.0,0
PF04379,PF13369:PF08755:PF09346,10,13,6,4,7,1001,0.46,0.99,0.6,0.52,6,2,8,4,1004,0.33,0.99,0.2,0.25
PF02202,PF15829:PF15576:PF15839,0,3,0,0,3,1015,0.0,1.0,0,0,0,0,0,0,1018,0,1.0,0,0
PF01470,PF04716:PF04667:PF08561,12,21,4,8,17,989,0.19,0.98,0.33,0.24,2,1,11,1,1005,0.5,0.99,0.08,0.2
PF02364,PF14288:PF14498:PF06964,9,24,9,0,15,994,0.38,0.99,1.0,0.61,8,5,4,3,1006,0.62,0.99,0.56,0.59
PF14861,PF17223:PF14654:PF02451,0,1,0,0,1,1017,0.0,1.0,0,0,0,0,0,0,1018,0,1.0,0,0
PF02873,PF02913:PF04030:PF09265,6,52,3,3,49,963,0.06,0.95,0.5,0.16,9,3,3,6,1006,0.33,0.99,0.5,0.4
PF08532,PF07117:PF16967:PF07494,8,1,0,8,1,1009,0.0,0.99,0.0,-0.0,0,0,8,0,1010,0,0.99,0.0,0
PF08448,PF13188:PF00990:PF00672,11,24,8,3,16,991,0.33,0.98,0.73,0.48,11,7,4,4,1003,0.64,0.99,0.64,0.63
PF11054,PF07276:PF06753:PF03778,1,1,0,1,1,1016,0.0,1.0,0.0,-0.0,0,0,1,0,1017,0,1.0,0.0,0
PF11289,PF00721:PF03946:PF02556,0,28,0,0,28,990,0.0,0.97,0,0,0,0,0,0,1018,0,1.0,0,0
PF06984,PF09793:PF01279:PF10248,11,11,0,11,11,996,0.0,0.98,0.0,-0.01,1,0,11,1,1006,0.0,0.99,0.0,-0.0
PF15244,PF15369:PF15290:PF15717,1,3,0,1,3,1014,0.0,1.0,0.0,-0.0,0,0,1,0,1017,0,1.0,0.0,0
PF17088,PF15036:PF15125:PF05558,0,5,0,0,5,1013,0.0,1.0,0,0,0,0,0,0,1018,0,1.0,0,0
PF16469,PF16126:PF16485:PF08762,2,6,0,2,6,1010,0.0,0.99,0.0,-0.0,0,0,2,0,1016,0,1.0,0.0,0
PF05841,PF13810:PF10295:PF15696,0,4,0,0,4,1014,0.0,1.0,0,0,0,0,0,0,1018,0,1.0,0,0
PF06544,PF01205:PF08572:PF16543,13,33,6,7,27,978,0.18,0.97,0.46,0.28,6,3,10,3,1002,0.5,0.99,0.23,0.33
PF08390,PF12403:PF04618:PF12045,5,3,0,5,3,1010,0.0,0.99,0.0,-0.0,1,0,5,1,1012,0.0,0.99,0.0,-0.0
PF04597,PF14802:PF09496:PF04440,10,4,0,10,4,1004,0.0,0.99,0.0,-0.01,0,0,10,0,1008,0,0.99,0.0,0
PF05792,PF11766:PF12727:PF02063,0,3,0,0,3,1015,0.0,1.0,0,0,0,0,0,0,1018,0,1.0,0,0
PF09174,PF01951:PF09786:PF01217,2,50,2,0,48,968,0.04,0.95,1.0,0.2,5,2,0,3,1013,0.4,1.0,1.0,0.63
PF14469,PF15172:PF02531:PF15173,2,3,0,2,3,1013,0.0,1.0,0.0,-0.0,0,0,2,0,1016,0,1.0,0.0,0
PF11412,PF08411:PF15823:PF00997,0,1,0,0,1,1017,0.0,1.0,0,0,0,0,0,0,1018,0,1.0,0,0
PF10253,PF11510:PF14958:PF13559,5,7,2,3,5,1008,0.29,0.99,0.4,0.33,0,0,5,0,1013,0,1.0,0.0,0
PF05272,PF11751:PF07409:PF06798,0,0,0,0,0,1018,0,1.0,0,0,0,0,0,0,1018,0,1.0,0,0
PF00975,PF16197:PF08659:PF00668,21,55,20,1,35,962,0.36,0.96,0.95,0.58,34,16,5,18,979,0.47,0.98,0.76,0.59
PF05397,PF15624:PF09441:PF13945,11,6,1,10,5,1002,0.17,0.99,0.09,0.12,0,0,11,0,1007,0,0.99,0.0,0
PF03232,PF00708:PF06760:PF15009,9,7,2,7,5,1004,0.29,0.99,0.22,0.25,3,2,7,1,1008,0.67,0.99,0.22,0.38
PF07385,PF05536:PF05777:PF03107,0,16,0,0,16,1002,0.0,0.98,0,0,2,0,0,2,1016,0.0,1.0,0,0
PF09615,PF04931:PF07147:PF01579,0,22,0,0,22,996,0.0,0.98,0,0,4,0,0,4,1014,0.0,1.0,0,0
PF05478,PF06473:PF03416:PF01007,5,31,1,4,30,983,0.03,0.97,0.2,0.07,4,1,4,3,1010,0.25,0.99,0.2,0.22
PF00891,PF08100:PF02545:PF01066,33,48,19,14,29,956,0.4,0.96,0.58,0.46,12,9,24,3,982,0.75,0.97,0.27,0.44
PF04657,PF08497:PF15281:PF03888,4,3,0,4,3,1011,0.0,0.99,0.0,-0.0,0,0,4,0,1014,0,1.0,0.0,0
PF09281,PF06394:PF02657:PF11421,2,13,0,2,13,1003,0.0,0.99,0.0,-0.01,0,0,2,0,1016,0,1.0,0.0,0
PF05698,PF05697:PF10022:PF14764,0,14,0,0,14,1004,0.0,0.99,0,0,1,0,0,1,1017,0.0,1.0,0,0
PF09682,PF13906:PF04952:PF00523,0,21,0,0,21,997,0.0,0.98,0,0,0,0,0,0,1018,0,1.0,0,0
PF09405,PF10264:PF08729:PF09469,8,10,3,5,7,1003,0.3,0.99,0.38,0.33,2,1,7,1,1009,0.5,0.99,0.12,0.25
PF01098,PF07361:PF04247:PF00358,10,15,1,9,14,994,0.07,0.98,0.1,0.07,0,0,10,0,1008,0,0.99,0.0,0
PF00589,PF12259:PF00075:PF03732,21,85,12,9,73,924,0.14,0.92,0.57,0.26,19,7,14,12,985,0.37,0.97,0.33,0.34
PF07250,PF09118:PF00703:PF01822,7,66,6,1,60,951,0.09,0.94,0.86,0.27,13,5,2,8,1003,0.38,0.99,0.71,0.52
PF02635,PF10279:PF05974:PF03090,0,0,0,0,0,1018,0,1.0,0,0,0,0,0,0,1018,0,1.0,0,0
PF07559,PF03963:PF06429:PF09250,1,3,1,0,2,1015,0.33,1.0,1.0,0.58,1,1,0,0,1017,1.0,1.0,1.0,1.0
PF07281,PF02285:PF14473:PF06541,4,4,1,3,3,1011,0.25,0.99,0.25,0.25,0,0,4,0,1014,0,1.0,0.0,0
PF14943,PF10853:PF00159:PF05361,12,7,3,9,4,1002,0.43,0.99,0.25,0.32,2,1,11,1,1005,0.5,0.99,0.08,0.2
PF17119,PF06883:PF04183:PF00674,4,7,3,1,4,1010,0.43,1.0,0.75,0.56,0,0,4,0,1014,0,1.0,0.0,0
PF07354,PF15053:PF15293:PF01415,2,5,0,2,5,1011,0.0,0.99,0.0,-0.0,0,0,2,0,1016,0,1.0,0.0,0
PF14906,PF13910:PF15027:PF17034,3,8,2,1,6,1009,0.25,0.99,0.67,0.41,0,0,3,0,1015,0,1.0,0.0,0
PF00299,PF00323:PF01114:PF04644,1,2,0,1,2,1015,0.0,1.0,0.0,-0.0,0,0,1,0,1017,0,1.0,0.0,0
PF03665,PF15872:PF07956:PF15302,5,7,2,3,5,1008,0.29,0.99,0.4,0.33,0,0,5,0,1013,0,1.0,0.0,0
PF02719,PF03831:PF05509:PF01913,4,2,0,4,2,1012,0.0,0.99,0.0,-0.0,0,0,4,0,1014,0,1.0,0.0,0
PF07223,PF12049:PF10330:PF10571,1,2,0,1,2,1015,0.0,1.0,0.0,-0.0,0,0,1,0,1017,0,1.0,0.0,0
PF10481,PF07926:PF12297:PF16830,4,9,0,4,9,1005,0.0,0.99,0.0,-0.01,0,0,4,0,1014,0,1.0,0.0,0
PF10129,PF10423:PF16259:PF09698,0,1,0,0,1,1017,0.0,1.0,0,0,0,0,0,0,1018,0,1.0,0,0
PF09387,PF07738:PF07202:PF10377,0,33,0,0,33,985,0.0,0.97,0,0,6,0,0,6,1012,0.0,0.99,0,0
PF01527,PF04236:PF04218:PF09026,9,17,3,6,14,995,0.18,0.98,0.33,0.23,5,2,7,3,1006,0.4,0.99,0.22,0.29
PF17187,PF08622:PF09164:PF12470,2,5,2,0,3,1013,0.4,1.0,1.0,0.63,1,1,1,0,1016,1.0,1.0,0.5,0.71
PF10294,PF01869:PF01063:PF13847,39,59,15,24,44,935,0.25,0.93,0.38,0.28,12,9,30,3,976,0.75,0.97,0.23,0.4
PF10212,PF16704:PF03470:PF15908,4,8,2,2,6,1008,0.25,0.99,0.5,0.35,1,1,3,0,1014,1.0,1.0,0.25,0.5
PF06552,PF03842:PF15015:PF01701,4,1,0,4,1,1013,0.0,1.0,0.0,-0.0,0,0,4,0,1014,0,1.0,0.0,0
PF15729,PF02601:PF08291:PF15856,1,3,0,1,3,1014,0.0,1.0,0.0,-0.0,0,0,1,0,1017,0,1.0,0.0,0
PF01196,PF15860:PF04716:PF08641,16,22,5,11,17,985,0.23,0.97,0.31,0.25,1,1,15,0,1002,1.0,0.99,0.06,0.25
PF12302,PF03592:PF10566:PF14882,2,0,0,2,0,1016,0,1.0,0.0,0,0,0,2,0,1016,0,1.0,0.0,0
PF16654,PF11697:PF13101:PF10091,0,0,0,0,0,1018,0,1.0,0,0,0,0,0,0,1018,0,1.0,0,0
PF14204,PF17144:PF01643:PF03766,15,15,11,4,4,999,0.73,0.99,0.73,0.73,1,1,14,0,1003,1.0,0.99,0.07,0.26
PF07906,PF05726:PF02664:PF16916,0,19,0,0,19,999,0.0,0.98,0,0,3,0,0,3,1015,0.0,1.0,0,0
PF15221,PF14841:PF08724:PF06890,1,1,0,1,1,1016,0.0,1.0,0.0,-0.0,0,0,1,0,1017,0,1.0,0.0,0
PF08096,PF07042:PF05525:PF08850,0,1,0,0,1,1017,0.0,1.0,0,0,0,0,0,0,1018,0,1.0,0,0
PF00566,PF00581:PF12068:PF15733,84,60,38,46,22,912,0.63,0.93,0.45,0.5,2,2,82,0,934,1.0,0.92,0.02,0.15
PF01020,PF04758:PF16843:PF09055,12,14,2,10,12,994,0.14,0.98,0.17,0.14,2,1,11,1,1005,0.5,0.99,0.08,0.2
PF08402,PF08352:PF12399:PF13732,7,13,5,2,8,1003,0.38,0.99,0.71,0.52,3,3,4,0,1011,1.0,1.0,0.43,0.65
PF17023,PF01555:PF15608:PF02702,0,9,0,0,9,1009,0.0,0.99,0,0,0,0,0,0,1018,0,1.0,0,0
PF06621,PF12114:PF09427:PF11413,4,11,3,1,8,1006,0.27,0.99,0.75,0.45,4,2,2,2,1012,0.5,1.0,0.5,0.5
PF06295,PF06560:PF00789:PF02793,0,42,0,0,42,976,0.0,0.96,0,0,2,0,0,2,1016,0.0,1.0,0,0
PF14437,PF10175:PF00313:PF08922,6,39,4,2,35,977,0.1,0.96,0.67,0.25,6,1,5,5,1007,0.17,0.99,0.17,0.16
PF12162,PF14596:PF12188:PF08947,2,1,1,1,0,1016,1.0,1.0,0.5,0.71,1,1,1,0,1016,1.0,1.0,0.5,0.71
PF01487,PF08501:PF01488:PF00275,13,29,11,2,18,987,0.38,0.98,0.85,0.56,15,11,2,4,1001,0.73,0.99,0.85,0.78
PF10950,PF01114:PF00184:PF06683,0,3,0,0,3,1015,0.0,1.0,0,0,0,0,0,0,1018,0,1.0,0,0
PF00011,PF00525:PF01161:PF12483,34,33,11,23,22,962,0.33,0.96,0.32,0.31,1,1,33,0,984,1.0,0.97,0.03,0.17
PF08416,PF08919:PF12162:PF12610,12,12,2,10,10,996,0.17,0.98,0.17,0.16,0,0,12,0,1006,0,0.99,0.0,0
PF05231,PF04917:PF12729:PF11751,2,2,0,2,2,1014,0.0,1.0,0.0,-0.0,0,0,2,0,1016,0,1.0,0.0,0
PF01903,PF00489:PF09459:PF02024,2,3,0,2,3,1013,0.0,1.0,0.0,-0.0,0,0,2,0,1016,0,1.0,0.0,0
PF05292,PF06244:PF03878:PF01597,11,36,7,4,29,978,0.19,0.97,0.64,0.34,7,3,8,4,1003,0.43,0.99,0.27,0.34
PF15498,PF17164:PF06826:PF07499,0,3,0,0,3,1015,0.0,1.0,0,0,0,0,0,0,1018,0,1.0,0,0
PF08660,PF06925:PF08127:PF05216,9,15,5,4,10,999,0.33,0.99,0.56,0.42,0,0,9,0,1009,0,0.99,0.0,0
PF04790,PF05007:PF00590:PF10246,5,31,4,1,27,986,0.13,0.97,0.8,0.31,5,3,2,2,1011,0.6,1.0,0.6,0.6
PF10137,PF13545:PF00325:PF12801,0,7,0,0,7,1011,0.0,0.99,0,0,1,0,0,1,1017,0.0,1.0,0,0
PF07710,PF08563:PF11619:PF00870,2,5,2,0,3,1013,0.4,1.0,1.0,0.63,2,2,0,0,1016,1.0,1.0,1.0,1.0
PF01791,PF04176:PF02284:PF04667,12,17,3,9,14,992,0.18,0.98,0.25,0.2,3,2,10,1,1005,0.67,0.99,0.17,0.33
PF08114,PF06934:PF10106:PF15186,1,2,0,1,2,1015,0.0,1.0,0.0,-0.0,0,0,1,0,1017,0,1.0,0.0,0
PF08698,PF10173:PF10248:PF09340,14,11,3,11,8,996,0.27,0.98,0.21,0.23,3,1,13,2,1002,0.33,0.99,0.07,0.15
PF10084,PF12608:PF00779:PF05541,0,7,0,0,7,1011,0.0,0.99,0,0,0,0,0,0,1018,0,1.0,0,0
PF05617,PF02519:PF02681:PF04535,3,19,1,2,18,997,0.05,0.98,0.33,0.13,2,0,3,2,1013,0.0,1.0,0.0,-0.0
PF00267,PF08093:PF15482:PF17006,1,1,0,1,1,1016,0.0,1.0,0.0,-0.0,0,0,1,0,1017,0,1.0,0.0,0
PF09391,PF00533:PF12738:PF10144,0,56,0,0,56,962,0.0,0.94,0,0,20,0,0,20,998,0.0,0.98,0,0
PF10192,PF05826:PF01207:PF07528,8,46,4,4,42,968,0.09,0.95,0.5,0.19,6,2,6,4,1006,0.33,0.99,0.25,0.28
PF04495,PF15279:PF04087:PF09808,5,5,1,4,4,1009,0.2,0.99,0.2,0.2,0,0,5,0,1013,0,1.0,0.0,0
PF14292,PF12080:PF15750:PF09829,1,1,0,1,1,1016,0.0,1.0,0.0,-0.0,0,0,1,0,1017,0,1.0,0.0,0
PF03834,PF07816:PF07896:PF01871,14,8,5,9,3,1001,0.62,0.99,0.36,0.47,1,1,13,0,1004,1.0,0.99,0.07,0.27
PF03766,PF12590:PF06298:PF02224,1,7,0,1,7,1010,0.0,0.99,0.0,-0.0,0,0,1,0,1017,0,1.0,0.0,0
PF09078,PF08437:PF04225:PF14685,1,9,0,1,9,1008,0.0,0.99,0.0,-0.0,0,0,1,0,1017,0,1.0,0.0,0
PF04827,PF03407:PF04884:PF12899,31,29,9,22,20,967,0.31,0.96,0.29,0.28,5,5,26,0,987,1.0,0.97,0.16,0.4
PF07561,PF08508:PF15730:PF04592,1,4,1,0,3,1014,0.25,1.0,1.0,0.5,0,0,1,0,1017,0,1.0,0.0,0
PF15886,PF06955:PF00722:PF02948,7,43,4,3,39,972,0.09,0.96,0.57,0.22,11,2,5,9,1002,0.18,0.99,0.29,0.22
PF13390,PF09829:PF05974:PF15281,0,3,0,0,3,1015,0.0,1.0,0,0,0,0,0,0,1018,0,1.0,0,0
PF00288,PF08544:PF10509:PF07959,44,39,35,9,4,970,0.9,0.99,0.8,0.84,12,11,33,1,973,0.92,0.97,0.25,0.47
PF11230,PF10105:PF11842:PF06962,2,2,2,0,0,1016,1.0,1.0,1.0,1.0,2,2,0,0,1016,1.0,1.0,1.0,1.0
PF10418,PF02898:PF00970:PF01855,1,48,1,0,47,970,0.02,0.95,1.0,0.14,10,1,0,9,1008,0.1,0.99,1.0,0.31
PF06044,PF12299:PF12101:PF15153,2,0,0,2,0,1016,0,1.0,0.0,0,0,0,2,0,1016,0,1.0,0.0,0
PF04715,PF00425:PF00977:PF00697,12,34,12,0,22,984,0.35,0.98,1.0,0.59,4,3,9,1,1005,0.75,0.99,0.25,0.43
PF03029,PF10178:PF00398:PF08231,22,34,10,12,24,972,0.29,0.96,0.45,0.35,2,2,20,0,996,1.0,0.98,0.09,0.3
PF03174,PF03173:PF02838:PF14845,3,25,3,0,22,993,0.12,0.98,1.0,0.34,5,3,0,2,1013,0.6,1.0,1.0,0.77
PF15171,PF06351:PF15370:PF00727,1,9,0,1,9,1008,0.0,0.99,0.0,-0.0,0,0,1,0,1017,0,1.0,0.0,0
PF15298,PF07809:PF02576:PF11255,0,0,0,0,0,1018,0,1.0,0,0,0,0,0,0,1018,0,1.0,0,0
PF10584,PF12465:PF00227:PF04859,32,88,31,1,57,929,0.35,0.94,0.97,0.57,5,3,29,2,984,0.6,0.97,0.09,0.23
PF05732,PF03742:PF06651:PF06681,0,1,0,0,1,1017,0.0,1.0,0,0,0,0,0,0,1018,0,1.0,0,0
PF06404,PF06206:PF07712:PF02422,1,3,0,1,3,1014,0.0,1.0,0.0,-0.0,0,0,1,0,1017,0,1.0,0.0,0
PF03309,PF02654:PF14258:PF04559,1,3,0,1,3,1014,0.0,1.0,0.0,-0.0,0,0,1,0,1017,0,1.0,0.0,0
PF01295,PF03038:PF10084:PF11882,1,6,0,1,6,1011,0.0,0.99,0.0,-0.0,0,0,1,0,1017,0,1.0,0.0,0
PF10278,PF02605:PF07160:PF07464,7,4,0,7,4,1007,0.0,0.99,0.0,-0.01,0,0,7,0,1011,0,0.99,0.0,0
PF16156,PF13780:PF14690:PF11019,1,0,0,1,0,1017,0,1.0,0.0,0,0,0,1,0,1017,0,1.0,0.0,0
PF00842,PF14031:PF08661:PF14918,0,15,0,0,15,1003,0.0,0.99,0,0,1,0,0,1,1017,0.0,1.0,0,0
PF07111,PF13097:PF15313:PF07137,3,15,1,2,14,1001,0.07,0.98,0.33,0.14,0,0,3,0,1015,0,1.0,0.0,0
PF02829,PF14602:PF12464:PF06426,3,34,3,0,31,984,0.09,0.97,1.0,0.29,12,3,0,9,1006,0.25,0.99,1.0,0.5
PF03595,PF01987:PF07106:PF04667,21,16,7,14,9,988,0.44,0.98,0.33,0.37,2,1,20,1,996,0.5,0.98,0.05,0.15
PF15028,PF03618:PF10912:PF15001,0,4,0,0,4,1014,0.0,1.0,0,0,0,0,0,0,1018,0,1.0,0,0
PF12921,PF17177:PF13812:PF13762,1,65,0,1,65,952,0.0,0.94,0.0,-0.01,27,0,1,27,990,0.0,0.97,0.0,-0.01
PF12239,PF06172:PF10455:PF01774,10,10,1,9,9,999,0.1,0.98,0.1,0.09,0,0,10,0,1008,0,0.99,0.0,0
PF09614,PF09611:PF04717:PF09498,0,0,0,0,0,1018,0,1.0,0,0,0,0,0,0,1018,0,1.0,0,0
PF09832,PF05611:PF08093:PF07353,0,3,0,0,3,1015,0.0,1.0,0,0,0,0,0,0,1018,0,1.0,0,0
PF12951,PF12779:PF02107:PF16586,1,2,0,1,2,1015,0.0,1.0,0.0,-0.0,0,0,1,0,1017,0,1.0,0.0,0
PF04002,PF08544:PF07959:PF10509,1,39,1,0,38,979,0.03,0.96,1.0,0.16,12,1,0,11,1006,0.08,0.99,1.0,0.29
PF01371,PF08414:PF01979:PF04992,1,55,1,0,54,963,0.02,0.95,1.0,0.13,5,0,1,5,1012,0.0,0.99,0.0,-0.0
PF16319,PF09856:PF10134:PF06290,1,0,0,1,0,1017,0,1.0,0.0,0,0,0,1,0,1017,0,1.0,0.0,0
PF15774,PF15337:PF15696:PF07199,0,3,0,0,3,1015,0.0,1.0,0,0,0,0,0,0,1018,0,1.0,0,0
PF08565,PF08564:PF03234:PF02083,11,13,10,1,3,1004,0.77,1.0,0.91,0.83,6,6,5,0,1007,1.0,1.0,0.55,0.74
PF03673,PF12453:PF12567:PF16066,1,2,1,0,1,1016,0.5,1.0,1.0,0.71,2,1,0,1,1016,0.5,1.0,1.0,0.71
PF09592,PF07418:PF00321:PF15071,0,0,0,0,0,1018,0,1.0,0,0,0,0,0,0,1018,0,1.0,0,0
PF11771,PF02950:PF05355:PF04691,0,4,0,0,4,1014,0.0,1.0,0,0,1,0,0,1,1017,0.0,1.0,0,0
PF11111,PF01668:PF15207:PF15343,1,3,0,1,3,1014,0.0,1.0,0.0,-0.0,0,0,1,0,1017,0,1.0,0.0,0
PF03509,PF16791:PF03508:PF00029,0,8,0,0,8,1010,0.0,0.99,0,0,0,0,0,0,1018,0,1.0,0,0
PF08887,PF03525:PF02557:PF15485,0,2,0,0,2,1016,0.0,1.0,0,0,0,0,0,0,1018,0,1.0,0,0
PF02894,PF09166:PF08635:PF02774,19,16,3,16,13,986,0.19,0.97,0.16,0.16,3,2,17,1,998,0.67,0.98,0.11,0.26
PF13821,PF07713:PF12457:PF11952,7,18,5,2,13,998,0.28,0.99,0.71,0.44,4,3,4,1,1010,0.75,1.0,0.43,0.56
PF02778,PF01974:PF01648:PF13299,11,47,10,1,37,970,0.21,0.96,0.91,0.43,14,7,4,7,1000,0.5,0.99,0.64,0.56
PF02386,PF16655:PF12213:PF01373,16,17,5,11,12,990,0.29,0.98,0.31,0.29,1,1,15,0,1002,1.0,0.99,0.06,0.25
PF08873,PF05290:PF02684:PF01645,0,7,0,0,7,1011,0.0,0.99,0,0,0,0,0,0,1018,0,1.0,0,0
PF15183,PF05387:PF15576:PF15829,1,2,0,1,2,1015,0.0,1.0,0.0,-0.0,0,0,1,0,1017,0,1.0,0.0,0
PF03801,PF07989:PF16531:PF07926,9,21,4,5,17,992,0.19,0.98,0.44,0.28,4,3,6,1,1008,0.75,0.99,0.33,0.5
PF10716,PF11317:PF15172:PF09459,1,2,0,1,2,1015,0.0,1.0,0.0,-0.0,0,0,1,0,1017,0,1.0,0.0,0
PF16202,PF09382:PF08072:PF16204,6,17,6,0,11,1001,0.35,0.99,1.0,0.59,7,6,0,1,1011,0.86,1.0,1.0,0.93
PF15073,PF12600:PF06493:PF04428,1,3,0,1,3,1014,0.0,1.0,0.0,-0.0,0,0,1,0,1017,0,1.0,0.0,0
PF00370,PF02782:PF01144:PF08442,42,58,33,9,25,951,0.57,0.97,0.79,0.65,12,7,35,5,971,0.58,0.96,0.17,0.3
PF14767,PF14766:PF14768:PF08961,0,4,0,0,4,1014,0.0,1.0,0,0,0,0,0,0,1018,0,1.0,0,0
PF10494,PF15305:PF15370:PF06351,10,7,0,10,7,1001,0.0,0.98,0.0,-0.01,0,0,10,0,1008,0,0.99,0.0,0
PF15375,PF10276:PF10018:PF12319,8,18,5,3,13,997,0.28,0.98,0.62,0.41,0,0,8,0,1010,0,0.99,0.0,0
PF06468,PF02014:PF10223:PF03188,7,36,5,2,31,980,0.14,0.97,0.71,0.31,8,3,4,5,1006,0.38,0.99,0.43,0.4
PF09333,PF12624:PF16910:PF16908,16,29,9,7,20,982,0.31,0.97,0.56,0.41,18,3,13,15,987,0.17,0.97,0.19,0.16
PF00030,PF03762:PF15048:PF10044,18,4,0,18,4,996,0.0,0.98,0.0,-0.01,0,0,18,0,1000,0,0.98,0.0,0
PF04499,PF04109:PF09729:PF13506,20,23,7,13,16,982,0.3,0.97,0.35,0.31,3,2,18,1,997,0.67,0.98,0.1,0.25
PF00813,PF01313:PF08361:PF06798,0,1,0,0,1,1017,0.0,1.0,0,0,0,0,0,0,1018,0,1.0,0,0
PF02160,PF05869:PF10917:PF03539,1,5,1,0,4,1013,0.2,1.0,1.0,0.45,0,0,1,0,1017,0,1.0,0.0,0
PF16705,PF04382:PF05902:PF16511,1,20,1,0,19,998,0.05,0.98,1.0,0.22,5,1,0,4,1013,0.2,1.0,1.0,0.45
PF06956,PF02979:PF03888:PF17188,2,3,0,2,3,1013,0.0,1.0,0.0,-0.0,0,0,2,0,1016,0,1.0,0.0,0
PF08855,PF14251:PF11751:PF04610,0,5,0,0,5,1013,0.0,1.0,0,0,0,0,0,0,1018,0,1.0,0,0
PF16171,PF05604:PF15669:PF15553,0,1,0,0,1,1017,0.0,1.0,0,0,0,0,0,0,1018,0,1.0,0,0
PF01277,PF07172:PF00468:PF16009,1,7,0,1,7,1010,0.0,0.99,0.0,-0.0,0,0,1,0,1017,0,1.0,0.0,0
PF02799,PF01233:PF05076:PF12470,17,15,15,2,0,1001,1.0,1.0,0.88,0.94,3,3,14,0,1001,1.0,0.99,0.18,0.42
PF00451,PF09232:PF08576:PF17124,1,3,0,1,3,1014,0.0,1.0,0.0,-0.0,0,0,1,0,1017,0,1.0,0.0,0
PF01278,PF08411:PF01706:PF16449,1,2,0,1,2,1015,0.0,1.0,0.0,-0.0,0,0,1,0,1017,0,1.0,0.0,0
PF15613,PF02791:PF10537:PF15612,19,25,19,0,6,993,0.76,0.99,1.0,0.87,15,14,5,1,998,0.93,0.99,0.74,0.83
PF01775,PF02284:PF06172:PF05995,9,13,4,5,9,1000,0.31,0.99,0.44,0.36,3,2,7,1,1008,0.67,0.99,0.22,0.38
PF00097,PF13445:PF13639:PF14634,71,150,47,24,103,844,0.31,0.88,0.66,0.4,37,27,44,10,937,0.73,0.95,0.38,0.5
PF04160,PF13471:PF04225:PF14685,0,10,0,0,10,1008,0.0,0.99,0,0,1,0,0,1,1017,0.0,1.0,0,0
PF11291,PF10375:PF05685:PF00524,0,6,0,0,6,1012,0.0,0.99,0,0,0,0,0,0,1018,0,1.0,0,0
PF01052,PF15143:PF15726:PF06082,0,0,0,0,0,1018,0,1.0,0,0,0,0,0,0,1018,0,1.0,0,0
PF14065,PF11743:PF01540:PF09643,0,0,0,0,0,1018,0,1.0,0,0,0,0,0,0,1018,0,1.0,0,0
PF09139,PF14996:PF15938:PF15161,14,2,2,12,0,1004,1.0,0.99,0.14,0.38,1,1,13,0,1004,1.0,0.99,0.07,0.27
PF11339,PF14344:PF07503:PF12531,0,1,0,0,1,1017,0.0,1.0,0,0,0,0,0,0,1018,0,1.0,0,0
PF00584,PF08228:PF02427:PF15305,9,5,1,8,4,1005,0.2,0.99,0.11,0.14,0,0,9,0,1009,0,0.99,0.0,0
PF07167,PF13722:PF03090:PF11751,2,0,0,2,0,1016,0,1.0,0.0,0,0,0,2,0,1016,0,1.0,0.0,0
PF04371,PF06609:PF05648:PF13577,1,24,0,1,24,993,0.0,0.98,0.0,-0.0,9,0,1,9,1008,0.0,0.99,0.0,-0.0
PF01590,PF00233:PF00360:PF00989,35,57,28,7,29,954,0.49,0.96,0.8,0.61,12,10,25,2,981,0.83,0.97,0.29,0.48
PF03981,PF13225:PF01786:PF05678,7,21,2,5,19,992,0.1,0.98,0.29,0.16,3,2,5,1,1010,0.67,0.99,0.29,0.43
PF15061,PF09690:PF09232:PF04860,2,1,0,2,1,1015,0.0,1.0,0.0,-0.0,0,0,2,0,1016,0,1.0,0.0,0
PF16046,PF10311:PF10376:PF08140,1,7,0,1,7,1010,0.0,0.99,0.0,-0.0,0,0,1,0,1017,0,1.0,0.0,0
PF04551,PF02901:PF15252:PF05690,5,11,2,3,9,1004,0.18,0.99,0.4,0.26,2,2,3,0,1013,1.0,1.0,0.4,0.63
PF05867,PF15120:PF07259:PF15849,5,2,1,4,1,1012,0.5,1.0,0.2,0.31,0,0,5,0,1013,0,1.0,0.0,0
PF05979,PF07301:PF05474:PF06286,0,0,0,0,0,1018,0,1.0,0,0,0,0,0,0,1018,0,1.0,0,0
PF06962,PF11842:PF10105:PF11230,2,2,2,0,0,1016,1.0,1.0,1.0,1.0,2,2,0,0,1016,1.0,1.0,1.0,1.0
PF03952,PF00113:PF00016:PF02788,13,20,11,2,9,996,0.55,0.99,0.85,0.68,2,0,13,2,1003,0.0,0.99,0.0,-0.01
PF13865,PF08081:PF12414:PF12220,11,7,3,8,4,1003,0.43,0.99,0.27,0.34,2,2,9,0,1007,1.0,0.99,0.18,0.42
PF15078,PF04485:PF15079:PF04360,0,0,0,0,0,1018,0,1.0,0,0,0,0,0,0,1018,0,1.0,0,0
PF07137,PF13097:PF00835:PF15313,3,13,0,3,13,1002,0.0,0.98,0.0,-0.01,0,0,3,0,1015,0,1.0,0.0,0
PF07933,PF10520:PF05529:PF09288,11,15,4,7,11,996,0.27,0.98,0.36,0.3,0,0,11,0,1007,0,0.99,0.0,0
PF09307,PF08831:PF02961:PF10511,3,6,3,0,3,1012,0.5,1.0,1.0,0.71,1,0,3,1,1014,0.0,1.0,0.0,-0.0
PF12609,PF15060:PF01701:PF03842,1,1,0,1,1,1016,0.0,1.0,0.0,-0.0,0,0,1,0,1017,0,1.0,0.0,0
PF07065,PF02089:PF01680:PF07350,9,18,3,6,15,994,0.17,0.98,0.33,0.23,2,1,8,1,1008,0.5,0.99,0.11,0.23
PF14124,PF04848:PF15776:PF15141,0,5,0,0,5,1013,0.0,1.0,0,0,0,0,0,0,1018,0,1.0,0,0
PF03470,PF03468:PF10212:PF15905,3,10,3,0,7,1008,0.3,0.99,1.0,0.55,1,0,3,1,1014,0.0,1.0,0.0,-0.0
PF01613,PF09791:PF02898:PF06999,15,36,5,10,31,972,0.14,0.96,0.33,0.2,5,2,13,3,1000,0.4,0.98,0.13,0.22
PF07705,PF00419:PF11304:PF04453,0,1,0,0,1,1017,0.0,1.0,0,0,0,0,0,0,1018,0,1.0,0,0
PF01912,PF01775:PF06172:PF04176,11,13,3,8,10,997,0.23,0.98,0.27,0.24,5,3,8,2,1005,0.6,0.99,0.27,0.4
PF12043,PF03085:PF11770:PF10127,2,1,0,2,1,1015,0.0,1.0,0.0,-0.0,0,0,2,0,1016,0,1.0,0.0,0
PF14121,PF02820:PF07657:PF08434,0,27,0,0,27,991,0.0,0.97,0,0,6,0,0,6,1012,0.0,0.99,0,0
PF00532,PF00356:PF00308:PF08479,5,17,5,0,12,1001,0.29,0.99,1.0,0.54,1,0,5,1,1012,0.0,0.99,0.0,-0.0
PF05987,PF08766:PF03711:PF10484,1,45,1,0,44,973,0.02,0.96,1.0,0.15,6,0,1,6,1011,0.0,0.99,0.0,-0.0
PF10545,PF02944:PF07776:PF05485,43,92,28,15,64,911,0.3,0.92,0.65,0.41,26,13,30,13,962,0.5,0.96,0.3,0.37
PF05049,PF14946:PF15020:PF04598,8,10,1,7,9,1001,0.1,0.98,0.12,0.1,1,0,8,1,1009,0.0,0.99,0.0,-0.0
PF13473,PF13340:PF08894:PF09684,3,4,1,2,3,1012,0.25,1.0,0.33,0.29,1,1,2,0,1015,1.0,1.0,0.33,0.58
PF08409,PF09295:PF16669:PF07786,9,13,4,5,9,1000,0.31,0.99,0.44,0.36,2,2,7,0,1009,1.0,0.99,0.22,0.47
PF08569,PF15390:PF09748:PF05254,7,20,5,2,15,996,0.25,0.98,0.71,0.42,2,1,6,1,1010,0.5,0.99,0.14,0.26
PF08584,PF02284:PF00143:PF00793,4,19,1,3,18,996,0.05,0.98,0.25,0.11,0,0,4,0,1014,0,1.0,0.0,0
PF15372,PF11568:PF12533:PF01586,1,6,1,0,5,1012,0.17,1.0,1.0,0.41,1,1,0,0,1017,1.0,1.0,1.0,1.0
PF09249,PF17007:PF11751:PF13742,2,2,0,2,2,1014,0.0,1.0,0.0,-0.0,0,0,2,0,1016,0,1.0,0.0,0
PF03105,PF00939:PF03124:PF03009,31,51,23,8,28,959,0.45,0.96,0.74,0.56,6,6,25,0,987,1.0,0.98,0.19,0.43
PF02685,PF05996:PF15011:PF04725,6,8,1,5,7,1005,0.12,0.99,0.17,0.14,1,1,5,0,1012,1.0,1.0,0.17,0.41
PF10473,PF12795:PF08505:PF10979,4,5,0,4,5,1009,0.0,0.99,0.0,-0.0,0,0,4,0,1014,0,1.0,0.0,0
PF15082,PF09322:PF08183:PF15392,3,0,0,3,0,1015,0,1.0,0.0,0,0,0,3,0,1015,0,1.0,0.0,0
PF00474,PF01545:PF00884:PF05971,39,74,16,23,58,921,0.22,0.92,0.41,0.26,19,10,29,9,970,0.53,0.96,0.26,0.35
PF10186,PF09816:PF04087:PF02701,8,15,2,6,13,997,0.13,0.98,0.25,0.17,1,1,7,0,1010,1.0,0.99,0.12,0.35
PF07837,PF04961:PF02971:PF14687,7,11,4,3,7,1004,0.36,0.99,0.57,0.45,4,4,3,0,1011,1.0,1.0,0.57,0.75
PF14389,PF04784:PF12257:PF00610,6,49,6,0,43,969,0.12,0.96,1.0,0.34,13,2,4,11,1001,0.15,0.99,0.33,0.22
PF02078,PF10581:PF02750:PF14161,4,2,0,4,2,1012,0.0,0.99,0.0,-0.0,0,0,4,0,1014,0,1.0,0.0,0
PF06607,PF16516:PF04440:PF14988,2,6,0,2,6,1010,0.0,0.99,0.0,-0.0,2,0,2,2,1014,0.0,1.0,0.0,-0.0
PF04239,PF02413:PF15089:PF08453,3,2,1,2,1,1014,0.5,1.0,0.33,0.41,0,0,3,0,1015,0,1.0,0.0,0
PF14402,PF09685:PF02088:PF07472,0,0,0,0,0,1018,0,1.0,0,0,0,0,0,0,1018,0,1.0,0,0
PF01752,PF08453:PF17188:PF01514,2,2,2,0,0,1016,1.0,1.0,1.0,1.0,0,0,2,0,1016,0,1.0,0.0,0
PF11255,PF02576:PF11460:PF06989,0,0,0,0,0,1018,0,1.0,0,0,0,0,0,0,1018,0,1.0,0,0
PF06558,PF14026:PF12084:PF07415,1,0,0,1,0,1017,0,1.0,0.0,0,0,0,1,0,1017,0,1.0,0.0,0
PF01782,PF04871:PF03470:PF05239,3,20,3,0,17,998,0.15,0.98,1.0,0.38,0,0,3,0,1015,0,1.0,0.0,0
PF08828,PF15791:PF12374:PF03474,1,3,1,0,2,1015,0.33,1.0,1.0,0.58,1,1,0,0,1017,1.0,1.0,1.0,1.0
PF15210,PF15683:PF15208:PF01478,0,2,0,0,2,1016,0.0,1.0,0,0,0,0,0,0,1018,0,1.0,0,0
PF04626,PF14539:PF05962:PF08291,1,1,0,1,1,1016,0.0,1.0,0.0,-0.0,0,0,1,0,1017,0,1.0,0.0,0
PF13916,PF12509:PF08729:PF14444,4,10,1,3,9,1005,0.1,0.99,0.25,0.15,1,0,4,1,1013,0.0,1.0,0.0,-0.0
PF10109,PF04355:PF07157:PF15976,0,0,0,0,0,1018,0,1.0,0,0,0,0,0,0,1018,0,1.0,0,0
PF02469,PF08648:PF16845:PF12947,30,33,12,18,21,967,0.36,0.96,0.4,0.36,4,3,27,1,987,0.75,0.97,0.1,0.27
PF15031,PF15171:PF15109:PF03488,6,2,0,6,2,1010,0.0,0.99,0.0,-0.0,0,0,6,0,1012,0,0.99,0.0,0
PF02833,PF01368:PF03074:PF12735,13,26,11,2,15,990,0.42,0.98,0.85,0.59,1,1,12,0,1005,1.0,0.99,0.08,0.28
PF15447,PF03011:PF15445:PF12377,1,1,1,0,0,1017,1.0,1.0,1.0,1.0,1,1,0,0,1017,1.0,1.0,1.0,1.0
PF01183,PF09631:PF03980:PF07281,11,17,3,8,14,993,0.18,0.98,0.27,0.21,1,0,11,1,1006,0.0,0.99,0.0,-0.0
PF04339,PF15216:PF15041:PF11317,2,2,0,2,2,1014,0.0,1.0,0.0,-0.0,0,0,2,0,1016,0,1.0,0.0,0
PF11818,PF14684:PF16667:PF15153,2,2,2,0,0,1016,1.0,1.0,1.0,1.0,1,1,1,0,1016,1.0,1.0,0.5,0.71
PF05739,PF02269:PF00804:PF11416,35,34,23,12,11,972,0.68,0.98,0.66,0.66,7,7,28,0,983,1.0,0.97,0.2,0.44
PF00113,PF03952:PF00016:PF00883,15,40,12,3,28,975,0.3,0.97,0.8,0.48,4,1,14,3,1000,0.25,0.98,0.07,0.12
PF16494,PF03733:PF01699:PF03160,1,48,1,0,47,970,0.02,0.95,1.0,0.14,10,1,0,9,1008,0.1,0.99,1.0,0.31
PF01030,PF00757:PF14843:PF12772,10,9,6,4,3,1005,0.67,0.99,0.6,0.63,6,5,5,1,1007,0.83,0.99,0.5,0.64
PF12205,PF08518:PF16559:PF14806,3,16,3,0,13,1002,0.19,0.99,1.0,0.43,5,3,0,2,1013,0.6,1.0,1.0,0.77
PF03122,PF05643:PF04094:PF02606,1,6,0,1,6,1011,0.0,0.99,0.0,-0.0,0,0,1,0,1017,0,1.0,0.0,0
PF14429,PF16172:PF11878:PF06920,13,16,8,5,8,997,0.5,0.99,0.62,0.55,6,6,7,0,1005,1.0,0.99,0.46,0.68
PF05701,PF09730:PF15458:PF09744,7,16,2,5,14,997,0.12,0.98,0.29,0.18,2,1,6,1,1010,0.5,0.99,0.14,0.26
PF10423,PF05299:PF04471:PF04320,1,4,1,0,3,1014,0.25,1.0,1.0,0.5,0,0,1,0,1017,0,1.0,0.0,0
PF16889,PF10566:PF17164:PF03831,1,0,0,1,0,1017,0,1.0,0.0,0,0,0,1,0,1017,0,1.0,0.0,0
PF03199,PF03917:PF15685:PF01609,2,10,2,0,8,1008,0.2,0.99,1.0,0.45,1,0,2,1,1015,0.0,1.0,0.0,-0.0
PF06864,PF12421:PF16325:PF07523,1,1,0,1,1,1016,0.0,1.0,0.0,-0.0,0,0,1,0,1017,0,1.0,0.0,0
PF10242,PF06951:PF00210:PF14955,4,24,3,1,21,993,0.12,0.98,0.75,0.3,5,2,2,3,1011,0.4,1.0,0.5,0.44
PF05476,PF15186:PF01303:PF17206,1,2,0,1,2,1015,0.0,1.0,0.0,-0.0,0,0,1,0,1017,0,1.0,0.0,0
PF15243,PF05039:PF10839:PF15359,0,2,0,0,2,1016,0.0,1.0,0,0,0,0,0,0,1018,0,1.0,0,0
PF10559,PF00344:PF00101:PF14853,8,23,8,0,15,995,0.35,0.99,1.0,0.59,4,3,5,1,1009,0.75,0.99,0.38,0.53
PF06372,PF12095:PF06549:PF01194,2,6,1,1,5,1011,0.17,0.99,0.5,0.29,0,0,2,0,1016,0,1.0,0.0,0
PF05962,PF14539:PF08291:PF08093,1,1,0,1,1,1016,0.0,1.0,0.0,-0.0,0,0,1,0,1017,0,1.0,0.0,0
PF09425,PF06200:PF03479:PF05140,7,16,6,1,10,1001,0.38,0.99,0.86,0.56,4,1,6,3,1008,0.25,0.99,0.14,0.18
PF00644,PF12174:PF05406:PF02877,44,28,21,23,7,967,0.75,0.97,0.48,0.58,19,17,27,2,972,0.89,0.97,0.39,0.58
PF13675,PF12729:PF10279:PF11138,1,1,1,0,0,1017,1.0,1.0,1.0,1.0,0,0,1,0,1017,0,1.0,0.0,0
PF16916,PF10241:PF13566:PF01545,10,42,10,0,32,976,0.24,0.97,1.0,0.48,4,2,8,2,1006,0.5,0.99,0.2,0.31
PF06585,PF16984:PF06757:PF08925,11,10,5,6,5,1002,0.5,0.99,0.45,0.47,1,0,11,1,1006,0.0,0.99,0.0,-0.0
PF00181,PF07985:PF03947:PF01359,17,58,13,4,45,956,0.22,0.95,0.76,0.4,13,7,10,6,995,0.54,0.98,0.41,0.46
PF00052,PF15002:PF06009:PF00054,13,25,7,6,18,987,0.28,0.98,0.54,0.38,4,2,11,2,1003,0.5,0.99,0.15,0.27
PF16317,PF15383:PF07248:PF15998,5,15,2,3,13,1000,0.13,0.98,0.4,0.22,2,1,4,1,1012,0.5,1.0,0.2,0.31
PF05387,PF15576:PF15120:PF03823,0,4,0,0,4,1014,0.0,1.0,0,0,1,0,0,1,1017,0.0,1.0,0,0
PF05811,PF10195:PF14989:PF06080,4,11,2,2,9,1005,0.18,0.99,0.5,0.3,2,0,4,2,1012,0.0,0.99,0.0,-0.0
PF01609,PF04865:PF02211:PF00419,3,4,0,3,4,1011,0.0,0.99,0.0,-0.0,0,0,3,0,1015,0,1.0,0.0,0
PF03823,PF15829:PF15576:PF15120,3,2,1,2,1,1014,0.5,1.0,0.33,0.41,1,1,2,0,1015,1.0,1.0,0.33,0.58
PF04956,PF06744:PF04391:PF04466,3,0,0,3,0,1015,0,1.0,0.0,0,0,0,3,0,1015,0,1.0,0.0,0
PF15145,PF05115:PF06651:PF07068,0,2,0,0,2,1016,0.0,1.0,0,0,0,0,0,0,1018,0,1.0,0,0
PF16095,PF08477:PF12799:PF06479,19,63,18,1,45,954,0.29,0.95,0.95,0.51,16,9,10,7,992,0.56,0.98,0.47,0.51
PF05181,PF07111:PF07137:PF09775,8,5,1,7,4,1006,0.2,0.99,0.12,0.15,1,0,8,1,1009,0.0,0.99,0.0,-0.0
PF00382,PF08271:PF07741:PF02002,20,24,17,3,7,991,0.71,0.99,0.85,0.77,6,5,15,1,997,0.83,0.98,0.25,0.45
PF03604,PF06373:PF15359:PF01099,10,3,1,9,2,1006,0.33,0.99,0.1,0.18,0,0,10,0,1008,0,0.99,0.0,0
PF02690,PF04261:PF07837:PF01858,8,20,4,4,16,994,0.2,0.98,0.5,0.31,2,1,7,1,1009,0.5,0.99,0.12,0.25
PF12047,PF02008:PF00145:PF01426,12,56,12,0,44,962,0.21,0.96,1.0,0.45,22,12,0,10,996,0.55,0.99,1.0,0.73
PF02026,PF01365:PF08454:PF08709,8,17,7,1,10,1000,0.41,0.99,0.88,0.6,10,5,3,5,1005,0.5,0.99,0.62,0.56
PF12012,PF15273:PF11261:PF12509,10,11,2,8,9,999,0.18,0.98,0.2,0.18,0,0,10,0,1008,0,0.99,0.0,0
PF06695,PF15062:PF10063:PF11016,0,3,0,0,3,1015,0.0,1.0,0,0,0,0,0,0,1018,0,1.0,0,0
PF14632,PF14641:PF14639:PF14635,13,13,12,1,1,1004,0.92,1.0,0.92,0.92,13,12,1,1,1004,0.92,1.0,0.92,0.92
PF15217,PF15212:PF06724:PF05947,0,0,0,0,0,1018,0,1.0,0,0,0,0,0,0,1018,0,1.0,0,0
PF08326,PF00289:PF02785:PF02436,12,34,12,0,22,984,0.35,0.98,1.0,0.59,33,12,0,21,985,0.36,0.98,1.0,0.6
PF10761,PF00619:PF06479:PF05225,0,52,0,0,52,966,0.0,0.95,0,0,11,0,0,11,1007,0.0,0.99,0,0
PF06021,PF08444:PF08445:PF02482,4,13,4,0,9,1005,0.31,0.99,1.0,0.55,1,1,3,0,1014,1.0,1.0,0.25,0.5
PF16177,PF13193:PF07774:PF00668,14,94,13,1,81,923,0.14,0.92,0.93,0.34,34,8,6,26,978,0.24,0.97,0.57,0.35
PF08262,PF10735:PF10626:PF03826,0,8,0,0,8,1010,0.0,0.99,0,0,0,0,0,0,1018,0,1.0,0,0
PF01282,PF00159:PF01198:PF00499,6,27,3,3,24,988,0.11,0.97,0.5,0.23,1,1,5,0,1012,1.0,1.0,0.17,0.41
PF00133,PF08264:PF06827:PF09334,52,61,38,14,23,943,0.62,0.96,0.73,0.66,18,17,35,1,965,0.94,0.96,0.33,0.54
PF04802,PF04182:PF10264:PF10744,7,12,3,4,9,1002,0.25,0.99,0.43,0.32,2,1,6,1,1010,0.5,0.99,0.14,0.26
PF06371,PF06367:PF06346:PF06345,23,25,23,0,2,993,0.92,1.0,1.0,0.96,4,4,19,0,995,1.0,0.98,0.17,0.41
PF05695,PF09262:PF02359:PF10350,9,28,3,6,25,984,0.11,0.97,0.33,0.18,4,1,8,3,1006,0.25,0.99,0.11,0.16
PF06181,PF12628:PF15337:PF15553,0,3,0,0,3,1015,0.0,1.0,0,0,0,0,0,0,1018,0,1.0,0,0
PF08450,PF07350:PF14027:PF00756,22,31,12,10,19,977,0.39,0.97,0.55,0.45,3,1,21,2,994,0.33,0.98,0.05,0.12
PF09737,PF11635:PF01731:PF13506,5,19,2,3,17,996,0.11,0.98,0.4,0.2,0,0,5,0,1013,0,1.0,0.0,0
PF10340,PF03576:PF10868:PF01947,0,0,0,0,0,1018,0,1.0,0,0,0,0,0,0,1018,0,1.0,0,0
PF05641,PF03735:PF05266:PF16097,13,7,4,9,3,1002,0.57,0.99,0.31,0.41,1,1,12,0,1005,1.0,0.99,0.08,0.28
PF08699,PF16486:PF02170:PF05831,42,45,39,3,6,970,0.87,0.99,0.93,0.89,32,31,11,1,975,0.97,0.99,0.74,0.84
PF07005,PF17042:PF01116:PF14833,6,36,6,0,30,982,0.17,0.97,1.0,0.4,9,6,0,3,1009,0.67,1.0,1.0,0.82
PF03324,PF13750:PF03090:PF03241,0,0,0,0,0,1018,0,1.0,0,0,0,0,0,0,1018,0,1.0,0,0
PF03746,PF05860:PF08411:PF16473,1,2,0,1,2,1015,0.0,1.0,0.0,-0.0,0,0,1,0,1017,0,1.0,0.0,0
PF05875,PF10455:PF13088:PF06966,19,23,10,9,13,986,0.43,0.98,0.53,0.47,2,2,17,0,999,1.0,0.98,0.11,0.32
PF13905,PF03107:PF01436:PF13419,17,82,12,5,70,931,0.15,0.93,0.71,0.3,18,10,7,8,993,0.56,0.99,0.59,0.56
PF03018,PF03168:PF01419:PF04398,12,27,4,8,23,983,0.15,0.97,0.33,0.21,7,4,8,3,1003,0.57,0.99,0.33,0.43
PF03937,PF01987:PF03942:PF10276,3,21,1,2,20,995,0.05,0.98,0.33,0.12,3,0,3,3,1012,0.0,0.99,0.0,-0.0
PF15491,PF15082:PF15235:PF07610,0,4,0,0,4,1014,0.0,1.0,0,0,1,0,0,1,1017,0.0,1.0,0,0
PF01797,PF08571:PF00681:PF04356,2,13,0,2,13,1003,0.0,0.99,0.0,-0.01,2,0,2,2,1014,0.0,1.0,0.0,-0.0
PF08349,PF04671:PF09826:PF12040,2,3,0,2,3,1013,0.0,1.0,0.0,-0.0,0,0,2,0,1016,0,1.0,0.0,0
PF12631,PF10396:PF03648:PF07477,6,16,6,0,10,1002,0.38,0.99,1.0,0.61,3,0,6,3,1009,0.0,0.99,0.0,-0.0
PF11549,PF17108:PF10647:PF17005,1,3,1,0,2,1015,0.33,1.0,1.0,0.58,1,1,0,0,1017,1.0,1.0,1.0,1.0
PF00452,PF01146:PF01127:PF04089,10,22,3,7,19,989,0.14,0.97,0.3,0.19,2,2,8,0,1008,1.0,0.99,0.2,0.45
PF06596,PF14998:PF09348:PF00489,1,4,1,0,3,1014,0.25,1.0,1.0,0.5,0,0,1,0,1017,0,1.0,0.0,0
PF00029,PF03508:PF03509:PF16791,8,0,0,8,0,1010,0,0.99,0.0,0,0,0,8,0,1010,0,0.99,0.0,0
PF02991,PF10229:PF02661:PF02628,16,28,8,8,20,982,0.29,0.97,0.5,0.37,3,2,14,1,1001,0.67,0.99,0.12,0.28
PF11798,PF00817:PF13438:PF11799,6,27,6,0,21,991,0.22,0.98,1.0,0.47,25,6,0,19,993,0.24,0.98,1.0,0.49
PF04870,PF10179:PF04109:PF16061,14,15,3,11,12,992,0.2,0.98,0.21,0.2,1,0,14,1,1003,0.0,0.99,0.0,-0.0
PF02793,PF01825:PF16489:PF00002,20,64,20,0,44,954,0.31,0.96,1.0,0.55,29,8,12,21,977,0.28,0.97,0.4,0.32
PF04385,PF03302:PF12881:PF02420,3,5,0,3,5,1010,0.0,0.99,0.0,-0.0,0,0,3,0,1015,0,1.0,0.0,0
PF01655,PF02928:PF02375:PF08429,18,21,3,15,18,982,0.14,0.97,0.17,0.14,11,3,15,8,992,0.27,0.98,0.17,0.2
PF04702,PF15675:PF00190:PF06718,1,17,1,0,16,1001,0.06,0.98,1.0,0.24,1,1,0,0,1017,1.0,1.0,1.0,1.0
PF13757,PF15057:PF06668:PF08487,0,17,0,0,17,1001,0.0,0.98,0,0,5,0,0,5,1013,0.0,1.0,0,0
PF15473,PF00162:PF02390:PF02203,8,33,6,2,27,983,0.18,0.97,0.75,0.36,8,3,5,5,1005,0.38,0.99,0.38,0.37
PF07547,PF15774:PF16756:PF15696,4,0,0,4,0,1014,0,1.0,0.0,0,0,0,4,0,1014,0,1.0,0.0,0
PF01404,PF14575:PF07699:PF14521,6,26,5,1,21,991,0.19,0.98,0.83,0.39,6,4,2,2,1010,0.67,1.0,0.67,0.66
PF16810,PF10504:PF01387:PF01698,8,2,0,8,2,1008,0.0,0.99,0.0,-0.0,0,0,8,0,1010,0,0.99,0.0,0
PF06470,PF12455:PF03801:PF15905,17,14,2,15,12,989,0.14,0.97,0.12,0.12,3,2,15,1,1000,0.67,0.98,0.12,0.28
PF06022,PF07418:PF09592:PF05042,0,4,0,0,4,1014,0.0,1.0,0,0,0,0,0,0,1018,0,1.0,0,0
PF08274,PF08345:PF03428:PF04963,0,2,0,0,2,1016,0.0,1.0,0,0,0,0,0,0,1018,0,1.0,0,0
PF01369,PF12783:PF16213:PF09324,42,30,19,23,11,965,0.63,0.97,0.45,0.52,17,12,30,5,971,0.71,0.97,0.29,0.44
PF15479,PF06429:PF14421:PF02305,2,2,0,2,2,1014,0.0,1.0,0.0,-0.0,1,0,2,1,1015,0.0,1.0,0.0,-0.0
PF05235,PF10412:PF04264:PF15128,0,0,0,0,0,1018,0,1.0,0,0,0,0,0,0,1018,0,1.0,0,0
PF04567,PF04565:PF04561:PF06883,12,20,12,0,8,998,0.6,0.99,1.0,0.77,6,3,9,3,1003,0.5,0.99,0.25,0.35
PF15322,PF08453:PF10279:PF05939,0,2,0,0,2,1016,0.0,1.0,0,0,0,0,0,0,1018,0,1.0,0,0
PF04548,PF11886:PF00735:PF04103,22,37,11,11,26,970,0.3,0.96,0.5,0.37,5,4,18,1,995,0.8,0.98,0.18,0.38
PF06012,PF06025:PF10427:PF12938,6,13,6,0,7,1005,0.46,0.99,1.0,0.68,2,2,4,0,1012,1.0,1.0,0.33,0.58
PF14307,PF08762:PF16126:PF04196,0,5,0,0,5,1013,0.0,1.0,0,0,1,0,0,1,1017,0.0,1.0,0,0
PF11801,PF17171:PF10806:PF05491,0,14,0,0,14,1004,0.0,0.99,0,0,3,0,0,3,1015,0.0,1.0,0,0
PF02805,PF00165:PF08639:PF14161,6,10,6,0,4,1008,0.6,1.0,1.0,0.77,2,2,4,0,1012,1.0,1.0,0.33,0.58
PF14876,PF17219:PF02201:PF12620,0,28,0,0,28,990,0.0,0.97,0,0,3,0,0,3,1015,0.0,1.0,0,0
PF03767,PF06404:PF07712:PF00074,7,3,0,7,3,1008,0.0,0.99,0.0,-0.0,0,0,7,0,1011,0,0.99,0.0,0
PF07297,PF03912:PF06882:PF14985,5,4,0,5,4,1009,0.0,0.99,0.0,-0.0,0,0,5,0,1013,0,1.0,0.0,0
PF16517,PF09235:PF00788:PF15000,7,49,6,1,43,968,0.12,0.96,0.86,0.31,2,1,6,1,1010,0.5,0.99,0.14,0.26
PF15120,PF15829:PF15576:PF07259,1,3,1,0,2,1015,0.33,1.0,1.0,0.58,0,0,1,0,1017,0,1.0,0.0,0
PF00027,PF08412:PF13545:PF13426,83,36,18,65,18,917,0.5,0.92,0.22,0.29,6,6,77,0,935,1.0,0.92,0.07,0.26
PF09292,PF01149:PF06831:PF04422,4,16,4,0,12,1002,0.25,0.99,1.0,0.5,9,4,0,5,1009,0.44,1.0,1.0,0.67
PF05262,PF07988:PF06640:PF08558,1,6,0,1,6,1011,0.0,0.99,0.0,-0.0,0,0,1,0,1017,0,1.0,0.0,0
PF05090,PF08014:PF11727:PF16043,7,2,1,6,1,1010,0.5,0.99,0.14,0.26,0,0,7,0,1011,0,0.99,0.0,0
PF09343,PF15175:PF15849:PF17062,2,0,0,2,0,1016,0,1.0,0.0,0,0,0,2,0,1016,0,1.0,0.0,0
PF08369,PF00148:PF09363:PF09364,1,3,1,0,2,1015,0.33,1.0,1.0,0.58,2,0,1,2,1015,0.0,1.0,0.0,-0.0
PF12014,PF10442:PF04300:PF03048,2,10,2,0,8,1008,0.2,0.99,1.0,0.45,1,1,1,0,1016,1.0,1.0,0.5,0.71
PF10416,PF11581:PF15749:PF07444,0,4,0,0,4,1014,0.0,1.0,0,0,0,0,0,0,1018,0,1.0,0,0
PF14306,PF01747:PF00273:PF09164,9,9,9,0,0,1009,1.0,1.0,1.0,1.0,0,0,9,0,1009,0,0.99,0.0,0
PF03036,PF15388:PF14822:PF03299,8,13,3,5,10,1000,0.23,0.99,0.38,0.29,1,1,7,0,1010,1.0,0.99,0.12,0.35
PF01139,PF05434:PF16954:PF05497,11,13,2,9,11,996,0.15,0.98,0.18,0.16,0,0,11,0,1007,0,0.99,0.0,0
PF10224,PF10780:PF10244:PF06108,4,13,2,2,11,1003,0.15,0.99,0.5,0.27,1,0,4,1,1013,0.0,1.0,0.0,-0.0
PF04942,PF01549:PF05507:PF01683,2,56,1,1,55,961,0.02,0.94,0.5,0.09,13,1,1,12,1004,0.08,0.99,0.5,0.19
PF05038,PF11304:PF01807:PF08275,3,6,1,2,5,1010,0.17,0.99,0.33,0.23,4,0,3,4,1011,0.0,0.99,0.0,-0.0
PF06206,PF07172:PF06373:PF02681,1,6,0,1,6,1011,0.0,0.99,0.0,-0.0,0,0,1,0,1017,0,1.0,0.0,0
PF07915,PF05672:PF01873:PF02213,19,27,6,13,21,978,0.22,0.97,0.32,0.25,7,5,14,2,997,0.71,0.98,0.26,0.43
PF14588,PF15775:PF10109:PF07157,2,0,0,2,0,1016,0,1.0,0.0,0,0,0,2,0,1016,0,1.0,0.0,0
PF00688,PF04709:PF00019:PF09771,15,20,15,0,5,998,0.75,1.0,1.0,0.86,5,4,11,1,1002,0.8,0.99,0.27,0.46
PF12368,PF06617:PF11127:PF03959,6,30,2,4,28,984,0.07,0.97,0.33,0.14,2,0,6,2,1010,0.0,0.99,0.0,-0.0
PF01296,PF06540:PF05196:PF04644,1,2,1,0,1,1016,0.5,1.0,1.0,0.71,1,1,0,0,1017,1.0,1.0,1.0,1.0
PF10337,PF10334:PF06165:PF17167,7,10,7,0,3,1008,0.7,1.0,1.0,0.84,3,1,6,2,1009,0.33,0.99,0.14,0.21
PF02744,PF01087:PF14768:PF01450,9,19,9,0,10,999,0.47,0.99,1.0,0.68,0,0,9,0,1009,0,0.99,0.0,0
PF01486,PF12347:PF01625:PF01192,10,25,4,6,21,987,0.16,0.97,0.4,0.24,5,2,8,3,1005,0.4,0.99,0.2,0.28
PF02629,PF08442:PF00285:PF00549,16,44,16,0,28,974,0.36,0.97,1.0,0.59,20,9,7,11,991,0.45,0.98,0.56,0.49
PF07504,PF02128:PF03413:PF05285,3,18,3,0,15,1000,0.17,0.99,1.0,0.41,3,3,0,0,1015,1.0,1.0,1.0,1.0
PF15080,PF14512:PF03238:PF15547,1,0,0,1,0,1017,0,1.0,0.0,0,0,0,1,0,1017,0,1.0,0.0,0
PF15668,PF15843:PF13550:PF09690,2,0,0,2,0,1016,0,1.0,0.0,0,0,0,2,0,1016,0,1.0,0.0,0
PF01379,PF03900:PF00148:PF03894,15,18,15,0,3,1000,0.83,1.0,1.0,0.91,1,1,14,0,1003,1.0,0.99,0.07,0.26
PF12940,PF10426:PF00303:PF00186,4,16,4,0,12,1002,0.25,0.99,1.0,0.5,3,1,3,2,1012,0.33,1.0,0.25,0.29
PF13162,PF14015:PF02508:PF10380,0,3,0,0,3,1015,0.0,1.0,0,0,0,0,0,0,1018,0,1.0,0,0
PF11309,PF01226:PF15245:PF07797,0,12,0,0,12,1006,0.0,0.99,0,0,0,0,0,0,1018,0,1.0,0,0
PF01256,PF01652:PF03091:PF12239,15,40,6,9,34,969,0.15,0.96,0.4,0.23,7,4,11,3,1000,0.57,0.99,0.27,0.38
PF00200,PF08516:PF16698:PF01562,29,37,26,3,11,978,0.7,0.99,0.9,0.79,21,20,9,1,988,0.95,0.99,0.69,0.81
PF15782,PF00680:PF14961:PF02106,3,12,1,2,11,1004,0.08,0.99,0.33,0.16,0,0,3,0,1015,0,1.0,0.0,0
PF15588,PF05448:PF15334:PF15817,0,3,0,0,3,1015,0.0,1.0,0,0,0,0,0,0,1018,0,1.0,0,0
PF06450,PF03831:PF11794:PF02554,1,0,0,1,0,1017,0,1.0,0.0,0,0,0,1,0,1017,0,1.0,0.0,0
PF00260,PF08515:PF12447:PF07105,1,11,0,1,11,1006,0.0,0.99,0.0,-0.0,0,0,1,0,1017,0,1.0,0.0,0
PF02127,PF14388:PF06079:PF01963,9,28,3,6,25,984,0.11,0.97,0.33,0.18,4,2,7,2,1007,0.5,0.99,0.22,0.33
PF11061,PF10690:PF07617:PF03426,0,0,0,0,0,1018,0,1.0,0,0,0,0,0,0,1018,0,1.0,0,0
PF03690,PF00048:PF05719:PF09749,12,22,5,7,17,989,0.23,0.98,0.42,0.3,6,3,9,3,1003,0.5,0.99,0.25,0.35
PF05784,PF12896:PF12444:PF00734,0,47,0,0,47,971,0.0,0.95,0,0,6,0,0,6,1012,0.0,0.99,0,0
PF03354,PF06346:PF06311:PF06345,0,6,0,0,6,1012,0.0,0.99,0,0,3,0,0,3,1015,0.0,1.0,0,0
PF00483,PF00132:PF06426:PF14602,30,62,20,10,42,946,0.32,0.95,0.67,0.44,27,6,24,21,967,0.22,0.96,0.2,0.19
PF00501,PF00550:PF16177:PF13360,124,85,65,59,20,874,0.76,0.92,0.52,0.59,18,18,106,0,894,1.0,0.9,0.15,0.36
PF03901,PF10245:PF05219:PF07542,30,23,7,23,16,972,0.3,0.96,0.23,0.25,1,1,29,0,988,1.0,0.97,0.03,0.18
PF02750,PF10581:PF02078:PF14160,0,6,0,0,6,1012,0.0,0.99,0,0,0,0,0,0,1018,0,1.0,0,0
PF06098,PF07802:PF08227:PF07406,3,11,1,2,10,1005,0.09,0.99,0.33,0.17,1,0,3,1,1014,0.0,1.0,0.0,-0.0
PF02698,PF10224:PF06108:PF06351,6,11,1,5,10,1002,0.09,0.99,0.17,0.12,1,1,5,0,1012,1.0,1.0,0.17,0.41
PF16845,PF00031:PF00061:PF15243,4,26,3,1,23,991,0.12,0.98,0.75,0.29,3,2,2,1,1013,0.67,1.0,0.5,0.58
PF05974,PF03090:PF05939:PF06798,0,0,0,0,0,1018,0,1.0,0,0,0,0,0,0,1018,0,1.0,0,0
PF03738,PF11965:PF00799:PF08343,0,5,0,0,5,1013,0.0,1.0,0,0,1,0,0,1,1017,0.0,1.0,0,0
PF06183,PF07385:PF05325:PF13471,0,4,0,0,4,1014,0.0,1.0,0,0,0,0,0,0,1018,0,1.0,0,0
PF08334,PF01514:PF08479:PF08411,1,1,0,1,1,1016,0.0,1.0,0.0,-0.0,0,0,1,0,1017,0,1.0,0.0,0
PF17019,PF11863:PF04671:PF09951,0,1,0,0,1,1017,0.0,1.0,0,0,0,0,0,0,1018,0,1.0,0,0
PF17014,PF04355:PF04451:PF06890,0,1,0,0,1,1017,0.0,1.0,0,0,0,0,0,0,1018,0,1.0,0,0
PF09295,PF16669:PF07721:PF07219,2,13,2,0,11,1005,0.15,0.99,1.0,0.39,2,1,1,1,1015,0.5,1.0,0.5,0.5
PF00705,PF02747:PF08523:PF01643,10,17,9,1,8,1000,0.53,0.99,0.9,0.69,1,1,9,0,1008,1.0,0.99,0.1,0.31
PF05783,PF14612:PF06179:PF14937,9,13,4,5,9,1000,0.31,0.99,0.44,0.36,2,1,8,1,1008,0.5,0.99,0.11,0.23
PF11879,PF11601:PF16526:PF03521,4,12,3,1,9,1005,0.25,0.99,0.75,0.43,1,1,3,0,1014,1.0,1.0,0.25,0.5
PF04959,PF04153:PF15396:PF13914,17,17,6,11,11,990,0.35,0.98,0.35,0.34,4,4,13,0,1001,1.0,0.99,0.24,0.48
PF05438,PF15744:PF04360:PF03883,2,2,1,1,1,1015,0.5,1.0,0.5,0.5,0,0,2,0,1016,0,1.0,0.0,0
PF00535,PF00652:PF04577:PF02709,64,69,41,23,28,926,0.59,0.95,0.64,0.59,21,18,46,3,951,0.86,0.95,0.28,0.47
PF00763,PF01268:PF02882:PF01014,24,32,24,0,8,986,0.75,0.99,1.0,0.86,13,13,11,0,994,1.0,0.99,0.54,0.73
PF14496,PF09699:PF11593:PF16217,1,2,0,1,2,1015,0.0,1.0,0.0,-0.0,0,0,1,0,1017,0,1.0,0.0,0
PF11933,PF03521:PF16799:PF11601,4,7,1,3,6,1008,0.14,0.99,0.25,0.18,1,1,3,0,1014,1.0,1.0,0.25,0.5
PF13645,PF15102:PF02827:PF03317,0,9,0,0,9,1009,0.0,0.99,0,0,0,0,0,0,1018,0,1.0,0,0
PF04052,PF01514:PF04355:PF08334,0,1,0,0,1,1017,0.0,1.0,0,0,0,0,0,0,1018,0,1.0,0,0
PF03629,PF06206:PF06404:PF05498,4,9,1,3,8,1006,0.11,0.99,0.25,0.16,0,0,4,0,1014,0,1.0,0.0,0
PF01579,PF15002:PF10325:PF10328,5,26,1,4,25,988,0.04,0.97,0.2,0.08,5,0,5,5,1008,0.0,0.99,0.0,-0.0
PF11635,PF09737:PF12350:PF12243,7,7,1,6,6,1005,0.14,0.99,0.14,0.14,3,0,7,3,1008,0.0,0.99,0.0,-0.0
PF00056,PF02866:PF07258:PF01731,24,38,20,4,18,976,0.53,0.98,0.83,0.65,3,2,22,1,993,0.67,0.98,0.08,0.23
PF14078,PF17189:PF16028:PF09694,0,14,0,0,14,1004,0.0,0.99,0,0,0,0,0,0,1018,0,1.0,0,0
PF03242,PF03386:PF05512:PF07344,0,3,0,0,3,1015,0.0,1.0,0,0,0,0,0,0,1018,0,1.0,0,0
PF00637,PF12816:PF17122:PF10367,29,21,13,16,8,981,0.62,0.98,0.45,0.52,6,6,23,0,989,1.0,0.98,0.21,0.45
PF07560,PF07707:PF01569:PF12156,0,85,0,0,85,933,0.0,0.92,0,0,19,0,0,19,999,0.0,0.98,0,0
PF15386,PF13270:PF12855:PF11460,1,4,0,1,4,1013,0.0,1.0,0.0,-0.0,1,0,1,1,1016,0.0,1.0,0.0,-0.0
PF00437,PF09079:PF01272:PF05491,16,22,5,11,17,985,0.23,0.97,0.31,0.25,2,2,14,0,1002,1.0,0.99,0.12,0.35
PF11603,PF04428:PF09093:PF14307,2,4,0,2,4,1012,0.0,0.99,0.0,-0.0,0,0,2,0,1016,0,1.0,0.0,0
PF16087,PF11427:PF13936:PF14949,21,17,7,14,10,987,0.41,0.98,0.33,0.36,4,3,18,1,996,0.75,0.98,0.14,0.32
PF01026,PF08619:PF05042:PF01238,21,23,8,13,15,982,0.35,0.97,0.38,0.35,2,2,19,0,997,1.0,0.98,0.1,0.31
PF04316,PF08404:PF17193:PF08021,0,0,0,0,0,1018,0,1.0,0,0,0,0,0,0,1018,0,1.0,0,0
PF11471,PF16966:PF15424:PF10106,0,1,0,0,1,1017,0.0,1.0,0,0,0,0,0,0,1018,0,1.0,0,0
PF01751,PF01131:PF00521:PF13368,30,33,27,3,6,982,0.82,0.99,0.9,0.85,9,9,21,0,988,1.0,0.98,0.3,0.54
PF05097,PF06136:PF05627:PF14547,5,12,1,4,11,1002,0.08,0.99,0.2,0.12,3,1,4,2,1011,0.33,0.99,0.2,0.26
PF09145,PF13722:PF11751:PF04451,0,1,0,0,1,1017,0.0,1.0,0,0,0,0,0,0,1018,0,1.0,0,0
PF12013,PF00172:PF16783:PF14619,11,144,10,1,134,873,0.07,0.87,0.91,0.23,6,3,8,3,1004,0.5,0.99,0.27,0.36
PF15023,PF06834:PF01668:PF01706,0,3,0,0,3,1015,0.0,1.0,0,0,0,0,0,0,1018,0,1.0,0,0
PF02603,PF05036:PF07475:PF03668,4,8,4,0,4,1010,0.5,1.0,1.0,0.71,4,4,0,0,1014,1.0,1.0,1.0,1.0
PF02390,PF00162:PF15473:PF00177,16,43,11,5,32,970,0.26,0.96,0.69,0.41,10,5,11,5,997,0.5,0.98,0.31,0.39
PF04325,PF00524:PF11300:PF11291,3,4,1,2,3,1012,0.25,1.0,0.33,0.29,1,0,3,1,1014,0.0,1.0,0.0,-0.0
PF10589,PF10531:PF01512:PF04064,7,18,7,0,11,1000,0.39,0.99,1.0,0.62,7,5,2,2,1009,0.71,1.0,0.71,0.71
PF13618,PF08848:PF16265:PF12805,0,0,0,0,0,1018,0,1.0,0,0,0,0,0,0,1018,0,1.0,0,0
PF11402,PF08093:PF05962:PF15547,0,2,0,0,2,1016,0.0,1.0,0,0,0,0,0,0,1018,0,1.0,0,0
PF09809,PF04667:PF09769:PF00159,7,9,1,6,8,1003,0.11,0.99,0.14,0.12,1,1,6,0,1011,1.0,0.99,0.14,0.38
PF08688,PF08687:PF15737:PF16474,2,14,2,0,12,1004,0.14,0.99,1.0,0.38,2,1,1,1,1015,0.5,1.0,0.5,0.5
PF08239,PF08005:PF07691:PF13402,9,19,5,4,14,995,0.26,0.98,0.56,0.37,3,2,7,1,1008,0.67,0.99,0.22,0.38
PF12294,PF08497:PF01668:PF08017,0,8,0,0,8,1010,0.0,0.99,0,0,1,0,0,1,1017,0.0,1.0,0,0
PF03328,PF06172:PF03972:PF12311,17,10,5,12,5,996,0.5,0.98,0.29,0.38,1,1,16,0,1001,1.0,0.98,0.06,0.24
PF01280,PF05129:PF10203:PF01779,16,23,5,11,18,984,0.22,0.97,0.31,0.25,1,1,15,0,1002,1.0,0.99,0.06,0.25
PF15659,PF16804:PF07353:PF08093,0,3,0,0,3,1015,0.0,1.0,0,0,0,0,0,0,1018,0,1.0,0,0
PF13696,PF08783:PF17180:PF15017,10,9,8,2,1,1007,0.89,1.0,0.8,0.84,2,2,8,0,1008,1.0,0.99,0.2,0.45
PF00762,PF02104:PF00210:PF05995,18,24,6,12,18,982,0.25,0.97,0.33,0.27,5,3,15,2,998,0.6,0.98,0.17,0.31
PF17147,PF01558:PF01855:PF10371,8,14,8,0,6,1004,0.57,0.99,1.0,0.75,6,6,2,0,1010,1.0,1.0,0.75,0.87
PF06069,PF05164:PF12240:PF11291,0,1,0,0,1,1017,0.0,1.0,0,0,0,0,0,0,1018,0,1.0,0,0
PF01242,PF02566:PF04148:PF03928,7,17,2,5,15,996,0.12,0.98,0.29,0.17,0,0,7,0,1011,0,0.99,0.0,0
PF00035,PF01207:PF14622:PF00636,54,55,28,26,27,937,0.51,0.95,0.52,0.49,18,15,39,3,961,0.83,0.96,0.28,0.47
PF01145,PF01066:PF13813:PF00156,40,62,23,17,39,939,0.37,0.94,0.57,0.43,17,14,26,3,975,0.82,0.97,0.35,0.53
PF02994,PF12259:PF00589:PF16012,19,29,5,14,24,975,0.17,0.96,0.26,0.19,5,3,16,2,997,0.6,0.98,0.16,0.3
PF09322,PF15082:PF15407:PF15914,0,6,0,0,6,1012,0.0,0.99,0,0,0,0,0,0,1018,0,1.0,0,0
PF10181,PF01632:PF08561:PF04716,3,21,0,3,21,994,0.0,0.98,0.0,-0.01,2,0,3,2,1013,0.0,1.0,0.0,-0.0
PF03561,PF04115:PF08622:PF17187,8,13,4,4,9,1001,0.31,0.99,0.5,0.39,2,0,8,2,1008,0.0,0.99,0.0,-0.0
PF08689,PF15749:PF13396:PF11510,5,8,1,4,7,1006,0.12,0.99,0.2,0.15,2,1,4,1,1012,0.5,1.0,0.2,0.31
PF03169,PF07969:PF04979:PF01738,36,41,22,14,19,963,0.54,0.97,0.61,0.56,9,9,27,0,982,1.0,0.97,0.25,0.49
PF03871,PF01191:PF03868:PF00993,12,20,11,1,9,997,0.55,0.99,0.92,0.71,3,3,9,0,1006,1.0,0.99,0.25,0.5
PF05901,PF06651:PF07016:PF01790,0,2,0,0,2,1016,0.0,1.0,0,0,0,0,0,0,1018,0,1.0,0,0
PF06011,PF06333:PF11597:PF14558,7,11,5,2,6,1005,0.45,0.99,0.71,0.57,5,3,4,2,1009,0.6,0.99,0.43,0.5
PF03448,PF00893:PF01769:PF16118,4,7,1,3,6,1008,0.14,0.99,0.25,0.18,1,1,3,0,1014,1.0,1.0,0.25,0.5
PF01535,PF01048:PF14432:PF02363,126,57,47,79,10,882,0.82,0.91,0.37,0.52,16,16,110,0,892,1.0,0.89,0.13,0.34
PF15147,PF12510:PF09304:PF03271,1,14,1,0,13,1004,0.07,0.99,1.0,0.27,1,1,0,0,1017,1.0,1.0,1.0,1.0
PF03768,PF03769:PF16048:PF17054,0,7,0,0,7,1011,0.0,0.99,0,0,0,0,0,0,1018,0,1.0,0,0
PF08651,PF08853:PF05138:PF15233,1,4,0,1,4,1013,0.0,1.0,0.0,-0.0,0,0,1,0,1017,0,1.0,0.0,0
PF11365,PF04880:PF10226:PF11831,8,16,3,5,13,997,0.19,0.98,0.38,0.26,2,1,7,1,1009,0.5,0.99,0.12,0.25
PF02854,PF02847:PF09088:PF09090,34,25,21,13,4,980,0.84,0.98,0.62,0.71,11,9,25,2,982,0.82,0.97,0.26,0.46
PF00998,PF00516:PF09163:PF09677,2,0,0,2,0,1016,0,1.0,0.0,0,0,0,2,0,1016,0,1.0,0.0,0
PF17029,PF13994:PF04883:PF06476,0,1,0,0,1,1017,0.0,1.0,0,0,0,0,0,0,1018,0,1.0,0,0
PF15371,PF02200:PF07610:PF13482,4,3,0,4,3,1011,0.0,0.99,0.0,-0.0,0,0,4,0,1014,0,1.0,0.0,0
PF07296,PF04453:PF11304:PF03944,0,2,0,0,2,1016,0.0,1.0,0,0,0,0,0,0,1018,0,1.0,0,0
PF14619,PF07529:PF08073:PF06465,8,26,7,1,19,991,0.27,0.98,0.88,0.48,11,3,5,8,1002,0.27,0.99,0.38,0.31
PF06222,PF09722:PF15775:PF04349,0,0,0,0,0,1018,0,1.0,0,0,0,0,0,0,1018,0,1.0,0,0
PF10951,PF05939:PF07805:PF14251,0,3,0,0,3,1015,0.0,1.0,0,0,0,0,0,0,1018,0,1.0,0,0
PF08603,PF01213:PF01288:PF00809,10,24,9,1,15,993,0.38,0.98,0.9,0.58,9,3,7,6,1002,0.33,0.99,0.3,0.31
PF02969,PF10491:PF07967:PF07923,8,15,3,5,12,998,0.2,0.98,0.38,0.27,5,2,6,3,1007,0.4,0.99,0.25,0.31
PF00872,PF01610:PF10532:PF11202,4,3,1,3,2,1012,0.33,1.0,0.25,0.29,2,1,3,1,1013,0.5,1.0,0.25,0.35
PF01466,PF03931:PF01357:PF05605,26,37,19,7,18,974,0.51,0.98,0.73,0.6,12,9,17,3,989,0.75,0.98,0.35,0.5
PF01390,PF02983:PF09272:PF15494,30,13,6,24,7,981,0.46,0.97,0.2,0.29,2,1,29,1,987,0.5,0.97,0.03,0.12
PF04096,PF12110:PF13634:PF14636,11,28,11,0,17,990,0.39,0.98,1.0,0.62,11,6,5,5,1002,0.55,0.99,0.55,0.54
PF00010,PF08447:PF11413:PF08815,100,30,19,81,11,907,0.63,0.91,0.19,0.31,5,5,95,0,918,1.0,0.91,0.05,0.21
PF02218,PF08824:PF07815:PF12026,4,10,1,3,9,1005,0.1,0.99,0.25,0.15,2,1,3,1,1013,0.5,1.0,0.25,0.35
PF00862,PF13439:PF12038:PF15924,10,28,4,6,24,984,0.14,0.97,0.4,0.23,2,1,9,1,1007,0.5,0.99,0.1,0.22
PF12531,PF06745:PF01580:PF07610,0,6,0,0,6,1012,0.0,0.99,0,0,0,0,0,0,1018,0,1.0,0,0
PF07147,PF02872:PF16656:PF06584,9,36,6,3,30,979,0.17,0.97,0.67,0.32,7,3,6,4,1005,0.43,0.99,0.33,0.37
PF02609,PF05736:PF11862:PF07927,1,3,0,1,3,1014,0.0,1.0,0.0,-0.0,0,0,1,0,1017,0,1.0,0.0,0
PF12396,PF03709:PF14831:PF06738,6,8,0,6,8,1004,0.0,0.99,0.0,-0.01,1,0,6,1,1011,0.0,0.99,0.0,-0.0
PF10345,PF04679:PF01068:PF04675,6,19,6,0,13,999,0.32,0.99,1.0,0.56,18,5,1,13,999,0.28,0.99,0.83,0.48
PF05928,PF08240:PF00004:PF03106,0,206,0,0,206,812,0.0,0.8,0,0,58,0,0,58,960,0.0,0.94,0,0
PF02306,PF17193:PF02399:PF08456,1,4,0,1,4,1013,0.0,1.0,0.0,-0.0,1,0,1,1,1016,0.0,1.0,0.0,-0.0
PF04917,PF11751:PF08805:PF10554,1,1,1,0,0,1017,1.0,1.0,1.0,1.0,0,0,1,0,1017,0,1.0,0.0,0
PF12063,PF11629:PF14593:PF12202,9,11,3,6,8,1001,0.27,0.99,0.33,0.29,4,3,6,1,1008,0.75,0.99,0.33,0.5
PF10542,PF00127:PF02361:PF12046,0,8,0,0,8,1010,0.0,0.99,0,0,0,0,0,0,1018,0,1.0,0,0
PF01532,PF02225:PF04258:PF04389,40,75,25,15,50,928,0.33,0.94,0.62,0.43,34,17,23,17,961,0.5,0.96,0.42,0.44
PF12147,PF10971:PF14671:PF09192,1,6,1,0,5,1012,0.17,1.0,1.0,0.41,1,1,0,0,1017,1.0,1.0,1.0,1.0
PF02939,PF01975:PF03133:PF03718,13,39,7,6,32,973,0.18,0.96,0.54,0.3,5,1,12,4,1001,0.2,0.98,0.08,0.12
PF11404,PF07941:PF08763:PF16519,1,15,1,0,14,1003,0.07,0.99,1.0,0.26,3,1,0,2,1015,0.33,1.0,1.0,0.58
PF05069,PF10077:PF01292:PF07661,0,11,0,0,11,1007,0.0,0.99,0,0,1,0,0,1,1017,0.0,1.0,0,0
PF14572,PF13793:PF03951:PF00156,14,48,14,0,34,970,0.29,0.97,1.0,0.53,17,8,6,9,995,0.47,0.99,0.57,0.51
PF07736,PF08364:PF06282:PF11987,0,28,0,0,28,990,0.0,0.97,0,0,5,0,0,5,1013,0.0,1.0,0,0
PF02162,PF03827:PF09193:PF10413,6,4,2,4,2,1010,0.5,0.99,0.33,0.41,1,1,5,0,1012,1.0,1.0,0.17,0.41
PF05134,PF03934:PF02501:PF11612,1,2,1,0,1,1016,0.5,1.0,1.0,0.71,2,1,0,1,1016,0.5,1.0,1.0,0.71
PF07690,PF00083:PF06609:PF06813,241,136,91,150,45,732,0.67,0.81,0.38,0.4,14,13,228,1,776,0.93,0.78,0.05,0.19
PF13709,PF01455:PF14052:PF13780,1,0,0,1,0,1017,0,1.0,0.0,0,0,0,1,0,1017,0,1.0,0.0,0
PF04077,PF03244:PF08308:PF05666,1,0,0,1,0,1017,0,1.0,0.0,0,0,0,1,0,1017,0,1.0,0.0,0
PF15762,PF15312:PF02070:PF15482,0,0,0,0,0,1018,0,1.0,0,0,0,0,0,0,1018,0,1.0,0,0
PF04571,PF16876:PF11597:PF06972,11,15,9,2,6,1001,0.6,0.99,0.82,0.7,1,1,10,0,1007,1.0,0.99,0.09,0.3
PF03317,PF15200:PF05115:PF15556,5,2,1,4,1,1012,0.5,1.0,0.2,0.31,0,0,5,0,1013,0,1.0,0.0,0
PF15334,PF15770:PF17022:PF01668,0,2,0,0,2,1016,0.0,1.0,0,0,0,0,0,0,1018,0,1.0,0,0
PF14677,PF14680:PF14676:PF14679,1,1,1,0,0,1017,1.0,1.0,1.0,1.0,1,1,0,0,1017,1.0,1.0,1.0,1.0
PF05969,PF07405:PF08398:PF13013,0,2,0,0,2,1016,0.0,1.0,0,0,0,0,0,0,1018,0,1.0,0,0
PF13882,PF06583:PF12355:PF05473,3,4,1,2,3,1012,0.25,1.0,0.33,0.29,1,1,2,0,1015,1.0,1.0,0.33,0.58
PF03997,PF01775:PF00210:PF05497,6,23,4,2,19,993,0.17,0.98,0.67,0.33,4,1,5,3,1009,0.25,0.99,0.17,0.2
PF10505,PF09733:PF01594:PF15189,7,12,1,6,11,1000,0.08,0.98,0.14,0.1,2,0,7,2,1009,0.0,0.99,0.0,-0.0
PF06682,PF14941:PF04452:PF02422,7,4,0,7,4,1007,0.0,0.99,0.0,-0.01,0,0,7,0,1011,0,0.99,0.0,0
PF16545,PF03823:PF17104:PF08649,7,4,1,6,3,1008,0.25,0.99,0.14,0.18,1,0,7,1,1010,0.0,0.99,0.0,-0.0
PF01426,PF01448:PF12047:PF00145,40,39,20,20,19,959,0.51,0.96,0.5,0.49,12,12,28,0,978,1.0,0.97,0.3,0.54
PF02847,PF02854:PF09090:PF09088,20,36,18,2,18,980,0.5,0.98,0.9,0.66,11,6,14,5,993,0.55,0.98,0.3,0.4
PF13310,PF01420:PF01254:PF06670,2,2,2,0,0,1016,1.0,1.0,1.0,1.0,1,1,1,0,1016,1.0,1.0,0.5,0.71
PF07986,PF05334:PF12253:PF06584,16,7,1,15,6,996,0.14,0.98,0.06,0.09,2,1,15,1,1001,0.5,0.98,0.06,0.17
PF15316,PF12328:PF14653:PF06351,2,6,0,2,6,1010,0.0,0.99,0.0,-0.0,0,0,2,0,1016,0,1.0,0.0,0
PF12519,PF16871:PF11958:PF06838,5,6,0,5,6,1007,0.0,0.99,0.0,-0.01,0,0,5,0,1013,0,1.0,0.0,0
PF02229,PF02201:PF08766:PF13178,14,43,10,4,33,971,0.23,0.96,0.71,0.39,18,6,8,12,992,0.33,0.98,0.43,0.37
PF05835,PF05395:PF15691:PF02157,5,10,1,4,9,1004,0.1,0.99,0.2,0.14,0,0,5,0,1013,0,1.0,0.0,0
PF08472,PF05116:PF00534:PF14306,2,62,1,1,61,955,0.02,0.94,0.5,0.08,9,0,2,9,1007,0.0,0.99,0.0,-0.0
PF04489,PF07445:PF12495:PF08984,0,0,0,0,0,1018,0,1.0,0,0,0,0,0,0,1018,0,1.0,0,0
PF15295,PF12830:PF12295:PF08767,0,23,0,0,23,995,0.0,0.98,0,0,2,0,0,2,1016,0.0,1.0,0,0
PF01915,PF00933:PF14310:PF14498,33,38,33,0,5,980,0.87,1.0,1.0,0.93,28,28,5,0,985,1.0,1.0,0.85,0.92
PF17056,PF08591:PF06695:PF11341,0,2,0,0,2,1016,0.0,1.0,0,0,0,0,0,0,1018,0,1.0,0,0
PF02200,PF15997:PF15923:PF14465,1,3,0,1,3,1014,0.0,1.0,0.0,-0.0,0,0,1,0,1017,0,1.0,0.0,0
PF15443,PF15460:PF05874:PF15553,1,2,0,1,2,1015,0.0,1.0,0.0,-0.0,0,0,1,0,1017,0,1.0,0.0,0
PF12185,PF00638:PF08911:PF08604,5,34,5,0,29,984,0.15,0.97,1.0,0.38,6,2,3,4,1009,0.33,0.99,0.4,0.36
PF12619,PF14551:PF04558:PF16870,13,59,13,0,46,959,0.22,0.95,1.0,0.46,11,4,9,7,998,0.36,0.98,0.31,0.33
PF07110,PF14027:PF04199:PF01828,12,31,7,5,24,982,0.23,0.97,0.58,0.35,10,4,8,6,1000,0.4,0.99,0.33,0.36
PF05598,PF04865:PF03428:PF06890,3,0,0,3,0,1015,0,1.0,0.0,0,0,0,3,0,1015,0,1.0,0.0,0
PF07732,PF07731:PF00394:PF05691,51,55,47,4,8,959,0.85,0.99,0.92,0.88,43,41,10,2,965,0.95,0.99,0.8,0.87
PF00654,PF01595:PF00571:PF04739,34,67,30,4,37,947,0.45,0.96,0.88,0.61,14,5,29,9,975,0.36,0.96,0.15,0.21
PF06638,PF16954:PF15008:PF06951,3,13,0,3,13,1002,0.0,0.98,0.0,-0.01,0,0,3,0,1015,0,1.0,0.0,0
PF10220,PF15012:PF07965:PF04916,10,13,2,8,11,997,0.15,0.98,0.2,0.17,1,1,9,0,1008,1.0,0.99,0.1,0.31
PF01301,PF13364:PF10435:PF02140,31,36,19,12,17,970,0.53,0.97,0.61,0.55,7,7,24,0,987,1.0,0.98,0.23,0.47
PF16279,PF08832:PF08815:PF07469,6,6,6,0,0,1012,1.0,1.0,1.0,1.0,6,6,0,0,1012,1.0,1.0,1.0,1.0
PF10171,PF01776:PF02060:PF00726,7,9,2,5,7,1004,0.22,0.99,0.29,0.25,0,0,7,0,1011,0,0.99,0.0,0
PF04065,PF00649:PF07001:PF09429,7,18,3,4,15,996,0.17,0.98,0.43,0.26,4,1,6,3,1008,0.25,0.99,0.14,0.18
PF09495,PF06842:PF03962:PF05512,1,14,0,1,14,1003,0.0,0.99,0.0,-0.0,4,0,1,4,1013,0.0,1.0,0.0,-0.0
PF03769,PF03768:PF08140:PF12853,1,6,0,1,6,1011,0.0,0.99,0.0,-0.0,0,0,1,0,1017,0,1.0,0.0,0
PF16879,PF08295:PF02671:PF04571,15,36,15,0,21,982,0.42,0.98,1.0,0.64,17,15,0,2,1001,0.88,1.0,1.0,0.94
PF08316,PF04090:PF10330:PF06420,7,4,0,7,4,1007,0.0,0.99,0.0,-0.01,1,0,7,1,1010,0.0,0.99,0.0,-0.0
PF06298,PF01091:PF00101:PF03979,1,10,0,1,10,1007,0.0,0.99,0.0,-0.0,3,0,1,3,1014,0.0,1.0,0.0,-0.0
PF07930,PF11954:PF01427:PF06176,1,9,0,1,9,1008,0.0,0.99,0.0,-0.0,0,0,1,0,1017,0,1.0,0.0,0
PF13575,PF15097:PF08093:PF17206,0,3,0,0,3,1015,0.0,1.0,0,0,0,0,0,0,1018,0,1.0,0,0
PF09129,PF11880:PF04740:PF11849,2,3,2,0,1,1015,0.67,1.0,1.0,0.82,0,0,2,0,1016,0,1.0,0.0,0
PF13986,PF06167:PF11304:PF08479,1,1,1,0,0,1017,1.0,1.0,1.0,1.0,0,0,1,0,1017,0,1.0,0.0,0
PF13323,PF00368:PF03176:PF16414,3,38,3,0,35,980,0.08,0.97,1.0,0.28,6,0,3,6,1009,0.0,0.99,0.0,-0.0
PF14542,PF04402:PF02372:PF00727,2,10,1,1,9,1007,0.1,0.99,0.5,0.22,1,0,2,1,1015,0.0,1.0,0.0,-0.0
PF09799,PF00159:PF00965:PF10244,6,15,3,3,12,1000,0.2,0.99,0.5,0.31,1,1,5,0,1012,1.0,1.0,0.17,0.41
PF10009,PF06890:PF02565:PF02399,0,2,0,0,2,1016,0.0,1.0,0,0,0,0,0,0,1018,0,1.0,0,0
PF16055,PF08497:PF00669:PF08453,0,3,0,0,3,1015,0.0,1.0,0,0,0,0,0,0,1018,0,1.0,0,0
PF09169,PF09103:PF09121:PF09104,5,6,5,0,1,1012,0.83,1.0,1.0,0.91,1,1,4,0,1013,1.0,1.0,0.2,0.45
PF10270,PF00831:PF03501:PF07106,7,19,2,5,17,994,0.11,0.98,0.29,0.16,4,1,6,3,1008,0.25,0.99,0.14,0.18
PF07403,PF14297:PF04738:PF05756,0,0,0,0,0,1018,0,1.0,0,0,0,0,0,0,1018,0,1.0,0,0
PF16944,PF05508:PF08634:PF05030,2,9,0,2,9,1007,0.0,0.99,0.0,-0.0,0,0,2,0,1016,0,1.0,0.0,0
PF03619,PF05653:PF02423:PF14719,27,26,8,19,18,973,0.31,0.96,0.3,0.28,4,4,23,0,991,1.0,0.98,0.15,0.38
PF05572,PF11380:PF17103:PF17102,10,9,0,10,9,999,0.0,0.98,0.0,-0.01,7,0,10,7,1001,0.0,0.98,0.0,-0.01
PF15918,PF15759:PF10446:PF11223,0,2,0,0,2,1016,0.0,1.0,0,0,0,0,0,0,1018,0,1.0,0,0
PF16218,PF15550:PF14972:PF02393,0,2,0,0,2,1016,0.0,1.0,0,0,0,0,0,0,1018,0,1.0,0,0
PF00415,PF08005:PF10462:PF02493,67,46,22,45,24,927,0.48,0.93,0.33,0.36,6,6,61,0,951,1.0,0.94,0.09,0.29
PF16181,PF16180:PF00554:PF01609,3,20,3,0,17,998,0.15,0.98,1.0,0.38,2,2,1,0,1015,1.0,1.0,0.67,0.82
PF10101,PF07442:PF12207:PF13701,0,0,0,0,0,1018,0,1.0,0,0,0,0,0,0,1018,0,1.0,0,0
PF12135,PF07430:PF08027:PF10630,0,1,0,0,1,1017,0.0,1.0,0,0,0,0,0,0,1018,0,1.0,0,0
PF00548,PF02226:PF08727:PF12381,12,12,12,0,0,1006,1.0,1.0,1.0,1.0,12,12,0,0,1006,1.0,1.0,1.0,1.0
PF05290,PF08873:PF03120:PF06753,0,7,0,0,7,1011,0.0,0.99,0,0,0,0,0,0,1018,0,1.0,0,0
PF08355,PF08356:PF10149:PF16512,13,17,12,1,5,1000,0.71,0.99,0.92,0.8,5,5,8,0,1005,1.0,0.99,0.38,0.62
PF11770,PF10295:PF02211:PF13810,0,7,0,0,7,1011,0.0,0.99,0,0,0,0,0,0,1018,0,1.0,0,0
PF02479,PF07892:PF06252:PF09707,0,1,0,0,1,1017,0.0,1.0,0,0,0,0,0,0,1018,0,1.0,0,0
PF11440,PF04965:PF07199:PF08744,0,0,0,0,0,1018,0,1.0,0,0,0,0,0,0,1018,0,1.0,0,0
PF13400,PF06305:PF12034:PF03713,0,3,0,0,3,1015,0.0,1.0,0,0,0,0,0,0,1018,0,1.0,0,0
PF04119,PF12900:PF10310:PF13741,3,7,0,3,7,1008,0.0,0.99,0.0,-0.0,1,0,3,1,1014,0.0,1.0,0.0,-0.0
PF03548,PF15186:PF03050:PF00669,3,2,0,3,2,1013,0.0,1.0,0.0,-0.0,0,0,3,0,1015,0,1.0,0.0,0
PF08321,PF05011:PF02872:PF03711,10,30,6,4,24,984,0.2,0.97,0.6,0.34,5,4,6,1,1007,0.8,0.99,0.4,0.56
PF05720,PF07944:PF03644:PF05675,0,23,0,0,23,995,0.0,0.98,0,0,2,0,0,2,1016,0.0,1.0,0,0
PF01337,PF16836:PF02955:PF09074,0,4,0,0,4,1014,0.0,1.0,0,0,0,0,0,0,1018,0,1.0,0,0
PF02955,PF02951:PF03729:PF06890,4,4,4,0,0,1014,1.0,1.0,1.0,1.0,0,0,4,0,1014,0,1.0,0.0,0
PF15262,PF12202:PF11629:PF12063,4,17,4,0,13,1001,0.24,0.99,1.0,0.48,4,3,1,1,1013,0.75,1.0,0.75,0.75
PF15079,PF06773:PF15851:PF11369,0,0,0,0,0,1018,0,1.0,0,0,0,0,0,0,1018,0,1.0,0,0
PF15921,PF12180:PF16516:PF09730,0,11,0,0,11,1007,0.0,0.99,0,0,0,0,0,0,1018,0,1.0,0,0
PF08244,PF00251:PF11837:PF16346,13,16,13,0,3,1002,0.81,1.0,1.0,0.9,2,2,11,0,1005,1.0,0.99,0.15,0.39
PF10287,PF10290:PF16173:PF07831,3,3,1,2,2,1013,0.33,1.0,0.33,0.33,0,0,3,0,1015,0,1.0,0.0,0
PF09122,PF11127:PF06617:PF13972,0,5,0,0,5,1013,0.0,1.0,0,0,0,0,0,0,1018,0,1.0,0,0
PF14626,PF07199:PF05337:PF15696,1,2,0,1,2,1015,0.0,1.0,0.0,-0.0,0,0,1,0,1017,0,1.0,0.0,0
PF16754,PF12034:PF13400:PF06305,0,3,0,0,3,1015,0.0,1.0,0,0,0,0,0,0,1018,0,1.0,0,0
PF08947,PF12162:PF08916:PF16454,1,11,1,0,10,1007,0.09,0.99,1.0,0.3,1,0,1,1,1016,0.0,1.0,0.0,-0.0
PF09876,PF08206:PF13184:PF08529,1,4,1,0,3,1014,0.25,1.0,1.0,0.5,4,1,0,3,1014,0.25,1.0,1.0,0.5
PF03389,PF04740:PF02217:PF04965,0,3,0,0,3,1015,0.0,1.0,0,0,0,0,0,0,1018,0,1.0,0,0
PF02480,PF06305:PF07010:PF02124,4,3,3,1,0,1014,1.0,1.0,0.75,0.87,0,0,4,0,1014,0,1.0,0.0,0
PF01235,PF02741:PF05707:PF01752,4,3,0,4,3,1011,0.0,0.99,0.0,-0.0,0,0,4,0,1014,0,1.0,0.0,0
PF05532,PF03823:PF08636:PF15576,1,6,1,0,5,1012,0.17,1.0,1.0,0.41,0,0,1,0,1017,0,1.0,0.0,0
PF05700,PF12638:PF15704:PF15054,9,12,4,5,8,1001,0.33,0.99,0.44,0.38,1,1,8,0,1009,1.0,0.99,0.11,0.33
PF02761,PF02762:PF02262:PF08295,6,20,6,0,14,998,0.3,0.99,1.0,0.54,5,5,1,0,1012,1.0,1.0,0.83,0.91
PF02089,PF02284:PF01198:PF05724,12,35,6,6,29,977,0.17,0.97,0.5,0.28,3,1,11,2,1004,0.33,0.99,0.08,0.16
PF11978,PF01505:PF10998:PF10312,2,15,2,0,13,1003,0.13,0.99,1.0,0.36,2,2,0,0,1016,1.0,1.0,1.0,1.0
PF00534,PF08472:PF00862:PF16760,51,14,12,39,2,965,0.86,0.96,0.24,0.44,0,0,51,0,967,0,0.95,0.0,0
PF03829,PF03608:PF08220:PF03612,2,5,2,0,3,1013,0.4,1.0,1.0,0.63,2,2,0,0,1016,1.0,1.0,1.0,1.0
PF12416,PF16056:PF15625:PF16562,3,9,1,2,8,1007,0.11,0.99,0.33,0.19,1,1,2,0,1015,1.0,1.0,0.33,0.58
PF01325,PF03090:PF01706:PF13269,3,1,0,3,1,1014,0.0,1.0,0.0,-0.0,0,0,3,0,1015,0,1.0,0.0,0
PF17061,PF03745:PF06592:PF15185,0,3,0,0,3,1015,0.0,1.0,0,0,0,0,0,0,1018,0,1.0,0,0
PF01649,PF02195:PF15339:PF02087,11,10,1,10,9,998,0.1,0.98,0.09,0.09,0,0,11,0,1007,0,0.99,0.0,0
PF12515,PF12409:PF09040:PF08282,8,35,7,1,28,982,0.2,0.97,0.88,0.41,4,4,4,0,1010,1.0,1.0,0.5,0.71
PF08444,PF06021:PF01114:PF02321,2,17,2,0,15,1001,0.12,0.99,1.0,0.34,0,0,2,0,1016,0,1.0,0.0,0
PF05103,PF04225:PF08437:PF10118,2,12,1,1,11,1005,0.08,0.99,0.5,0.2,0,0,2,0,1016,0,1.0,0.0,0
PF01175,PF07159:PF15350:PF16709,4,7,1,3,6,1008,0.14,0.99,0.25,0.18,3,0,4,3,1011,0.0,0.99,0.0,-0.0
PF08908,PF04289:PF04333:PF14063,0,0,0,0,0,1018,0,1.0,0,0,0,0,0,0,1018,0,1.0,0,0
PF11055,PF08093:PF09832:PF05611,0,1,0,0,1,1017,0.0,1.0,0,0,0,0,0,0,1018,0,1.0,0,0
PF14865,PF10974:PF15480:PF11027,0,3,0,0,3,1015,0.0,1.0,0,0,0,0,0,0,1018,0,1.0,0,0
PF04286,PF07434:PF06745:PF04349,2,0,0,2,0,1016,0,1.0,0.0,0,0,0,2,0,1016,0,1.0,0.0,0
PF03762,PF14200:PF15048:PF10044,2,7,0,2,7,1009,0.0,0.99,0.0,-0.0,0,0,2,0,1016,0,1.0,0.0,0
PF12100,PF11214:PF04451:PF10109,0,1,0,0,1,1017,0.0,1.0,0,0,0,0,0,0,1018,0,1.0,0,0
PF04781,PF04780:PF08166:PF11699,2,12,2,0,10,1006,0.17,0.99,1.0,0.41,2,0,2,2,1014,0.0,1.0,0.0,-0.0
PF08017,PF15485:PF14251:PF03525,7,2,0,7,2,1009,0.0,0.99,0.0,-0.0,0,0,7,0,1011,0,0.99,0.0,0
PF09753,PF09341:PF14802:PF09814,10,15,3,7,12,996,0.2,0.98,0.3,0.24,5,3,7,2,1006,0.6,0.99,0.3,0.42
PF10333,PF09428:PF02393:PF15062,0,1,0,0,1,1017,0.0,1.0,0,0,0,0,0,0,1018,0,1.0,0,0
PF11356,PF07157:PF13722:PF07409,2,0,0,2,0,1016,0,1.0,0.0,0,0,0,2,0,1016,0,1.0,0.0,0
PF11803,PF04321:PF14524:PF00908,3,18,2,1,16,999,0.11,0.98,0.67,0.27,5,2,1,3,1012,0.4,1.0,0.67,0.51
PF15879,PF10310:PF10775:PF13933,5,2,1,4,1,1012,0.5,1.0,0.2,0.31,0,0,5,0,1013,0,1.0,0.0,0
PF01735,PF15625:PF05664:PF16056,16,18,2,14,16,986,0.11,0.97,0.12,0.1,2,1,15,1,1001,0.5,0.98,0.06,0.17
PF14858,PF10650:PF15651:PF16830,0,3,0,0,3,1015,0.0,1.0,0,0,0,0,0,0,1018,0,1.0,0,0
PF06952,PF04754:PF03050:PF06573,0,3,0,0,3,1015,0.0,1.0,0,0,0,0,0,0,1018,0,1.0,0,0
PF11876,PF07495:PF03743:PF09874,0,9,0,0,9,1009,0.0,0.99,0,0,0,0,0,0,1018,0,1.0,0,0
PF00870,PF08563:PF07710:PF11619,5,2,2,3,0,1013,1.0,1.0,0.4,0.63,2,2,3,0,1013,1.0,1.0,0.4,0.63
PF04687,PF04285:PF02742:PF02277,1,6,0,1,6,1011,0.0,0.99,0.0,-0.0,0,0,1,0,1017,0,1.0,0.0,0
PF01285,PF14764:PF06584:PF03615,4,12,1,3,11,1003,0.08,0.99,0.25,0.14,2,0,4,2,1012,0.0,0.99,0.0,-0.0
PF15189,PF09733:PF07839:PF15386,5,8,3,2,5,1008,0.38,0.99,0.6,0.47,1,1,4,0,1013,1.0,1.0,0.2,0.45
PF02672,PF00121:PF00044:PF02800,3,42,3,0,39,976,0.07,0.96,1.0,0.26,21,2,1,19,996,0.1,0.98,0.67,0.25
PF11722,PF05206:PF05253:PF02971,9,19,7,2,12,997,0.37,0.99,0.78,0.53,7,4,5,3,1006,0.57,0.99,0.44,0.5
PF11970,PF02112:PF08600:PF11710,3,22,3,0,19,996,0.14,0.98,1.0,0.37,2,0,3,2,1013,0.0,1.0,0.0,-0.0
PF10268,PF10712:PF00012:PF06723,6,72,5,1,67,945,0.07,0.93,0.83,0.23,6,3,3,3,1009,0.5,0.99,0.5,0.5
PF06684,PF03222:PF04183:PF05694,0,8,0,0,8,1010,0.0,0.99,0,0,1,0,0,1,1017,0.0,1.0,0,0
PF06954,PF14672:PF15724:PF06875,1,0,0,1,0,1017,0,1.0,0.0,0,0,0,1,0,1017,0,1.0,0.0,0
PF05421,PF14289:PF10417:PF15490,2,33,2,0,31,985,0.06,0.97,1.0,0.24,3,2,0,1,1015,0.67,1.0,1.0,0.82
PF06027,PF08704:PF07798:PF04570,8,16,2,6,14,996,0.12,0.98,0.25,0.17,2,1,7,1,1009,0.5,0.99,0.12,0.25
PF16692,PF16401:PF14022:PF09949,4,11,2,2,9,1005,0.18,0.99,0.5,0.3,1,1,3,0,1014,1.0,1.0,0.25,0.5
PF10647,PF17005:PF17108:PF11549,3,1,1,2,0,1015,1.0,1.0,0.33,0.58,1,1,2,0,1015,1.0,1.0,0.33,0.58
PF00737,PF01947:PF15085:PF09252,1,2,0,1,2,1015,0.0,1.0,0.0,-0.0,0,0,1,0,1017,0,1.0,0.0,0
PF15251,PF09805:PF12926:PF04729,2,15,0,2,15,1001,0.0,0.98,0.0,-0.01,1,0,2,1,1015,0.0,1.0,0.0,-0.0
PF06978,PF08170:PF12733:PF06662,7,9,7,0,2,1009,0.78,1.0,1.0,0.88,1,1,6,0,1011,1.0,0.99,0.14,0.38
PF09767,PF02450:PF02341:PF01546,4,51,1,3,50,964,0.02,0.95,0.25,0.06,9,0,4,9,1005,0.0,0.99,0.0,-0.01
PF02284,PF05915:PF08561:PF07114,6,9,2,4,7,1005,0.22,0.99,0.33,0.27,1,0,6,1,1011,0.0,0.99,0.0,-0.0
PF02767,PF02768:PF00712:PF08805,7,7,7,0,0,1011,1.0,1.0,1.0,1.0,7,7,0,0,1011,1.0,1.0,1.0,1.0
PF09261,PF07748:PF01074:PF08541,21,28,20,1,8,989,0.71,0.99,0.95,0.82,22,19,2,3,994,0.86,1.0,0.9,0.88
PF14805,PF04764:PF14882:PF15029,3,0,0,3,0,1015,0,1.0,0.0,0,0,0,3,0,1015,0,1.0,0.0,0
PF03222,PF14159:PF15699:PF08137,1,0,0,1,0,1017,0,1.0,0.0,0,0,0,1,0,1017,0,1.0,0.0,0
PF15339,PF14866:PF00770:PF06875,0,1,0,0,1,1017,0.0,1.0,0,0,0,0,0,0,1018,0,1.0,0,0
PF01392,PF01534:PF00051:PF16977,24,39,18,6,21,973,0.46,0.97,0.75,0.58,8,8,16,0,994,1.0,0.98,0.33,0.57
PF07834,PF15486:PF13943:PF04308,2,4,1,1,3,1013,0.25,1.0,0.5,0.35,1,1,1,0,1016,1.0,1.0,0.5,0.71
PF07847,PF00197:PF07896:PF03168,9,16,3,6,13,996,0.19,0.98,0.33,0.24,2,1,8,1,1008,0.5,0.99,0.11,0.23
PF16547,PF11919:PF16507:PF10347,3,12,3,0,9,1006,0.25,0.99,1.0,0.5,8,3,0,5,1010,0.38,1.0,1.0,0.61
PF01246,PF07052:PF10273:PF08636,10,17,3,7,14,994,0.18,0.98,0.3,0.22,2,2,8,0,1008,1.0,0.99,0.2,0.45
PF07277,PF07367:PF05633:PF10508,0,16,0,0,16,1002,0.0,0.98,0,0,2,0,0,2,1016,0.0,1.0,0,0
PF13482,PF15775:PF14251:PF14512,1,2,0,1,2,1015,0.0,1.0,0.0,-0.0,0,0,1,0,1017,0,1.0,0.0,0
PF04740,PF13780:PF16888:PF03428,0,0,0,0,0,1018,0,1.0,0,0,0,0,0,0,1018,0,1.0,0,0
PF00770,PF05355:PF15339:PF15041,1,4,0,1,4,1013,0.0,1.0,0.0,-0.0,0,0,1,0,1017,0,1.0,0.0,0
PF00743,PF13434:PF07247:PF07938,57,24,17,40,7,954,0.71,0.95,0.3,0.44,8,8,49,0,961,1.0,0.95,0.14,0.37
PF13828,PF09580:PF08446:PF04987,0,21,0,0,21,997,0.0,0.98,0,0,8,0,0,8,1010,0.0,0.99,0,0
PF15304,PF01430:PF05100:PF09444,1,2,0,1,2,1015,0.0,1.0,0.0,-0.0,0,0,1,0,1017,0,1.0,0.0,0
PF07468,PF01117:PF02278:PF03648,4,5,0,4,5,1009,0.0,0.99,0.0,-0.0,0,0,4,0,1014,0,1.0,0.0,0
PF11894,PF04704:PF11899:PF16875,11,7,2,9,5,1002,0.29,0.99,0.18,0.22,0,0,11,0,1007,0,0.99,0.0,0
PF16496,PF16498:PF07988:PF16495,7,11,6,1,5,1006,0.55,0.99,0.86,0.68,5,4,3,1,1010,0.8,1.0,0.57,0.67
PF14719,PF13908:PF09783:PF11527,4,22,1,3,21,993,0.05,0.98,0.25,0.1,1,1,3,0,1014,1.0,1.0,0.25,0.5
PF07717,PF04408:PF04568:PF08148,70,83,69,1,14,934,0.83,0.99,0.99,0.9,8,8,62,0,948,1.0,0.94,0.11,0.33
PF15901,PF15902:PF09067:PF06328,9,14,9,0,5,1004,0.64,1.0,1.0,0.8,4,4,5,0,1009,1.0,1.0,0.44,0.67
PF13902,PF12752:PF01422:PF01424,9,44,7,2,37,972,0.16,0.96,0.78,0.34,13,4,5,9,1000,0.31,0.99,0.44,0.36
PF05048,PF02617:PF02207:PF12014,4,13,4,0,9,1005,0.31,0.99,1.0,0.55,5,3,1,2,1012,0.6,1.0,0.75,0.67
PF17004,PF13174:PF05279:PF08492,7,18,6,1,12,999,0.33,0.99,0.86,0.53,4,4,3,0,1011,1.0,1.0,0.57,0.75
PF05403,PF03973:PF12238:PF06951,0,11,0,0,11,1007,0.0,0.99,0,0,0,0,0,0,1018,0,1.0,0,0
PF01757,PF04515:PF01755:PF07162,33,35,8,25,27,958,0.23,0.95,0.24,0.21,5,3,30,2,983,0.6,0.97,0.09,0.23
PF11805,PF08228:PF17032:PF05419,0,3,0,0,3,1015,0.0,1.0,0,0,0,0,0,0,1018,0,1.0,0,0
PF12811,PF11211:PF14109:PF12840,0,0,0,0,0,1018,0,1.0,0,0,0,0,0,0,1018,0,1.0,0,0
PF00109,PF02801:PF08242:PF14765,60,71,59,1,12,946,0.83,0.99,0.98,0.9,36,34,26,2,956,0.94,0.97,0.57,0.72
PF16012,PF07530:PF12259:PF07245,9,11,2,7,9,1000,0.18,0.98,0.22,0.19,4,1,8,3,1006,0.25,0.99,0.11,0.16
PF16421,PF08781:PF02319:PF04855,8,30,7,1,23,987,0.23,0.98,0.88,0.44,15,3,5,12,998,0.2,0.98,0.38,0.27
PF12968,PF05979:PF12188:PF04529,3,2,1,2,1,1014,0.5,1.0,0.33,0.41,0,0,3,0,1015,0,1.0,0.0,0
PF09755,PF04139:PF04939:PF11945,4,21,2,2,19,995,0.1,0.98,0.5,0.21,3,1,3,2,1012,0.33,1.0,0.25,0.29
PF11020,PF14959:PF12612:PF08168,0,14,0,0,14,1004,0.0,0.99,0,0,0,0,0,0,1018,0,1.0,0,0
PF03268,PF15556:PF01947:PF15838,0,0,0,0,0,1018,0,1.0,0,0,0,0,0,0,1018,0,1.0,0,0
PF04532,PF05299:PF15662:PF05962,1,1,0,1,1,1016,0.0,1.0,0.0,-0.0,0,0,1,0,1017,0,1.0,0.0,0
PF03060,PF06052:PF01259:PF09339,23,23,7,16,16,979,0.3,0.97,0.3,0.29,1,1,22,0,995,1.0,0.98,0.04,0.21
PF10189,PF02213:PF12422:PF14738,8,20,2,6,18,992,0.1,0.98,0.25,0.15,1,1,7,0,1010,1.0,0.99,0.12,0.35
PF04520,PF06376:PF00321:PF05915,0,4,0,0,4,1014,0.0,1.0,0,0,0,0,0,0,1018,0,1.0,0,0
PF00564,PF13240:PF02196:PF08926,38,18,10,28,8,972,0.56,0.96,0.26,0.37,6,6,32,0,980,1.0,0.97,0.16,0.39
PF07686,PF08205:PF13895:PF03921,57,43,27,30,16,945,0.63,0.95,0.47,0.52,15,11,46,4,957,0.73,0.95,0.19,0.36
PF13240,PF12202:PF16797:PF08587,5,19,3,2,16,997,0.16,0.98,0.6,0.3,4,2,3,2,1011,0.5,1.0,0.4,0.44
PF09481,PF15355:PF15662:PF02119,0,2,0,0,2,1016,0.0,1.0,0,0,0,0,0,0,1018,0,1.0,0,0
PF04752,PF05910:PF01327:PF02391,11,24,5,6,19,988,0.21,0.98,0.45,0.3,3,2,9,1,1006,0.67,0.99,0.18,0.34
PF02146,PF04574:PF16815:PF10275,51,15,14,37,1,966,0.93,0.96,0.27,0.5,4,4,47,0,967,1.0,0.95,0.08,0.27
PF12298,PF09282:PF00212:PF14769,6,6,1,5,5,1007,0.17,0.99,0.17,0.16,0,0,6,0,1012,0,0.99,0.0,0
PF02677,PF01312:PF08707:PF03244,2,1,0,2,1,1015,0.0,1.0,0.0,-0.0,0,0,2,0,1016,0,1.0,0.0,0
PF09826,PF07409:PF04717:PF04963,2,1,1,1,0,1016,1.0,1.0,0.5,0.71,0,0,2,0,1016,0,1.0,0.0,0
PF04488,PF04572:PF13679:PF13344,30,41,11,19,30,958,0.27,0.95,0.37,0.29,11,6,24,5,983,0.55,0.97,0.2,0.32
PF14685,PF04225:PF12883:PF08437,1,9,0,1,9,1008,0.0,0.99,0.0,-0.0,1,0,1,1,1016,0.0,1.0,0.0,-0.0
PF04386,PF09772:PF11461:PF00336,0,18,0,0,18,1000,0.0,0.98,0,0,0,0,0,0,1018,0,1.0,0,0
PF11379,PF14328:PF01475:PF04052,1,4,0,1,4,1013,0.0,1.0,0.0,-0.0,0,0,1,0,1017,0,1.0,0.0,0
PF08586,PF05204:PF09249:PF03848,0,7,0,0,7,1011,0.0,0.99,0,0,0,0,0,0,1018,0,1.0,0,0
PF09479,PF01436:PF08239:PF12126,1,43,1,0,42,975,0.02,0.96,1.0,0.15,6,1,0,5,1012,0.17,1.0,1.0,0.41
PF14573,PF08093:PF15775:PF09361,0,1,0,0,1,1017,0.0,1.0,0,0,0,0,0,0,1018,0,1.0,0,0
PF02667,PF08726:PF13599:PF10335,0,17,0,0,17,1001,0.0,0.98,0,0,1,0,0,1,1017,0.0,1.0,0,0
PF02657,PF00358:PF07361:PF09863,3,15,0,3,15,1000,0.0,0.98,0.0,-0.01,0,0,3,0,1015,0,1.0,0.0,0
PF10476,PF05177:PF15509:PF06752,0,8,0,0,8,1010,0.0,0.99,0,0,1,0,0,1,1017,0.0,1.0,0,0
PF01723,PF06679:PF16981:PF15475,1,1,0,1,1,1016,0.0,1.0,0.0,-0.0,0,0,1,0,1017,0,1.0,0.0,0
PF12115,PF06912:PF10839:PF00537,0,4,0,0,4,1014,0.0,1.0,0,0,0,0,0,0,1018,0,1.0,0,0
PF07943,PF00768:PF08275:PF01807,6,12,6,0,6,1006,0.5,0.99,1.0,0.71,5,1,5,4,1008,0.2,0.99,0.17,0.18
PF12170,PF03525:PF04965:PF08795,1,0,0,1,0,1017,0,1.0,0.0,0,0,0,1,0,1017,0,1.0,0.0,0
PF15207,PF06573:PF01752:PF15343,1,3,0,1,3,1014,0.0,1.0,0.0,-0.0,1,0,1,1,1016,0.0,1.0,0.0,-0.0
PF07333,PF11264:PF00537:PF06351,1,4,0,1,4,1013,0.0,1.0,0.0,-0.0,0,0,1,0,1017,0,1.0,0.0,0
PF05693,PF16969:PF07767:PF09751,9,21,3,6,18,991,0.14,0.98,0.33,0.21,6,2,7,4,1005,0.33,0.99,0.22,0.27
PF15444,PF15130:PF15872:PF17085,0,1,0,0,1,1017,0.0,1.0,0,0,0,0,0,0,1018,0,1.0,0,0
PF05053,PF14674:PF14677:PF14679,2,1,0,2,1,1015,0.0,1.0,0.0,-0.0,1,0,2,1,1015,0.0,1.0,0.0,-0.0
PF02770,PF00441:PF02771:PF08028,67,61,59,8,2,949,0.97,0.99,0.88,0.92,57,56,11,1,950,0.98,0.99,0.84,0.9
PF03030,PF01559:PF07712:PF03331,12,2,0,12,2,1004,0.0,0.99,0.0,-0.0,0,0,12,0,1006,0,0.99,0.0,0
PF03385,PF02219:PF02408:PF10155,1,15,0,1,15,1002,0.0,0.98,0.0,-0.0,1,0,1,1,1016,0.0,1.0,0.0,-0.0
PF04139,PF09755:PF05346:PF04939,11,22,6,5,16,991,0.27,0.98,0.55,0.38,4,2,9,2,1005,0.5,0.99,0.18,0.3
PF16102,PF08035:PF00976:PF08384,0,0,0,0,0,1018,0,1.0,0,0,0,0,0,0,1018,0,1.0,0,0
PF01551,PF01476:PF03427:PF05938,14,45,6,8,39,965,0.13,0.95,0.43,0.22,6,2,12,4,1000,0.33,0.98,0.14,0.21
PF16276,PF14186:PF08365:PF06540,2,6,0,2,6,1010,0.0,0.99,0.0,-0.0,1,0,2,1,1015,0.0,1.0,0.0,-0.0
PF00930,PF02897:PF07676:PF00326,13,57,13,0,44,961,0.23,0.96,1.0,0.47,24,8,5,16,989,0.33,0.98,0.62,0.44
PF08622,PF17187:PF08309:PF02537,2,10,2,0,8,1008,0.2,0.99,1.0,0.45,0,0,2,0,1016,0,1.0,0.0,0
PF01467,PF01121:PF07072:PF13656,37,21,12,25,9,972,0.57,0.97,0.32,0.41,9,8,29,1,980,0.89,0.97,0.22,0.43
PF13144,PF12446:PF11039:PF13451,0,2,0,0,2,1016,0.0,1.0,0,0,0,0,0,0,1018,0,1.0,0,0
PF13257,PF15934:PF15821:PF12240,4,1,0,4,1,1013,0.0,1.0,0.0,-0.0,0,0,4,0,1014,0,1.0,0.0,0
PF04178,PF03208:PF00810:PF04176,13,24,7,6,17,988,0.29,0.98,0.54,0.39,5,4,9,1,1004,0.8,0.99,0.31,0.49
PF10232,PF07406:PF10273:PF05308,9,10,4,5,6,1003,0.4,0.99,0.44,0.42,0,0,9,0,1009,0,0.99,0.0,0
PF08172,PF15908:PF03801:PF07989,3,21,0,3,21,994,0.0,0.98,0.0,-0.01,5,0,3,5,1010,0.0,0.99,0.0,-0.0
PF01299,PF04145:PF01138:PF03725,21,72,13,8,59,938,0.18,0.93,0.62,0.31,30,12,9,18,979,0.4,0.97,0.57,0.47
PF00466,PF03647:PF04769:PF11735,19,22,7,12,15,984,0.32,0.97,0.37,0.33,2,2,17,0,999,1.0,0.98,0.11,0.32
PF12485,PF16533:PF16600:PF07647,1,41,1,0,40,977,0.02,0.96,1.0,0.15,2,1,0,1,1016,0.5,1.0,1.0,0.71
PF13851,PF12180:PF13870:PF13166,3,4,0,3,4,1011,0.0,0.99,0.0,-0.0,0,0,3,0,1015,0,1.0,0.0,0
PF05002,PF09032:PF16273:PF14050,20,4,2,18,2,996,0.5,0.98,0.1,0.22,0,0,20,0,998,0,0.98,0.0,0
PF02252,PF02251:PF16565:PF03665,12,10,7,5,3,1003,0.7,0.99,0.58,0.64,2,2,10,0,1006,1.0,0.99,0.17,0.41
PF15468,PF05840:PF08808:PF17076,3,0,0,3,0,1015,0,1.0,0.0,0,0,0,3,0,1015,0,1.0,0.0,0
PF08192,PF17017:PF15046:PF10563,0,4,0,0,4,1014,0.0,1.0,0,0,0,0,0,0,1018,0,1.0,0,0
PF01040,PF09335:PF07542:PF02636,36,39,13,23,26,956,0.33,0.95,0.36,0.32,5,4,32,1,981,0.8,0.97,0.11,0.29
PF05280,PF12241:PF03831:PF09826,4,3,1,3,2,1012,0.33,1.0,0.25,0.29,0,0,4,0,1014,0,1.0,0.0,0
PF11427,PF13936:PF16087:PF09339,10,31,7,3,24,984,0.23,0.97,0.7,0.39,6,4,6,2,1006,0.67,0.99,0.4,0.51
PF15046,PF08945:PF07392:PF15175,3,0,0,3,0,1015,0,1.0,0.0,0,0,0,3,0,1015,0,1.0,0.0,0
PF06789,PF14251:PF15775:PF15480,2,3,0,2,3,1013,0.0,1.0,0.0,-0.0,0,0,2,0,1016,0,1.0,0.0,0
PF16114,PF00549:PF08442:PF02629,5,32,5,0,27,986,0.16,0.97,1.0,0.39,24,5,0,19,994,0.21,0.98,1.0,0.45
PF02170,PF08699:PF16486:PF02171,44,55,43,1,12,962,0.78,0.99,0.98,0.87,40,37,7,3,971,0.93,0.99,0.84,0.88
PF07112,PF07390:PF09361:PF01913,0,1,0,0,1,1017,0.0,1.0,0,0,0,0,0,0,1018,0,1.0,0,0
PF15242,PF04714:PF07052:PF15991,1,15,0,1,15,1002,0.0,0.98,0.0,-0.0,0,0,1,0,1017,0,1.0,0.0,0
PF15424,PF14882:PF06798:PF06403,0,1,0,0,1,1017,0.0,1.0,0,0,0,0,0,0,1018,0,1.0,0,0
PF08121,PF07277:PF03594:PF08547,1,17,0,1,17,1000,0.0,0.98,0.0,-0.0,0,0,1,0,1017,0,1.0,0.0,0
PF12308,PF02191:PF12287:PF02449,2,24,1,1,23,993,0.04,0.98,0.5,0.14,1,0,2,1,1015,0.0,1.0,0.0,-0.0
PF14831,PF09804:PF16550:PF02112,2,10,2,0,8,1008,0.2,0.99,1.0,0.45,0,0,2,0,1016,0,1.0,0.0,0
PF01200,PF15216:PF08092:PF02943,12,3,0,12,3,1003,0.0,0.99,0.0,-0.01,0,0,12,0,1006,0,0.99,0.0,0
PF08348,PF03255:PF11559:PF07540,0,21,0,0,21,997,0.0,0.98,0,0,1,0,0,1,1017,0.0,1.0,0,0
PF04839,PF00468:PF00127:PF10542,1,8,1,0,7,1010,0.12,0.99,1.0,0.35,0,0,1,0,1017,0,1.0,0.0,0
PF06050,PF09989:PF17192:PF02056,0,8,0,0,8,1010,0.0,0.99,0,0,0,0,0,0,1018,0,1.0,0,0
PF04658,PF10234:PF09728:PF10595,10,14,3,7,11,997,0.21,0.98,0.3,0.24,3,2,8,1,1007,0.67,0.99,0.2,0.36
PF04515,PF01757:PF06237:PF10155,15,40,7,8,33,970,0.17,0.96,0.47,0.27,2,1,14,1,1002,0.5,0.99,0.07,0.18
PF02097,PF05901:PF06725:PF06355,0,3,0,0,3,1015,0.0,1.0,0,0,0,0,0,0,1018,0,1.0,0,0
PF14678,PF14674:PF14680:PF14676,4,1,1,3,0,1014,1.0,1.0,0.25,0.5,1,1,3,0,1014,1.0,1.0,0.25,0.5
PF09743,PF08638:PF15917:PF04118,4,17,1,3,16,998,0.06,0.98,0.25,0.11,1,0,4,1,1013,0.0,1.0,0.0,-0.0
PF02419,PF00284:PF03023:PF09044,1,12,1,0,11,1006,0.08,0.99,1.0,0.29,0,0,1,0,1017,0,1.0,0.0,0
PF08084,PF12134:PF08083:PF10596,13,18,13,0,5,1000,0.72,1.0,1.0,0.85,17,13,0,4,1001,0.76,1.0,1.0,0.87
PF09328,PF05023:PF02670:PF08125,2,26,2,0,24,992,0.08,0.98,1.0,0.27,1,0,2,1,1015,0.0,1.0,0.0,-0.0
PF00450,PF05388:PF00694:PF00141,53,61,25,28,36,929,0.41,0.94,0.47,0.41,9,5,48,4,961,0.56,0.95,0.09,0.21
PF04336,PF12854:PF16930:PF00292,1,65,0,1,65,952,0.0,0.94,0.0,-0.01,6,0,1,6,1011,0.0,0.99,0.0,-0.0
PF11300,PF16872:PF00524:PF02108,1,4,1,0,3,1014,0.25,1.0,1.0,0.5,0,0,1,0,1017,0,1.0,0.0,0
PF10413,PF09193:PF03827:PF08983,3,2,1,2,1,1014,0.5,1.0,0.33,0.41,1,1,2,0,1015,1.0,1.0,0.33,0.58
PF01740,PF00916:PF12036:PF16748,35,39,31,4,8,975,0.79,0.99,0.89,0.83,0,0,35,0,983,0,0.97,0.0,0
PF09669,PF01312:PF15727:PF02413,1,0,0,1,0,1017,0,1.0,0.0,0,0,0,1,0,1017,0,1.0,0.0,0
PF17054,PF08444:PF08140:PF03768,6,3,0,6,3,1009,0.0,0.99,0.0,-0.0,0,0,6,0,1012,0,0.99,0.0,0
PF01624,PF05188:PF05192:PF05190,28,39,27,1,12,978,0.69,0.99,0.96,0.81,28,27,1,1,989,0.96,1.0,0.96,0.96
PF08751,PF13610:PF15662:PF15155,4,5,0,4,5,1009,0.0,0.99,0.0,-0.0,0,0,4,0,1014,0,1.0,0.0,0
PF15860,PF08561:PF01632:PF04716,6,21,0,6,21,991,0.0,0.97,0.0,-0.01,2,0,6,2,1010,0.0,0.99,0.0,-0.0
PF09907,PF07769:PF04264:PF15203,1,1,0,1,1,1016,0.0,1.0,0.0,-0.0,0,0,1,0,1017,0,1.0,0.0,0
PF03168,PF06749:PF14547:PF04535,12,11,7,5,4,1002,0.64,0.99,0.58,0.6,2,2,10,0,1006,1.0,0.99,0.17,0.41
PF03235,PF13810:PF16071:PF11223,4,2,1,3,1,1013,0.5,1.0,0.25,0.35,0,0,4,0,1014,0,1.0,0.0,0
PF10143,PF06415:PF07195:PF13280,4,6,2,2,4,1010,0.33,0.99,0.5,0.41,0,0,4,0,1014,0,1.0,0.0,0
PF15019,PF08598:PF01160:PF10332,1,7,0,1,7,1010,0.0,0.99,0.0,-0.0,0,0,1,0,1017,0,1.0,0.0,0
PF14328,PF01752:PF15483:PF06070,0,4,0,0,4,1014,0.0,1.0,0,0,0,0,0,0,1018,0,1.0,0,0
PF06817,PF13655:PF08388:PF12009,5,12,3,2,9,1004,0.25,0.99,0.6,0.38,6,1,4,5,1008,0.17,0.99,0.2,0.18
PF00226,PF11926:PF16669:PF05154,113,22,19,94,3,902,0.86,0.9,0.17,0.36,3,3,110,0,905,1.0,0.89,0.03,0.15
PF13866,PF15285:PF15689:PF15690,1,1,0,1,1,1016,0.0,1.0,0.0,-0.0,0,0,1,0,1017,0,1.0,0.0,0
PF06841,PF02511:PF09428:PF02522,0,4,0,0,4,1014,0.0,1.0,0,0,0,0,0,0,1018,0,1.0,0,0
PF02342,PF16562:PF08151:PF15625,4,12,1,3,11,1003,0.08,0.99,0.25,0.14,1,1,3,0,1014,1.0,1.0,0.25,0.5
PF05671,PF04764:PF15851:PF15150,2,0,0,2,0,1016,0,1.0,0.0,0,0,0,2,0,1016,0,1.0,0.0,0
PF02384,PF06250:PF12161:PF06122,5,2,2,3,0,1013,1.0,1.0,0.4,0.63,2,2,3,0,1013,1.0,1.0,0.4,0.63
PF01769,PF03448:PF12260:PF06312,6,16,3,3,13,999,0.19,0.98,0.5,0.3,1,1,5,0,1012,1.0,1.0,0.17,0.41
PF03820,PF03248:PF03690:PF14941,16,16,5,11,11,991,0.31,0.98,0.31,0.3,2,2,14,0,1002,1.0,0.99,0.12,0.35
PF02866,PF00056:PF07258:PF01731,22,40,20,2,20,976,0.5,0.98,0.91,0.67,2,1,21,1,995,0.5,0.98,0.05,0.15
PF10077,PF14983:PF04350:PF13746,4,6,1,3,5,1009,0.17,0.99,0.25,0.2,0,0,4,0,1014,0,1.0,0.0,0
PF00857,PF14923:PF13499:PF00886,36,128,26,10,102,880,0.2,0.89,0.72,0.34,5,4,32,1,981,0.8,0.97,0.11,0.29
PF09676,PF00994:PF01802:PF07295,0,37,0,0,37,981,0.0,0.96,0,0,0,0,0,0,1018,0,1.0,0,0
PF05935,PF11316:PF08453:PF17164,2,2,0,2,2,1014,0.0,1.0,0.0,-0.0,0,0,2,0,1016,0,1.0,0.0,0
PF08496,PF10108:PF07326:PF16586,3,2,1,2,1,1014,0.5,1.0,0.33,0.41,0,0,3,0,1015,0,1.0,0.0,0
PF03402,PF00143:PF00124:PF12020,3,3,0,3,3,1012,0.0,0.99,0.0,-0.0,0,0,3,0,1015,0,1.0,0.0,0
PF01839,PF08441:PF00882:PF01788,19,17,17,2,0,999,1.0,1.0,0.89,0.94,0,0,19,0,999,0,0.98,0.0,0
PF07858,PF06243:PF00890:PF17023,0,48,0,0,48,970,0.0,0.95,0,0,0,0,0,0,1018,0,1.0,0,0
PF13007,PF03050:PF07476:PF14882,0,0,0,0,0,1018,0,1.0,0,0,0,0,0,0,1018,0,1.0,0,0
PF05404,PF02752:PF10937:PF00532,3,35,1,2,34,981,0.03,0.96,0.33,0.09,2,0,3,2,1013,0.0,1.0,0.0,-0.0
PF05099,PF15990:PF00684:PF15820,0,6,0,0,6,1012,0.0,0.99,0,0,0,0,0,0,1018,0,1.0,0,0
PF00435,PF16901:PF10541:PF16350,42,23,8,34,15,961,0.35,0.95,0.19,0.23,3,2,40,1,975,0.67,0.96,0.05,0.17
PF15763,PF01668:PF01312:PF14251,0,4,0,0,4,1014,0.0,1.0,0,0,0,0,0,0,1018,0,1.0,0,0
PF01822,PF11790:PF09362:PF02485,50,30,18,32,12,956,0.6,0.96,0.36,0.44,4,4,46,0,968,1.0,0.95,0.08,0.28
PF15905,PF17045:PF15908:PF10205,1,6,1,0,5,1012,0.17,1.0,1.0,0.41,1,1,0,0,1017,1.0,1.0,1.0,1.0
PF14824,PF13241:PF14823:PF10414,10,10,10,0,0,1008,1.0,1.0,1.0,1.0,8,8,2,0,1008,1.0,1.0,0.8,0.89
PF10992,PF16649:PF15211:PF15972,2,1,0,2,1,1015,0.0,1.0,0.0,-0.0,0,0,2,0,1016,0,1.0,0.0,0
PF01439,PF05659:PF12061:PF11835,5,6,3,2,3,1010,0.5,1.0,0.6,0.55,1,1,4,0,1013,1.0,1.0,0.2,0.45
PF04770,PF03479:PF02234:PF07052,6,23,4,2,19,993,0.17,0.98,0.67,0.33,3,1,5,2,1010,0.33,0.99,0.17,0.23
PF15990,PF15820:PF05099:PF00684,4,2,0,4,2,1012,0.0,0.99,0.0,-0.0,0,0,4,0,1014,0,1.0,0.0,0
PF02928,PF02375:PF08429:PF10497,10,29,10,0,19,989,0.34,0.98,1.0,0.58,11,9,1,2,1006,0.82,1.0,0.9,0.86
PF01521,PF01025:PF07896:PF07816,19,20,5,14,15,984,0.25,0.97,0.26,0.24,0,0,19,0,999,0,0.98,0.0,0
PF16040,PF03359:PF05508:PF14909,7,13,1,6,12,999,0.08,0.98,0.14,0.1,1,1,6,0,1011,1.0,0.99,0.14,0.38
PF05911,PF03468:PF04108:PF03470,0,7,0,0,7,1011,0.0,0.99,0,0,3,0,0,3,1015,0.0,1.0,0,0
PF15105,PF03050:PF05797:PF09669,0,1,0,0,1,1017,0.0,1.0,0,0,0,0,0,0,1018,0,1.0,0,0
PF08513,PF04494:PF11540:PF12341,26,20,12,14,8,984,0.6,0.98,0.46,0.52,2,2,24,0,992,1.0,0.98,0.08,0.27
PF15529,PF09611:PF04717:PF07805,0,1,0,0,1,1017,0.0,1.0,0,0,0,0,0,0,1018,0,1.0,0,0
PF04881,PF11593:PF10459:PF01882,1,4,0,1,4,1013,0.0,1.0,0.0,-0.0,0,0,1,0,1017,0,1.0,0.0,0
PF01933,PF11264:PF12900:PF15370,5,9,2,3,7,1006,0.22,0.99,0.4,0.29,0,0,5,0,1013,0,1.0,0.0,0
PF00595,PF00625:PF09058:PF06456,115,50,35,80,15,888,0.7,0.91,0.3,0.42,6,6,109,0,903,1.0,0.89,0.05,0.22
PF08388,PF13655:PF06817:PF08284,6,29,6,0,23,989,0.21,0.98,1.0,0.45,4,3,3,1,1011,0.75,1.0,0.5,0.61
PF06360,PF15091:PF05736:PF15770,0,0,0,0,0,1018,0,1.0,0,0,0,0,0,0,1018,0,1.0,0,0
PF16763,PF11260:PF14494:PF06756,0,0,0,0,0,1018,0,1.0,0,0,0,0,0,0,1018,0,1.0,0,0
PF13581,PF02329:PF11386:PF02420,0,1,0,0,1,1017,0.0,1.0,0,0,0,0,0,0,1018,0,1.0,0,0
PF03636,PF03633:PF03632:PF06165,4,11,4,0,7,1007,0.36,0.99,1.0,0.6,1,1,3,0,1014,1.0,1.0,0.25,0.5
PF03864,PF02924:PF11767:PF02748,1,9,0,1,9,1008,0.0,0.99,0.0,-0.0,0,0,1,0,1017,0,1.0,0.0,0
PF13884,PF13887:PF13888:PF05224,8,16,6,2,10,1000,0.38,0.99,0.75,0.53,6,6,2,0,1010,1.0,1.0,0.75,0.87
PF04615,PF01280:PF11309:PF05129,17,25,5,12,20,981,0.2,0.97,0.29,0.23,1,1,16,0,1001,1.0,0.98,0.06,0.24
PF01427,PF07930:PF11954:PF07311,4,6,0,4,6,1008,0.0,0.99,0.0,-0.0,0,0,4,0,1014,0,1.0,0.0,0
PF12929,PF10252:PF10067:PF06500,11,2,0,11,2,1005,0.0,0.99,0.0,-0.0,1,0,11,1,1006,0.0,0.99,0.0,-0.0
PF12153,PF02070:PF15482:PF15762,0,0,0,0,0,1018,0,1.0,0,0,0,0,0,0,1018,0,1.0,0,0
PF09327,PF12256:PF12421:PF07523,0,0,0,0,0,1018,0,1.0,0,0,0,0,0,0,1018,0,1.0,0,0
PF12203,PF09757:PF15778:PF15090,2,10,1,1,9,1007,0.1,0.99,0.5,0.22,0,0,2,0,1016,0,1.0,0.0,0
PF06415,PF10143:PF01676:PF05038,4,16,4,0,12,1002,0.25,0.99,1.0,0.5,6,2,2,4,1010,0.33,0.99,0.5,0.41
PF05645,PF08221:PF00940:PF14881,6,23,5,1,18,994,0.22,0.98,0.83,0.42,4,3,3,1,1011,0.75,1.0,0.5,0.61
PF01813,PF16054:PF03874:PF12271,7,18,1,6,17,994,0.06,0.98,0.14,0.08,3,0,7,3,1008,0.0,0.99,0.0,-0.0
PF10585,PF16190:PF16191:PF16195,4,5,3,1,2,1012,0.6,1.0,0.75,0.67,3,3,1,0,1014,1.0,1.0,0.75,0.87
PF05317,PF17062:PF11044:PF12388,0,0,0,0,0,1018,0,1.0,0,0,0,0,0,0,1018,0,1.0,0,0
PF02144,PF01282:PF01273:PF08315,9,31,5,4,26,983,0.16,0.97,0.56,0.29,2,1,8,1,1008,0.5,0.99,0.11,0.23
PF10127,PF07805:PF09108:PF03241,1,1,0,1,1,1016,0.0,1.0,0.0,-0.0,0,0,1,0,1017,0,1.0,0.0,0
PF14072,PF09967:PF11542:PF05100,1,3,0,1,3,1014,0.0,1.0,0.0,-0.0,0,0,1,0,1017,0,1.0,0.0,0
PF14802,PF09496:PF08286:PF01730,0,6,0,0,6,1012,0.0,0.99,0,0,0,0,0,0,1018,0,1.0,0,0
PF09193,PF10413:PF12109:PF03827,1,5,1,0,4,1013,0.2,1.0,1.0,0.45,1,1,0,0,1017,1.0,1.0,1.0,1.0
PF07836,PF13809:PF08502:PF01313,2,9,1,1,8,1008,0.11,0.99,0.5,0.23,0,0,2,0,1016,0,1.0,0.0,0
PF08497,PF07805:PF02465:PF10908,0,1,0,0,1,1017,0.0,1.0,0,0,0,0,0,0,1018,0,1.0,0,0
PF15008,PF05497:PF14935:PF12020,0,7,0,0,7,1011,0.0,0.99,0,0,0,0,0,0,1018,0,1.0,0,0
PF15489,PF11277:PF01930:PF11229,3,9,2,1,7,1008,0.22,0.99,0.67,0.38,1,1,2,0,1015,1.0,1.0,0.33,0.58
PF07247,PF07350:PF12311:PF12239,15,13,2,13,11,992,0.15,0.98,0.13,0.13,3,2,13,1,1002,0.67,0.99,0.13,0.29
PF06379,PF12081:PF08479:PF04865,1,0,0,1,0,1017,0,1.0,0.0,0,0,0,1,0,1017,0,1.0,0.0,0
PF00946,PF14318:PF12255:PF02748,5,6,4,1,2,1011,0.67,1.0,0.8,0.73,0,0,5,0,1013,0,1.0,0.0,0
PF05527,PF08718:PF08174:PF05361,6,20,2,4,18,994,0.1,0.98,0.33,0.17,5,2,4,3,1009,0.4,0.99,0.33,0.36
PF03359,PF15279:PF04087:PF14909,9,4,0,9,4,1005,0.0,0.99,0.0,-0.01,0,0,9,0,1009,0,0.99,0.0,0
PF07891,PF15235:PF15093:PF09038,1,3,0,1,3,1014,0.0,1.0,0.0,-0.0,0,0,1,0,1017,0,1.0,0.0,0
PF01940,PF07110:PF12680:PF12311,9,19,5,4,14,995,0.26,0.98,0.56,0.37,4,2,7,2,1007,0.5,0.99,0.22,0.33
PF12237,PF09445:PF11547:PF10258,4,19,3,1,16,998,0.16,0.98,0.75,0.34,5,2,2,3,1011,0.4,1.0,0.5,0.44
PF06689,PF00574:PF10335:PF01346,3,21,3,0,18,997,0.14,0.98,1.0,0.37,3,0,3,3,1012,0.0,0.99,0.0,-0.0
PF12566,PF04052:PF11379:PF11870,2,1,0,2,1,1015,0.0,1.0,0.0,-0.0,0,0,2,0,1016,0,1.0,0.0,0
PF03600,PF00939:PF03124:PF02656,6,38,4,2,34,978,0.11,0.96,0.67,0.26,8,1,5,7,1005,0.12,0.99,0.17,0.14
PF11965,PF02514:PF03709:PF03738,2,3,1,1,2,1014,0.33,1.0,0.5,0.41,0,0,2,0,1016,0,1.0,0.0,0
PF16967,PF07434:PF15976:PF09361,0,0,0,0,0,1018,0,1.0,0,0,0,0,0,0,1018,0,1.0,0,0
PF12372,PF14952:PF15912:PF12231,6,7,0,6,7,1005,0.0,0.99,0.0,-0.01,0,0,6,0,1012,0,0.99,0.0,0
PF17108,PF17005:PF10647:PF11549,1,3,1,0,2,1015,0.33,1.0,1.0,0.58,1,1,0,0,1017,1.0,1.0,1.0,1.0
PF07677,PF01835:PF07703:PF01821,14,13,11,3,2,1002,0.85,1.0,0.79,0.81,10,10,4,0,1004,1.0,1.0,0.71,0.84
PF01361,PF09500:PF02801:PF05366,1,59,0,1,59,958,0.0,0.94,0.0,-0.01,0,0,1,0,1017,0,1.0,0.0,0
PF16158,PF16577:PF04718:PF00569,11,47,6,5,41,966,0.13,0.95,0.55,0.25,5,3,8,2,1005,0.6,0.99,0.27,0.4
PF02578,PF01669:PF12153:PF02070,2,1,0,2,1,1015,0.0,1.0,0.0,-0.0,0,0,2,0,1016,0,1.0,0.0,0
PF11092,PF15482:PF11863:PF06724,0,0,0,0,0,1018,0,1.0,0,0,0,0,0,0,1018,0,1.0,0,0
PF06367,PF06371:PF06345:PF06346,24,24,23,1,1,993,0.96,1.0,0.96,0.96,4,4,20,0,994,1.0,0.98,0.17,0.4
PF06477,PF08212:PF02958:PF03997,9,38,5,4,33,976,0.13,0.96,0.56,0.26,5,1,8,4,1005,0.2,0.99,0.11,0.14
PF09041,PF15557:PF02213:PF07001,3,17,1,2,16,999,0.06,0.98,0.33,0.13,4,0,3,4,1011,0.0,0.99,0.0,-0.0
PF06229,PF14941:PF15053:PF10166,8,2,1,7,1,1009,0.5,0.99,0.12,0.25,2,1,7,1,1009,0.5,0.99,0.12,0.25
PF02042,PF04576:PF16043:PF05997,9,21,3,6,18,991,0.14,0.98,0.33,0.21,2,2,7,0,1009,1.0,0.99,0.22,0.47
PF02975,PF03241:PF07434:PF16861,3,3,0,3,3,1012,0.0,0.99,0.0,-0.0,0,0,3,0,1015,0,1.0,0.0,0
PF10079,PF07495:PF14328:PF11863,0,1,0,0,1,1017,0.0,1.0,0,0,0,0,0,0,1018,0,1.0,0,0
PF16562,PF15625:PF16056:PF08151,5,10,1,4,9,1004,0.1,0.99,0.2,0.14,1,1,4,0,1013,1.0,1.0,0.2,0.45
PF01709,PF07350:PF04176:PF06172,12,10,6,6,4,1002,0.6,0.99,0.5,0.54,1,1,11,0,1006,1.0,0.99,0.08,0.29
PF01187,PF15133:PF11105:PF08627,11,2,0,11,2,1005,0.0,0.99,0.0,-0.0,0,0,11,0,1007,0,0.99,0.0,0
PF09003,PF13356:PF14842:PF08298,2,3,1,1,2,1014,0.33,1.0,0.5,0.41,0,0,2,0,1016,0,1.0,0.0,0
PF14280,PF12835:PF09543:PF02388,1,2,1,0,1,1016,0.5,1.0,1.0,0.71,1,1,0,0,1017,1.0,1.0,1.0,1.0
PF03511,PF15865:PF11229:PF10493,0,6,0,0,6,1012,0.0,0.99,0,0,0,0,0,0,1018,0,1.0,0,0
PF09369,PF03880:PF03461:PF02559,7,6,2,5,4,1007,0.33,0.99,0.29,0.3,3,2,5,1,1010,0.67,0.99,0.29,0.43
PF02107,PF02501:PF06429:PF03963,2,4,2,0,2,1014,0.5,1.0,1.0,0.71,1,1,1,0,1016,1.0,1.0,0.5,0.71
PF10785,PF12853:PF07950:PF13241,4,19,3,1,16,998,0.16,0.98,0.75,0.34,0,0,4,0,1014,0,1.0,0.0,0
PF16168,PF15355:PF09611:PF10106,0,1,0,0,1,1017,0.0,1.0,0,0,0,0,0,0,1018,0,1.0,0,0
PF14659,PF05666:PF03592:PF14841,2,1,0,2,1,1015,0.0,1.0,0.0,-0.0,0,0,2,0,1016,0,1.0,0.0,0
PF09529,PF06798:PF03090:PF04463,0,2,0,0,2,1016,0.0,1.0,0,0,0,0,0,0,1018,0,1.0,0,0
PF02864,PF02865:PF01017:PF12610,4,4,3,1,1,1013,0.75,1.0,0.75,0.75,2,2,2,0,1014,1.0,1.0,0.5,0.71
PF04110,PF06388:PF14542:PF11779,8,8,2,6,6,1004,0.25,0.99,0.25,0.24,1,1,7,0,1010,1.0,0.99,0.12,0.35
PF05045,PF04196:PF15518:PF06458,0,1,0,0,1,1017,0.0,1.0,0,0,1,0,0,1,1017,0.0,1.0,0,0
PF03704,PF13464:PF14280:PF02388,2,3,1,1,2,1014,0.33,1.0,0.5,0.41,1,1,1,0,1016,1.0,1.0,0.5,0.71
PF09341,PF03073:PF15786:PF04299,8,14,2,6,12,998,0.14,0.98,0.25,0.18,0,0,8,0,1010,0,0.99,0.0,0
PF01594,PF09733:PF15627:PF13320,5,7,1,4,6,1007,0.14,0.99,0.2,0.16,0,0,5,0,1013,0,1.0,0.0,0
PF05236,PF08788:PF04589:PF12886,10,11,1,9,10,998,0.09,0.98,0.1,0.09,0,0,10,0,1008,0,0.99,0.0,0
PF12916,PF05552:PF11272:PF12101,1,0,0,1,0,1017,0,1.0,0.0,0,0,0,1,0,1017,0,1.0,0.0,0
PF09131,PF00419:PF11027:PF15709,0,3,0,0,3,1015,0.0,1.0,0,0,0,0,0,0,1018,0,1.0,0,0
PF15822,PF05299:PF02072:PF00555,1,2,0,1,2,1015,0.0,1.0,0.0,-0.0,0,0,1,0,1017,0,1.0,0.0,0
PF14361,PF02070:PF11124:PF13742,2,2,0,2,2,1014,0.0,1.0,0.0,-0.0,0,0,2,0,1016,0,1.0,0.0,0
PF08070,PF16898:PF00521:PF00986,4,25,4,0,21,993,0.16,0.98,1.0,0.4,13,4,0,9,1005,0.31,0.99,1.0,0.55
PF06292,PF10540:PF15625:PF01735,13,24,7,6,17,988,0.29,0.98,0.54,0.39,3,2,11,1,1004,0.67,0.99,0.15,0.32
PF13411,PF07739:PF10490:PF14917,4,6,1,3,5,1009,0.17,0.99,0.25,0.2,0,0,4,0,1014,0,1.0,0.0,0
PF07923,PF11882:PF16742:PF14022,7,8,6,1,2,1009,0.75,1.0,0.86,0.8,0,0,7,0,1011,0,0.99,0.0,0
PF11605,PF16988:PF04157:PF05026,5,19,5,0,14,999,0.26,0.99,1.0,0.51,6,3,2,3,1010,0.5,1.0,0.6,0.55
PF16313,PF03241:PF00700:PF13861,2,1,0,2,1,1015,0.0,1.0,0.0,-0.0,0,0,2,0,1016,0,1.0,0.0,0
PF03927,PF09092:PF05069:PF16448,0,2,0,0,2,1016,0.0,1.0,0,0,0,0,0,0,1018,0,1.0,0,0
PF00562,PF04561:PF04563:PF04565,22,25,19,3,6,990,0.76,0.99,0.86,0.81,16,16,6,0,996,1.0,0.99,0.73,0.85
PF15474,PF07833:PF06114:PF11975,1,15,0,1,15,1002,0.0,0.98,0.0,-0.0,2,0,1,2,1015,0.0,1.0,0.0,-0.0
PF01949,PF01527:PF11917:PF00331,0,24,0,0,24,994,0.0,0.98,0,0,3,0,0,3,1015,0.0,1.0,0,0
PF01780,PF04900:PF05254:PF06825,9,26,7,2,19,990,0.27,0.98,0.78,0.45,1,0,9,1,1008,0.0,0.99,0.0,-0.0
PF06299,PF03815:PF01825:PF00530,0,66,0,0,66,952,0.0,0.94,0,0,13,0,0,13,1005,0.0,0.99,0,0
PF15627,PF14959:PF13910:PF08216,2,8,0,2,8,1008,0.0,0.99,0.0,-0.0,0,0,2,0,1016,0,1.0,0.0,0
PF03702,PF12006:PF05870:PF11017,8,8,3,5,5,1005,0.38,0.99,0.38,0.37,0,0,8,0,1010,0,0.99,0.0,0
PF14961,PF15020:PF11229:PF15782,0,11,0,0,11,1007,0.0,0.99,0,0,0,0,0,0,1018,0,1.0,0,0
PF06178,PF11855:PF16741:PF03446,0,39,0,0,39,979,0.0,0.96,0,0,2,0,0,2,1016,0.0,1.0,0,0
PF00358,PF06780:PF10662:PF05128,9,2,1,8,1,1008,0.5,0.99,0.11,0.23,1,1,8,0,1009,1.0,0.99,0.11,0.33
PF14368,PF04720:PF14009:PF06749,15,21,6,9,15,988,0.29,0.98,0.4,0.33,2,2,13,0,1003,1.0,0.99,0.13,0.36
PF13903,PF03091:PF12020:PF09783,9,26,2,7,24,985,0.08,0.97,0.22,0.12,4,1,8,3,1006,0.25,0.99,0.11,0.16
PF02018,PF00331:PF08244:PF11837,7,23,4,3,19,992,0.17,0.98,0.57,0.31,4,0,7,4,1007,0.0,0.99,0.0,-0.01
PF14746,PF14745:PF14744:PF03894,5,10,5,0,5,1008,0.5,1.0,1.0,0.71,6,4,1,2,1011,0.67,1.0,0.8,0.73
PF05139,PF09424:PF14770:PF03576,0,9,0,0,9,1009,0.0,0.99,0,0,0,0,0,0,1018,0,1.0,0,0
PF06602,PF02893:PF02141:PF12335,35,58,16,19,42,941,0.28,0.94,0.46,0.33,13,9,26,4,979,0.69,0.97,0.26,0.41
PF02365,PF04577:PF15996:PF12576,30,28,9,21,19,969,0.32,0.96,0.3,0.29,3,2,28,1,987,0.67,0.97,0.07,0.2
PF12767,PF08652:PF05916:PF04143,3,24,2,1,22,993,0.08,0.98,0.67,0.23,5,1,2,4,1011,0.2,0.99,0.33,0.26
PF09216,PF08642:PF14494:PF16311,0,0,0,0,0,1018,0,1.0,0,0,0,0,0,0,1018,0,1.0,0,0
PF06666,PF11202:PF04391:PF04740,0,0,0,0,0,1018,0,1.0,0,0,0,0,0,0,1018,0,1.0,0,0
PF01067,PF00648:PF09149:PF13833,35,79,33,2,46,937,0.42,0.95,0.94,0.61,22,18,17,4,979,0.82,0.98,0.51,0.64
PF08600,PF07967:PF03715:PF02112,5,25,5,0,20,993,0.2,0.98,1.0,0.44,2,1,4,1,1012,0.5,1.0,0.2,0.31
PF08027,PF03784:PF12904:PF16720,1,1,1,0,0,1017,1.0,1.0,1.0,1.0,0,0,1,0,1017,0,1.0,0.0,0
PF15067,PF12527:PF10361:PF08014,4,1,0,4,1,1013,0.0,1.0,0.0,-0.0,0,0,4,0,1014,0,1.0,0.0,0
PF00829,PF07798:PF02291:PF03479,13,16,5,8,11,994,0.31,0.98,0.38,0.34,2,1,12,1,1004,0.5,0.99,0.08,0.19
PF13569,PF07560:PF07317:PF09070,0,8,0,0,8,1010,0.0,0.99,0,0,0,0,0,0,1018,0,1.0,0,0
PF07890,PF15063:PF06271:PF15364,5,2,1,4,1,1012,0.5,1.0,0.2,0.31,0,0,5,0,1013,0,1.0,0.0,0
PF02921,PF08802:PF09165:PF00848,15,16,8,7,8,995,0.5,0.99,0.53,0.51,2,2,13,0,1003,1.0,0.99,0.13,0.36
PF04669,PF14159:PF14547:PF01195,10,9,2,8,7,1001,0.22,0.99,0.2,0.2,0,0,10,0,1008,0,0.99,0.0,0
PF04204,PF03049:PF10062:PF00805,0,17,0,0,17,1001,0.0,0.98,0,0,0,0,0,0,1018,0,1.0,0,0
PF01620,PF14984:PF15138:PF07400,0,1,0,0,1,1017,0.0,1.0,0,0,0,0,0,0,1018,0,1.0,0,0
PF06463,PF16881:PF06969:PF01967,9,16,8,1,8,1001,0.5,0.99,0.89,0.66,4,4,5,0,1009,1.0,1.0,0.44,0.67
PF10787,PF15826:PF14258:PF15089,0,0,0,0,0,1018,0,1.0,0,0,0,0,0,0,1018,0,1.0,0,0
PF10998,PF10226:PF06428:PF05334,3,12,1,2,11,1004,0.08,0.99,0.33,0.16,0,0,3,0,1015,0,1.0,0.0,0
PF08624,PF10307:PF08733:PF10336,4,4,0,4,4,1010,0.0,0.99,0.0,-0.0,0,0,4,0,1014,0,1.0,0.0,0
PF04610,PF11751:PF13722:PF02554,3,0,0,3,0,1015,0,1.0,0.0,0,0,0,3,0,1015,0,1.0,0.0,0
PF04845,PF15388:PF08643:PF16086,6,7,1,5,6,1006,0.14,0.99,0.17,0.15,0,0,6,0,1012,0,0.99,0.0,0
PF12030,PF16674:PF14836:PF13446,4,11,2,2,9,1005,0.18,0.99,0.5,0.3,2,2,2,0,1014,1.0,1.0,0.5,0.71
PF02618,PF03831:PF13780:PF11245,1,0,0,1,0,1017,0,1.0,0.0,0,0,0,1,0,1017,0,1.0,0.0,0
PF12576,PF06414:PF10156:PF15996,2,19,0,2,19,997,0.0,0.98,0.0,-0.01,3,0,2,3,1013,0.0,1.0,0.0,-0.0
PF15935,PF16449:PF01706:PF08411,0,2,0,0,2,1016,0.0,1.0,0,0,0,0,0,0,1018,0,1.0,0,0
PF13383,PF05405:PF00210:PF06083,7,19,1,6,18,993,0.05,0.98,0.14,0.08,4,1,6,3,1008,0.25,0.99,0.14,0.18
PF00110,PF00822:PF13088:PF06179,13,21,4,9,17,988,0.19,0.97,0.31,0.23,4,3,10,1,1004,0.75,0.99,0.23,0.41
PF05026,PF15916:PF14803:PF09296,12,12,4,8,8,998,0.33,0.98,0.33,0.33,3,1,11,2,1004,0.33,0.99,0.08,0.16
PF00711,PF00272:PF12020:PF04901,0,2,0,0,2,1016,0.0,1.0,0,0,0,0,0,0,1018,0,1.0,0,0
PF04630,PF00006:PF01559:PF12056,0,49,0,0,49,969,0.0,0.95,0,0,2,0,0,2,1016,0.0,1.0,0,0
PF05620,PF03943:PF09162:PF17085,4,6,1,3,5,1009,0.17,0.99,0.25,0.2,3,1,3,2,1012,0.33,1.0,0.25,0.29
PF06703,PF03298:PF01922:PF02969,7,16,3,4,13,998,0.19,0.98,0.43,0.28,3,0,7,3,1008,0.0,0.99,0.0,-0.0
PF08212,PF00061:PF03973:PF05434,8,22,2,6,20,990,0.09,0.97,0.25,0.14,4,0,8,4,1006,0.0,0.99,0.0,-0.01
PF10057,PF03729:PF08708:PF12241,0,1,0,0,1,1017,0.0,1.0,0,0,0,0,0,0,1018,0,1.0,0,0
PF08649,PF11093:PF03823:PF15003,2,4,1,1,3,1013,0.25,1.0,0.5,0.35,0,0,2,0,1016,0,1.0,0.0,0
PF00168,PF10540:PF08150:PF08165,133,12,12,121,0,885,1.0,0.88,0.09,0.28,4,4,129,0,885,1.0,0.87,0.03,0.16
PF01931,PF04681:PF15550:PF12328,1,9,0,1,9,1008,0.0,0.99,0.0,-0.0,0,0,1,0,1017,0,1.0,0.0,0
PF05203,PF15624:PF15914:PF09441,7,8,3,4,5,1006,0.38,0.99,0.43,0.4,0,0,7,0,1011,0,0.99,0.0,0
PF08165,PF16165:PF08150:PF08151,2,10,2,0,8,1008,0.2,0.99,1.0,0.45,7,2,0,5,1011,0.29,1.0,1.0,0.53
PF11736,PF03922:PF03050:PF01752,4,2,0,4,2,1012,0.0,0.99,0.0,-0.0,0,0,4,0,1014,0,1.0,0.0,0
PF04844,PF03479:PF11250:PF02234,6,14,3,3,11,1001,0.21,0.99,0.5,0.32,2,2,4,0,1012,1.0,1.0,0.33,0.58
PF15245,PF11623:PF03760:PF07797,0,5,0,0,5,1013,0.0,1.0,0,0,0,0,0,0,1018,0,1.0,0,0
PF16987,PF08495:PF16866:PF14299,14,18,6,8,12,992,0.33,0.98,0.43,0.37,2,1,13,1,1003,0.5,0.99,0.07,0.19
PF04998,PF04992:PF04983:PF11523,35,35,30,5,5,978,0.86,0.99,0.86,0.85,6,5,30,1,982,0.83,0.97,0.14,0.34
PF00376,PF09278:PF12792:PF07494,2,3,2,0,1,1015,0.67,1.0,1.0,0.82,2,2,0,0,1016,1.0,1.0,1.0,1.0
PF00171,PF00465:PF00696:PF00551,106,69,44,62,25,887,0.64,0.91,0.42,0.47,13,12,94,1,911,0.92,0.91,0.11,0.3
PF02142,PF00185:PF02729:PF01979,23,57,14,9,43,952,0.25,0.95,0.61,0.37,21,12,11,9,986,0.57,0.98,0.52,0.54
PF02636,PF07896:PF07816:PF11927,10,16,2,8,14,994,0.12,0.98,0.2,0.15,2,1,9,1,1007,0.5,0.99,0.1,0.22
PF05871,PF08704:PF03416:PF03091,11,33,6,5,27,980,0.18,0.97,0.55,0.3,6,2,9,4,1003,0.33,0.99,0.18,0.24
PF07064,PF17034:PF10392:PF08640,5,17,0,5,17,996,0.0,0.98,0.0,-0.01,3,0,5,3,1010,0.0,0.99,0.0,-0.0
PF03407,PF03016:PF10250:PF03106,16,63,9,7,54,948,0.14,0.94,0.56,0.26,17,5,11,12,990,0.29,0.98,0.31,0.29
PF15095,PF06773:PF13588:PF06876,1,2,0,1,2,1015,0.0,1.0,0.0,-0.0,0,0,1,0,1017,0,1.0,0.0,0
PF05210,PF08776:PF09816:PF00786,1,39,1,0,38,979,0.03,0.96,1.0,0.16,7,1,0,6,1011,0.14,0.99,1.0,0.38
PF13825,PF16500:PF07655:PF02097,0,2,0,0,2,1016,0.0,1.0,0,0,0,0,0,0,1018,0,1.0,0,0
PF05907,PF01423:PF07426:PF01015,10,73,9,1,64,944,0.12,0.94,0.9,0.32,11,4,6,7,1001,0.36,0.99,0.4,0.37
PF00418,PF08377:PF00593:PF15399,4,5,2,2,3,1011,0.4,1.0,0.5,0.44,0,0,4,0,1014,0,1.0,0.0,0
PF12046,PF05419:PF08576:PF02531,0,4,0,0,4,1014,0.0,1.0,0,0,1,0,0,1,1017,0.0,1.0,0,0
PF07460,PF07453:PF01541:PF11793,12,28,11,1,17,989,0.39,0.98,0.92,0.59,6,5,7,1,1005,0.83,0.99,0.42,0.59
PF04640,PF04032:PF10248:PF09340,6,14,3,3,11,1001,0.21,0.99,0.5,0.32,2,1,5,1,1011,0.5,0.99,0.17,0.29
PF07149,PF03963:PF14564:PF14983,0,4,0,0,4,1014,0.0,1.0,0,0,0,0,0,0,1018,0,1.0,0,0
PF08646,PF16900:PF02721:PF04057,22,21,16,6,5,991,0.76,0.99,0.73,0.74,11,11,11,0,996,1.0,0.99,0.5,0.7
PF05392,PF07391:PF11870:PF10671,3,0,0,3,0,1015,0,1.0,0.0,0,0,0,3,0,1015,0,1.0,0.0,0
PF14793,PF11892:PF11862:PF11775,0,1,0,0,1,1017,0.0,1.0,0,0,0,0,0,0,1018,0,1.0,0,0
PF12200,PF17106:PF10423:PF02909,1,5,1,0,4,1013,0.2,1.0,1.0,0.45,1,1,0,0,1017,1.0,1.0,1.0,1.0
PF10595,PF09728:PF11250:PF15264,4,12,3,1,9,1005,0.25,0.99,0.75,0.43,1,0,4,1,1013,0.0,1.0,0.0,-0.0
PF16497,PF14517:PF00993:PF16196,2,1,0,2,1,1015,0.0,1.0,0.0,-0.0,0,0,2,0,1016,0,1.0,0.0,0
PF17171,PF11801:PF06814:PF17172,10,19,6,4,13,995,0.32,0.98,0.6,0.43,2,2,8,0,1008,1.0,0.99,0.2,0.45
PF01269,PF03103:PF15973:PF04107,15,11,2,13,9,994,0.18,0.98,0.13,0.14,1,1,14,0,1003,1.0,0.99,0.07,0.26
PF02614,PF07523:PF09397:PF13746,2,9,0,2,9,1007,0.0,0.99,0.0,-0.0,0,0,2,0,1016,0,1.0,0.0,0
PF11802,PF16001:PF15814:PF14992,0,1,0,0,1,1017,0.0,1.0,0,0,1,0,0,1,1017,0.0,1.0,0,0
PF05509,PF05513:PF07178:PF05309,1,1,1,0,0,1017,1.0,1.0,1.0,1.0,1,1,0,0,1017,1.0,1.0,1.0,1.0
PF01442,PF15239:PF06189:PF02267,6,7,2,4,5,1007,0.29,0.99,0.33,0.3,1,1,5,0,1012,1.0,1.0,0.17,0.41
PF05983,PF01279:PF00159:PF00446,11,5,1,10,4,1003,0.2,0.99,0.09,0.13,1,0,11,1,1006,0.0,0.99,0.0,-0.0
PF13167,PF16360:PF01018:PF15086,5,15,2,3,13,1000,0.13,0.98,0.4,0.22,1,1,4,0,1013,1.0,1.0,0.2,0.45
PF00638,PF08911:PF14975:PF12185,29,14,11,18,3,986,0.79,0.98,0.38,0.54,2,2,27,0,989,1.0,0.97,0.07,0.26
PF03989,PF00521:PF16898:PF00986,12,25,10,2,15,991,0.4,0.98,0.83,0.57,13,8,4,5,1001,0.62,0.99,0.67,0.64
PF16205,PF14853:PF14852:PF01381,12,13,3,9,10,996,0.23,0.98,0.25,0.23,4,1,11,3,1003,0.25,0.99,0.08,0.14
PF12037,PF14363:PF00004:PF01434,1,157,1,0,156,861,0.01,0.85,1.0,0.07,42,1,0,41,976,0.02,0.96,1.0,0.15
PF15477,PF11669:PF12527:PF10361,8,3,0,8,3,1007,0.0,0.99,0.0,-0.0,0,0,8,0,1010,0,0.99,0.0,0
PF01342,PF03172:PF17035:PF14051,8,22,8,0,14,996,0.36,0.99,1.0,0.6,3,3,5,0,1010,1.0,1.0,0.38,0.61
PF04216,PF14467:PF15150:PF14294,1,2,0,1,2,1015,0.0,1.0,0.0,-0.0,0,0,1,0,1017,0,1.0,0.0,0
PF10043,PF13677:PF13721:PF06834,0,3,0,0,3,1015,0.0,1.0,0,0,0,0,0,0,1018,0,1.0,0,0
PF04606,PF12843:PF10279:PF15168,0,3,0,0,3,1015,0.0,1.0,0,0,0,0,0,0,1018,0,1.0,0,0
PF02261,PF07499:PF04355:PF01312,2,2,0,2,2,1014,0.0,1.0,0.0,-0.0,0,0,2,0,1016,0,1.0,0.0,0
PF15519,PF12220:PF08080:PF08081,10,5,2,8,3,1005,0.4,0.99,0.2,0.28,1,1,9,0,1008,1.0,0.99,0.1,0.31
PF04300,PF08495:PF12014:PF10442,8,5,2,6,3,1007,0.4,0.99,0.25,0.31,3,1,7,2,1008,0.33,0.99,0.12,0.2
PF12328,PF06351:PF15316:PF02024,4,5,0,4,5,1009,0.0,0.99,0.0,-0.0,0,0,4,0,1014,0,1.0,0.0,0
PF01657,PF14380:PF01476:PF14786,22,45,9,13,36,960,0.2,0.95,0.41,0.26,4,4,18,0,996,1.0,0.98,0.18,0.42
PF08589,PF14519:PF01741:PF03576,4,2,0,4,2,1012,0.0,0.99,0.0,-0.0,0,0,4,0,1014,0,1.0,0.0,0
PF05219,PF10245:PF03901:PF11927,5,46,2,3,44,969,0.04,0.95,0.4,0.12,4,1,4,3,1010,0.25,0.99,0.2,0.22
PF09282,PF07223:PF00212:PF12049,2,2,0,2,2,1014,0.0,1.0,0.0,-0.0,0,0,2,0,1016,0,1.0,0.0,0
PF09596,PF12478:PF15232:PF15888,1,5,0,1,5,1012,0.0,0.99,0.0,-0.0,0,0,1,0,1017,0,1.0,0.0,0
PF06282,PF17100:PF07736:PF10396,0,30,0,0,30,988,0.0,0.97,0,0,2,0,0,2,1016,0.0,1.0,0,0
PF16037,PF07240:PF06875:PF15883,0,0,0,0,0,1018,0,1.0,0,0,0,0,0,0,1018,0,1.0,0,0
PF10407,PF15082:PF12178:PF15407,0,5,0,0,5,1013,0.0,1.0,0,0,0,0,0,0,1018,0,1.0,0,0
PF07672,PF04212:PF15040:PF08571,0,41,0,0,41,977,0.0,0.96,0,0,2,0,0,2,1016,0.0,1.0,0,0
PF07569,PF15512:PF09453:PF11816,13,26,11,2,15,990,0.42,0.98,0.85,0.59,4,4,9,0,1005,1.0,0.99,0.31,0.55
PF02056,PF11975:PF15272:PF02501,8,10,8,0,2,1008,0.8,1.0,1.0,0.89,0,0,8,0,1010,0,0.99,0.0,0
PF11418,PF10649:PF04924:PF09987,0,0,0,0,0,1018,0,1.0,0,0,0,0,0,0,1018,0,1.0,0,0
PF08397,PF12026:PF08824:PF07815,7,10,3,4,7,1004,0.3,0.99,0.43,0.35,2,2,5,0,1011,1.0,1.0,0.29,0.53
PF00619,PF12061:PF05659:PF13553,28,11,6,22,5,985,0.55,0.97,0.21,0.33,2,2,26,0,990,1.0,0.97,0.07,0.26
PF04825,PF15917:PF04118:PF04571,17,17,4,13,13,988,0.24,0.97,0.24,0.22,2,2,15,0,1001,1.0,0.99,0.12,0.34
PF06401,PF16173:PF01114:PF08444,3,3,0,3,3,1012,0.0,0.99,0.0,-0.0,0,0,3,0,1015,0,1.0,0.0,0
PF00258,PF00667:PF00175:PF02898,38,67,32,6,35,945,0.48,0.96,0.84,0.62,34,28,10,6,974,0.82,0.98,0.74,0.77
PF09483,PF17152:PF00381:PF01752,0,3,0,0,3,1015,0.0,1.0,0,0,0,0,0,0,1018,0,1.0,0,0
PF14922,PF12948:PF06428:PF15311,4,14,3,1,11,1003,0.21,0.99,0.75,0.4,0,0,4,0,1014,0,1.0,0.0,0
PF03423,PF16338:PF16863:PF17137,3,23,3,0,20,995,0.13,0.98,1.0,0.36,2,1,2,1,1014,0.5,1.0,0.33,0.41
PF06480,PF16193:PF16725:PF08519,16,25,5,11,20,982,0.2,0.97,0.31,0.24,5,4,12,1,1001,0.8,0.99,0.25,0.44
PF15041,PF15119:PF06729:PF14866,1,1,0,1,1,1016,0.0,1.0,0.0,-0.0,0,0,1,0,1017,0,1.0,0.0,0
PF02285,PF15071:PF15359:PF07281,4,6,1,3,5,1009,0.17,0.99,0.25,0.2,0,0,4,0,1014,0,1.0,0.0,0
PF01101,PF04222:PF15856:PF02500,16,1,0,16,1,1001,0.0,0.98,0.0,-0.0,0,0,16,0,1002,0,0.98,0.0,0
PF05721,PF14027:PF04479:PF11807,38,35,14,24,21,959,0.4,0.96,0.37,0.36,13,11,27,2,978,0.85,0.97,0.29,0.49
PF15358,PF15162:PF15134:PF15623,0,1,0,0,1,1017,0.0,1.0,0,0,0,0,0,0,1018,0,1.0,0,0
PF09332,PF15539:PF16940:PF16041,4,11,0,4,11,1003,0.0,0.99,0.0,-0.01,1,0,4,1,1013,0.0,1.0,0.0,-0.0
PF06390,PF15708:PF04625:PF03848,1,1,0,1,1,1016,0.0,1.0,0.0,-0.0,0,0,1,0,1017,0,1.0,0.0,0
PF15999,PF05841:PF04988:PF15923,3,6,0,3,6,1009,0.0,0.99,0.0,-0.0,0,0,3,0,1015,0,1.0,0.0,0
PF03321,PF04398:PF06749:PF00197,6,15,2,4,13,999,0.13,0.98,0.33,0.2,2,1,5,1,1011,0.5,0.99,0.17,0.29
PF02427,PF02448:PF02531:PF15173,0,2,0,0,2,1016,0.0,1.0,0,0,0,0,0,0,1018,0,1.0,0,0
PF00292,PF16719:PF00157:PF03826,9,16,5,4,11,998,0.31,0.99,0.56,0.41,3,2,7,1,1008,0.67,0.99,0.22,0.38
PF09945,PF00594:PF14357:PF00211,0,63,0,0,63,955,0.0,0.94,0,0,4,0,0,4,1014,0.0,1.0,0,0
PF08883,PF05419:PF06679:PF10868,11,0,0,11,0,1007,0,0.99,0.0,0,0,0,11,0,1007,0,0.99,0.0,0
PF08719,PF01872:PF00383:PF08211,19,56,12,7,44,955,0.21,0.95,0.63,0.35,12,5,14,7,992,0.42,0.98,0.26,0.32
PF01112,PF00755:PF03619:PF08615,23,49,12,11,37,958,0.24,0.95,0.52,0.34,13,5,18,8,987,0.38,0.97,0.22,0.28
PF02371,PF10994:PF15162:PF16590,3,1,0,3,1,1014,0.0,1.0,0.0,-0.0,0,0,3,0,1015,0,1.0,0.0,0
PF13910,PF14959:PF15027:PF08168,2,1,0,2,1,1015,0.0,1.0,0.0,-0.0,0,0,2,0,1016,0,1.0,0.0,0
PF14785,PF05591:PF05947:PF04966,0,1,0,0,1,1017,0.0,1.0,0,0,0,0,0,0,1018,0,1.0,0,0
PF12343,PF04892:PF03974:PF14980,1,1,0,1,1,1016,0.0,1.0,0.0,-0.0,0,0,1,0,1017,0,1.0,0.0,0
PF04542,PF04539:PF04545:PF00140,21,24,17,4,7,990,0.71,0.99,0.81,0.75,15,12,9,3,994,0.8,0.99,0.57,0.67
PF10316,PF10325:PF10327:PF06113,7,10,2,5,8,1003,0.2,0.99,0.29,0.23,2,1,6,1,1010,0.5,0.99,0.14,0.26
PF01779,PF05129:PF04418:PF15003,9,15,1,8,14,995,0.07,0.98,0.11,0.08,2,0,9,2,1007,0.0,0.99,0.0,-0.0
PF04234,PF03389:PF11775:PF03135,1,5,0,1,5,1012,0.0,0.99,0.0,-0.0,0,0,1,0,1017,0,1.0,0.0,0
PF00385,PF17218:PF13907:PF09337,68,23,17,51,6,944,0.74,0.94,0.25,0.41,7,7,61,0,950,1.0,0.94,0.1,0.31
PF12418,PF12806:PF08028:PF09317,3,3,3,0,0,1015,1.0,1.0,1.0,1.0,3,3,0,0,1015,1.0,1.0,1.0,1.0
PF16196,PF00993:PF00969:PF08204,0,3,0,0,3,1015,0.0,1.0,0,0,0,0,0,0,1018,0,1.0,0,0
PF05188,PF01624:PF05190:PF05192,28,40,28,0,12,978,0.7,0.99,1.0,0.83,27,27,1,0,990,1.0,1.0,0.96,0.98
PF01016,PF04716:PF06376:PF05915,16,15,4,12,11,991,0.27,0.98,0.25,0.25,2,2,14,0,1002,1.0,0.99,0.12,0.35
PF09970,PF03051:PF16020:PF01684,0,12,0,0,12,1006,0.0,0.99,0,0,0,0,0,0,1018,0,1.0,0,0
PF13949,PF03097:PF02185:PF14948,22,45,21,1,24,972,0.47,0.98,0.95,0.66,13,5,17,8,988,0.38,0.98,0.23,0.28
PF02602,PF06172:PF04756:PF04520,16,11,5,11,6,996,0.45,0.98,0.31,0.37,0,0,16,0,1002,0,0.98,0.0,0
PF04900,PF04729:PF10276:PF10173,15,11,5,10,6,997,0.45,0.98,0.33,0.38,2,1,14,1,1002,0.5,0.99,0.07,0.18
PF10567,PF01580:PF06505:PF07805,1,6,0,1,6,1011,0.0,0.99,0.0,-0.0,0,0,1,0,1017,0,1.0,0.0,0
PF03310,PF13861:PF06744:PF00700,3,1,0,3,1,1014,0.0,1.0,0.0,-0.0,0,0,3,0,1015,0,1.0,0.0,0
PF01581,PF08257:PF10660:PF09360,5,16,3,2,13,1000,0.19,0.99,0.6,0.33,2,0,5,2,1011,0.0,0.99,0.0,-0.0
PF15128,PF06798:PF06403:PF05466,0,1,0,0,1,1017,0.0,1.0,0,0,0,0,0,0,1018,0,1.0,0,0
PF13228,PF05711:PF13698:PF07022,0,1,0,0,1,1017,0.0,1.0,0,0,0,0,0,0,1018,0,1.0,0,0
PF02092,PF02091:PF06792:PF17167,11,10,6,5,4,1003,0.6,0.99,0.55,0.57,1,1,10,0,1007,1.0,0.99,0.09,0.3
PF16687,PF15912:PF15557:PF07001,5,7,1,4,6,1007,0.14,0.99,0.2,0.16,0,0,5,0,1013,0,1.0,0.0,0
PF04328,PF12081:PF04355:PF08479,0,0,0,0,0,1018,0,1.0,0,0,0,0,0,0,1018,0,1.0,0,0
PF02656,PF03124:PF00939:PF03600,22,28,10,12,18,978,0.36,0.97,0.45,0.39,2,1,21,1,995,0.5,0.98,0.05,0.15
PF03372,PF14529:PF13966:PF02383,66,130,46,20,84,868,0.35,0.9,0.7,0.45,33,22,44,11,941,0.67,0.95,0.33,0.45
PF13839,PF14416:PF12314:PF13914,21,20,16,5,4,993,0.8,0.99,0.76,0.78,3,3,18,0,997,1.0,0.98,0.14,0.37
PF09729,PF16944:PF05508:PF15279,8,3,1,7,2,1008,0.33,0.99,0.12,0.2,0,0,8,0,1010,0,0.99,0.0,0
PF05973,PF00695:PF05427:PF00047,0,41,0,0,41,977,0.0,0.96,0,0,2,0,0,2,1016,0.0,1.0,0,0
PF04704,PF15350:PF12733:PF04056,2,9,1,1,8,1008,0.11,0.99,0.5,0.23,1,0,2,1,1015,0.0,1.0,0.0,-0.0
PF12214,PF04087:PF06886:PF05334,7,6,3,4,3,1008,0.5,0.99,0.43,0.46,0,0,7,0,1011,0,0.99,0.0,0
PF16667,PF05671:PF02604:PF15830,1,2,0,1,2,1015,0.0,1.0,0.0,-0.0,0,0,1,0,1017,0,1.0,0.0,0
PF08018,PF16048:PF08023:PF16047,0,0,0,0,0,1018,0,1.0,0,0,0,0,0,0,1018,0,1.0,0,0
PF12056,PF05562:PF03331:PF07712,4,4,2,2,2,1012,0.5,1.0,0.5,0.5,0,0,4,0,1014,0,1.0,0.0,0
PF15732,PF04370:PF14297:PF15482,0,0,0,0,0,1018,0,1.0,0,0,0,0,0,0,1018,0,1.0,0,0
PF00790,PF12210:PF03127:PF04366,28,22,14,14,8,982,0.64,0.98,0.5,0.55,4,4,24,0,990,1.0,0.98,0.14,0.37
PF14941,PF14931:PF06679:PF00726,0,2,0,0,2,1016,0.0,1.0,0,0,0,0,0,0,1018,0,1.0,0,0
PF17126,PF13636:PF04523:PF06744,3,1,1,2,0,1015,1.0,1.0,0.33,0.58,0,0,3,0,1015,0,1.0,0.0,0
PF15497,PF00706:PF05962:PF15838,1,1,0,1,1,1016,0.0,1.0,0.0,-0.0,0,0,1,0,1017,0,1.0,0.0,0
PF14222,PF14225:PF14228:PF16206,7,15,7,0,8,1003,0.47,0.99,1.0,0.68,6,6,1,0,1011,1.0,1.0,0.86,0.93
PF06203,PF00320:PF16563:PF09949,14,48,8,6,40,964,0.17,0.95,0.57,0.29,6,4,10,2,1002,0.67,0.99,0.29,0.43
PF10470,PF09005:PF16568:PF16274,0,11,0,0,11,1007,0.0,0.99,0,0,1,0,0,1,1017,0.0,1.0,0,0
PF05162,PF16843:PF09055:PF04758,5,14,2,3,12,1001,0.14,0.99,0.4,0.23,2,1,4,1,1012,0.5,1.0,0.2,0.31
PF08426,PF12904:PF05782:PF15302,0,2,0,0,2,1016,0.0,1.0,0,0,0,0,0,0,1018,0,1.0,0,0
PF08729,PF12480:PF15778:PF10264,4,11,2,2,9,1005,0.18,0.99,0.5,0.3,2,1,3,1,1013,0.5,1.0,0.25,0.35
PF00691,PF01475:PF04052:PF07494,5,5,0,5,5,1008,0.0,0.99,0.0,-0.0,0,0,5,0,1013,0,1.0,0.0,0
PF08487,PF13768:PF06668:PF13757,11,21,11,0,10,997,0.52,0.99,1.0,0.72,3,3,8,0,1007,1.0,0.99,0.27,0.52
PF16174,PF09598:PF02940:PF03715,1,22,0,1,22,995,0.0,0.98,0.0,-0.0,0,0,1,0,1017,0,1.0,0.0,0
PF00301,PF04367:PF11255:PF09419,2,13,0,2,13,1003,0.0,0.99,0.0,-0.01,0,0,2,0,1016,0,1.0,0.0,0
PF07393,PF05278:PF13369:PF03469,7,15,4,3,11,1000,0.27,0.99,0.57,0.38,4,3,4,1,1010,0.75,1.0,0.43,0.56
PF16930,PF05679:PF14518:PF04336,0,16,0,0,16,1002,0.0,0.98,0,0,1,0,0,1,1017,0.0,1.0,0,0
PF10705,PF10868:PF07961:PF03488,0,1,0,0,1,1017,0.0,1.0,0,0,0,0,0,0,1018,0,1.0,0,0
PF01110,PF01913:PF07505:PF03428,1,1,0,1,1,1016,0.0,1.0,0.0,-0.0,0,0,1,0,1017,0,1.0,0.0,0
PF11492,PF00915:PF04865:PF15150,1,1,1,0,0,1017,1.0,1.0,1.0,1.0,0,0,1,0,1017,0,1.0,0.0,0
PF07742,PF15279:PF09816:PF05182,10,20,5,5,15,993,0.25,0.98,0.5,0.34,3,1,9,2,1006,0.33,0.99,0.1,0.18
PF11741,PF04351:PF04350:PF04466,0,0,0,0,0,1018,0,1.0,0,0,0,0,0,0,1018,0,1.0,0,0
PF10839,PF00537:PF06541:PF14473,0,1,0,0,1,1017,0.0,1.0,0,0,0,0,0,0,1018,0,1.0,0,0
PF06662,PF15296:PF14764:PF12733,3,10,1,2,9,1006,0.1,0.99,0.33,0.18,1,0,3,1,1014,0.0,1.0,0.0,-0.0
PF02449,PF09822:PF14764:PF16401,11,10,2,9,8,999,0.2,0.98,0.18,0.18,1,0,11,1,1006,0.0,0.99,0.0,-0.0
PF12816,PF12451:PF17122:PF00637,4,29,2,2,27,987,0.07,0.97,0.5,0.18,8,1,3,7,1007,0.12,0.99,0.25,0.17
PF08592,PF10224:PF09424:PF12900,6,14,1,5,13,999,0.07,0.98,0.17,0.1,1,0,6,1,1011,0.0,0.99,0.0,-0.0
PF00759,PF09478:PF00553:PF07855,19,17,4,15,13,986,0.24,0.97,0.21,0.21,3,3,16,0,999,1.0,0.98,0.16,0.39
PF17146,PF15017:PF14051:PF05508,7,8,2,5,6,1005,0.25,0.99,0.29,0.26,1,1,6,0,1011,1.0,0.99,0.14,0.38
PF14416,PF13839:PF13824:PF16401,16,24,16,0,8,994,0.67,0.99,1.0,0.81,2,2,14,0,1002,1.0,0.99,0.12,0.35
PF06243,PF07858:PF02466:PF02446,0,31,0,0,31,987,0.0,0.97,0,0,0,0,0,0,1018,0,1.0,0,0
PF14866,PF15085:PF15119:PF15680,0,3,0,0,3,1015,0.0,1.0,0,0,0,0,0,0,1018,0,1.0,0,0
PF03004,PF03017:PF10226:PF04880,20,8,4,16,4,994,0.5,0.98,0.2,0.31,1,1,19,0,998,1.0,0.98,0.05,0.22
PF15481,PF02200:PF16091:PF05677,4,2,0,4,2,1012,0.0,0.99,0.0,-0.0,0,0,4,0,1014,0,1.0,0.0,0
PF08711,PF07500:PF06881:PF15694,27,18,13,14,5,986,0.72,0.98,0.48,0.58,2,2,25,0,991,1.0,0.98,0.07,0.27
PF00993,PF16196:PF00969:PF16497,0,4,0,0,4,1014,0.0,1.0,0,0,1,0,0,1,1017,0.0,1.0,0,0
PF07046,PF00553:PF13198:PF02721,1,14,1,0,13,1004,0.07,0.99,1.0,0.27,1,1,0,0,1017,1.0,1.0,1.0,1.0
PF03011,PF15447:PF15445:PF12377,1,1,1,0,0,1017,1.0,1.0,1.0,1.0,1,1,0,0,1017,1.0,1.0,1.0,1.0
PF16697,PF12479:PF03135:PF05228,3,6,1,2,5,1010,0.17,0.99,0.33,0.23,0,0,3,0,1015,0,1.0,0.0,0
PF00223,PF00421:PF00146:PF01578,7,31,4,3,27,984,0.13,0.97,0.57,0.26,11,1,6,10,1001,0.09,0.98,0.14,0.11
PF00342,PF04668:PF00223:PF00421,22,22,4,18,18,978,0.18,0.96,0.18,0.16,5,2,20,3,993,0.4,0.98,0.09,0.18
PF01773,PF07670:PF07662:PF07664,12,20,11,1,9,997,0.55,0.99,0.92,0.71,5,3,9,2,1004,0.6,0.99,0.25,0.38
PF00352,PF13259:PF04927:PF04111,22,16,6,16,10,986,0.38,0.97,0.27,0.31,2,2,20,0,996,1.0,0.98,0.09,0.3
PF04758,PF01020:PF16843:PF09055,11,16,3,8,13,994,0.19,0.98,0.27,0.22,1,1,10,0,1007,1.0,0.99,0.09,0.3
PF09775,PF01286:PF12659:PF13408,0,6,0,0,6,1012,0.0,0.99,0,0,0,0,0,0,1018,0,1.0,0,0
PF08733,PF08624:PF15923:PF09463,2,5,0,2,5,1011,0.0,0.99,0.0,-0.0,0,0,2,0,1016,0,1.0,0.0,0
PF10273,PF07052:PF08034:PF16007,5,12,2,3,10,1003,0.17,0.99,0.4,0.25,1,1,4,0,1013,1.0,1.0,0.2,0.45
PF06172,PF01774:PF02284:PF01775,0,17,0,0,17,1001,0.0,0.98,0,0,5,0,0,5,1013,0.0,1.0,0,0
PF04198,PF01420:PF05280:PF03831,6,5,3,3,2,1010,0.6,1.0,0.5,0.55,1,1,5,0,1012,1.0,1.0,0.17,0.41
PF14282,PF03847:PF05875:PF03959,2,47,2,0,45,971,0.04,0.96,1.0,0.2,6,1,1,5,1011,0.17,0.99,0.5,0.29
PF01842,PF00351:PF10369:PF12549,23,30,7,16,23,972,0.23,0.96,0.3,0.25,5,3,20,2,993,0.6,0.98,0.13,0.27
PF01547,PF02608:PF07562:PF03247,21,18,5,16,13,984,0.28,0.97,0.24,0.24,3,1,20,2,995,0.33,0.98,0.05,0.12
PF11943,PF11965:PF02272:PF13901,0,37,0,0,37,981,0.0,0.96,0,0,5,0,0,5,1013,0.0,1.0,0,0
PF17137,PF16338:PF00088:PF16863,6,27,2,4,25,987,0.07,0.97,0.33,0.15,8,2,4,6,1006,0.25,0.99,0.33,0.28
PF07769,PF13722:PF07409:PF06450,0,1,0,0,1,1017,0.0,1.0,0,0,0,0,0,0,1018,0,1.0,0,0
PF13648,PF14865:PF06952:PF06393,0,2,0,0,2,1016,0.0,1.0,0,0,0,0,0,0,1018,0,1.0,0,0
PF15622,PF11699:PF15620:PF06566,0,7,0,0,7,1011,0.0,0.99,0,0,0,0,0,0,1018,0,1.0,0,0
PF14144,PF02173:PF03957:PF12498,8,7,3,5,4,1006,0.43,0.99,0.38,0.4,2,2,6,0,1010,1.0,0.99,0.25,0.5
PF00833,PF04568:PF09111:PF06825,18,20,6,12,14,986,0.3,0.97,0.33,0.3,3,2,16,1,999,0.67,0.98,0.11,0.27
PF16062,PF00821:PF08925:PF10266,3,12,1,2,11,1004,0.08,0.99,0.33,0.16,0,0,3,0,1015,0,1.0,0.0,0
PF01523,PF03548:PF02614:PF13247,11,5,1,10,4,1003,0.2,0.99,0.09,0.13,0,0,11,0,1007,0,0.99,0.0,0
PF01493,PF00310:PF14691:PF16092,7,22,7,0,15,996,0.32,0.99,1.0,0.56,5,5,2,0,1011,1.0,1.0,0.71,0.84
PF08478,PF05467:PF07045:PF02621,0,1,0,0,1,1017,0.0,1.0,0,0,0,0,0,0,1018,0,1.0,0,0
PF16860,PF10558:PF05300:PF03073,4,10,1,3,9,1005,0.1,0.99,0.25,0.15,0,0,4,0,1014,0,1.0,0.0,0
PF15344,PF06989:PF15062:PF13270,1,3,0,1,3,1014,0.0,1.0,0.0,-0.0,0,0,1,0,1017,0,1.0,0.0,0
PF09284,PF14683:PF14686:PF06045,8,17,8,0,9,1001,0.47,0.99,1.0,0.68,15,8,0,7,1003,0.53,0.99,1.0,0.73
PF04425,PF04426:PF08124:PF02884,0,5,0,0,5,1013,0.0,1.0,0,0,1,0,0,1,1017,0.0,1.0,0,0
PF03489,PF02199:PF05184:PF03227,7,22,5,2,17,994,0.23,0.98,0.71,0.4,3,1,6,2,1009,0.33,0.99,0.14,0.21
PF08407,PF15489:PF11732:PF16134,16,10,2,14,8,994,0.2,0.98,0.12,0.15,6,1,15,5,997,0.17,0.98,0.06,0.09
PF02938,PF09924:PF09170:PF10451,7,7,4,3,3,1008,0.57,0.99,0.57,0.57,1,1,6,0,1011,1.0,0.99,0.14,0.38
PF10383,PF12432:PF14022:PF06869,6,5,1,5,4,1008,0.2,0.99,0.17,0.18,1,1,5,0,1012,1.0,1.0,0.17,0.41
PF10303,PF09810:PF10356:PF14378,1,11,0,1,11,1006,0.0,0.99,0.0,-0.0,0,0,1,0,1017,0,1.0,0.0,0
PF12068,PF15733:PF11830:PF00566,9,84,9,0,75,934,0.11,0.93,1.0,0.31,4,2,7,2,1007,0.5,0.99,0.22,0.33
PF17208,PF12140:PF02820:PF12618,3,22,2,1,20,995,0.09,0.98,0.67,0.24,7,1,2,6,1009,0.14,0.99,0.33,0.21
PF01784,PF09812:PF02284:PF05995,3,14,1,2,13,1002,0.07,0.99,0.33,0.15,4,1,2,3,1012,0.25,1.0,0.33,0.29
PF05534,PF02329:PF04506:PF07402,0,10,0,0,10,1008,0.0,0.99,0,0,0,0,0,0,1018,0,1.0,0,0
PF08996,PF12254:PF14260:PF03104,12,37,12,0,25,981,0.32,0.98,1.0,0.56,24,10,2,14,992,0.42,0.98,0.83,0.58
PF09631,PF08641:PF09597:PF15370,10,8,3,7,5,1003,0.38,0.99,0.3,0.33,0,0,10,0,1008,0,0.99,0.0,0
PF06493,PF15337:PF16967:PF11162,0,3,0,0,3,1015,0.0,1.0,0,0,0,0,0,0,1018,0,1.0,0,0
PF07107,PF11016:PF06695:PF00127,1,3,0,1,3,1014,0.0,1.0,0.0,-0.0,0,0,1,0,1017,0,1.0,0.0,0
PF15290,PF14722:PF10309:PF12516,1,16,0,1,16,1001,0.0,0.98,0.0,-0.0,1,0,1,1,1016,0.0,1.0,0.0,-0.0
PF00051,PF01392:PF09396:PF16030,34,30,20,14,10,974,0.67,0.98,0.59,0.61,4,4,30,0,984,1.0,0.97,0.12,0.34
PF08002,PF14251:PF06573:PF08497,0,4,0,0,4,1014,0.0,1.0,0,0,0,0,0,0,1018,0,1.0,0,0
PF00588,PF08032:PF12105:PF00383,25,53,16,9,37,956,0.3,0.95,0.64,0.42,5,5,20,0,993,1.0,0.98,0.2,0.44
PF03778,PF10285:PF07276:PF06753,0,1,0,0,1,1017,0.0,1.0,0,0,0,0,0,0,1018,0,1.0,0,0
PF14844,PF06469:PF15787:PF02138,21,36,20,1,16,981,0.56,0.98,0.95,0.72,11,8,13,3,994,0.73,0.98,0.38,0.52
PF12626,PF00308:PF04984:PF02211,3,8,3,0,5,1010,0.38,1.0,1.0,0.61,0,0,3,0,1015,0,1.0,0.0,0
PF02543,PF12241:PF01580:PF09327,3,6,1,2,5,1010,0.17,0.99,0.33,0.23,0,0,3,0,1015,0,1.0,0.0,0
PF09347,PF07086:PF01522:PF03427,5,35,4,1,31,982,0.11,0.97,0.8,0.3,1,0,5,1,1012,0.0,0.99,0.0,-0.0
PF07934,PF10576:PF14815:PF00633,13,12,3,10,9,996,0.25,0.98,0.23,0.23,3,1,12,2,1003,0.33,0.99,0.08,0.16
PF14490,PF15128:PF15716:PF03816,0,2,0,0,2,1016,0.0,1.0,0,0,0,0,0,0,1018,0,1.0,0,0
PF16908,PF12624:PF09333:PF16910,18,35,17,1,18,982,0.49,0.98,0.94,0.67,20,13,5,7,993,0.65,0.99,0.72,0.68
PF05057,PF12394:PF17111:PF01734,32,65,20,12,45,941,0.31,0.94,0.62,0.41,11,9,23,2,984,0.82,0.98,0.28,0.47
PF01099,PF06373:PF05039:PF06446,1,0,0,1,0,1017,0,1.0,0.0,0,0,0,1,0,1017,0,1.0,0.0,0
PF15327,PF16051:PF09444:PF05547,2,2,0,2,2,1014,0.0,1.0,0.0,-0.0,0,0,2,0,1016,0,1.0,0.0,0
PF06991,PF08209:PF03299:PF06413,7,23,5,2,18,993,0.22,0.98,0.71,0.39,3,1,6,2,1009,0.33,0.99,0.14,0.21
PF16044,PF09784:PF05512:PF02101,4,9,0,4,9,1005,0.0,0.99,0.0,-0.01,1,0,4,1,1013,0.0,1.0,0.0,-0.0
PF15059,PF15622:PF06566:PF17169,3,1,0,3,1,1014,0.0,1.0,0.0,-0.0,0,0,3,0,1015,0,1.0,0.0,0
PF05757,PF00321:PF06232:PF04520,2,4,0,2,4,1012,0.0,0.99,0.0,-0.0,0,0,2,0,1016,0,1.0,0.0,0
PF10626,PF02059:PF00123:PF13195,0,9,0,0,9,1009,0.0,0.99,0,0,0,0,0,0,1018,0,1.0,0,0
PF16314,PF05974:PF15212:PF06805,0,0,0,0,0,1018,0,1.0,0,0,0,0,0,0,1018,0,1.0,0,0
PF09457,PF11618:PF16056:PF15625,10,8,2,8,6,1002,0.25,0.99,0.2,0.22,1,1,9,0,1008,1.0,0.99,0.1,0.31
PF02214,PF03520:PF03521:PF11879,47,12,8,39,4,967,0.67,0.96,0.17,0.32,3,3,44,0,971,1.0,0.96,0.06,0.25
PF06858,PF08155:PF10179:PF02421,22,21,16,6,5,991,0.76,0.99,0.73,0.74,1,1,21,0,996,1.0,0.98,0.05,0.21
PF04360,PF15175:PF05853:PF15046,0,4,0,0,4,1014,0.0,1.0,0,0,0,0,0,0,1018,0,1.0,0,0
PF01082,PF03712:PF03351:PF10517,19,24,18,1,6,993,0.75,0.99,0.95,0.84,16,12,7,4,995,0.75,0.99,0.63,0.68
PF13768,PF08487:PF08473:PF08399,21,17,13,8,4,993,0.76,0.99,0.62,0.68,7,6,15,1,996,0.86,0.98,0.29,0.49
PF06202,PF14701:PF14699:PF14702,3,3,2,1,1,1014,0.67,1.0,0.67,0.67,2,2,1,0,1015,1.0,1.0,0.67,0.82
PF10926,PF04166:PF15334:PF10073,0,6,0,0,6,1012,0.0,0.99,0,0,0,0,0,0,1018,0,1.0,0,0
PF00084,PF13402:PF02494:PF13948,52,25,21,31,4,962,0.84,0.97,0.4,0.57,3,3,49,0,966,1.0,0.95,0.06,0.23
PF14739,PF13931:PF11995:PF16540,3,14,3,0,11,1004,0.21,0.99,1.0,0.46,3,3,0,0,1015,1.0,1.0,1.0,1.0
PF11636,PF00992:PF08999:PF00832,0,15,0,0,15,1003,0.0,0.99,0,0,3,0,0,3,1015,0.0,1.0,0,0
PF06668,PF08473:PF13757:PF08487,3,14,3,0,11,1004,0.21,0.99,1.0,0.46,2,1,2,1,1014,0.5,1.0,0.33,0.41
PF05023,PF09328:PF06880:PF02670,9,14,2,7,12,997,0.14,0.98,0.22,0.17,1,0,9,1,1008,0.0,0.99,0.0,-0.0
PF12804,PF04613:PF06426:PF13720,9,18,2,7,16,993,0.11,0.98,0.22,0.15,2,1,8,1,1008,0.5,0.99,0.11,0.23
PF08744,PF03525:PF04965:PF10933,0,0,0,0,0,1018,0,1.0,0,0,0,0,0,0,1018,0,1.0,0,0
PF12777,PF12780:PF03028:PF08385,38,43,37,1,6,974,0.86,0.99,0.97,0.91,37,35,3,2,978,0.95,1.0,0.92,0.93
PF15030,PF03344:PF06513:PF05715,1,3,0,1,3,1014,0.0,1.0,0.0,-0.0,1,0,1,1,1016,0.0,1.0,0.0,-0.0
PF05649,PF01431:PF04616:PF04042,35,73,33,2,40,943,0.45,0.96,0.94,0.64,18,14,21,4,979,0.78,0.98,0.4,0.55
PF15022,PF09669:PF04738:PF04342,0,1,0,0,1,1017,0.0,1.0,0,0,0,0,0,0,1018,0,1.0,0,0
PF02601,PF01752:PF04965:PF08291,2,2,0,2,2,1014,0.0,1.0,0.0,-0.0,0,0,2,0,1016,0,1.0,0.0,0
PF12763,PF12761:PF16880:PF16652,35,24,17,18,7,976,0.71,0.98,0.49,0.57,5,5,30,0,983,1.0,0.97,0.14,0.37
PF10395,PF14952:PF12432:PF12231,1,9,1,0,8,1009,0.11,0.99,1.0,0.33,0,0,1,0,1017,0,1.0,0.0,0
PF00999,PF16644:PF02254:PF08619,55,15,13,42,2,961,0.87,0.96,0.24,0.44,1,1,54,0,963,1.0,0.95,0.02,0.13
PF08792,PF15211:PF15047:PF15713,0,2,0,0,2,1016,0.0,1.0,0,0,0,0,0,0,1018,0,1.0,0,0
PF14747,PF15550:PF02950:PF10994,0,1,0,0,1,1017,0.0,1.0,0,0,0,0,0,0,1018,0,1.0,0,0
PF01862,PF15796:PF02196:PF09727,1,15,0,1,15,1002,0.0,0.98,0.0,-0.0,3,0,1,3,1014,0.0,1.0,0.0,-0.0
PF14693,PF01386:PF01132:PF09285,3,8,2,1,6,1009,0.25,0.99,0.67,0.41,6,0,3,6,1009,0.0,0.99,0.0,-0.0
PF14671,PF09192:PF01331:PF07655,4,17,3,1,14,1000,0.18,0.99,0.75,0.36,1,1,3,0,1014,1.0,1.0,0.25,0.5
PF06109,PF17062:PF08591:PF14986,0,0,0,0,0,1018,0,1.0,0,0,0,0,0,0,1018,0,1.0,0,0
PF04618,PF04617:PF04731:PF10525,3,5,1,2,4,1011,0.2,0.99,0.33,0.26,1,1,2,0,1015,1.0,1.0,0.33,0.58
PF04909,PF16952:PF03951:PF12437,38,11,4,34,7,973,0.36,0.96,0.11,0.18,2,2,36,0,980,1.0,0.96,0.05,0.23
PF13011,PF05418:PF15141:PF15097,0,2,0,0,2,1016,0.0,1.0,0,0,0,0,0,0,1018,0,1.0,0,0
PF05449,PF10995:PF06505:PF01913,0,1,0,0,1,1017,0.0,1.0,0,0,0,0,0,0,1018,0,1.0,0,0
PF08695,PF08641:PF09631:PF10780,4,11,1,3,10,1004,0.09,0.99,0.25,0.15,3,1,3,2,1012,0.33,1.0,0.25,0.29
PF02944,PF10545:PF12596:PF04937,14,55,14,0,41,963,0.25,0.96,1.0,0.49,10,5,9,5,999,0.5,0.99,0.36,0.42
PF07664,PF01773:PF07670:PF07662,2,21,2,0,19,997,0.1,0.98,1.0,0.31,12,1,1,11,1005,0.08,0.99,0.5,0.2
PF02281,PF08558:PF07317:PF01448,0,21,0,0,21,997,0.0,0.98,0,0,0,0,0,0,1018,0,1.0,0,0
PF10941,PF11351:PF06394:PF00274,0,20,0,0,20,998,0.0,0.98,0,0,0,0,0,0,1018,0,1.0,0,0
PF03128,PF14554:PF04692:PF15800,2,2,1,1,1,1015,0.5,1.0,0.5,0.5,1,1,1,0,1016,1.0,1.0,0.5,0.71
PF15049,PF02277:PF06890:PF10974,0,3,0,0,3,1015,0.0,1.0,0,0,0,0,0,0,1018,0,1.0,0,0
PF08547,PF13460:PF10294:PF01370,15,115,11,4,104,899,0.1,0.89,0.73,0.24,33,7,8,26,977,0.21,0.97,0.47,0.3
PF14622,PF00636:PF16482:PF00035,22,58,16,6,42,954,0.28,0.95,0.73,0.43,19,13,9,6,990,0.68,0.99,0.59,0.63
PF14213,PF08881:PF00172:PF12943,0,142,0,0,142,876,0.0,0.86,0,0,9,0,0,9,1009,0.0,0.99,0,0
PF04046,PF12214:PF16297:PF14922,9,10,4,5,6,1003,0.4,0.99,0.44,0.42,3,2,7,1,1008,0.67,0.99,0.22,0.38
PF14374,PF00573:PF05019:PF00375,12,33,10,2,23,983,0.3,0.98,0.83,0.49,5,4,8,1,1005,0.8,0.99,0.33,0.51
PF06747,PF10276:PF01922:PF06645,10,16,2,8,14,994,0.12,0.98,0.2,0.15,1,0,10,1,1007,0.0,0.99,0.0,-0.0
PF06124,PF03406:PF14903:PF04986,2,2,0,2,2,1014,0.0,1.0,0.0,-0.0,0,0,2,0,1016,0,1.0,0.0,0
PF13878,PF13880:PF02421:PF10444,5,13,4,1,9,1004,0.31,0.99,0.8,0.49,0,0,5,0,1013,0,1.0,0.0,0
PF05552,PF04586:PF04671:PF11775,0,2,0,0,2,1016,0.0,1.0,0,0,0,0,0,0,1018,0,1.0,0,0
PF03368,PF11648:PF00636:PF03461,14,28,13,1,15,989,0.46,0.98,0.93,0.65,5,5,9,0,1004,1.0,0.99,0.36,0.59
PF13971,PF15556:PF15843:PF15119,0,1,0,0,1,1017,0.0,1.0,0,0,0,0,0,0,1018,0,1.0,0,0
PF16206,PF16213:PF09324:PF12783,8,30,8,0,22,988,0.27,0.98,1.0,0.51,17,7,1,10,1000,0.41,0.99,0.88,0.6
PF06899,PF14340:PF14452:PF10037,0,5,0,0,5,1013,0.0,1.0,0,0,0,0,0,0,1018,0,1.0,0,0
PF06628,PF00199:PF01965:PF01761,19,53,18,1,35,964,0.34,0.96,0.95,0.56,15,9,10,6,993,0.6,0.98,0.47,0.53
PF00264,PF12142:PF12143:PF04577,38,22,11,27,11,969,0.5,0.96,0.29,0.36,2,2,36,0,980,1.0,0.96,0.05,0.23
PF04459,PF02217:PF17014:PF13753,0,3,0,0,3,1015,0.0,1.0,0,0,0,0,0,0,1018,0,1.0,0,0
PF00453,PF00499:PF04716:PF10183,15,22,3,12,19,984,0.14,0.97,0.2,0.15,2,0,15,2,1001,0.0,0.98,0.0,-0.01
PF09987,PF10690:PF11418:PF04958,0,3,0,0,3,1015,0.0,1.0,0,0,0,0,0,0,1018,0,1.0,0,0
PF13567,PF03772:PF08402:PF13732,4,11,4,0,7,1007,0.36,0.99,1.0,0.6,3,2,2,1,1013,0.67,1.0,0.5,0.58
PF15352,PF11035:PF15345:PF16829,0,3,0,0,3,1015,0.0,1.0,0,0,0,0,0,0,1018,0,1.0,0,0
PF06791,PF14706:PF11471:PF13737,0,2,0,0,2,1016,0.0,1.0,0,0,0,0,0,0,1018,0,1.0,0,0
PF14579,PF07733:PF09170:PF02938,13,20,13,0,7,998,0.65,0.99,1.0,0.8,1,1,12,0,1005,1.0,0.99,0.08,0.28
PF13336,PF02550:PF01273:PF01144,12,37,10,2,27,979,0.27,0.97,0.83,0.47,3,1,11,2,1004,0.33,0.99,0.08,0.16
PF03469,PF16034:PF06294:PF04423,10,11,2,8,9,999,0.18,0.98,0.2,0.18,1,1,9,0,1008,1.0,0.99,0.1,0.31
PF05912,PF04402:PF00727:PF00714,3,10,1,2,9,1006,0.1,0.99,0.33,0.18,1,0,3,1,1014,0.0,1.0,0.0,-0.0
PF16108,PF15602:PF10946:PF10366,0,14,0,0,14,1004,0.0,0.99,0,0,0,0,0,0,1018,0,1.0,0,0
PF02607,PF02965:PF00809:PF02310,4,15,4,0,11,1003,0.27,0.99,1.0,0.51,6,4,0,2,1012,0.67,1.0,1.0,0.82
PF05562,PF01387:PF12056:PF09778,3,6,2,1,4,1011,0.33,1.0,0.67,0.47,0,0,3,0,1015,0,1.0,0.0,0
PF03742,PF08404:PF08093:PF10106,1,2,0,1,2,1015,0.0,1.0,0.0,-0.0,0,0,1,0,1017,0,1.0,0.0,0
PF13192,PF14721:PF14962:PF04224,3,6,1,2,5,1010,0.17,0.99,0.33,0.23,2,1,2,1,1014,0.5,1.0,0.33,0.41
PF09553,PF02863:PF08401:PF12191,2,2,0,2,2,1014,0.0,1.0,0.0,-0.0,0,0,2,0,1016,0,1.0,0.0,0
PF09371,PF16921:PF14633:PF14878,3,14,3,0,11,1004,0.21,0.99,1.0,0.46,13,2,1,11,1004,0.15,0.99,0.67,0.32
PF05202,PF02277:PF07157:PF01330,0,5,0,0,5,1013,0.0,1.0,0,0,0,0,0,0,1018,0,1.0,0,0
PF16669,PF07721:PF09295:PF13174,8,17,4,4,13,997,0.24,0.98,0.5,0.34,3,1,7,2,1008,0.33,0.99,0.12,0.2
PF11882,PF07923:PF07171:PF02884,6,10,6,0,4,1008,0.6,1.0,1.0,0.77,1,1,5,0,1012,1.0,1.0,0.17,0.41
PF13804,PF09003:PF13356:PF13683,5,10,0,5,10,1003,0.0,0.99,0.0,-0.01,2,0,5,2,1011,0.0,0.99,0.0,-0.0
PF09494,PF03000:PF09237:PF03131,11,26,5,6,21,986,0.19,0.97,0.45,0.28,8,4,7,4,1003,0.5,0.99,0.36,0.42
PF12131,PF08773:PF08127:PF11705,2,11,2,0,9,1007,0.18,0.99,1.0,0.42,1,1,1,0,1016,1.0,1.0,0.5,0.71
PF14654,PF05647:PF14920:PF14919,0,0,0,0,0,1018,0,1.0,0,0,0,0,0,0,1018,0,1.0,0,0
PF16869,PF16858:PF06278:PF00926,0,13,0,0,13,1005,0.0,0.99,0,0,4,0,0,4,1014,0.0,1.0,0,0
PF09856,PF02561:PF05229:PF03831,0,0,0,0,0,1018,0,1.0,0,0,0,0,0,0,1018,0,1.0,0,0
PF15427,PF15709:PF15976:PF15504,1,1,0,1,1,1016,0.0,1.0,0.0,-0.0,0,0,1,0,1017,0,1.0,0.0,0
PF03835,PF10405:PF10403:PF10404,12,10,10,2,0,1006,1.0,1.0,0.83,0.91,10,10,2,0,1006,1.0,1.0,0.83,0.91
PF04621,PF12310:PF11620:PF02198,5,16,2,3,14,999,0.12,0.98,0.4,0.22,2,2,3,0,1013,1.0,1.0,0.4,0.63
PF03068,PF08527:PF08526:PF02971,8,8,4,4,4,1006,0.5,0.99,0.5,0.5,4,4,4,0,1010,1.0,1.0,0.5,0.71
PF14644,PF14643:PF15246:PF15452,3,10,3,0,7,1008,0.3,0.99,1.0,0.55,0,0,3,0,1015,0,1.0,0.0,0
PF15057,PF13757:PF14771:PF08487,9,12,3,6,9,1000,0.25,0.99,0.33,0.28,3,2,7,1,1008,0.67,0.99,0.22,0.38
PF09179,PF11734:PF16822:PF14882,3,3,3,0,0,1015,1.0,1.0,1.0,1.0,0,0,3,0,1015,0,1.0,0.0,0
PF00209,PF03491:PF05291:PF03137,39,18,7,32,11,968,0.39,0.96,0.18,0.25,5,4,35,1,978,0.8,0.96,0.1,0.28
PF17046,PF11558:PF17106:PF17111,5,21,5,0,16,997,0.24,0.98,1.0,0.48,2,2,3,0,1013,1.0,1.0,0.4,0.63
PF16815,PF17003:PF14087:PF07347,6,15,5,1,10,1002,0.33,0.99,0.83,0.52,3,3,3,0,1012,1.0,1.0,0.5,0.71
PF02927,PF00942:PF09478:PF00553,2,10,1,1,9,1007,0.1,0.99,0.5,0.22,3,1,1,2,1014,0.33,1.0,0.5,0.41
PF07887,PF03514:PF03106:PF03407,11,34,11,0,23,984,0.32,0.98,1.0,0.56,19,10,1,9,998,0.53,0.99,0.91,0.69
PF10152,PF02181:PF06346:PF10158,12,42,7,5,35,971,0.17,0.96,0.58,0.3,5,3,9,2,1004,0.6,0.99,0.25,0.38
PF00363,PF07139:PF07800:PF02186,1,21,0,1,21,996,0.0,0.98,0.0,-0.0,1,0,1,1,1016,0.0,1.0,0.0,-0.0
PF10291,PF08683:PF15246:PF15920,6,9,1,5,8,1004,0.11,0.99,0.17,0.13,0,0,6,0,1012,0,0.99,0.0,0
PF00028,PF01049:PF02210:PF07953,48,43,26,22,17,953,0.6,0.96,0.54,0.55,7,6,42,1,969,0.86,0.96,0.12,0.32
PF16709,PF16711:PF16712:PF16874,3,2,1,2,1,1014,0.5,1.0,0.33,0.41,1,1,2,0,1015,1.0,1.0,0.33,0.58
PF09454,PF05743:PF07334:PF07292,10,13,10,0,3,1005,0.77,1.0,1.0,0.88,1,0,10,1,1007,0.0,0.99,0.0,-0.0
PF16021,PF12829:PF08730:PF15115,5,1,0,5,1,1012,0.0,0.99,0.0,-0.0,0,0,5,0,1013,0,1.0,0.0,0
PF10571,PF12049:PF06989:PF06420,0,1,0,0,1,1017,0.0,1.0,0,0,0,0,0,0,1018,0,1.0,0,0
PF10021,PF08588:PF15346:PF11255,12,5,3,9,2,1004,0.6,0.99,0.25,0.38,0,0,12,0,1006,0,0.99,0.0,0
PF04835,PF04848:PF01913:PF03238,0,4,0,0,4,1014,0.0,1.0,0,0,0,0,0,0,1018,0,1.0,0,0
PF06955,PF15886:PF04833:PF06880,8,11,3,5,8,1002,0.27,0.99,0.38,0.31,0,0,8,0,1010,0,0.99,0.0,0
PF08808,PF15281:PF04351:PF17206,0,4,0,0,4,1014,0.0,1.0,0,0,0,0,0,0,1018,0,1.0,0,0
PF02221,PF11938:PF12513:PF00833,19,33,6,13,27,972,0.18,0.96,0.32,0.22,7,3,16,4,995,0.43,0.98,0.16,0.25
PF15064,PF05111:PF00865:PF02106,2,1,0,2,1,1015,0.0,1.0,0.0,-0.0,0,0,2,0,1016,0,1.0,0.0,0
PF03727,PF00349:PF09764:PF04833,22,22,20,2,2,994,0.91,1.0,0.91,0.91,6,6,16,0,996,1.0,0.98,0.27,0.52
PF00792,PF00613:PF02192:PF00794,24,35,24,0,11,983,0.69,0.99,1.0,0.82,21,21,3,0,994,1.0,1.0,0.88,0.93
PF15748,PF11402:PF08026:PF10514,0,0,0,0,0,1018,0,1.0,0,0,0,0,0,0,1018,0,1.0,0,0
PF16482,PF14622:PF07528:PF02137,4,42,3,1,39,975,0.07,0.96,0.75,0.22,8,2,2,6,1008,0.25,0.99,0.5,0.35
PF01406,PF09190:PF04981:PF05622,19,17,7,12,10,989,0.41,0.98,0.37,0.38,7,4,15,3,996,0.57,0.98,0.21,0.34
PF10336,PF09463:PF10198:PF10446,1,5,0,1,5,1012,0.0,0.99,0.0,-0.0,0,0,1,0,1017,0,1.0,0.0,0
PF02525,PF06232:PF10705:PF15063,2,4,0,2,4,1012,0.0,0.99,0.0,-0.0,0,0,2,0,1016,0,1.0,0.0,0
PF05541,PF05366:PF09141:PF02570,0,14,0,0,14,1004,0.0,0.99,0,0,1,0,0,1,1017,0.0,1.0,0,0
PF16818,PF09832:PF05611:PF15202,0,0,0,0,0,1018,0,1.0,0,0,0,0,0,0,1018,0,1.0,0,0
PF01835,PF07677:PF07703:PF07678,9,17,9,0,8,1001,0.53,0.99,1.0,0.72,14,9,0,5,1004,0.64,1.0,1.0,0.8
PF09383,PF01032:PF08352:PF09821,2,7,2,0,5,1011,0.29,1.0,1.0,0.53,2,2,0,0,1016,1.0,1.0,1.0,1.0
PF08617,PF12414:PF08081:PF08143,8,4,2,6,2,1008,0.5,0.99,0.25,0.35,1,1,7,0,1010,1.0,0.99,0.12,0.35
PF15734,PF10500:PF09216:PF03692,3,3,0,3,3,1012,0.0,0.99,0.0,-0.0,0,0,3,0,1015,0,1.0,0.0,0
PF05393,PF08945:PF03203:PF17015,0,0,0,0,0,1018,0,1.0,0,0,0,0,0,0,1018,0,1.0,0,0
PF06881,PF07500:PF15694:PF15693,4,16,2,2,14,1000,0.12,0.98,0.5,0.24,0,0,4,0,1014,0,1.0,0.0,0
PF00389,PF01842:PF02826:PF10369,49,46,23,26,23,946,0.5,0.95,0.47,0.46,12,10,39,2,967,0.83,0.96,0.2,0.4
PF13638,PF17215:PF17216:PF10374,14,15,8,6,7,997,0.53,0.99,0.57,0.55,7,6,8,1,1003,0.86,0.99,0.43,0.6
PF08666,PF03102:PF14918:PF16116,8,2,0,8,2,1008,0.0,0.99,0.0,-0.0,0,0,8,0,1010,0,0.99,0.0,0
PF13458,PF12849:PF08376:PF16214,8,17,5,3,12,998,0.29,0.99,0.62,0.42,4,3,5,1,1009,0.75,0.99,0.38,0.53
PF10000,PF13840:PF00742:PF01958,3,26,2,1,24,991,0.08,0.98,0.67,0.22,3,1,2,2,1013,0.33,1.0,0.33,0.33
PF05419,PF12046:PF17032:PF02531,0,2,0,0,2,1016,0.0,1.0,0,0,0,0,0,0,1018,0,1.0,0,0
PF04945,PF13296:PF04963:PF05513,1,2,0,1,2,1015,0.0,1.0,0.0,-0.0,1,0,1,1,1016,0.0,1.0,0.0,-0.0
PF07902,PF09365:PF05611:PF08093,1,3,0,1,3,1014,0.0,1.0,0.0,-0.0,0,0,1,0,1017,0,1.0,0.0,0
PF06241,PF14764:PF06662:PF06427,1,16,1,0,15,1002,0.06,0.99,1.0,0.25,2,1,0,1,1016,0.5,1.0,1.0,0.71
PF04205,PF00070:PF00998:PF02378,2,12,1,1,11,1005,0.08,0.99,0.5,0.2,2,1,1,1,1015,0.5,1.0,0.5,0.5
PF12161,PF13588:PF00419:PF07149,2,3,2,0,1,1015,0.67,1.0,1.0,0.82,0,0,2,0,1016,0,1.0,0.0,0
PF11799,PF00817:PF11798:PF13438,25,27,25,0,2,991,0.93,1.0,1.0,0.96,6,6,19,0,993,1.0,0.98,0.24,0.49
PF03828,PF01909:PF14111:PF01107,26,70,19,7,51,941,0.27,0.94,0.73,0.42,12,10,16,2,990,0.83,0.98,0.38,0.56
PF12714,PF08742:PF00094:PF01826,13,49,13,0,36,969,0.27,0.96,1.0,0.51,30,13,0,17,988,0.43,0.98,1.0,0.65
PF04223,PF01289:PF11751:PF04764,1,1,0,1,1,1016,0.0,1.0,0.0,-0.0,0,0,1,0,1017,0,1.0,0.0,0
PF12467,PF13780:PF11026:PF10554,5,0,0,5,0,1013,0,1.0,0.0,0,0,0,5,0,1013,0,1.0,0.0,0
PF03998,PF03214:PF06219:PF15165,9,5,1,8,4,1005,0.2,0.99,0.11,0.14,0,0,9,0,1009,0,0.99,0.0,0
PF00686,PF16387:PF00723:PF03009,36,39,21,15,18,964,0.54,0.97,0.58,0.54,10,10,26,0,982,1.0,0.97,0.28,0.52
PF09688,PF02427:PF07961:PF02393,0,0,0,0,0,1018,0,1.0,0,0,0,0,0,0,1018,0,1.0,0,0
PF03592,PF06381:PF11863:PF17206,0,1,0,0,1,1017,0.0,1.0,0,0,0,0,0,0,1018,0,1.0,0,0
PF06017,PF00063:PF04088:PF10580,22,74,20,2,54,942,0.27,0.94,0.91,0.48,1,1,21,0,996,1.0,0.98,0.05,0.21
PF15674,PF02924:PF06074:PF04993,3,0,0,3,0,1015,0,1.0,0.0,0,0,0,3,0,1015,0,1.0,0.0,0
PF03283,PF02990:PF05938:PF09353,19,35,7,12,28,971,0.2,0.96,0.37,0.25,6,2,17,4,995,0.33,0.98,0.11,0.18
PF12168,PF01706:PF13742:PF04170,1,3,0,1,3,1014,0.0,1.0,0.0,-0.0,0,0,1,0,1017,0,1.0,0.0,0
PF01958,PF00742:PF03447:PF10000,11,19,11,0,8,999,0.58,0.99,1.0,0.76,8,3,8,5,1002,0.38,0.99,0.27,0.31
PF03661,PF11998:PF00515:PF02096,14,72,9,5,63,941,0.12,0.93,0.64,0.26,10,5,9,5,999,0.5,0.99,0.36,0.42
PF12590,PF01643:PF14767:PF08523,1,7,1,0,6,1011,0.14,0.99,1.0,0.38,0,0,1,0,1017,0,1.0,0.0,0
PF13737,PF17188:PF01312:PF14362,0,0,0,0,0,1018,0,1.0,0,0,0,0,0,0,1018,0,1.0,0,0
PF04536,PF11282:PF08034:PF12926,4,2,0,4,2,1012,0.0,0.99,0.0,-0.0,0,0,4,0,1014,0,1.0,0.0,0
PF05891,PF03091:PF01256:PF01093,15,25,8,7,17,986,0.32,0.98,0.53,0.4,3,1,14,2,1001,0.33,0.98,0.07,0.14
PF07302,PF07499:PF12101:PF13090,0,4,0,0,4,1014,0.0,1.0,0,0,0,0,0,0,1018,0,1.0,0,0
PF04935,PF09511:PF08302:PF08303,8,10,0,8,10,1000,0.0,0.98,0.0,-0.01,4,0,8,4,1006,0.0,0.99,0.0,-0.01
PF00479,PF02781:PF01182:PF08288,14,33,14,0,19,985,0.42,0.98,1.0,0.65,7,4,10,3,1001,0.57,0.99,0.29,0.4
PF07679,PF07645:PF06582:PF00057,92,98,51,41,47,879,0.52,0.91,0.55,0.49,37,27,65,10,916,0.73,0.93,0.29,0.43
PF04776,PF06271:PF08227:PF14769,9,11,2,7,9,1000,0.18,0.98,0.22,0.19,0,0,9,0,1009,0,0.99,0.0,0
PF16325,PF14841:PF06070:PF02465,1,2,0,1,2,1015,0.0,1.0,0.0,-0.0,0,0,1,0,1017,0,1.0,0.0,0
PF01853,PF05712:PF01530:PF08474,31,31,10,21,21,966,0.32,0.96,0.32,0.3,7,6,25,1,986,0.86,0.97,0.19,0.4
PF09299,PF14659:PF16850:PF04085,0,3,0,0,3,1015,0.0,1.0,0,0,0,0,0,0,1018,0,1.0,0,0
PF15065,PF06951:PF15260:PF15008,8,12,2,6,10,1000,0.17,0.98,0.25,0.2,1,1,7,0,1010,1.0,0.99,0.12,0.35
PF05458,PF15872:PF15069:PF15741,5,1,0,5,1,1012,0.0,0.99,0.0,-0.0,0,0,5,0,1013,0,1.0,0.0,0
PF10339,PF14743:PF11793:PF04250,0,9,0,0,9,1009,0.0,0.99,0,0,1,0,0,1,1017,0.0,1.0,0,0
PF16837,PF11931:PF12108:PF16958,6,7,6,0,1,1011,0.86,1.0,1.0,0.93,5,5,1,0,1012,1.0,1.0,0.83,0.91
PF10960,PF13948:PF04680:PF15789,0,6,0,0,6,1012,0.0,0.99,0,0,0,0,0,0,1018,0,1.0,0,0
PF02838,PF03174:PF03173:PF14845,9,21,5,4,16,993,0.24,0.98,0.56,0.36,3,3,6,0,1009,1.0,0.99,0.33,0.58
PF14629,PF08740:PF08542:PF14363,8,32,3,5,29,981,0.09,0.97,0.38,0.18,6,2,6,4,1006,0.33,0.99,0.25,0.28
PF12598,PF16176:PF11078:PF00907,1,19,1,0,18,999,0.05,0.98,1.0,0.23,5,1,0,4,1013,0.2,1.0,1.0,0.45
PF00717,PF04667:PF02284:PF10181,33,13,6,27,7,978,0.46,0.97,0.18,0.28,1,0,33,1,984,0.0,0.97,0.0,-0.01
PF04398,PF06749:PF04674:PF06404,9,12,2,7,10,999,0.17,0.98,0.22,0.18,1,1,8,0,1009,1.0,0.99,0.11,0.33
PF03806,PF04764:PF15851:PF02503,1,2,1,0,1,1016,0.5,1.0,1.0,0.71,0,0,1,0,1017,0,1.0,0.0,0
PF13237,PF00499:PF00507:PF13187,8,16,8,0,8,1002,0.5,0.99,1.0,0.7,2,2,6,0,1010,1.0,0.99,0.25,0.5
PF15832,PF15876:PF15107:PF14985,0,2,0,0,2,1016,0.0,1.0,0,0,0,0,0,0,1018,0,1.0,0,0
PF13628,PF05707:PF16804:PF15555,0,1,0,0,1,1017,0.0,1.0,0,0,0,0,0,0,1018,0,1.0,0,0
PF04060,PF12883:PF08402:PF00528,4,35,3,1,32,982,0.09,0.97,0.75,0.25,6,2,2,4,1010,0.33,0.99,0.5,0.41
PF01789,PF07896:PF02915:PF07816,6,6,1,5,5,1007,0.17,0.99,0.17,0.16,1,1,5,0,1012,1.0,1.0,0.17,0.41
PF09493,PF08497:PF05418:PF15826,0,1,0,0,1,1017,0.0,1.0,0,0,0,0,0,0,1018,0,1.0,0,0
PF12834,PF15762:PF15482:PF03544,0,4,0,0,4,1014,0.0,1.0,0,0,0,0,0,0,1018,0,1.0,0,0
PF04030,PF08031:PF02913:PF09265,21,64,10,11,54,943,0.16,0.94,0.48,0.25,17,6,15,11,986,0.35,0.97,0.29,0.3
PF13880,PF13878:PF02421:PF04546,4,12,4,0,8,1006,0.33,0.99,1.0,0.58,0,0,4,0,1014,0,1.0,0.0,0
PF12324,PF11245:PF11751:PF08708,3,0,0,3,0,1015,0,1.0,0.0,0,0,0,3,0,1015,0,1.0,0.0,0
PF10525,PF04617:PF12407:PF04731,4,2,1,3,1,1013,0.5,1.0,0.25,0.35,1,1,3,0,1014,1.0,1.0,0.25,0.5
PF08268,PF07734:PF10442:PF12014,12,18,7,5,11,995,0.39,0.98,0.58,0.47,2,2,10,0,1006,1.0,0.99,0.17,0.41
PF12412,PF05167:PF12834:PF03241,0,1,0,0,1,1017,0.0,1.0,0,0,0,0,0,0,1018,0,1.0,0,0
PF03840,PF04237:PF02162:PF01973,1,6,0,1,6,1011,0.0,0.99,0.0,-0.0,0,0,1,0,1017,0,1.0,0.0,0
PF15952,PF08730:PF09690:PF07359,0,0,0,0,0,1018,0,1.0,0,0,0,0,0,0,1018,0,1.0,0,0
PF00104,PF00105:PF02166:PF02159,45,47,40,5,7,966,0.85,0.99,0.89,0.86,10,10,35,0,973,1.0,0.97,0.22,0.46
PF09440,PF08375:PF05470:PF10602,5,33,4,1,29,984,0.12,0.97,0.8,0.3,5,1,4,4,1009,0.2,0.99,0.2,0.2
PF09351,PF11595:PF15546:PF15092,10,5,3,7,2,1006,0.6,0.99,0.3,0.42,3,3,7,0,1008,1.0,0.99,0.3,0.55
PF08025,PF04111:PF06923:PF03116,0,12,0,0,12,1006,0.0,0.99,0,0,0,0,0,0,1018,0,1.0,0,0
PF02591,PF12889:PF10865:PF16286,0,0,0,0,0,1018,0,1.0,0,0,0,0,0,0,1018,0,1.0,0,0
PF10106,PF17206:PF09498:PF03592,1,1,0,1,1,1016,0.0,1.0,0.0,-0.0,0,0,1,0,1017,0,1.0,0.0,0
PF15074,PF13684:PF08036:PF01904,4,8,0,4,8,1006,0.0,0.99,0.0,-0.01,0,0,4,0,1014,0,1.0,0.0,0
PF05593,PF06484:PF15636:PF03527,4,4,2,2,2,1012,0.5,1.0,0.5,0.5,1,0,4,1,1013,0.0,1.0,0.0,-0.0
PF02114,PF01784:PF05995:PF09812,6,13,1,5,12,1000,0.08,0.98,0.17,0.11,1,1,5,0,1012,1.0,1.0,0.17,0.41
PF16685,PF15273:PF10189:PF15326,3,9,0,3,9,1006,0.0,0.99,0.0,-0.01,1,0,3,1,1014,0.0,1.0,0.0,-0.0
PF06049,PF09049:PF00323:PF09051,1,0,0,1,0,1017,0,1.0,0.0,0,0,0,1,0,1017,0,1.0,0.0,0
PF00854,PF07819:PF12036:PF12274,30,21,10,20,11,977,0.48,0.97,0.33,0.38,1,0,30,1,987,0.0,0.97,0.0,-0.01
PF15922,PF13597:PF12345:PF06968,2,10,2,0,8,1008,0.2,0.99,1.0,0.45,2,2,0,0,1016,1.0,1.0,1.0,1.0
PF04272,PF03275:PF15046:PF07119,2,4,0,2,4,1012,0.0,0.99,0.0,-0.0,0,0,2,0,1016,0,1.0,0.0,0
PF04783,PF14818:PF06972:PF12129,7,13,5,2,8,1003,0.38,0.99,0.71,0.52,0,0,7,0,1011,0,0.99,0.0,0
PF07973,PF01411:PF02272:PF03129,26,58,25,1,33,959,0.43,0.97,0.96,0.63,17,14,12,3,989,0.82,0.99,0.54,0.66
PF01432,PF05652:PF03074:PF08439,25,16,7,18,9,984,0.44,0.97,0.28,0.34,2,2,23,0,993,1.0,0.98,0.08,0.28
PF11081,PF04355:PF02565:PF05838,0,0,0,0,0,1018,0,1.0,0,0,0,0,0,0,1018,0,1.0,0,0
PF01987,PF04667:PF10780:PF01097,6,8,1,5,7,1005,0.12,0.99,0.17,0.14,0,0,6,0,1012,0,0.99,0.0,0
PF04353,PF04553:PF12357:PF05664,0,21,0,0,21,997,0.0,0.98,0,0,4,0,0,4,1014,0.0,1.0,0,0
PF03073,PF13741:PF14954:PF03488,2,4,0,2,4,1012,0.0,0.99,0.0,-0.0,1,0,2,1,1015,0.0,1.0,0.0,-0.0
PF10432,PF16265:PF05488:PF12805,2,0,0,2,0,1016,0,1.0,0.0,0,0,0,2,0,1016,0,1.0,0.0,0
PF01558,PF17147:PF10371:PF01855,6,14,6,0,8,1004,0.43,0.99,1.0,0.65,8,6,0,2,1010,0.75,1.0,1.0,0.87
PF15705,PF15706:PF16070:PF00963,2,11,2,0,9,1007,0.18,0.99,1.0,0.42,9,2,0,7,1009,0.22,0.99,1.0,0.47
PF14355,PF11363:PF01752:PF15758,0,2,0,0,2,1016,0.0,1.0,0,0,0,0,0,0,1018,0,1.0,0,0
PF00936,PF15470:PF03326:PF13990,0,0,0,0,0,1018,0,1.0,0,0,0,0,0,0,1018,0,1.0,0,0
PF00941,PF03450:PF01315:PF00111,22,43,22,0,21,975,0.51,0.98,1.0,0.71,22,22,0,0,996,1.0,1.0,1.0,1.0
PF15076,PF15107:PF09690:PF01638,0,1,0,0,1,1017,0.0,1.0,0,0,0,0,0,0,1018,0,1.0,0,0
PF06472,PF01061:PF14510:PF13304,13,56,8,5,48,957,0.14,0.95,0.62,0.28,16,4,9,12,993,0.25,0.98,0.31,0.27
PF07700,PF16214:PF06327:PF04940,14,12,1,13,11,993,0.08,0.98,0.07,0.07,6,1,13,5,999,0.17,0.98,0.07,0.1
PF15556,PF02977:PF15119:PF17050,0,2,0,0,2,1016,0.0,1.0,0,0,0,0,0,0,1018,0,1.0,0,0
PF10357,PF00022:PF15361:PF16840,12,60,8,4,52,954,0.13,0.94,0.67,0.28,3,1,11,2,1004,0.33,0.99,0.08,0.16
PF11688,PF05757:PF06253:PF01593,0,64,0,0,64,954,0.0,0.94,0,0,2,0,0,2,1016,0.0,1.0,0,0
PF01199,PF04690:PF01294:PF05512,13,8,4,9,4,1001,0.5,0.99,0.31,0.39,2,2,11,0,1005,1.0,0.99,0.15,0.39
PF02631,PF08653:PF15553:PF17078,2,2,0,2,2,1014,0.0,1.0,0.0,-0.0,0,0,2,0,1016,0,1.0,0.0,0
PF13597,PF12345:PF06969:PF06968,4,8,2,2,6,1008,0.25,0.99,0.5,0.35,2,2,2,0,1014,1.0,1.0,0.5,0.71
PF10639,PF09415:PF01025:PF01679,14,27,3,11,24,980,0.11,0.97,0.21,0.14,3,2,12,1,1003,0.67,0.99,0.14,0.3
PF09586,PF09611:PF17007:PF07610,0,1,0,0,1,1017,0.0,1.0,0,0,0,0,0,0,1018,0,1.0,0,0
PF08122,PF09696:PF10780:PF15013,4,10,0,4,10,1004,0.0,0.99,0.0,-0.01,0,0,4,0,1014,0,1.0,0.0,0
PF09834,PF13362:PF05065:PF09594,0,2,0,0,2,1016,0.0,1.0,0,0,0,0,0,0,1018,0,1.0,0,0
PF06242,PF00580:PF07943:PF07497,4,23,4,0,19,995,0.17,0.98,1.0,0.41,3,2,2,1,1013,0.67,1.0,0.5,0.58
PF05426,PF09424:PF08787:PF06912,4,13,1,3,12,1002,0.08,0.99,0.25,0.13,0,0,4,0,1014,0,1.0,0.0,0
PF16198,PF08068:PF01472:PF01509,10,28,10,0,18,990,0.36,0.98,1.0,0.59,7,6,4,1,1007,0.86,1.0,0.6,0.71
PF01890,PF08982:PF12390:PF12080,1,3,0,1,3,1014,0.0,1.0,0.0,-0.0,0,0,1,0,1017,0,1.0,0.0,0
PF16519,PF11404:PF12372:PF07001,8,11,3,5,8,1002,0.27,0.99,0.38,0.31,1,1,7,0,1010,1.0,0.99,0.12,0.35
PF15929,PF10188:PF04664:PF09789,0,5,0,0,5,1013,0.0,1.0,0,0,0,0,0,0,1018,0,1.0,0,0
PF15790,PF07529:PF13892:PF06465,1,33,1,0,32,985,0.03,0.97,1.0,0.17,8,1,0,7,1010,0.12,0.99,1.0,0.35
PF06288,PF01323:PF08338:PF12435,1,30,1,0,29,988,0.03,0.97,1.0,0.18,4,0,1,4,1013,0.0,1.0,0.0,-0.0
PF09045,PF15737:PF09007:PF16667,1,3,1,0,2,1015,0.33,1.0,1.0,0.58,1,1,0,0,1017,1.0,1.0,1.0,1.0
PF04045,PF00079:PF16038:PF08584,18,32,3,15,29,971,0.09,0.96,0.17,0.1,2,1,17,1,999,0.5,0.98,0.06,0.16
PF02368,PF17034:PF10441:PF07539,4,19,2,2,17,997,0.11,0.98,0.5,0.22,2,1,3,1,1013,0.5,1.0,0.25,0.35
PF12996,PF11750:PF12495:PF06243,0,0,0,0,0,1018,0,1.0,0,0,0,0,0,0,1018,0,1.0,0,0
PF10426,PF12940:PF04757:PF08652,4,36,4,0,32,982,0.11,0.97,1.0,0.33,2,1,3,1,1013,0.5,1.0,0.25,0.35
PF07270,PF06115:PF04955:PF09779,0,2,0,0,2,1016,0.0,1.0,0,0,0,0,0,0,1018,0,1.0,0,0
PF10160,PF04176:PF02284:PF04716,0,22,0,0,22,996,0.0,0.98,0,0,4,0,0,4,1014,0.0,1.0,0,0
PF03924,PF00486:PF06580:PF00672,8,23,5,3,18,992,0.22,0.98,0.62,0.36,12,3,5,9,1001,0.25,0.99,0.38,0.3
PF13538,PF02689:PF12014:PF05970,5,42,5,0,37,976,0.12,0.96,1.0,0.34,7,3,2,4,1009,0.43,0.99,0.6,0.5
PF02500,PF13505:PF15856:PF11751,0,1,0,0,1,1017,0.0,1.0,0,0,0,0,0,0,1018,0,1.0,0,0
PF11584,PF15809:PF15041:PF05151,0,1,0,0,1,1017,0.0,1.0,0,0,0,0,0,0,1018,0,1.0,0,0
PF12887,PF12879:PF15253:PF12090,0,5,0,0,5,1013,0.0,1.0,0,0,0,0,0,0,1018,0,1.0,0,0
PF07072,PF01467:PF01121:PF15360,2,44,2,0,42,974,0.05,0.96,1.0,0.21,9,2,0,7,1009,0.22,0.99,1.0,0.47
PF05295,PF10285:PF10630:PF10284,0,0,0,0,0,1018,0,1.0,0,0,0,0,0,0,1018,0,1.0,0,0
PF14243,PF15851:PF04223:PF13530,0,3,0,0,3,1015,0.0,1.0,0,0,0,0,0,0,1018,0,1.0,0,0
PF14372,PF10683:PF04937:PF02892,21,39,14,7,25,972,0.36,0.97,0.67,0.48,12,8,13,4,993,0.67,0.98,0.38,0.5
PF16959,PF01401:PF02935:PF03298,2,17,2,0,15,1001,0.12,0.99,1.0,0.34,4,2,0,2,1014,0.5,1.0,1.0,0.71
PF08000,PF02074:PF02951:PF15427,2,6,0,2,6,1010,0.0,0.99,0.0,-0.0,0,0,2,0,1016,0,1.0,0.0,0
PF09133,PF10033:PF16944:PF09429,5,12,1,4,11,1002,0.08,0.99,0.2,0.12,1,0,5,1,1012,0.0,0.99,0.0,-0.0
PF02323,PF03203:PF17015:PF04892,1,0,0,1,0,1017,0,1.0,0.0,0,0,0,1,0,1017,0,1.0,0.0,0
PF05889,PF00147:PF08702:PF15043,1,51,1,0,50,967,0.02,0.95,1.0,0.14,4,1,0,3,1014,0.25,1.0,1.0,0.5
PF05777,PF07385:PF14065:PF17016,0,0,0,0,0,1018,0,1.0,0,0,0,0,0,0,1018,0,1.0,0,0
PF09556,PF12080:PF11775:PF10566,1,0,0,1,0,1017,0,1.0,0.0,0,0,0,1,0,1017,0,1.0,0.0,0
PF08531,PF05592:PF14200:PF03422,13,30,13,0,17,988,0.43,0.98,1.0,0.65,7,5,8,2,1003,0.71,0.99,0.38,0.52
PF07197,PF16872:PF02108:PF13005,1,0,0,1,0,1017,0,1.0,0.0,0,0,0,1,0,1017,0,1.0,0.0,0
PF02630,PF01871:PF06026:PF07816,17,10,1,16,9,992,0.1,0.98,0.06,0.06,0,0,17,0,1001,0,0.98,0.0,0
PF04072,PF13673:PF07819:PF03178,15,49,10,5,39,964,0.2,0.96,0.67,0.35,12,7,8,5,998,0.58,0.99,0.47,0.52
PF05197,PF14798:PF05308:PF01907,5,13,3,2,10,1003,0.23,0.99,0.6,0.37,1,1,4,0,1013,1.0,1.0,0.2,0.45
PF16757,PF01120:PF08526:PF08527,6,22,6,0,16,996,0.27,0.98,1.0,0.52,4,0,6,4,1008,0.0,0.99,0.0,-0.0
PF09358,PF16191:PF16190:PF16195,12,5,2,10,3,1003,0.4,0.99,0.17,0.25,3,1,11,2,1004,0.33,0.99,0.08,0.16
PF08266,PF08758:PF01458:PF06414,5,13,3,2,10,1003,0.23,0.99,0.6,0.37,2,1,4,1,1012,0.5,1.0,0.2,0.31
PF05424,PF03011:PF15445:PF12377,1,1,1,0,0,1017,1.0,1.0,1.0,1.0,1,1,0,0,1017,1.0,1.0,1.0,1.0
PF10514,PF15085:PF15114:PF15343,0,2,0,0,2,1016,0.0,1.0,0,0,0,0,0,0,1018,0,1.0,0,0
PF04999,PF03865:PF04559:PF06506,1,4,0,1,4,1013,0.0,1.0,0.0,-0.0,0,0,1,0,1017,0,1.0,0.0,0
PF06102,PF13092:PF11833:PF07107,9,11,1,8,10,999,0.09,0.98,0.11,0.09,1,1,8,0,1009,1.0,0.99,0.11,0.33
PF01478,PF07203:PF01316:PF15192,1,3,0,1,3,1014,0.0,1.0,0.0,-0.0,0,0,1,0,1017,0,1.0,0.0,0
PF15715,PF15109:PF06541:PF15364,0,0,0,0,0,1018,0,1.0,0,0,0,0,0,0,1018,0,1.0,0,0
PF13598,PF10212:PF16704:PF15964,7,4,2,5,2,1009,0.5,0.99,0.29,0.37,1,1,6,0,1011,1.0,0.99,0.14,0.38
PF05185,PF11531:PF00111:PF03473,22,48,13,9,35,961,0.27,0.96,0.59,0.38,10,6,16,4,992,0.6,0.98,0.27,0.4
PF05267,PF16089:PF01097:PF15013,0,4,0,0,4,1014,0.0,1.0,0,0,0,0,0,0,1018,0,1.0,0,0
PF04773,PF09327:PF04546:PF06826,7,5,3,4,2,1009,0.6,0.99,0.43,0.5,0,0,7,0,1011,0,0.99,0.0,0
PF15551,PF15703:PF15814:PF15741,0,1,0,0,1,1017,0.0,1.0,0,0,0,0,0,0,1018,0,1.0,0,0
PF17097,PF07834:PF13474:PF08509,0,9,0,0,9,1009,0.0,0.99,0,0,1,0,0,1,1017,0.0,1.0,0,0
PF05084,PF01300:PF07101:PF11478,0,17,0,0,17,1001,0.0,0.98,0,0,0,0,0,0,1018,0,1.0,0,0
PF02226,PF08727:PF00548:PF00947,12,12,12,0,0,1006,1.0,1.0,1.0,1.0,12,12,0,0,1006,1.0,1.0,1.0,1.0
PF11476,PF15751:PF07149:PF15830,0,1,0,0,1,1017,0.0,1.0,0,0,0,0,0,0,1018,0,1.0,0,0
PF11232,PF11235:PF11244:PF11265,4,6,3,1,3,1011,0.5,1.0,0.75,0.61,0,0,4,0,1014,0,1.0,0.0,0
PF13967,PF02714:PF14703:PF12621,22,23,21,1,2,994,0.91,1.0,0.95,0.93,21,21,1,0,996,1.0,1.0,0.95,0.98
PF00180,PF00255:PF00724:PF01198,37,67,14,23,53,928,0.21,0.93,0.38,0.24,9,6,31,3,978,0.67,0.97,0.16,0.32
PF10488,PF10472:PF14047:PF14049,1,0,0,1,0,1017,0,1.0,0.0,0,0,0,1,0,1017,0,1.0,0.0,0
PF07109,PF03882:PF15925:PF12897,2,3,1,1,2,1014,0.33,1.0,0.5,0.41,0,0,2,0,1016,0,1.0,0.0,0
PF03607,PF05517:PF13281:PF12474,17,19,7,10,12,989,0.37,0.98,0.41,0.38,5,4,13,1,1000,0.8,0.99,0.24,0.43
PF00440,PF08361:PF13421:PF04166,18,6,2,16,4,996,0.33,0.98,0.11,0.18,1,1,17,0,1000,1.0,0.98,0.06,0.23
PF16577,PF12744:PF16158:PF00569,2,49,2,0,47,969,0.04,0.95,1.0,0.2,5,2,0,3,1013,0.4,1.0,1.0,0.63
PF01991,PF16454:PF05296:PF12162,8,11,2,6,9,1001,0.18,0.99,0.25,0.21,0,0,8,0,1010,0,0.99,0.0,0
PF05914,PF15302:PF02106:PF05111,2,1,0,2,1,1015,0.0,1.0,0.0,-0.0,0,0,2,0,1016,0,1.0,0.0,0
PF03893,PF01098:PF01225:PF03734,4,21,1,3,20,994,0.05,0.98,0.25,0.1,3,0,4,3,1011,0.0,0.99,0.0,-0.0
PF16322,PF01167:PF10442:PF08495,1,15,1,0,14,1003,0.07,0.99,1.0,0.26,3,0,1,3,1014,0.0,1.0,0.0,-0.0
PF10173,PF10217:PF05615:PF07052,5,19,3,2,16,997,0.16,0.98,0.6,0.3,0,0,5,0,1013,0,1.0,0.0,0
PF06743,PF08368:PF08373:PF01321,8,25,6,2,19,991,0.24,0.98,0.75,0.42,9,6,2,3,1007,0.67,1.0,0.75,0.7
PF04442,PF00436:PF07896:PF07816,10,25,5,5,20,988,0.2,0.98,0.5,0.31,2,2,8,0,1008,1.0,0.99,0.2,0.45
PF01900,PF01680:PF11991:PF00453,15,26,7,8,19,984,0.27,0.97,0.47,0.34,1,0,15,1,1002,0.0,0.98,0.0,-0.0
PF16731,PF00770:PF15555:PF17112,0,2,0,0,2,1016,0.0,1.0,0,0,0,0,0,0,1018,0,1.0,0,0
PF12284,PF12045:PF10525:PF03529,1,5,1,0,4,1013,0.2,1.0,1.0,0.45,1,1,0,0,1017,1.0,1.0,1.0,1.0
PF03795,PF01828:PF07543:PF09424,9,13,5,4,8,1001,0.38,0.99,0.56,0.46,3,3,6,0,1009,1.0,0.99,0.33,0.58
PF17076,PF15281:PF02277:PF01312,0,6,0,0,6,1012,0.0,0.99,0,0,0,0,0,0,1018,0,1.0,0,0
PF11864,PF03542:PF02145:PF11881,5,14,5,0,9,1004,0.36,0.99,1.0,0.59,5,5,0,0,1013,1.0,1.0,1.0,1.0
PF14489,PF06403:PF07804:PF08708,1,2,0,1,2,1015,0.0,1.0,0.0,-0.0,0,0,1,0,1017,0,1.0,0.0,0
PF08713,PF04691:PF08040:PF15055,0,2,0,0,2,1016,0.0,1.0,0,0,0,0,0,0,1018,0,1.0,0,0
PF09478,PF00553:PF02927:PF00759,9,19,3,6,16,993,0.16,0.98,0.33,0.22,4,3,6,1,1008,0.75,0.99,0.33,0.5
PF16725,PF09262:PF08519:PF09079,3,29,2,1,27,988,0.07,0.97,0.67,0.21,5,2,1,3,1012,0.4,1.0,0.67,0.51
PF06916,PF10173:PF10217:PF05615,10,11,3,7,8,1000,0.27,0.99,0.3,0.28,1,0,10,1,1007,0.0,0.99,0.0,-0.0
PF07227,PF16066:PF09240:PF09067,2,5,1,1,4,1012,0.2,1.0,0.5,0.31,1,1,1,0,1016,1.0,1.0,0.5,0.71
PF12007,PF10106:PF09611:PF02530,0,2,0,0,2,1016,0.0,1.0,0,0,0,0,0,0,1018,0,1.0,0,0
PF03900,PF00766:PF01379:PF08327,16,34,15,1,19,983,0.44,0.98,0.94,0.64,7,4,12,3,999,0.57,0.99,0.25,0.37
PF10180,PF02116:PF10104:PF07904,10,11,1,9,10,998,0.09,0.98,0.1,0.09,2,0,10,2,1006,0.0,0.99,0.0,-0.0
PF08848,PF05448:PF15443:PF02425,0,3,0,0,3,1015,0.0,1.0,0,0,0,0,0,0,1018,0,1.0,0,0
PF05296,PF00103:PF01387:PF06524,2,6,0,2,6,1010,0.0,0.99,0.0,-0.0,1,0,2,1,1015,0.0,1.0,0.0,-0.0
PF17035,PF12024:PF17105:PF03172,14,12,3,11,9,995,0.25,0.98,0.21,0.22,2,2,12,0,1004,1.0,0.99,0.14,0.38
PF13635,PF13390:PF01407:PF03814,0,1,0,0,1,1017,0.0,1.0,0,0,0,0,0,0,1018,0,1.0,0,0
PF02102,PF14866:PF16311:PF17049,3,1,0,3,1,1014,0.0,1.0,0.0,-0.0,0,0,3,0,1015,0,1.0,0.0,0
PF01417,PF14661:PF09429:PF08733,26,12,3,23,9,983,0.25,0.97,0.12,0.16,0,0,26,0,992,0,0.97,0.0,0
PF01221,PF10157:PF01023:PF16166,17,17,6,11,11,990,0.35,0.98,0.35,0.34,5,4,13,1,1000,0.8,0.99,0.24,0.43
PF00570,PF09382:PF14493:PF01612,30,63,29,1,34,954,0.46,0.97,0.97,0.65,10,9,21,1,987,0.9,0.98,0.3,0.51
PF13809,PF10076:PF06745:PF04285,0,0,0,0,0,1018,0,1.0,0,0,0,0,0,0,1018,0,1.0,0,0
PF05838,PF09951:PF06505:PF04355,0,0,0,0,0,1018,0,1.0,0,0,0,0,0,0,1018,0,1.0,0,0
PF00254,PF13174:PF00515:PF01346,57,58,26,31,32,929,0.45,0.94,0.46,0.42,13,7,50,6,955,0.54,0.94,0.12,0.24
PF01658,PF07994:PF03670:PF11105,1,10,1,0,9,1008,0.1,0.99,1.0,0.31,0,0,1,0,1017,0,1.0,0.0,0
PF05933,PF15089:PF08708:PF00669,2,1,0,2,1,1015,0.0,1.0,0.0,-0.0,0,0,2,0,1016,0,1.0,0.0,0
PF00005,PF06422:PF06472:PF14510,168,26,23,145,3,847,0.88,0.85,0.14,0.31,14,14,154,0,850,1.0,0.85,0.08,0.27
PF03314,PF02098:PF10323:PF10328,4,24,1,3,23,991,0.04,0.97,0.25,0.09,4,0,4,4,1010,0.0,0.99,0.0,-0.0
PF14228,PF14222:PF14225:PF16206,7,15,7,0,8,1003,0.47,0.99,1.0,0.68,6,6,1,0,1011,1.0,1.0,0.86,0.93
PF09762,PF17045:PF11577:PF11496,3,12,0,3,12,1003,0.0,0.99,0.0,-0.01,1,0,3,1,1014,0.0,1.0,0.0,-0.0
PF00203,PF00252:PF09439:PF07106,18,30,7,11,23,977,0.23,0.97,0.39,0.29,6,3,15,3,997,0.5,0.98,0.17,0.28
PF02348,PF02130:PF08282:PF12409,5,37,3,2,34,979,0.08,0.96,0.6,0.21,4,1,4,3,1010,0.25,0.99,0.2,0.22
PF15333,PF05399:PF14986:PF02950,0,1,0,0,1,1017,0.0,1.0,0,0,0,0,0,0,1018,0,1.0,0,0
PF13232,PF08847:PF13013:PF03379,0,2,0,0,2,1016,0.0,1.0,0,0,0,0,0,0,1018,0,1.0,0,0
PF13922,PF05066:PF13919:PF12031,4,17,4,0,13,1001,0.24,0.99,1.0,0.48,4,4,0,0,1014,1.0,1.0,1.0,1.0
PF06433,PF14850:PF02911:PF05708,3,15,2,1,13,1002,0.13,0.99,0.67,0.29,1,1,2,0,1015,1.0,1.0,0.33,0.58
PF10215,PF11093:PF15831:PF02202,5,0,0,5,0,1013,0,1.0,0.0,0,0,0,5,0,1013,0,1.0,0.0,0
PF06479,PF14593:PF12063:PF11629,10,10,4,6,6,1002,0.4,0.99,0.4,0.39,4,3,7,1,1007,0.75,0.99,0.3,0.47
PF01271,PF01093:PF01296:PF06540,0,1,0,0,1,1017,0.0,1.0,0,0,1,0,0,1,1017,0.0,1.0,0,0
PF04587,PF00698:PF16197:PF16073,13,48,8,5,40,965,0.17,0.96,0.62,0.3,39,7,6,32,973,0.18,0.96,0.54,0.3
PF00207,PF07703:PF10569:PF07677,18,17,14,4,3,997,0.82,0.99,0.78,0.8,12,12,6,0,1000,1.0,0.99,0.67,0.81
PF13321,PF01347:PF00080:PF11756,0,31,0,0,31,987,0.0,0.97,0,0,7,0,0,7,1011,0.0,0.99,0,0
PF00933,PF01915:PF14310:PF14498,35,35,32,3,3,980,0.91,0.99,0.91,0.91,29,28,7,1,982,0.97,0.99,0.8,0.88
PF04985,PF05939:PF12834:PF08093,0,1,0,0,1,1017,0.0,1.0,0,0,0,0,0,0,1018,0,1.0,0,0
PF09074,PF01706:PF05939:PF11435,0,2,0,0,2,1016,0.0,1.0,0,0,0,0,0,0,1018,0,1.0,0,0
PF05489,PF06805:PF05939:PF06890,0,0,0,0,0,1018,0,1.0,0,0,0,0,0,0,1018,0,1.0,0,0
PF00320,PF13919:PF01448:PF16563,41,22,10,31,12,965,0.45,0.96,0.24,0.31,7,7,34,0,977,1.0,0.97,0.17,0.41
PF05859,PF12319:PF15346:PF08598,3,8,1,2,7,1008,0.12,0.99,0.33,0.2,1,0,3,1,1014,0.0,1.0,0.0,-0.0
PF08081,PF12220:PF12196:PF08143,1,5,1,0,4,1013,0.2,1.0,1.0,0.45,1,1,0,0,1017,1.0,1.0,1.0,1.0
PF06421,PF00679:PF03764:PF14492,21,58,21,0,37,960,0.36,0.96,1.0,0.59,30,10,11,20,977,0.33,0.97,0.48,0.38
PF13230,PF02683:PF16091:PF15749,3,8,0,3,8,1007,0.0,0.99,0.0,-0.0,0,0,3,0,1015,0,1.0,0.0,0
PF04546,PF03979:PF00140:PF13490,4,7,4,0,3,1011,0.57,1.0,1.0,0.75,6,4,0,2,1012,0.67,1.0,1.0,0.82
PF00040,PF00039:PF00878:PF09396,20,7,6,14,1,997,0.86,0.99,0.3,0.5,2,2,18,0,998,1.0,0.98,0.1,0.31
PF06029,PF08964:PF03775:PF05666,5,0,0,5,0,1013,0,1.0,0.0,0,0,0,5,0,1013,0,1.0,0.0,0
PF05116,PF08472:PF12038:PF15924,11,9,2,9,7,1000,0.22,0.98,0.18,0.19,0,0,11,0,1007,0,0.99,0.0,0
PF01207,PF00035:PF10192:PF14622,35,64,17,18,47,936,0.27,0.94,0.49,0.33,19,9,26,10,973,0.47,0.96,0.26,0.33
PF08737,PF12735:PF08743:PF05450,6,19,3,3,16,996,0.16,0.98,0.5,0.27,2,2,4,0,1012,1.0,1.0,0.33,0.58
PF07494,PF01580:PF08345:PF14882,1,5,0,1,5,1012,0.0,0.99,0.0,-0.0,1,0,1,1,1016,0.0,1.0,0.0,-0.0
PF07961,PF17032:PF08591:PF02427,0,0,0,0,0,1018,0,1.0,0,0,0,0,0,0,1018,0,1.0,0,0
PF12833,PF02311:PF03480:PF12625,26,15,10,16,5,987,0.67,0.98,0.38,0.5,3,3,23,0,992,1.0,0.98,0.12,0.34
PF01347,PF09172:PF06448:PF09175,19,11,11,8,0,999,1.0,0.99,0.58,0.76,4,4,15,0,999,1.0,0.99,0.21,0.46
PF09336,PF01434:PF16565:PF16193,15,47,7,8,40,963,0.15,0.95,0.47,0.25,6,4,11,2,1001,0.67,0.99,0.27,0.42
PF14047,PF14049:PF10488:PF10472,0,1,0,0,1,1017,0.0,1.0,0,0,0,0,0,0,1018,0,1.0,0,0
PF10541,PF17213:PF10650:PF12297,5,6,1,4,5,1008,0.17,0.99,0.2,0.18,0,0,5,0,1013,0,1.0,0.0,0
PF02277,PF15281:PF03241:PF07157,3,3,0,3,3,1012,0.0,0.99,0.0,-0.0,0,0,3,0,1015,0,1.0,0.0,0
PF01367,PF06959:PF07109:PF02132,6,4,1,5,3,1009,0.25,0.99,0.17,0.2,1,0,6,1,1011,0.0,0.99,0.0,-0.0
PF00430,PF00124:PF00507:PF01058,5,21,3,2,18,995,0.14,0.98,0.6,0.29,3,0,5,3,1010,0.0,0.99,0.0,-0.0
PF04950,PF08142:PF13871:PF16568,19,17,15,4,2,997,0.88,0.99,0.79,0.83,4,4,15,0,999,1.0,0.99,0.21,0.46
PF07967,PF08600:PF03715:PF04139,11,25,7,4,18,989,0.28,0.98,0.64,0.41,4,2,9,2,1005,0.5,0.99,0.18,0.3
PF06459,PF08454:PF01365:PF02026,8,15,8,0,7,1003,0.53,0.99,1.0,0.73,11,7,1,4,1006,0.64,1.0,0.88,0.74
PF12420,PF10218:PF10252:PF01632,1,6,1,0,5,1012,0.17,1.0,1.0,0.41,0,0,1,0,1017,0,1.0,0.0,0
PF10806,PF00816:PF08310:PF13876,2,3,0,2,3,1013,0.0,1.0,0.0,-0.0,0,0,2,0,1016,0,1.0,0.0,0
PF14221,PF02212:PF07617:PF05015,0,34,0,0,34,984,0.0,0.97,0,0,0,0,0,0,1018,0,1.0,0,0
PF04836,PF05004:PF01381:PF08523,4,13,4,0,9,1005,0.31,0.99,1.0,0.55,8,1,3,7,1007,0.12,0.99,0.25,0.17
PF13000,PF01227:PF13334:PF12260,7,14,1,6,13,998,0.07,0.98,0.14,0.09,3,1,6,2,1009,0.33,0.99,0.14,0.21
PF02179,PF09055:PF16843:PF15157,17,6,2,15,4,997,0.33,0.98,0.12,0.19,1,1,16,0,1001,1.0,0.98,0.06,0.24
PF01456,PF10322:PF02420:PF02084,2,0,0,2,0,1016,0,1.0,0.0,0,0,0,2,0,1016,0,1.0,0.0,0
PF09085,PF09991:PF02620:PF03703,0,9,0,0,9,1009,0.0,0.99,0,0,0,0,0,0,1018,0,1.0,0,0
PF14981,PF08334:PF15029:PF12852,0,3,0,0,3,1015,0.0,1.0,0,0,0,0,0,0,1018,0,1.0,0,0
PF07202,PF10377:PF10650:PF11577,8,10,2,6,8,1002,0.2,0.99,0.25,0.22,2,2,6,0,1010,1.0,0.99,0.25,0.5
PF16903,PF02572:PF06798:PF13722,1,2,0,1,2,1015,0.0,1.0,0.0,-0.0,0,0,1,0,1017,0,1.0,0.0,0
PF09368,PF09732:PF13724:PF15539,3,12,1,2,11,1004,0.08,0.99,0.33,0.16,0,0,3,0,1015,0,1.0,0.0,0
PF03062,PF09335:PF00777:PF02517,35,51,16,19,35,948,0.31,0.95,0.46,0.35,4,4,31,0,983,1.0,0.97,0.11,0.33
PF08938,PF06421:PF03144:PF10441,5,70,4,1,66,947,0.06,0.93,0.8,0.2,13,4,1,9,1004,0.31,0.99,0.8,0.49
PF01776,PF12020:PF00272:PF09777,6,2,0,6,2,1010,0.0,0.99,0.0,-0.0,0,0,6,0,1012,0,0.99,0.0,0
PF15798,PF15089:PF02655:PF04349,0,2,0,0,2,1016,0.0,1.0,0,0,0,0,0,0,1018,0,1.0,0,0
PF16418,PF16417:PF04054:PF12842,9,14,9,0,5,1004,0.64,1.0,1.0,0.8,10,9,0,1,1008,0.9,1.0,1.0,0.95
PF08910,PF03479:PF15242:PF15397,0,12,0,0,12,1006,0.0,0.99,0,0,0,0,0,0,1018,0,1.0,0,0
PF07617,PF13599:PF10758:PF14602,0,28,0,0,28,990,0.0,0.97,0,0,4,0,0,4,1014,0.0,1.0,0,0
PF05158,PF06219:PF03894:PF03214,7,7,1,6,6,1005,0.14,0.99,0.14,0.14,0,0,7,0,1011,0,0.99,0.0,0
PF00710,PF07693:PF16553:PF11904,16,13,3,13,10,992,0.23,0.98,0.19,0.2,3,3,13,0,1002,1.0,0.99,0.19,0.43
PF14733,PF00847:PF12916:PF06779,2,26,1,1,25,991,0.04,0.97,0.5,0.13,1,1,1,0,1016,1.0,1.0,0.5,0.71
PF03124,PF00939:PF03105:PF02656,8,46,6,2,40,970,0.13,0.96,0.75,0.3,18,3,5,15,995,0.17,0.98,0.38,0.24
PF02257,PF12031:PF09743:PF12552,18,14,4,14,10,990,0.29,0.98,0.22,0.24,2,1,17,1,999,0.5,0.98,0.06,0.16
PF06376,PF04520:PF00321:PF05915,2,2,0,2,2,1014,0.0,1.0,0.0,-0.0,0,0,2,0,1016,0,1.0,0.0,0
PF15776,PF15343:PF17049:PF01312,2,1,0,2,1,1015,0.0,1.0,0.0,-0.0,0,0,2,0,1016,0,1.0,0.0,0
PF04430,PF06388:PF01470:PF04442,22,20,2,20,18,978,0.1,0.96,0.09,0.08,3,0,22,3,993,0.0,0.98,0.0,-0.01
PF02515,PF07491:PF07287:PF04828,32,30,12,20,18,968,0.4,0.96,0.38,0.37,7,5,27,2,984,0.71,0.97,0.16,0.33
PF14478,PF01122:PF12934:PF16173,2,5,2,0,3,1013,0.4,1.0,1.0,0.63,0,0,2,0,1016,0,1.0,0.0,0
PF10116,PF06082:PF03090:PF11775,0,0,0,0,0,1018,0,1.0,0,0,0,0,0,0,1018,0,1.0,0,0
PF04842,PF17034:PF12036:PF13355,4,9,0,4,9,1005,0.0,0.99,0.0,-0.01,1,0,4,1,1013,0.0,1.0,0.0,-0.0
PF09070,PF05903:PF08324:PF08614,8,26,6,2,20,990,0.23,0.98,0.75,0.41,9,3,5,6,1004,0.33,0.99,0.38,0.35
PF12947,PF12946:PF02412:PF00093,25,25,11,14,14,979,0.44,0.97,0.44,0.43,3,3,22,0,993,1.0,0.98,0.12,0.34
PF08701,PF05128:PF01018:PF08153,3,13,1,2,12,1003,0.08,0.99,0.33,0.16,3,1,2,2,1013,0.33,1.0,0.33,0.33
PF09007,PF04629:PF09060:PF09045,2,6,1,1,5,1011,0.17,0.99,0.5,0.29,1,1,1,0,1016,1.0,1.0,0.5,0.71
PF17020,PF02562:PF08632:PF13694,1,7,0,1,7,1010,0.0,0.99,0.0,-0.0,0,0,1,0,1017,0,1.0,0.0,0
PF10868,PF17032:PF15699:PF10716,0,1,0,0,1,1017,0.0,1.0,0,0,0,0,0,0,1018,0,1.0,0,0
PF07253,PF15786:PF09784:PF06907,0,3,0,0,3,1015,0.0,1.0,0,0,0,0,0,0,1018,0,1.0,0,0
PF03318,PF01117:PF07468:PF02594,1,13,1,0,12,1005,0.08,0.99,1.0,0.28,1,0,1,1,1016,0.0,1.0,0.0,-0.0
PF10384,PF09596:PF12478:PF09649,6,8,1,5,7,1005,0.12,0.99,0.17,0.14,0,0,6,0,1012,0,0.99,0.0,0
PF10075,PF05191:PF09754:PF06244,13,23,6,7,17,988,0.26,0.98,0.46,0.34,4,3,10,1,1004,0.75,0.99,0.23,0.41
PF12695,PF15743:PF01057:PF08093,2,3,0,2,3,1013,0.0,1.0,0.0,-0.0,0,0,2,0,1016,0,1.0,0.0,0
PF07021,PF08497:PF14251:PF08708,1,2,0,1,2,1015,0.0,1.0,0.0,-0.0,0,0,1,0,1017,0,1.0,0.0,0
PF08454,PF06459:PF01365:PF02026,14,13,12,2,1,1003,0.92,1.0,0.86,0.89,7,7,7,0,1004,1.0,0.99,0.5,0.7
PF00447,PF01985:PF06546:PF09744,30,18,9,21,9,979,0.5,0.97,0.3,0.37,2,2,28,0,988,1.0,0.97,0.07,0.25
PF01500,PF05287:PF13885:PF00323,1,1,0,1,1,1016,0.0,1.0,0.0,-0.0,0,0,1,0,1017,0,1.0,0.0,0
PF02576,PF11255:PF14279:PF06420,0,1,0,0,1,1017,0.0,1.0,0,0,0,0,0,0,1018,0,1.0,0,0
PF12478,PF15888:PF15997:PF09596,5,1,0,5,1,1012,0.0,0.99,0.0,-0.0,0,0,5,0,1013,0,1.0,0.0,0
PF07811,PF03470:PF12316:PF01843,0,33,0,0,33,985,0.0,0.97,0,0,3,0,0,3,1015,0.0,1.0,0,0
PF05523,PF01865:PF16834:PF08407,0,16,0,0,16,1002,0.0,0.98,0,0,0,0,0,0,1018,0,1.0,0,0
PF00733,PF13537:PF02922:PF12481,17,30,9,8,21,980,0.3,0.97,0.53,0.39,4,3,14,1,1000,0.75,0.99,0.18,0.36
PF05988,PF16011:PF03323:PF02554,2,8,0,2,8,1008,0.0,0.99,0.0,-0.0,2,0,2,2,1014,0.0,1.0,0.0,-0.0
PF00245,PF04430:PF15868:PF03211,15,36,9,6,27,976,0.25,0.97,0.6,0.37,4,0,15,4,999,0.0,0.98,0.0,-0.01
PF00055,PF06008:PF06009:PF02210,24,40,10,14,30,964,0.25,0.96,0.42,0.3,4,3,21,1,993,0.75,0.98,0.12,0.3
PF09339,PF01022:PF01614:PF02311,11,17,10,1,7,1000,0.59,0.99,0.91,0.73,3,2,9,1,1006,0.67,0.99,0.18,0.34
PF03523,PF00229:PF12287:PF09006,1,9,1,0,8,1009,0.11,0.99,1.0,0.33,0,0,1,0,1017,0,1.0,0.0,0
PF01115,PF09749:PF06658:PF02284,6,14,5,1,9,1003,0.36,0.99,0.83,0.54,4,3,3,1,1011,0.75,1.0,0.5,0.61
PF12509,PF11261:PF10264:PF08729,4,13,0,4,13,1001,0.0,0.98,0.0,-0.01,2,0,4,2,1012,0.0,0.99,0.0,-0.0
PF10979,PF01076:PF12795:PF15497,0,5,0,0,5,1013,0.0,1.0,0,0,1,0,0,1,1017,0.0,1.0,0,0
PF04592,PF07561:PF02535:PF05508,1,57,1,0,56,961,0.02,0.94,1.0,0.13,2,1,0,1,1016,0.5,1.0,1.0,0.71
PF02534,PF03524:PF12868:PF05100,7,8,7,0,1,1010,0.88,1.0,1.0,0.93,0,0,7,0,1011,0,0.99,0.0,0
PF11677,PF04691:PF02531:PF15172,0,4,0,0,4,1014,0.0,1.0,0,0,0,0,0,0,1018,0,1.0,0,0
PF02988,PF00021:PF02513:PF03821,1,5,1,0,4,1013,0.2,1.0,1.0,0.45,1,0,1,1,1016,0.0,1.0,0.0,-0.0
PF05019,PF05180:PF03151:PF03096,9,34,6,3,28,981,0.18,0.97,0.67,0.33,5,3,6,2,1007,0.6,0.99,0.33,0.44
PF00905,PF03717:PF07014:PF10290,19,18,16,3,2,997,0.89,1.0,0.84,0.86,0,0,19,0,999,0,0.98,0.0,0
PF08813,PF05125:PF13701:PF02991,0,16,0,0,16,1002,0.0,0.98,0,0,0,0,0,0,1018,0,1.0,0,0
PF03953,PF12327:PF00091:PF02491,50,58,46,4,12,956,0.79,0.98,0.92,0.85,5,2,48,3,965,0.4,0.95,0.04,0.11
PF10642,PF14877:PF08653:PF17017,0,5,0,0,5,1013,0.0,1.0,0,0,0,0,0,0,1018,0,1.0,0,0
PF08516,PF00200:PF16698:PF02333,24,33,23,1,10,984,0.7,0.99,0.96,0.81,3,1,23,2,992,0.33,0.98,0.04,0.11
PF13369,PF08755:PF04379:PF12014,7,15,6,1,9,1002,0.4,0.99,0.86,0.58,7,2,5,5,1006,0.29,0.99,0.29,0.28
PF10248,PF09340:PF04852:PF09805,3,15,1,2,14,1001,0.07,0.98,0.33,0.14,4,0,3,4,1011,0.0,0.99,0.0,-0.0
PF15697,PF06533:PF04618:PF05562,4,6,1,3,5,1009,0.17,0.99,0.25,0.2,1,1,3,0,1014,1.0,1.0,0.25,0.5
PF15482,PF08795:PF15312:PF06651,0,0,0,0,0,1018,0,1.0,0,0,0,0,0,0,1018,0,1.0,0,0
PF01142,PF06991:PF11885:PF07967,15,21,8,7,13,990,0.38,0.98,0.53,0.44,4,2,13,2,1001,0.5,0.99,0.13,0.25
PF14535,PF07074:PF15163:PF13570,1,12,1,0,11,1006,0.08,0.99,1.0,0.29,5,1,0,4,1013,0.2,1.0,1.0,0.45
PF02738,PF01315:PF01799:PF03450,23,23,22,1,1,994,0.96,1.0,0.96,0.96,22,21,2,1,994,0.95,1.0,0.91,0.93
PF00923,PF06376:PF01195:PF07712,13,9,2,11,7,998,0.22,0.98,0.15,0.18,1,1,12,0,1005,1.0,0.99,0.08,0.28
PF15188,PF15556:PF15212:PF05638,0,1,0,0,1,1017,0.0,1.0,0,0,0,0,0,0,1018,0,1.0,0,0
PF12682,PF15097:PF07209:PF17006,1,2,0,1,2,1015,0.0,1.0,0.0,-0.0,0,0,1,0,1017,0,1.0,0.0,0
PF15015,PF15685:PF03058:PF06670,0,0,0,0,0,1018,0,1.0,0,0,0,0,0,0,1018,0,1.0,0,0
PF01805,PF04818:PF09750:PF12230,32,46,24,8,22,964,0.52,0.97,0.75,0.61,10,10,22,0,986,1.0,0.98,0.31,0.55
PF16770,PF12258:PF16892:PF16893,12,2,0,12,2,1004,0.0,0.99,0.0,-0.0,2,0,12,2,1004,0.0,0.99,0.0,-0.0
PF03492,PF03087:PF00197:PF01960,9,17,4,5,13,996,0.24,0.98,0.44,0.32,1,0,9,1,1008,0.0,0.99,0.0,-0.0
PF06824,PF06609:PF14612:PF07519,11,28,5,6,23,984,0.18,0.97,0.45,0.27,4,1,10,3,1004,0.25,0.99,0.09,0.15
PF02487,PF05189:PF01300:PF09806,11,22,2,9,20,987,0.09,0.97,0.18,0.12,2,0,11,2,1005,0.0,0.99,0.0,-0.0
PF03258,PF17154:PF03538:PF12264,1,5,0,1,5,1012,0.0,0.99,0.0,-0.0,0,0,1,0,1017,0,1.0,0.0,0
PF04481,PF02195:PF00545:PF04736,3,12,0,3,12,1003,0.0,0.99,0.0,-0.01,0,0,3,0,1015,0,1.0,0.0,0
PF09802,PF15849:PF08107:PF09784,2,0,0,2,0,1016,0,1.0,0.0,0,0,0,2,0,1016,0,1.0,0.0,0
PF15780,PF12510:PF10358:PF15147,10,19,2,8,17,991,0.11,0.98,0.2,0.13,1,1,9,0,1008,1.0,0.99,0.1,0.31
PF02797,PF00195:PF01333:PF07632,20,27,19,1,8,990,0.7,0.99,0.95,0.81,2,2,18,0,998,1.0,0.98,0.1,0.31
PF11903,PF02775:PF10371:PF00205,4,29,3,1,26,988,0.1,0.97,0.75,0.27,23,2,2,21,993,0.09,0.98,0.5,0.2
PF13160,PF10734:PF08277:PF15508,0,11,0,0,11,1007,0.0,0.99,0,0,2,0,0,2,1016,0.0,1.0,0,0
PF06271,PF15305:PF13270:PF12926,2,5,1,1,4,1012,0.2,1.0,0.5,0.31,0,0,2,0,1016,0,1.0,0.0,0
PF07984,PF04831:PF13908:PF09783,1,19,0,1,19,998,0.0,0.98,0.0,-0.0,4,0,1,4,1013,0.0,1.0,0.0,-0.0
PF10703,PF01297:PF06719:PF12852,2,6,0,2,6,1010,0.0,0.99,0.0,-0.0,2,0,2,2,1014,0.0,1.0,0.0,-0.0
PF10553,PF03943:PF04926:PF09162,0,19,0,0,19,999,0.0,0.98,0,0,4,0,0,4,1014,0.0,1.0,0,0
PF17016,PF12355:PF14521:PF09240,0,10,0,0,10,1008,0.0,0.99,0,0,1,0,0,1,1017,0.0,1.0,0,0
PF17034,PF10441:PF15027:PF02368,6,8,1,5,7,1005,0.12,0.99,0.17,0.14,1,1,5,0,1012,1.0,1.0,0.17,0.41
PF00494,PF00828:PF11833:PF01789,34,34,15,19,19,965,0.44,0.96,0.44,0.42,2,1,33,1,983,0.5,0.97,0.03,0.12
PF03581,PF09676:PF06476:PF11102,0,1,0,0,1,1017,0.0,1.0,0,0,0,0,0,0,1018,0,1.0,0,0
PF08495,PF04300:PF10442:PF12014,4,10,3,1,7,1007,0.3,0.99,0.75,0.47,2,1,3,1,1013,0.5,1.0,0.25,0.35
PF05947,PF05943:PF03428:PF05591,0,0,0,0,0,1018,0,1.0,0,0,0,0,0,0,1018,0,1.0,0,0
PF14726,PF15914:PF12372:PF15912,4,9,0,4,9,1005,0.0,0.99,0.0,-0.01,2,0,4,2,1012,0.0,0.99,0.0,-0.0
PF04465,PF09260:PF03477:PF16028,0,9,0,0,9,1009,0.0,0.99,0,0,2,0,0,2,1016,0.0,1.0,0,0
PF08623,PF04048:PF08638:PF14649,10,22,1,9,21,987,0.05,0.97,0.1,0.05,2,0,10,2,1006,0.0,0.99,0.0,-0.0
PF11209,PF13205:PF07805:PF12019,1,5,0,1,5,1012,0.0,0.99,0.0,-0.0,0,0,1,0,1017,0,1.0,0.0,0
PF06910,PF15809:PF10737:PF15104,1,0,0,1,0,1017,0,1.0,0.0,0,0,0,1,0,1017,0,1.0,0.0,0
PF07453,PF07460:PF14528:PF01541,3,26,3,0,23,992,0.12,0.98,1.0,0.34,10,2,1,8,1007,0.2,0.99,0.67,0.36
PF05474,PF07149:PF11109:PF02951,0,5,0,0,5,1013,0.0,1.0,0,0,0,0,0,0,1018,0,1.0,0,0
PF05153,PF05995:PF15161:PF12296,13,16,5,8,11,994,0.31,0.98,0.38,0.34,2,2,11,0,1005,1.0,0.99,0.15,0.39
PF15151,PF07055:PF11924:PF07881,3,3,0,3,3,1012,0.0,0.99,0.0,-0.0,0,0,3,0,1015,0,1.0,0.0,0
PF08849,PF12805:PF06745:PF07209,0,1,0,0,1,1017,0.0,1.0,0,0,0,0,0,0,1018,0,1.0,0,0
PF00144,PF03109:PF11954:PF07930,68,45,26,42,19,931,0.58,0.94,0.38,0.44,3,3,65,0,950,1.0,0.94,0.04,0.2
PF15685,PF10856:PF15231:PF01840,0,0,0,0,0,1018,0,1.0,0,0,0,0,0,0,1018,0,1.0,0,0
PF08520,PF07382:PF10563:PF03588,1,5,0,1,5,1012,0.0,0.99,0.0,-0.0,0,0,1,0,1017,0,1.0,0.0,0
PF08227,PF15248:PF14988:PF12240,6,7,2,4,5,1007,0.29,0.99,0.33,0.3,2,1,5,1,1011,0.5,0.99,0.17,0.29
PF11744,PF04535:PF06749:PF14009,7,16,3,4,13,998,0.19,0.98,0.43,0.28,4,1,6,3,1008,0.25,0.99,0.14,0.18
PF11841,PF16457:PF04727:PF04446,7,28,7,0,21,990,0.25,0.98,1.0,0.49,10,7,0,3,1008,0.7,1.0,1.0,0.84
PF02995,PF13383:PF02958:PF00762,10,45,5,5,40,968,0.11,0.96,0.5,0.22,8,2,8,6,1002,0.25,0.99,0.2,0.22
PF03760,PF04852:PF15003:PF13933,1,6,1,0,5,1012,0.17,1.0,1.0,0.41,0,0,1,0,1017,0,1.0,0.0,0
PF00062,PF06189:PF00223:PF05742,8,13,5,3,8,1002,0.38,0.99,0.62,0.49,2,0,8,2,1008,0.0,0.99,0.0,-0.0
PF17043,PF12640:PF02070:PF12153,0,2,0,0,2,1016,0.0,1.0,0,0,0,0,0,0,1018,0,1.0,0,0
PF04031,PF08161:PF14611:PF10699,13,10,4,9,6,999,0.4,0.99,0.31,0.34,0,0,13,0,1005,0,0.99,0.0,0
PF10175,PF08152:PF07962:PF14437,6,20,2,4,18,994,0.1,0.98,0.33,0.17,3,2,4,1,1011,0.67,1.0,0.33,0.47
PF05247,PF15859:PF04023:PF05701,0,8,0,0,8,1010,0.0,0.99,0,0,0,0,0,0,1018,0,1.0,0,0
PF05916,PF00484:PF06376:PF01016,21,27,10,11,17,980,0.37,0.97,0.48,0.41,8,5,16,3,994,0.62,0.98,0.24,0.38
PF16495,PF16498:PF14379:PF16772,9,14,6,3,8,1001,0.43,0.99,0.67,0.53,1,1,8,0,1009,1.0,0.99,0.11,0.33
PF14234,PF00797:PF12239:PF01184,3,35,1,2,34,981,0.03,0.96,0.33,0.09,7,0,3,7,1008,0.0,0.99,0.0,-0.0
PF08783,PF13696:PF17180:PF03159,7,24,7,0,17,994,0.29,0.98,1.0,0.54,7,5,2,2,1009,0.71,1.0,0.71,0.71
PF00961,PF14528:PF07453:PF07460,9,13,8,1,5,1004,0.62,0.99,0.89,0.74,2,2,7,0,1009,1.0,0.99,0.22,0.47
PF01172,PF09377:PF02537:PF13506,10,22,7,3,15,993,0.32,0.98,0.7,0.46,1,0,10,1,1007,0.0,0.99,0.0,-0.0
PF05522,PF15343:PF14534:PF15668,0,2,0,0,2,1016,0.0,1.0,0,0,0,0,0,0,1018,0,1.0,0,0
PF13952,PF13960:PF13963:PF02992,3,16,2,1,14,1001,0.12,0.99,0.67,0.28,9,2,1,7,1008,0.22,0.99,0.67,0.38
PF13735,PF00308:PF12626:PF05280,2,9,2,0,7,1009,0.22,0.99,1.0,0.47,3,2,0,1,1015,0.67,1.0,1.0,0.82
PF04685,PF12215:PF04840:PF14699,5,20,5,0,15,998,0.25,0.99,1.0,0.5,2,2,3,0,1013,1.0,1.0,0.4,0.63
PF05683,PF05681:PF03315:PF07364,6,9,4,2,5,1007,0.44,0.99,0.67,0.54,1,1,5,0,1012,1.0,1.0,0.17,0.41
PF11235,PF11244:PF11232:PF11265,2,5,0,2,5,1011,0.0,0.99,0.0,-0.0,3,0,2,3,1013,0.0,1.0,0.0,-0.0
PF01176,PF01907:PF03298:PF03386,13,11,6,7,5,1000,0.55,0.99,0.46,0.5,1,0,13,1,1004,0.0,0.99,0.0,-0.0
PF06551,PF06462:PF00523:PF00337,0,31,0,0,31,987,0.0,0.97,0,0,3,0,0,3,1015,0.0,1.0,0,0
PF15998,PF09756:PF07939:PF09805,8,14,2,6,12,998,0.14,0.98,0.25,0.18,2,1,7,1,1009,0.5,0.99,0.12,0.25
PF16842,PF11627:PF08080:PF12196,1,2,1,0,1,1016,0.5,1.0,1.0,0.71,1,1,0,0,1017,1.0,1.0,1.0,1.0
PF03081,PF04859:PF06830:PF07762,24,19,8,16,11,983,0.42,0.97,0.33,0.36,2,2,22,0,994,1.0,0.98,0.08,0.29
PF02499,PF04196:PF06890:PF13722,0,1,0,0,1,1017,0.0,1.0,0,0,0,0,0,0,1018,0,1.0,0,0
PF02459,PF00153:PF09423:PF07993,1,145,1,0,144,873,0.01,0.86,1.0,0.08,34,1,0,33,984,0.03,0.97,1.0,0.17
PF12885,PF12886:PF05624:PF05640,3,6,3,0,3,1012,0.5,1.0,1.0,0.71,1,1,2,0,1015,1.0,1.0,0.33,0.58
PF04884,PF07542:PF03088:PF01758,17,29,6,11,23,978,0.21,0.97,0.35,0.25,7,4,13,3,998,0.57,0.98,0.24,0.36
PF05937,PF05956:PF05924:PF05923,3,10,3,0,7,1008,0.3,0.99,1.0,0.55,7,3,0,4,1011,0.43,1.0,1.0,0.65
PF16838,PF05352:PF02399:PF13296,0,3,0,0,3,1015,0.0,1.0,0,0,0,0,0,0,1018,0,1.0,0,0
PF15060,PF15231:PF10856:PF15130,0,1,0,0,1,1017,0.0,1.0,0,0,0,0,0,0,1018,0,1.0,0,0
PF15553,PF08642:PF05874:PF17078,0,2,0,0,2,1016,0.0,1.0,0,0,0,0,0,0,1018,0,1.0,0,0
PF13607,PF13380:PF06466:PF02567,2,25,2,0,23,993,0.08,0.98,1.0,0.28,6,1,1,5,1011,0.17,0.99,0.5,0.29
PF09232,PF07448:PF17124:PF00451,0,1,0,0,1,1017,0.0,1.0,0,0,0,0,0,0,1018,0,1.0,0,0
PF07774,PF13360:PF13570:PF16177,14,38,11,3,27,977,0.29,0.97,0.79,0.47,7,4,10,3,1001,0.57,0.99,0.29,0.4
PF16008,PF09818:PF01666:PF10138,0,3,0,0,3,1015,0.0,1.0,0,0,0,0,0,0,1018,0,1.0,0,0
PF02626,PF02682:PF00289:PF02785,11,37,11,0,26,981,0.3,0.97,1.0,0.54,33,8,3,25,982,0.24,0.97,0.73,0.41
PF03908,PF09496:PF04706:PF05837,11,10,5,6,5,1002,0.5,0.99,0.45,0.47,2,2,9,0,1007,1.0,0.99,0.18,0.42
PF16756,PF15774:PF08744:PF15391,0,1,0,0,1,1017,0.0,1.0,0,0,0,0,0,0,1018,0,1.0,0,0
PF02135,PF08214:PF09030:PF06001,21,25,18,3,7,990,0.72,0.99,0.86,0.78,13,11,10,2,995,0.85,0.99,0.52,0.66
PF00253,PF00124:PF00499:PF00115,16,19,4,12,15,987,0.21,0.97,0.25,0.22,2,1,15,1,1001,0.5,0.98,0.06,0.17
PF12319,PF10180:PF04367:PF07939,1,12,0,1,12,1005,0.0,0.99,0.0,-0.0,2,0,1,2,1015,0.0,1.0,0.0,-0.0
PF00314,PF03822:PF05938:PF00139,21,29,15,6,14,983,0.52,0.98,0.71,0.6,5,4,17,1,996,0.8,0.98,0.19,0.39
PF08557,PF11960:PF01070:PF00173,6,101,5,1,96,916,0.05,0.9,0.83,0.19,33,3,3,30,982,0.09,0.97,0.5,0.2
PF02973,PF11697:PF16411:PF13750,1,1,0,1,1,1016,0.0,1.0,0.0,-0.0,0,0,1,0,1017,0,1.0,0.0,0
PF01451,PF01981:PF10302:PF06432,12,28,6,6,22,984,0.21,0.97,0.5,0.32,3,2,10,1,1005,0.67,0.99,0.17,0.33
PF06179,PF01150:PF13462:PF00048,10,37,7,3,30,978,0.19,0.97,0.7,0.35,8,5,5,3,1005,0.62,0.99,0.5,0.56
PF04628,PF00838:PF11991:PF15011,11,20,4,7,16,991,0.2,0.98,0.36,0.26,3,1,10,2,1005,0.33,0.99,0.09,0.17
PF09323,PF03123:PF13876:PF14220,0,5,0,0,5,1013,0.0,1.0,0,0,0,0,0,0,1018,0,1.0,0,0
PF14283,PF13098:PF11775:PF06798,0,5,0,0,5,1013,0.0,1.0,0,0,0,0,0,0,1018,0,1.0,0,0
PF10258,PF04004:PF10180:PF11250,9,19,4,5,15,994,0.21,0.98,0.44,0.3,3,0,9,3,1006,0.0,0.99,0.0,-0.01
PF11940,PF09127:PF11838:PF01433,5,54,5,0,49,964,0.09,0.95,1.0,0.3,39,3,2,36,977,0.08,0.96,0.6,0.21
PF11017,PF15053:PF08730:PF15952,0,2,0,0,2,1016,0.0,1.0,0,0,0,0,0,0,1018,0,1.0,0,0
PF13948,PF01508:PF05572:PF04952,5,13,1,4,12,1001,0.08,0.98,0.2,0.12,0,0,5,0,1013,0,1.0,0.0,0
PF08593,PF09122:PF11127:PF11830,1,6,0,1,6,1011,0.0,0.99,0.0,-0.0,0,0,1,0,1017,0,1.0,0.0,0
PF07044,PF15633:PF04693:PF09253,0,0,0,0,0,1018,0,1.0,0,0,0,0,0,0,1018,0,1.0,0,0
PF02971,PF04961:PF07837:PF14920,4,7,4,0,3,1011,0.57,1.0,1.0,0.75,4,4,0,0,1014,1.0,1.0,1.0,1.0
PF08885,PF12098:PF07157:PF10566,1,0,0,1,0,1017,0,1.0,0.0,0,0,0,1,0,1017,0,1.0,0.0,0
PF02055,PF17189:PF05786:PF04885,17,15,13,4,2,999,0.87,0.99,0.76,0.81,2,2,15,0,1001,1.0,0.99,0.12,0.34
PF05017,PF02057:PF15467:PF10578,0,1,0,0,1,1017,0.0,1.0,0,0,0,0,0,0,1018,0,1.0,0,0
PF07684,PF06816:PF11936:PF16553,7,8,5,2,3,1008,0.62,1.0,0.71,0.67,2,2,5,0,1011,1.0,1.0,0.29,0.53
PF07773,PF07162:PF04991:PF14868,10,22,3,7,19,989,0.14,0.97,0.3,0.19,1,1,9,0,1008,1.0,0.99,0.1,0.31
PF10030,PF02413:PF10906:PF04451,0,3,0,0,3,1015,0.0,1.0,0,0,0,0,0,0,1018,0,1.0,0,0
PF12265,PF16699:PF14077:PF08614,7,11,3,4,8,1003,0.27,0.99,0.43,0.34,2,1,6,1,1010,0.5,0.99,0.14,0.26
PF09427,PF12533:PF01586:PF11851,3,5,1,2,4,1011,0.2,0.99,0.33,0.26,1,1,2,0,1015,1.0,1.0,0.33,0.58
PF12489,PF15965:PF00910:PF13329,3,27,0,3,27,988,0.0,0.97,0.0,-0.01,3,0,3,3,1012,0.0,0.99,0.0,-0.0
PF06147,PF05480:PF07445:PF06230,0,0,0,0,0,1018,0,1.0,0,0,0,0,0,0,1018,0,1.0,0,0
PF15010,PF01705:PF08209:PF10104,2,20,1,1,19,997,0.05,0.98,0.5,0.15,5,0,2,5,1011,0.0,0.99,0.0,-0.0
PF06458,PF07523:PF08479:PF15518,0,1,0,0,1,1017,0.0,1.0,0,0,0,0,0,0,1018,0,1.0,0,0
PF00543,PF11264:PF07544:PF06232,4,9,1,3,8,1006,0.11,0.99,0.25,0.16,2,0,4,2,1012,0.0,0.99,0.0,-0.0
PF12588,PF02666:PF08165:PF12735,3,18,3,0,15,1000,0.17,0.99,1.0,0.41,1,0,3,1,1014,0.0,1.0,0.0,-0.0
PF04231,PF09962:PF05448:PF12646,2,3,0,2,3,1013,0.0,1.0,0.0,-0.0,0,0,2,0,1016,0,1.0,0.0,0
PF12231,PF14952:PF15912:PF12372,3,10,0,3,10,1005,0.0,0.99,0.0,-0.01,0,0,3,0,1015,0,1.0,0.0,0
PF08706,PF13722:PF04196:PF15518,5,1,0,5,1,1012,0.0,0.99,0.0,-0.0,1,0,5,1,1012,0.0,0.99,0.0,-0.0
PF10587,PF00736:PF07899:PF05542,18,33,18,0,15,985,0.55,0.99,1.0,0.73,4,1,17,3,997,0.25,0.98,0.06,0.11
PF09340,PF10248:PF09805:PF04852,6,14,3,3,11,1001,0.21,0.99,0.5,0.32,3,1,5,2,1010,0.33,0.99,0.17,0.23
PF12080,PF07499:PF03090:PF11794,0,2,0,0,2,1016,0.0,1.0,0,0,0,0,0,0,1018,0,1.0,0,0
PF07163,PF05556:PF15829:PF15134,3,6,1,2,5,1010,0.17,0.99,0.33,0.23,1,0,3,1,1014,0.0,1.0,0.0,-0.0
PF04397,PF00196:PF01339:PF00486,1,18,1,0,17,1000,0.06,0.98,1.0,0.23,4,1,0,3,1014,0.25,1.0,1.0,0.5
PF08983,PF03827:PF10413:PF09193,1,4,1,0,3,1014,0.25,1.0,1.0,0.5,1,1,0,0,1017,1.0,1.0,1.0,1.0
PF04428,PF16967:PF04632:PF15976,3,0,0,3,0,1015,0,1.0,0.0,0,0,0,3,0,1015,0,1.0,0.0,0
PF04064,PF04063:PF16545:PF17104,2,9,2,0,7,1009,0.22,0.99,1.0,0.47,1,1,1,0,1016,1.0,1.0,0.5,0.71
PF05881,PF17157:PF17122:PF12451,4,8,2,2,6,1008,0.25,0.99,0.5,0.35,6,2,2,4,1010,0.33,0.99,0.5,0.41
PF00497,PF10613:PF01547:PF00003,29,70,21,8,49,940,0.3,0.94,0.72,0.44,12,9,20,3,986,0.75,0.98,0.31,0.47
PF15518,PF04196:PF12603:PF14842,1,1,1,0,0,1017,1.0,1.0,1.0,1.0,1,1,0,0,1017,1.0,1.0,1.0,1.0
PF12805,PF08497:PF14512:PF07209,0,1,0,0,1,1017,0.0,1.0,0,0,0,0,0,0,1018,0,1.0,0,0
PF16880,PF12761:PF12763:PF04799,15,38,12,3,26,977,0.32,0.97,0.8,0.49,7,4,11,3,1000,0.57,0.99,0.27,0.38
PF07894,PF08313:PF15778:PF09429,5,22,1,4,21,992,0.05,0.98,0.2,0.09,3,1,4,2,1011,0.33,0.99,0.2,0.26
PF03043,PF17188:PF01752:PF01514,0,2,0,0,2,1016,0.0,1.0,0,0,0,0,0,0,1018,0,1.0,0,0
PF07956,PF15302:PF07279:PF03665,7,6,2,5,4,1007,0.33,0.99,0.29,0.3,0,0,7,0,1011,0,0.99,0.0,0
PF03449,PF01272:PF03958:PF12659,12,11,10,2,1,1005,0.91,1.0,0.83,0.87,1,1,11,0,1006,1.0,0.99,0.08,0.29
PF03069,PF00265:PF06276:PF08553,12,13,2,10,11,995,0.15,0.98,0.17,0.15,2,1,11,1,1005,0.5,0.99,0.08,0.2
PF01414,PF07657:PF00386:PF01731,11,27,5,6,22,985,0.19,0.97,0.45,0.28,3,2,9,1,1006,0.67,0.99,0.18,0.34
PF02604,PF03831:PF05913:PF15143,0,1,0,0,1,1017,0.0,1.0,0,0,0,0,0,0,1018,0,1.0,0,0
PF14138,PF15936:PF09138:PF15552,10,14,2,8,12,996,0.14,0.98,0.2,0.16,1,1,9,0,1008,1.0,0.99,0.1,0.31
PF02683,PF13270:PF15503:PF11016,3,4,0,3,4,1011,0.0,0.99,0.0,-0.0,0,0,3,0,1015,0,1.0,0.0,0
PF05346,PF04139:PF15929:PF10188,14,11,4,10,7,997,0.36,0.98,0.29,0.31,0,0,14,0,1004,0,0.99,0.0,0
PF03676,PF02312:PF14831:PF03069,11,16,4,7,12,995,0.25,0.98,0.36,0.29,0,0,11,0,1007,0,0.99,0.0,0
PF04747,PF15818:PF08762:PF15130,0,5,0,0,5,1013,0.0,1.0,0,0,0,0,0,0,1018,0,1.0,0,0
PF12618,PF12140:PF17208:PF02820,3,23,3,0,20,995,0.13,0.98,1.0,0.36,8,3,0,5,1010,0.38,1.0,1.0,0.61
PF11571,PF10496:PF15906:PF04437,8,29,5,3,24,986,0.17,0.97,0.62,0.32,5,1,7,4,1006,0.2,0.99,0.12,0.15
PF00284,PF00223:PF00283:PF02419,2,8,1,1,7,1009,0.12,0.99,0.5,0.25,1,1,1,0,1016,1.0,1.0,0.5,0.71
PF11154,PF15826:PF09614:PF04234,2,1,0,2,1,1015,0.0,1.0,0.0,-0.0,0,0,2,0,1016,0,1.0,0.0,0
PF11739,PF11736:PF14376:PF03428,1,7,1,0,6,1011,0.14,0.99,1.0,0.38,0,0,1,0,1017,0,1.0,0.0,0
PF01245,PF03195:PF11911:PF12298,11,14,5,6,9,998,0.36,0.99,0.45,0.4,2,2,9,0,1007,1.0,0.99,0.18,0.42
PF02577,PF13474:PF02151:PF02861,2,23,2,0,21,995,0.09,0.98,1.0,0.29,4,1,1,3,1013,0.25,1.0,0.5,0.35
PF13855,PF00560:PF13306:PF12799,149,85,77,72,8,861,0.91,0.92,0.52,0.65,34,31,118,3,866,0.91,0.88,0.21,0.4
PF04984,PF13722:PF03090:PF08411,0,1,0,0,1,1017,0.0,1.0,0,0,0,0,0,0,1018,0,1.0,0,0
PF09252,PF15085:PF02087:PF05151,0,4,0,0,4,1014,0.0,1.0,0,0,0,0,0,0,1018,0,1.0,0,0
PF05684,PF08414:PF04452:PF04107,2,16,1,1,15,1001,0.06,0.98,0.5,0.17,1,0,2,1,1015,0.0,1.0,0.0,-0.0
PF04356,PF03659:PF03178:PF01797,0,43,0,0,43,975,0.0,0.96,0,0,7,0,0,7,1011,0.0,0.99,0,0
PF00986,PF00204:PF16898:PF08070,13,20,10,3,10,995,0.5,0.99,0.77,0.61,8,3,10,5,1000,0.38,0.99,0.23,0.29
PF09334,PF10458:PF08264:PF09635,33,41,17,16,24,961,0.41,0.96,0.52,0.44,7,5,28,2,983,0.71,0.97,0.15,0.32
PF02732,PF11977:PF14722:PF05182,25,27,9,16,18,975,0.33,0.97,0.36,0.33,7,4,21,3,990,0.57,0.98,0.16,0.29
PF08508,PF06485:PF10330:PF06420,2,7,0,2,7,1009,0.0,0.99,0.0,-0.0,0,0,2,0,1016,0,1.0,0.0,0
PF13097,PF00835:PF15313:PF07137,4,12,0,4,12,1002,0.0,0.98,0.0,-0.01,0,0,4,0,1014,0,1.0,0.0,0
PF16528,PF10699:PF14611:PF15862,17,7,2,15,5,996,0.29,0.98,0.12,0.17,0,0,17,0,1001,0,0.98,0.0,0
PF02724,PF16901:PF16350:PF01266,8,71,7,1,64,946,0.1,0.94,0.88,0.28,16,2,6,14,996,0.12,0.98,0.25,0.17
PF07145,PF06741:PF14438:PF07742,16,23,8,8,15,987,0.35,0.98,0.5,0.41,10,6,10,4,998,0.6,0.99,0.38,0.47
PF10524,PF00859:PF03166:PF03165,4,18,3,1,15,999,0.17,0.98,0.75,0.35,8,2,2,6,1008,0.25,0.99,0.5,0.35
PF10361,PF12527:PF05841:PF08528,0,5,0,0,5,1013,0.0,1.0,0,0,0,0,0,0,1018,0,1.0,0,0
PF01399,PF06237:PF04515:PF01757,59,45,16,43,29,930,0.36,0.93,0.27,0.27,6,5,54,1,958,0.83,0.95,0.08,0.26
PF04308,PF04764:PF01254:PF05671,0,3,0,0,3,1015,0.0,1.0,0,0,0,0,0,0,1018,0,1.0,0,0
PF10601,PF07816:PF15795:PF01146,24,10,6,18,4,990,0.6,0.98,0.25,0.38,0,0,24,0,994,0,0.98,0.0,0
PF14664,PF14663:PF14666:PF14668,11,12,11,0,1,1006,0.92,1.0,1.0,0.96,11,10,1,1,1006,0.91,1.0,0.91,0.91
PF04427,PF13664:PF03942:PF03358,22,32,9,13,23,973,0.28,0.96,0.41,0.32,8,4,18,4,992,0.5,0.98,0.18,0.29
PF15876,PF15832:PF01668:PF05418,0,3,0,0,3,1015,0.0,1.0,0,0,0,0,0,0,1018,0,1.0,0,0
PF05956,PF05937:PF05924:PF16689,3,9,3,0,6,1009,0.33,0.99,1.0,0.58,3,3,0,0,1015,1.0,1.0,1.0,1.0
PF07440,PF12121:PF08110:PF08023,0,0,0,0,0,1018,0,1.0,0,0,0,0,0,0,1018,0,1.0,0,0
PF05637,PF01786:PF02636:PF14159,19,20,6,13,14,985,0.3,0.97,0.32,0.29,2,2,17,0,999,1.0,0.98,0.11,0.32
PF17218,PF13907:PF01393:PF03716,3,22,2,1,20,995,0.09,0.98,0.67,0.24,3,1,2,2,1013,0.33,1.0,0.33,0.33
PF03763,PF01643:PF06298:PF08523,10,8,2,8,6,1002,0.25,0.99,0.2,0.22,0,0,10,0,1008,0,0.99,0.0,0
PF00952,PF14534:PF17010:PF16647,0,1,0,0,1,1017,0.0,1.0,0,0,0,0,0,0,1018,0,1.0,0,0
PF15619,PF06637:PF16043:PF15257,4,3,0,4,3,1011,0.0,0.99,0.0,-0.0,0,0,4,0,1014,0,1.0,0.0,0
PF08611,PF07510:PF01669:PF02070,6,2,0,6,2,1010,0.0,0.99,0.0,-0.0,0,0,6,0,1012,0,0.99,0.0,0
PF05164,PF02108:PF16872:PF11291,0,0,0,0,0,1018,0,1.0,0,0,0,0,0,0,1018,0,1.0,0,0
PF15761,PF15856:PF08291:PF15729,1,2,0,1,2,1015,0.0,1.0,0.0,-0.0,0,0,1,0,1017,0,1.0,0.0,0
PF16981,PF16839:PF01723:PF05912,0,4,0,0,4,1014,0.0,1.0,0,0,0,0,0,0,1018,0,1.0,0,0
PF03159,PF01107:PF02337:PF11719,18,15,6,12,9,991,0.4,0.98,0.33,0.35,3,3,15,0,1000,1.0,0.99,0.17,0.41
PF00454,PF02259:PF00613:PF00794,63,55,48,15,7,948,0.87,0.98,0.76,0.8,21,21,42,0,955,1.0,0.96,0.33,0.57
PF15202,PF15895:PF17015:PF15553,0,0,0,0,0,1018,0,1.0,0,0,0,0,0,0,1018,0,1.0,0,0
PF01415,PF15252:PF15551:PF15231,2,0,0,2,0,1016,0,1.0,0.0,0,0,0,2,0,1016,0,1.0,0.0,0
PF03851,PF10361:PF12527:PF08528,14,5,2,12,3,1001,0.4,0.99,0.14,0.23,0,0,14,0,1004,0,0.99,0.0,0
PF03723,PF03722:PF00372:PF16126,9,9,7,2,2,1007,0.78,1.0,0.78,0.78,5,5,4,0,1009,1.0,1.0,0.56,0.74
PF03618,PF06485:PF17078:PF15895,2,5,1,1,4,1012,0.2,1.0,0.5,0.31,0,0,2,0,1016,0,1.0,0.0,0
PF07992,PF01180:PF00355:PF01645,89,58,38,51,20,909,0.66,0.93,0.43,0.49,8,7,82,1,928,0.88,0.92,0.08,0.25
PF05182,PF10309:PF14722:PF16043,17,17,5,12,12,989,0.29,0.98,0.29,0.28,1,0,17,1,1000,0.0,0.98,0.0,-0.0
PF00939,PF03105:PF03124:PF03600,17,36,12,5,24,977,0.33,0.97,0.71,0.47,8,2,15,6,995,0.25,0.98,0.12,0.16
PF01530,PF08474:PF17208:PF12140,14,11,5,9,6,998,0.45,0.99,0.36,0.4,2,2,12,0,1004,1.0,0.99,0.14,0.38
PF16639,PF01333:PF03118:PF10179,9,14,5,4,9,1000,0.36,0.99,0.56,0.44,0,0,9,0,1009,0,0.99,0.0,0
PF16178,PF04547:PF04842:PF14288,10,30,9,1,21,987,0.3,0.98,0.9,0.51,1,1,9,0,1008,1.0,0.99,0.1,0.31
PF11874,PF17188:PF03888:PF15976,0,0,0,0,0,1018,0,1.0,0,0,0,0,0,0,1018,0,1.0,0,0
PF12036,PF04091:PF07035:PF08427,2,25,1,1,24,992,0.04,0.98,0.5,0.14,3,0,2,3,1013,0.0,1.0,0.0,-0.0
PF03573,PF04392:PF06798:PF10566,2,2,1,1,1,1015,0.5,1.0,0.5,0.5,0,0,2,0,1016,0,1.0,0.0,0
PF01293,PF03350:PF07896:PF01680,4,12,0,4,12,1002,0.0,0.98,0.0,-0.01,1,0,4,1,1013,0.0,1.0,0.0,-0.0
PF02891,PF02037:PF14443:PF14611,13,64,9,4,55,950,0.14,0.94,0.69,0.29,5,3,10,2,1003,0.6,0.99,0.23,0.37
PF05221,PF00670:PF01144:PF03071,10,31,7,3,24,984,0.23,0.97,0.7,0.39,3,2,8,1,1007,0.67,0.99,0.2,0.36
PF15029,PF11902:PF06403:PF14690,0,1,0,0,1,1017,0.0,1.0,0,0,0,0,0,0,1018,0,1.0,0,0
PF06267,PF17206:PF04221:PF04569,0,2,0,0,2,1016,0.0,1.0,0,0,0,0,0,0,1018,0,1.0,0,0
PF15994,PF15995:PF01043:PF00680,0,15,0,0,15,1003,0.0,0.99,0,0,0,0,0,0,1018,0,1.0,0,0
PF05899,PF02502:PF07883:PF06249,5,35,4,1,31,982,0.11,0.97,0.8,0.3,4,1,4,3,1010,0.25,0.99,0.2,0.22
PF01254,PF04764:PF15823:PF11109,1,1,0,1,1,1016,0.0,1.0,0.0,-0.0,0,0,1,0,1017,0,1.0,0.0,0
PF17011,PF01419:PF00764:PF09042,0,22,0,0,22,996,0.0,0.98,0,0,6,0,0,6,1012,0.0,0.99,0,0
PF02625,PF01325:PF05232:PF08497,1,3,1,0,2,1015,0.33,1.0,1.0,0.58,0,0,1,0,1017,0,1.0,0.0,0
PF13334,PF12326:PF00337:PF07061,3,32,3,0,29,986,0.09,0.97,1.0,0.3,6,1,2,5,1010,0.17,0.99,0.33,0.23
PF03455,PF03456:PF02141:PF10240,15,46,15,0,31,972,0.33,0.97,1.0,0.56,28,11,4,17,986,0.39,0.98,0.73,0.53
PF15825,PF15041:PF08730:PF15119,0,2,0,0,2,1016,0.0,1.0,0,0,0,0,0,0,1018,0,1.0,0,0
PF03237,PF13103:PF07338:PF05733,1,9,1,0,8,1009,0.11,0.99,1.0,0.33,1,1,0,0,1017,1.0,1.0,1.0,1.0
PF05004,PF04836:PF02310:PF00344,6,26,6,0,20,992,0.23,0.98,1.0,0.48,2,1,5,1,1011,0.5,0.99,0.17,0.29
PF09350,PF12572:PF09320:PF14901,3,21,1,2,20,995,0.05,0.98,0.33,0.12,3,0,3,3,1012,0.0,0.99,0.0,-0.0
PF09769,PF04667:PF09597:PF04716,3,19,2,1,17,998,0.11,0.98,0.67,0.26,0,0,3,0,1015,0,1.0,0.0,0
PF00158,PF02954:PF04397:PF00990,11,16,7,4,9,998,0.44,0.99,0.64,0.52,5,5,6,0,1007,1.0,0.99,0.45,0.67
PF00726,PF06679:PF00727:PF06373,1,4,0,1,4,1013,0.0,1.0,0.0,-0.0,0,0,1,0,1017,0,1.0,0.0,0
PF04987,PF01663:PF16347:PF12411,16,40,13,3,27,975,0.33,0.97,0.81,0.5,6,5,11,1,1001,0.83,0.99,0.31,0.51
PF00609,PF00781:PF14513:PF00130,20,80,20,0,60,938,0.25,0.94,1.0,0.48,27,15,5,12,986,0.56,0.98,0.75,0.64
PF06127,PF10780:PF03980:PF06244,4,14,1,3,13,1001,0.07,0.98,0.25,0.13,1,0,4,1,1013,0.0,1.0,0.0,-0.0
PF00869,PF08393:PF08326:PF03836,1,46,1,0,45,972,0.02,0.96,1.0,0.14,5,1,0,4,1013,0.2,1.0,1.0,0.45
PF01828,PF09424:PF02372:PF08787,7,11,3,4,8,1003,0.27,0.99,0.43,0.34,0,0,7,0,1011,0,0.99,0.0,0
PF15456,PF11500:PF09444:PF12757,3,2,0,3,2,1013,0.0,1.0,0.0,-0.0,0,0,3,0,1015,0,1.0,0.0,0
PF13961,PF13976:PF03732:PF14244,18,101,12,6,89,911,0.12,0.91,0.67,0.25,35,9,9,26,974,0.26,0.97,0.5,0.34
PF04014,PF09074:PF05666:PF08361,1,1,1,0,0,1017,1.0,1.0,1.0,1.0,0,0,1,0,1017,0,1.0,0.0,0
PF05557,PF03285:PF04440:PF15301,5,4,0,5,4,1009,0.0,0.99,0.0,-0.0,0,0,5,0,1013,0,1.0,0.0,0
PF11819,PF05902:PF04382:PF09379,10,41,8,2,33,975,0.2,0.97,0.8,0.38,5,0,10,5,1003,0.0,0.99,0.0,-0.01
PF16768,PF16769:PF16766:PF05104,2,1,1,1,0,1016,1.0,1.0,0.5,0.71,1,1,1,0,1016,1.0,1.0,0.5,0.71
PF02771,PF00441:PF02770:PF08028,58,69,58,0,11,949,0.84,0.99,1.0,0.91,58,56,2,2,958,0.97,1.0,0.97,0.96
PF11405,PF01552:PF14564:PF01312,0,13,0,0,13,1005,0.0,0.99,0,0,0,0,0,0,1018,0,1.0,0,0
PF15910,PF01279:PF00214:PF15063,0,2,0,0,2,1016,0.0,1.0,0,0,1,0,0,1,1017,0.0,1.0,0,0
PF05924,PF05923:PF05956:PF05937,9,8,7,2,1,1008,0.88,1.0,0.78,0.82,3,3,6,0,1009,1.0,0.99,0.33,0.58
PF05805,PF05296:PF12301:PF14941,7,3,0,7,3,1008,0.0,0.99,0.0,-0.0,0,0,7,0,1011,0,0.99,0.0,0
PF00956,PF01214:PF05197:PF16969,22,28,7,15,21,975,0.25,0.96,0.32,0.26,6,4,18,2,994,0.67,0.98,0.18,0.34
PF15753,PF00669:PF15119:PF15776,3,4,0,3,4,1011,0.0,0.99,0.0,-0.0,0,0,3,0,1015,0,1.0,0.0,0
PF05365,PF09802:PF07802:PF08107,6,6,2,4,4,1008,0.33,0.99,0.33,0.33,0,0,6,0,1012,0,0.99,0.0,0
PF06595,PF03155:PF04493:PF14281,0,23,0,0,23,995,0.0,0.98,0,0,3,0,0,3,1015,0.0,1.0,0,0
PF06905,PF15054:PF15884:PF01716,13,9,4,9,5,1000,0.44,0.99,0.31,0.36,0,0,13,0,1005,0,0.99,0.0,0
PF11527,PF10501:PF06637:PF10361,4,2,0,4,2,1012,0.0,0.99,0.0,-0.0,0,0,4,0,1014,0,1.0,0.0,0
PF06559,PF15175:PF03275:PF17062,1,1,0,1,1,1016,0.0,1.0,0.0,-0.0,0,0,1,0,1017,0,1.0,0.0,0
PF04187,PF03759:PF06136:PF15285,1,13,0,1,13,1004,0.0,0.99,0.0,-0.0,1,0,1,1,1016,0.0,1.0,0.0,-0.0
PF01416,PF08524:PF04189:PF02701,21,23,7,14,16,981,0.3,0.97,0.33,0.3,4,3,18,1,996,0.75,0.98,0.14,0.32
PF15920,PF16704:PF15253:PF02213,1,18,0,1,18,999,0.0,0.98,0.0,-0.0,1,0,1,1,1016,0.0,1.0,0.0,-0.0
PF13820,PF01335:PF17213:PF16501,2,16,2,0,14,1002,0.12,0.99,1.0,0.35,0,0,2,0,1016,0,1.0,0.0,0
PF02796,PF01969:PF14659:PF15143,5,2,1,4,1,1012,0.5,1.0,0.2,0.31,0,0,5,0,1013,0,1.0,0.0,0
PF13015,PF12999:PF05003:PF04871,12,28,10,2,18,988,0.36,0.98,0.83,0.54,4,3,9,1,1005,0.75,0.99,0.25,0.43
PF16656,PF14008:PF02872:PF05011,24,43,22,2,21,973,0.51,0.98,0.92,0.68,8,7,17,1,993,0.88,0.98,0.29,0.5
PF03135,PF07499:PF05974:PF11751,5,2,1,4,1,1012,0.5,1.0,0.2,0.31,0,0,5,0,1013,0,1.0,0.0,0
PF02276,PF15220:PF07209:PF12805,3,1,0,3,1,1014,0.0,1.0,0.0,-0.0,0,0,3,0,1015,0,1.0,0.0,0
PF13185,PF16797:PF13281:PF03924,13,13,5,8,8,997,0.38,0.98,0.38,0.38,3,3,10,0,1005,1.0,0.99,0.23,0.48
PF14694,PF04412:PF03709:PF00073,3,15,0,3,15,1000,0.0,0.98,0.0,-0.01,0,0,3,0,1015,0,1.0,0.0,0
PF11573,PF02403:PF12610:PF12162,4,27,4,0,23,991,0.15,0.98,1.0,0.38,1,0,4,1,1013,0.0,1.0,0.0,-0.0
PF04607,PF13328:PF13291:PF02824,10,29,7,3,22,986,0.24,0.98,0.7,0.4,5,5,5,0,1008,1.0,1.0,0.5,0.71
PF05608,PF10559:PF11728:PF00011,3,38,2,1,36,979,0.05,0.96,0.67,0.18,4,1,2,3,1012,0.25,1.0,0.33,0.29
PF07271,PF15400:PF06122:PF09684,0,1,0,0,1,1017,0.0,1.0,0,0,0,0,0,0,1018,0,1.0,0,0
PF14163,PF10399:PF04552:PF09826,2,5,2,0,3,1013,0.4,1.0,1.0,0.63,1,0,2,1,1015,0.0,1.0,0.0,-0.0
PF11717,PF01853:PF01388:PF08169,26,55,20,6,35,957,0.36,0.96,0.77,0.51,10,9,17,1,991,0.9,0.98,0.35,0.55
PF12872,PF01936:PF17182:PF14418,13,11,4,9,7,998,0.36,0.98,0.31,0.33,1,1,12,0,1005,1.0,0.99,0.08,0.28
PF17058,PF01077:PF03460:PF00769,0,22,0,0,22,996,0.0,0.98,0,0,15,0,0,15,1003,0.0,0.99,0,0
PF03641,PF00436:PF03358:PF04667,10,38,3,7,35,973,0.08,0.96,0.3,0.14,5,2,8,3,1005,0.4,0.99,0.2,0.28
PF06784,PF10320:PF05719:PF06825,5,16,1,4,15,998,0.06,0.98,0.2,0.1,1,0,5,1,1012,0.0,0.99,0.0,-0.0
PF13422,PF14052:PF06082:PF17185,8,0,0,8,0,1010,0,0.99,0.0,0,0,0,8,0,1010,0,0.99,0.0,0
PF01054,PF08142:PF08169:PF15628,0,20,0,0,20,998,0.0,0.98,0,0,1,0,0,1,1017,0.0,1.0,0,0
PF09011,PF08347:PF13775:PF12444,16,2,0,16,2,1000,0.0,0.98,0.0,-0.01,0,0,16,0,1002,0,0.98,0.0,0
PF14655,PF14656:PF16327:PF14837,13,9,6,7,3,1002,0.67,0.99,0.46,0.55,0,0,13,0,1005,0,0.99,0.0,0
PF04037,PF04910:PF11708:PF06886,4,20,1,3,19,995,0.05,0.98,0.25,0.1,5,1,3,4,1010,0.2,0.99,0.25,0.22
PF06889,PF11751:PF13722:PF03589,0,1,0,0,1,1017,0.0,1.0,0,0,0,0,0,0,1018,0,1.0,0,0
PF05722,PF12731:PF12737:PF07526,1,4,1,0,3,1014,0.25,1.0,1.0,0.5,1,1,0,0,1017,1.0,1.0,1.0,1.0
PF08116,PF15844:PF07152:PF14092,0,0,0,0,0,1018,0,1.0,0,0,0,0,0,0,1018,0,1.0,0,0
PF02380,PF12729:PF04738:PF05230,0,1,0,0,1,1017,0.0,1.0,0,0,0,0,0,0,1018,0,1.0,0,0
PF14997,PF08286:PF05281:PF01241,4,2,1,3,1,1013,0.5,1.0,0.25,0.35,0,0,4,0,1014,0,1.0,0.0,0
PF09073,PF15093:PF11510:PF15749,2,10,0,2,10,1006,0.0,0.99,0.0,-0.0,2,0,2,2,1014,0.0,1.0,0.0,-0.0
PF08969,PF11470:PF00581:PF16674,11,55,11,0,44,963,0.2,0.96,1.0,0.44,5,3,8,2,1005,0.6,0.99,0.27,0.4
PF16010,PF04526:PF03188:PF10348,17,31,8,9,23,978,0.26,0.97,0.47,0.33,5,4,13,1,1000,0.8,0.99,0.24,0.43
PF04126,PF15696:PF10295:PF10138,3,5,0,3,5,1010,0.0,0.99,0.0,-0.0,0,0,3,0,1015,0,1.0,0.0,0
PF11952,PF13821:PF01424:PF12457,6,42,6,0,36,976,0.14,0.96,1.0,0.37,7,4,2,3,1009,0.57,1.0,0.67,0.61
PF02935,PF14866:PF06514:PF15041,6,1,0,6,1,1011,0.0,0.99,0.0,-0.0,0,0,6,0,1012,0,0.99,0.0,0
PF02452,PF16997:PF08345:PF03428,2,1,0,2,1,1015,0.0,1.0,0.0,-0.0,0,0,2,0,1016,0,1.0,0.0,0
PF05119,PF04235:PF09695:PF05928,0,0,0,0,0,1018,0,1.0,0,0,0,0,0,0,1018,0,1.0,0,0
PF13299,PF07521:PF11718:PF07289,14,27,6,8,21,983,0.22,0.97,0.43,0.3,11,2,12,9,995,0.18,0.98,0.14,0.15
PF09447,PF10490:PF05685:PF11291,1,5,0,1,5,1012,0.0,0.99,0.0,-0.0,0,0,1,0,1017,0,1.0,0.0,0
PF05964,PF05965:PF10440:PF08429,18,31,17,1,14,986,0.55,0.99,0.94,0.71,3,3,15,0,1000,1.0,0.99,0.17,0.41
PF05910,PF04720:PF06376:PF06749,10,14,7,3,7,1001,0.5,0.99,0.7,0.59,2,2,8,0,1008,1.0,0.99,0.2,0.45
PF07716,PF00170:PF00233:PF02701,36,56,18,18,38,944,0.32,0.94,0.5,0.37,7,3,33,4,978,0.43,0.96,0.08,0.18
PF11792,PF13403:PF15659:PF11585,0,0,0,0,0,1018,0,1.0,0,0,0,0,0,0,1018,0,1.0,0,0
PF04091,PF12036:PF12460:PF07035,13,15,2,11,13,992,0.13,0.98,0.15,0.13,0,0,13,0,1005,0,0.99,0.0,0
PF00090,PF15913:PF00007:PF07474,57,20,17,40,3,958,0.85,0.96,0.3,0.49,3,3,54,0,961,1.0,0.95,0.05,0.22
PF16846,PF08493:PF10703:PF11951,2,81,2,0,79,937,0.02,0.92,1.0,0.15,3,2,0,1,1015,0.67,1.0,1.0,0.82
PF12400,PF01779:PF09340:PF09805,4,21,0,4,21,993,0.0,0.98,0.0,-0.01,2,0,4,2,1012,0.0,0.99,0.0,-0.0
PF07085,PF01515:PF15398:PF03306,6,14,5,1,9,1003,0.36,0.99,0.83,0.54,1,1,5,0,1012,1.0,1.0,0.17,0.41
PF07210,PF08768:PF01549:PF05507,0,47,0,0,47,971,0.0,0.95,0,0,6,0,0,6,1012,0.0,0.99,0,0
PF08669,PF01571:PF10170:PF16350,25,27,22,3,5,988,0.81,0.99,0.88,0.84,12,10,15,2,991,0.83,0.98,0.4,0.57
PF09135,PF08649:PF08636:PF11093,0,4,0,0,4,1014,0.0,1.0,0,0,0,0,0,0,1018,0,1.0,0,0
PF15246,PF10377:PF16501:PF16529,0,7,0,0,7,1011,0.0,0.99,0,0,3,0,0,3,1015,0.0,1.0,0,0
PF02096,PF01245:PF12298:PF11250,23,16,4,19,12,983,0.25,0.97,0.17,0.19,3,2,21,1,994,0.67,0.98,0.09,0.24
PF06800,PF13296:PF15319:PF02979,1,4,0,1,4,1013,0.0,1.0,0.0,-0.0,0,0,1,0,1017,0,1.0,0.0,0
PF14698,PF08328:PF10415:PF10397,8,31,4,4,27,983,0.13,0.97,0.5,0.24,5,2,6,3,1007,0.4,0.99,0.25,0.31
PF12898,PF14216:PF10138:PF13810,0,4,0,0,4,1014,0.0,1.0,0,0,0,0,0,0,1018,0,1.0,0,0
PF14862,PF15754:PF15333:PF05418,0,1,0,0,1,1017,0.0,1.0,0,0,0,0,0,0,1018,0,1.0,0,0
PF05265,PF02557:PF16824:PF07980,0,2,0,0,2,1016,0.0,1.0,0,0,0,0,0,0,1018,0,1.0,0,0
PF01407,PF07882:PF00519:PF03814,0,7,0,0,7,1011,0.0,0.99,0,0,0,0,0,0,1018,0,1.0,0,0
PF03658,PF05934:PF05278:PF16012,0,15,0,0,15,1003,0.0,0.99,0,0,1,0,0,1,1017,0.0,1.0,0,0
PF10162,PF13330:PF07691:PF03782,10,34,6,4,28,980,0.18,0.97,0.6,0.31,6,3,7,3,1005,0.5,0.99,0.3,0.38
PF06903,PF04963:PF05443:PF06834,0,2,0,0,2,1016,0.0,1.0,0,0,1,0,0,1,1017,0.0,1.0,0,0
PF15036,PF15125:PF14986:PF14866,1,3,0,1,3,1014,0.0,1.0,0.0,-0.0,0,0,1,0,1017,0,1.0,0.0,0
PF05603,PF15165:PF15302:PF10284,4,0,0,4,0,1014,0,1.0,0.0,0,0,0,4,0,1014,0,1.0,0.0,0
PF06545,PF04247:PF01523:PF03063,8,13,3,5,10,1000,0.23,0.99,0.38,0.29,0,0,8,0,1010,0,0.99,0.0,0
PF01459,PF01894:PF07701:PF01283,14,47,6,8,41,963,0.13,0.95,0.43,0.22,5,2,12,3,1001,0.4,0.99,0.14,0.23
PF06862,PF03085:PF09746:PF08731,11,10,1,10,9,998,0.1,0.98,0.09,0.09,0,0,11,0,1007,0,0.99,0.0,0
PF00071,PF00255:PF01015:PF10149,144,28,20,124,8,866,0.71,0.87,0.14,0.28,7,7,137,0,874,1.0,0.87,0.05,0.2
PF00077,PF08284:PF00692:PF00607,13,33,8,5,25,980,0.24,0.97,0.62,0.37,12,6,7,6,999,0.5,0.99,0.46,0.47
PF11179,PF03525:PF10138:PF15337,2,5,0,2,5,1011,0.0,0.99,0.0,-0.0,0,0,2,0,1016,0,1.0,0.0,0
PF02465,PF08497:PF16325:PF03428,0,1,0,0,1,1017,0.0,1.0,0,0,0,0,0,0,1018,0,1.0,0,0
PF13907,PF08074:PF15790:PF17218,14,14,6,8,8,996,0.43,0.98,0.43,0.42,2,2,12,0,1004,1.0,0.99,0.14,0.38
PF14921,PF12470:PF14875:PF04775,0,7,0,0,7,1011,0.0,0.99,0,0,1,0,0,1,1017,0.0,1.0,0,0
PF00120,PF03951:PF04909:PF00891,21,63,18,3,45,952,0.29,0.95,0.86,0.48,16,8,13,8,989,0.5,0.98,0.38,0.43
PF11200,PF08759:PF06629:PF13699,0,0,0,0,0,1018,0,1.0,0,0,0,0,0,0,1018,0,1.0,0,0
PF01882,PF08751:PF01913:PF05666,0,5,0,0,5,1013,0.0,1.0,0,0,0,0,0,0,1018,0,1.0,0,0
PF01934,PF13427:PF10634:PF03090,1,1,1,0,0,1017,1.0,1.0,1.0,1.0,0,0,1,0,1017,0,1.0,0.0,0
PF14596,PF12162:PF12188:PF14983,1,4,1,0,3,1014,0.25,1.0,1.0,0.5,1,1,0,0,1017,1.0,1.0,1.0,1.0
PF09585,PF14290:PF06876:PF10994,1,0,0,1,0,1017,0,1.0,0.0,0,0,0,1,0,1017,0,1.0,0.0,0
PF10035,PF02588:PF04917:PF06505,2,3,2,0,1,1015,0.67,1.0,1.0,0.82,0,0,2,0,1016,0,1.0,0.0,0
PF03066,PF00707:PF03479:PF15005,6,18,2,4,16,996,0.11,0.98,0.33,0.18,3,0,6,3,1009,0.0,0.99,0.0,-0.0
PF14336,PF03769:PF07286:PF14735,1,7,0,1,7,1010,0.0,0.99,0.0,-0.0,1,0,1,1,1016,0.0,1.0,0.0,-0.0
PF16051,PF08632:PF01430:PF09444,0,7,0,0,7,1011,0.0,0.99,0,0,0,0,0,0,1018,0,1.0,0,0
PF16195,PF16191:PF16190:PF10585,2,5,1,1,4,1012,0.2,1.0,0.5,0.31,3,1,1,2,1014,0.33,1.0,0.5,0.41
PF16278,PF04592:PF09830:PF04000,9,25,3,6,22,987,0.12,0.97,0.33,0.19,2,2,7,0,1009,1.0,0.99,0.22,0.47
PF00660,PF15478:PF14866:PF07448,1,1,0,1,1,1016,0.0,1.0,0.0,-0.0,0,0,1,0,1017,0,1.0,0.0,0
PF03959,PF12368:PF01667:PF06617,28,17,5,23,12,978,0.29,0.97,0.18,0.21,0,0,28,0,990,0,0.97,0.0,0
PF01825,PF02793:PF00002:PF16489,33,58,27,6,31,954,0.47,0.96,0.82,0.6,28,14,19,14,971,0.5,0.97,0.42,0.44
PF03383,PF11581:PF01739:PF06681,0,4,0,0,4,1014,0.0,1.0,0,0,0,0,0,0,1018,0,1.0,0,0
PF07484,PF01913:PF05939:PF05167,0,2,0,0,2,1016,0.0,1.0,0,0,0,0,0,0,1018,0,1.0,0,0
PF00658,PF11532:PF16842:PF08080,14,1,1,13,0,1004,1.0,0.99,0.07,0.27,1,1,13,0,1004,1.0,0.99,0.07,0.27
PF05510,PF09384:PF01783:PF05180,3,18,2,1,16,999,0.11,0.98,0.67,0.27,5,2,1,3,1012,0.4,1.0,0.67,0.51
PF03964,PF03050:PF11736:PF06573,0,6,0,0,6,1012,0.0,0.99,0,0,0,0,0,0,1018,0,1.0,0,0
PF14637,PF14638:PF14636:PF06333,6,12,6,0,6,1006,0.5,0.99,1.0,0.71,6,6,0,0,1012,1.0,1.0,1.0,1.0
PF04811,PF08033:PF04815:PF04810,26,29,26,0,3,989,0.9,1.0,1.0,0.95,25,24,2,1,991,0.96,1.0,0.92,0.94
PF00778,PF02377:PF08833:PF12316,6,8,4,2,4,1008,0.5,0.99,0.67,0.57,4,3,3,1,1011,0.75,1.0,0.5,0.61
PF04492,PF15482:PF05939:PF03616,2,1,0,2,1,1015,0.0,1.0,0.0,-0.0,0,0,2,0,1016,0,1.0,0.0,0
PF11911,PF09340:PF14610:PF07052,3,19,2,1,17,998,0.11,0.98,0.67,0.26,2,0,3,2,1013,0.0,1.0,0.0,-0.0
PF15324,PF07260:PF15274:PF15806,3,3,0,3,3,1012,0.0,0.99,0.0,-0.0,0,0,3,0,1015,0,1.0,0.0,0
PF13470,PF11057:PF12686:PF15828,0,2,0,0,2,1016,0.0,1.0,0,0,0,0,0,0,1018,0,1.0,0,0
PF00819,PF09990:PF04993:PF17049,0,1,0,0,1,1017,0.0,1.0,0,0,0,0,0,0,1018,0,1.0,0,0
PF08102,PF13737:PF07366:PF01478,0,5,0,0,5,1013,0.0,1.0,0,0,0,0,0,0,1018,0,1.0,0,0
PF13778,PF05572:PF08433:PF13914,1,26,1,0,25,992,0.04,0.98,1.0,0.19,3,0,1,3,1014,0.0,1.0,0.0,-0.0
PF11616,PF15811:PF11764:PF16822,2,12,1,1,11,1005,0.08,0.99,0.5,0.2,2,1,1,1,1015,0.5,1.0,0.5,0.5
PF08692,PF11016:PF03692:PF12855,0,3,0,0,3,1015,0.0,1.0,0,0,0,0,0,0,1018,0,1.0,0,0
PF11648,PF08061:PF13234:PF03461,10,11,4,6,7,1001,0.36,0.99,0.4,0.37,2,2,8,0,1008,1.0,0.99,0.2,0.45
PF10344,PF10359:PF10305:PF10293,2,5,2,0,3,1013,0.4,1.0,1.0,0.63,4,2,0,2,1014,0.5,1.0,1.0,0.71
PF02675,PF08411:PF17060:PF14251,3,4,0,3,4,1011,0.0,0.99,0.0,-0.0,0,0,3,0,1015,0,1.0,0.0,0
PF07726,PF03626:PF12592:PF06044,5,3,2,3,1,1012,0.67,1.0,0.4,0.51,2,2,3,0,1013,1.0,1.0,0.4,0.63
PF00825,PF08795:PF05962:PF04451,2,2,0,2,2,1014,0.0,1.0,0.0,-0.0,0,0,2,0,1016,0,1.0,0.0,0
PF10437,PF02237:PF09825:PF10210,2,10,2,0,8,1008,0.2,0.99,1.0,0.45,1,1,1,0,1016,1.0,1.0,0.5,0.71
PF11923,PF03159:PF01107:PF02337,10,23,4,6,19,989,0.17,0.98,0.4,0.25,3,3,7,0,1008,1.0,0.99,0.3,0.55
PF07816,PF07896:PF03350:PF09597,0,7,0,0,7,1011,0.0,0.99,0,0,0,0,0,0,1018,0,1.0,0,0
PF10568,PF17172:PF10806:PF09737,9,11,4,5,7,1002,0.36,0.99,0.44,0.4,2,2,7,0,1009,1.0,0.99,0.22,0.47
PF09859,PF15213:PF02283:PF03260,0,2,0,0,2,1016,0.0,1.0,0,0,0,0,0,0,1018,0,1.0,0,0
PF13996,PF08926:PF02354:PF09045,0,12,0,0,12,1006,0.0,0.99,0,0,1,0,0,1,1017,0.0,1.0,0,0
PF12569,PF04049:PF17109:PF07719,17,47,6,11,41,960,0.13,0.95,0.35,0.19,7,5,12,2,999,0.71,0.99,0.29,0.45
PF05995,PF02284:PF01774:PF01775,10,17,4,6,13,995,0.24,0.98,0.4,0.3,5,3,7,2,1006,0.6,0.99,0.3,0.42
PF01232,PF08125:PF06742:PF06863,6,10,6,0,4,1008,0.6,1.0,1.0,0.77,0,0,6,0,1012,0,0.99,0.0,0
PF15862,PF08578:PF12169:PF14611,2,10,1,1,9,1007,0.1,0.99,0.5,0.22,0,0,2,0,1016,0,1.0,0.0,0
PF07479,PF02317:PF01210:PF04862,26,33,24,2,9,983,0.73,0.99,0.92,0.81,7,5,21,2,990,0.71,0.98,0.19,0.36
PF04029,PF08795:PF15775:PF06890,2,0,0,2,0,1016,0,1.0,0.0,0,0,0,2,0,1016,0,1.0,0.0,0
PF14326,PF17164:PF15097:PF05567,0,1,0,0,1,1017,0.0,1.0,0,0,0,0,0,0,1018,0,1.0,0,0
PF12263,PF00127:PF12046:PF11016,1,3,0,1,3,1014,0.0,1.0,0.0,-0.0,0,0,1,0,1017,0,1.0,0.0,0
PF02224,PF01037:PF08982:PF07391,5,6,0,5,6,1007,0.0,0.99,0.0,-0.01,0,0,5,0,1013,0,1.0,0.0,0
PF00628,PF12269:PF03172:PF16737,97,8,7,90,1,920,0.88,0.91,0.07,0.24,2,2,95,0,921,1.0,0.91,0.02,0.14
PF16533,PF14847:PF09246:PF12485,2,7,1,1,6,1010,0.14,0.99,0.5,0.26,1,1,1,0,1016,1.0,1.0,0.5,0.71
PF17047,PF15625:PF16056:PF11618,13,8,2,11,6,999,0.25,0.98,0.15,0.19,1,1,12,0,1005,1.0,0.99,0.08,0.28
PF16338,PF17137:PF16863:PF00088,1,31,1,0,30,987,0.03,0.97,1.0,0.18,8,1,0,7,1010,0.12,0.99,1.0,0.35
PF05308,PF14798:PF05197:PF07406,3,7,1,2,6,1009,0.14,0.99,0.33,0.21,2,1,2,1,1014,0.5,1.0,0.33,0.41
PF04494,PF08145:PF04158:PF11540,10,10,2,8,8,1000,0.2,0.98,0.2,0.19,1,1,9,0,1008,1.0,0.99,0.1,0.31
PF12443,PF15241:PF03344:PF08632,0,5,0,0,5,1013,0.0,1.0,0,0,1,0,0,1,1017,0.0,1.0,0,0
PF03853,PF06212:PF01256:PF09532,21,27,13,8,14,983,0.48,0.98,0.62,0.54,6,6,15,0,997,1.0,0.99,0.29,0.53
PF15877,PF14775:PF10375:PF13166,0,5,0,0,5,1013,0.0,1.0,0,0,0,0,0,0,1018,0,1.0,0,0
PF08620,PF12765:PF10304:PF13888,4,19,0,4,19,995,0.0,0.98,0.0,-0.01,1,0,4,1,1013,0.0,1.0,0.0,-0.0
PF06809,PF03359:PF04087:PF12928,6,18,3,3,15,997,0.17,0.98,0.5,0.28,0,0,6,0,1012,0,0.99,0.0,0
PF10456,PF08944:PF16621:PF12825,14,8,4,10,4,1000,0.5,0.99,0.29,0.37,2,2,12,0,1004,1.0,0.99,0.14,0.38
PF01037,PF15750:PF05857:PF03050,3,1,0,3,1,1014,0.0,1.0,0.0,-0.0,0,0,3,0,1015,0,1.0,0.0,0
PF05604,PF08528:PF05548:PF04988,1,9,1,0,8,1009,0.11,0.99,1.0,0.33,3,1,0,2,1015,0.33,1.0,1.0,0.58
PF02050,PF03710:PF11800:PF04625,0,4,0,0,4,1014,0.0,1.0,0,0,0,0,0,0,1018,0,1.0,0,0
PF00622,PF13765:PF00643:PF06328,67,58,30,37,28,923,0.52,0.94,0.45,0.45,17,15,52,2,949,0.88,0.95,0.22,0.43
PF16039,PF09057:PF02087:PF07240,0,2,0,0,2,1016,0.0,1.0,0,0,0,0,0,0,1018,0,1.0,0,0
PF06957,PF11816:PF04053:PF04192,11,38,11,0,27,980,0.29,0.97,1.0,0.53,7,3,8,4,1003,0.43,0.99,0.27,0.34
PF05353,PF10645:PF15367:PF15667,1,4,0,1,4,1013,0.0,1.0,0.0,-0.0,0,0,1,0,1017,0,1.0,0.0,0
PF01106,PF08712:PF10561:PF11069,18,21,15,3,6,994,0.71,0.99,0.83,0.77,1,1,17,0,1000,1.0,0.98,0.06,0.23
PF12709,PF13096:PF05837:PF06211,2,2,0,2,2,1014,0.0,1.0,0.0,-0.0,0,0,2,0,1016,0,1.0,0.0,0
PF12209,PF07243:PF03831:PF04993,0,0,0,0,0,1018,0,1.0,0,0,0,0,0,0,1018,0,1.0,0,0
PF03493,PF03520:PF16519:PF11404,11,13,4,7,9,998,0.31,0.98,0.36,0.33,3,2,9,1,1006,0.67,0.99,0.18,0.34
PF01702,PF10231:PF01896:PF04819,14,16,5,9,11,993,0.31,0.98,0.36,0.32,4,2,12,2,1002,0.5,0.99,0.14,0.26
PF03721,PF03720:PF00984:PF03483,7,24,7,0,17,994,0.29,0.98,1.0,0.54,6,6,1,0,1011,1.0,1.0,0.86,0.93
PF04478,PF11282:PF15245:PF11623,3,2,0,3,2,1013,0.0,1.0,0.0,-0.0,0,0,3,0,1015,0,1.0,0.0,0
PF02012,PF02333:PF03527:PF15798,0,6,0,0,6,1012,0.0,0.99,0,0,0,0,0,0,1018,0,1.0,0,0
PF13463,PF07484:PF05939:PF03553,1,1,0,1,1,1016,0.0,1.0,0.0,-0.0,0,0,1,0,1017,0,1.0,0.0,0
PF13959,PF16124:PF03880:PF04795,22,34,9,13,25,971,0.26,0.96,0.41,0.31,3,3,19,0,996,1.0,0.98,0.14,0.37
PF01081,PF07582:PF06983:PF03718,3,3,0,3,3,1012,0.0,0.99,0.0,-0.0,0,0,3,0,1015,0,1.0,0.0,0
PF11825,PF02159:PF12743:PF02155,5,11,4,1,7,1006,0.36,0.99,0.8,0.54,6,4,1,2,1011,0.67,1.0,0.8,0.73
PF08507,PF08641:PF10280:PF12638,6,14,3,3,11,1001,0.21,0.99,0.5,0.32,1,0,6,1,1011,0.0,0.99,0.0,-0.0
PF09863,PF08220:PF12461:PF01706,0,6,0,0,6,1012,0.0,0.99,0,0,0,0,0,0,1018,0,1.0,0,0
PF02718,PF01340:PF06185:PF03038,0,1,0,0,1,1017,0.0,1.0,0,0,0,0,0,0,1018,0,1.0,0,0
PF01777,PF01929:PF17136:PF00900,15,34,7,8,27,976,0.21,0.97,0.47,0.29,7,4,11,3,1000,0.57,0.99,0.27,0.38
PF09435,PF08026:PF12194:PF06868,2,1,0,2,1,1015,0.0,1.0,0.0,-0.0,0,0,2,0,1016,0,1.0,0.0,0
PF00046,PF12403:PF02376:PF12045,95,8,8,87,0,923,1.0,0.91,0.08,0.28,1,1,94,0,923,1.0,0.91,0.01,0.1
PF10731,PF06681:PF05666:PF10106,0,1,0,0,1,1017,0.0,1.0,0,0,0,0,0,0,1018,0,1.0,0,0
PF02902,PF09331:PF05970:PF14214,68,50,29,39,21,929,0.58,0.94,0.43,0.47,17,15,53,2,948,0.88,0.95,0.22,0.43
PF16073,PF08354:PF14765:PF00698,20,49,18,2,31,967,0.37,0.97,0.9,0.56,37,18,2,19,979,0.49,0.98,0.9,0.65
PF05183,PF12612:PF10350:PF15979,27,26,5,22,21,970,0.19,0.96,0.19,0.17,9,3,24,6,985,0.33,0.97,0.11,0.18
PF02481,PF02729:PF00185:PF04557,8,28,7,1,21,989,0.25,0.98,0.88,0.46,20,6,2,14,996,0.3,0.98,0.75,0.47
PF12592,PF07726:PF03626:PF06044,3,5,2,1,3,1012,0.4,1.0,0.67,0.51,2,2,1,0,1015,1.0,1.0,0.67,0.82
PF04689,PF15486:PF10428:PF04471,6,7,2,4,5,1007,0.29,0.99,0.33,0.3,1,1,5,0,1012,1.0,1.0,0.17,0.41
PF10088,PF12937:PF06291:PF09794,0,100,0,0,100,918,0.0,0.9,0,0,5,0,0,5,1013,0.0,1.0,0,0
PF02171,PF16488:PF16487:PF16486,50,34,32,18,2,966,0.94,0.98,0.64,0.77,32,31,19,1,967,0.97,0.98,0.62,0.77
PF00747,PF11819:PF03568:PF00003,1,40,0,1,40,977,0.0,0.96,0.0,-0.01,11,0,1,11,1006,0.0,0.99,0.0,-0.0
PF01798,PF08156:PF09785:PF00311,26,33,23,3,10,982,0.7,0.99,0.88,0.78,3,3,23,0,992,1.0,0.98,0.12,0.34
PF13439,PF15924:PF12038:PF13579,23,9,3,20,6,989,0.33,0.97,0.13,0.2,0,0,23,0,995,0,0.98,0.0,0
PF13438,PF11798:PF11626:PF00817,1,32,1,0,31,986,0.03,0.97,1.0,0.17,7,1,0,6,1011,0.14,0.99,1.0,0.38
PF16056,PF11618:PF15625:PF09457,3,14,1,2,13,1002,0.07,0.99,0.33,0.15,2,1,2,1,1014,0.5,1.0,0.33,0.41
PF00467,PF11942:PF03439:PF16121,13,24,6,7,18,987,0.25,0.98,0.46,0.33,8,3,10,5,1000,0.38,0.99,0.23,0.29
PF16843,PF09055:PF05162:PF01020,1,19,1,0,18,999,0.05,0.98,1.0,0.23,2,1,0,1,1016,0.5,1.0,1.0,0.71
PF01127,PF15013:PF10183:PF04178,8,22,4,4,18,992,0.18,0.98,0.5,0.29,1,0,8,1,1009,0.0,0.99,0.0,-0.0
PF01488,PF08501:PF01487:PF05201,17,26,17,0,9,992,0.65,0.99,1.0,0.8,11,6,11,5,996,0.55,0.98,0.35,0.43
PF03190,PF07539:PF10350:PF12612,8,27,3,5,24,986,0.11,0.97,0.38,0.19,6,1,7,5,1005,0.17,0.99,0.12,0.14
PF02336,PF02277:PF13753:PF12081,2,3,0,2,3,1013,0.0,1.0,0.0,-0.0,0,0,2,0,1016,0,1.0,0.0,0
PF14949,PF12596:PF04583:PF04508,8,5,2,6,3,1007,0.4,0.99,0.25,0.31,2,2,6,0,1010,1.0,0.99,0.25,0.5
PF04129,PF14800:PF06248:PF04114,18,24,7,11,17,983,0.29,0.97,0.39,0.32,4,3,15,1,999,0.75,0.98,0.17,0.35
PF15146,PF15395:PF08811:PF12381,0,8,0,0,8,1010,0.0,0.99,0,0,0,0,0,0,1018,0,1.0,0,0
PF10399,PF14163:PF07954:PF07308,3,3,2,1,1,1014,0.67,1.0,0.67,0.67,0,0,3,0,1015,0,1.0,0.0,0
PF13988,PF06594:PF07964:PF10554,0,2,0,0,2,1016,0.0,1.0,0,0,0,0,0,0,1018,0,1.0,0,0
PF04130,PF02705:PF03407:PF01501,40,59,21,19,38,940,0.36,0.94,0.53,0.4,12,9,31,3,975,0.75,0.97,0.23,0.4
PF01222,PF09465:PF10477:PF10846,23,13,5,18,8,987,0.38,0.97,0.22,0.28,5,3,20,2,993,0.6,0.98,0.13,0.27
PF08229,PF15014:PF03918:PF15475,4,3,1,3,2,1012,0.33,1.0,0.25,0.29,0,0,4,0,1014,0,1.0,0.0,0
PF15878,PF05326:PF04013:PF08856,0,1,0,0,1,1017,0.0,1.0,0,0,0,0,0,0,1018,0,1.0,0,0
PF01386,PF14693:PF04549:PF14766,2,6,2,0,4,1012,0.33,1.0,1.0,0.58,0,0,2,0,1016,0,1.0,0.0,0
PF13612,PF11751:PF01752:PF07505,3,2,0,3,2,1013,0.0,1.0,0.0,-0.0,0,0,3,0,1015,0,1.0,0.0,0
PF11362,PF15398:PF10630:PF02106,1,1,0,1,1,1016,0.0,1.0,0.0,-0.0,0,0,1,0,1017,0,1.0,0.0,0
PF00021,PF02988:PF03821:PF01457,5,11,2,3,9,1004,0.18,0.99,0.4,0.26,0,0,5,0,1013,0,1.0,0.0,0
PF12394,PF05057:PF17046:PF07555,2,34,2,0,32,984,0.06,0.97,1.0,0.24,5,0,2,5,1011,0.0,0.99,0.0,-0.0
PF07829,PF10017:PF10070:PF07385,1,8,0,1,8,1009,0.0,0.99,0.0,-0.0,0,0,1,0,1017,0,1.0,0.0,0
PF07240,PF15883:PF16037:PF06581,0,0,0,0,0,1018,0,1.0,0,0,0,0,0,0,1018,0,1.0,0,0
PF14569,PF03552:PF09265:PF06364,8,25,8,0,17,993,0.32,0.98,1.0,0.56,5,4,4,1,1009,0.8,1.0,0.5,0.63
PF09191,PF12104:PF05790:PF11465,0,4,0,0,4,1014,0.0,1.0,0,0,1,0,0,1,1017,0.0,1.0,0,0
PF07313,PF16731:PF10737:PF14985,0,2,0,0,2,1016,0.0,1.0,0,0,0,0,0,0,1018,0,1.0,0,0
PF14250,PF11128:PF06689:PF14050,0,4,0,0,4,1014,0.0,1.0,0,0,0,0,0,0,1018,0,1.0,0,0
PF03892,PF09488:PF15952:PF08595,0,8,0,0,8,1010,0.0,0.99,0,0,0,0,0,0,1018,0,1.0,0,0
PF03965,PF05024:PF14076:PF12862,1,19,0,1,19,998,0.0,0.98,0.0,-0.0,4,0,1,4,1013,0.0,1.0,0.0,-0.0
PF08918,PF02768:PF02203:PF05231,4,13,2,2,11,1003,0.15,0.99,0.5,0.27,0,0,4,0,1014,0,1.0,0.0,0
PF07219,PF16546:PF02388:PF13464,2,14,1,1,13,1003,0.07,0.99,0.5,0.19,1,1,1,0,1016,1.0,1.0,0.5,0.71
PF06136,PF03759:PF05301:PF05627,6,16,3,3,13,999,0.19,0.98,0.5,0.3,1,1,5,0,1012,1.0,1.0,0.17,0.41
PF04405,PF04363:PF15167:PF15842,0,2,0,0,2,1016,0.0,1.0,0,0,2,0,0,2,1016,0.0,1.0,0,0
PF09777,PF00159:PF12020:PF13841,2,2,0,2,2,1014,0.0,1.0,0.0,-0.0,0,0,2,0,1016,0,1.0,0.0,0
PF12159,PF15055:PF16594:PF02202,0,1,0,0,1,1017,0.0,1.0,0,0,0,0,0,0,1018,0,1.0,0,0
PF12359,PF12340:PF15927:PF13329,8,20,8,0,12,998,0.4,0.99,1.0,0.63,3,3,5,0,1010,1.0,1.0,0.38,0.61
PF05006,PF05234:PF00419:PF03605,0,3,0,0,3,1015,0.0,1.0,0,0,0,0,0,0,1018,0,1.0,0,0
PF01878,PF08228:PF12926:PF11805,10,3,1,9,2,1006,0.33,0.99,0.1,0.18,0,0,10,0,1008,0,0.99,0.0,0
PF13718,PF05127:PF13725:PF08351,13,15,12,1,3,1002,0.8,1.0,0.92,0.86,12,12,1,0,1005,1.0,1.0,0.92,0.96
PF01741,PF17032:PF00489:PF09232,2,1,0,2,1,1015,0.0,1.0,0.0,-0.0,0,0,2,0,1016,0,1.0,0.0,0
PF06645,PF01279:PF02044:PF10775,8,2,0,8,2,1008,0.0,0.99,0.0,-0.0,0,0,8,0,1010,0,0.99,0.0,0
PF12333,PF14959:PF12612:PF13910,6,16,3,3,13,999,0.19,0.98,0.5,0.3,0,0,6,0,1012,0,0.99,0.0,0
PF11001,PF04090:PF08528:PF13002,7,11,3,4,8,1003,0.27,0.99,0.43,0.34,0,0,7,0,1011,0,0.99,0.0,0
PF12019,PF08724:PF03831:PF14841,1,1,0,1,1,1016,0.0,1.0,0.0,-0.0,0,0,1,0,1017,0,1.0,0.0,0
PF10509,PF07959:PF08544:PF00288,12,48,12,0,36,970,0.25,0.96,1.0,0.49,34,10,2,24,982,0.29,0.97,0.83,0.49
PF00806,PF07990:PF03124:PF11030,21,10,5,16,5,992,0.5,0.98,0.24,0.34,2,2,19,0,997,1.0,0.98,0.1,0.31
PF04670,PF04724:PF01712:PF10160,18,11,1,17,10,990,0.09,0.97,0.06,0.06,2,1,17,1,999,0.5,0.98,0.06,0.16
PF13508,PF13673:PF04982:PF06500,10,28,5,5,23,985,0.18,0.97,0.5,0.29,4,2,8,2,1006,0.5,0.99,0.2,0.31
PF01086,PF08137:PF12023:PF08627,4,4,0,4,4,1010,0.0,0.99,0.0,-0.0,0,0,4,0,1014,0,1.0,0.0,0
PF06718,PF02452:PF06028:PF03323,0,11,0,0,11,1007,0.0,0.99,0,0,2,0,0,2,1016,0.0,1.0,0,0
PF14950,PF14951:PF07085:PF14911,0,8,0,0,8,1010,0.0,0.99,0,0,0,0,0,0,1018,0,1.0,0,0
PF14830,PF12143:PF12142:PF02237,1,5,1,0,4,1013,0.2,1.0,1.0,0.45,2,1,0,1,1016,0.5,1.0,1.0,0.71
PF03527,PF15798:PF06977:PF10279,2,0,0,2,0,1016,0,1.0,0.0,0,0,0,2,0,1016,0,1.0,0.0,0
PF05488,PF17188:PF07434:PF10988,0,0,0,0,0,1018,0,1.0,0,0,0,0,0,0,1018,0,1.0,0,0
PF12008,PF04313:PF06114:PF01863,4,7,4,0,3,1011,0.57,1.0,1.0,0.75,4,4,0,0,1014,1.0,1.0,1.0,1.0
PF16035,PF01269:PF12751:PF16027,5,16,1,4,15,998,0.06,0.98,0.2,0.1,0,0,5,0,1013,0,1.0,0.0,0
PF06441,PF06237:PF10288:PF04083,14,33,3,11,30,974,0.09,0.96,0.21,0.12,3,2,12,1,1003,0.67,0.99,0.14,0.3
PF00211,PF07701:PF16214:PF08376,59,25,24,35,1,958,0.96,0.96,0.41,0.61,4,4,55,0,959,1.0,0.95,0.07,0.25
PF12661,PF00008:PF01049:PF00683,41,81,40,1,41,936,0.49,0.96,0.98,0.68,8,5,36,3,974,0.62,0.96,0.12,0.26
PF08058,PF10333:PF09428:PF15062,0,1,0,0,1,1017,0.0,1.0,0,0,0,0,0,0,1018,0,1.0,0,0
PF00411,PF00329:PF01196:PF01058,23,34,7,16,27,968,0.21,0.96,0.3,0.23,14,6,17,8,987,0.43,0.98,0.26,0.32
PF05611,PF07353:PF03275:PF09832,0,3,0,0,3,1015,0.0,1.0,0,0,0,0,0,0,1018,0,1.0,0,0
PF12570,PF15208:PF13753:PF11697,0,1,0,0,1,1017,0.0,1.0,0,0,0,0,0,0,1018,0,1.0,0,0
PF06757,PF10325:PF16984:PF01147,2,6,0,2,6,1010,0.0,0.99,0.0,-0.0,0,0,2,0,1016,0,1.0,0.0,0
PF11093,PF08649:PF02202:PF13933,0,2,0,0,2,1016,0.0,1.0,0,0,0,0,0,0,1018,0,1.0,0,0
PF03735,PF05641:PF05266:PF16135,7,22,6,1,16,995,0.27,0.98,0.86,0.48,6,4,3,2,1009,0.67,1.0,0.57,0.61
PF14186,PF16276:PF08910:PF11628,5,6,0,5,6,1007,0.0,0.99,0.0,-0.01,0,0,5,0,1013,0,1.0,0.0,0
PF03940,PF11573:PF07942:PF16185,0,16,0,0,16,1002,0.0,0.98,0,0,3,0,0,3,1015,0.0,1.0,0,0
PF00653,PF00382:PF12356:PF04181,16,29,8,8,21,981,0.28,0.97,0.5,0.36,3,3,13,0,1002,1.0,0.99,0.19,0.43
PF16979,PF05422:PF16978:PF12448,12,16,12,0,4,1002,0.75,1.0,1.0,0.86,2,2,10,0,1006,1.0,0.99,0.17,0.41
PF00166,PF03330:PF00967:PF01113,16,25,6,10,19,983,0.24,0.97,0.38,0.29,4,3,13,1,1001,0.75,0.99,0.19,0.37
PF13802,PF16863:PF01055:PF17137,21,38,20,1,18,979,0.53,0.98,0.95,0.7,23,15,6,8,989,0.65,0.99,0.71,0.68
PF08310,PF04122:PF12753:PF10139,1,1,0,1,1,1016,0.0,1.0,0.0,-0.0,0,0,1,0,1017,0,1.0,0.0,0
PF05591,PF05943:PF13722:PF05947,0,0,0,0,0,1018,0,1.0,0,0,0,0,0,0,1018,0,1.0,0,0
PF12488,PF00796:PF17206:PF17076,1,1,0,1,1,1016,0.0,1.0,0.0,-0.0,0,0,1,0,1017,0,1.0,0.0,0
PF08256,PF08248:PF07149:PF11800,0,0,0,0,0,1018,0,1.0,0,0,0,0,0,0,1018,0,1.0,0,0
PF01612,PF00570:PF08066:PF01927,55,33,25,30,8,955,0.76,0.96,0.45,0.57,10,10,45,0,963,1.0,0.96,0.18,0.42
PF08228,PF01878:PF15158:PF15673,3,11,1,2,10,1005,0.09,0.99,0.33,0.17,0,0,3,0,1015,0,1.0,0.0,0
PF04563,PF04561:PF06883:PF00562,21,22,16,5,6,991,0.73,0.99,0.76,0.74,7,4,17,3,994,0.57,0.98,0.19,0.32
PF16900,PF08646:PF02721:PF04057,15,27,15,0,12,991,0.56,0.99,1.0,0.74,12,11,4,1,1002,0.92,1.0,0.73,0.82
PF14983,PF07195:PF13726:PF07149,2,0,0,2,0,1016,0,1.0,0.0,0,0,0,2,0,1016,0,1.0,0.0,0
PF01984,PF07080:PF07225:PF09056,13,10,4,9,6,999,0.4,0.99,0.31,0.34,1,1,12,0,1005,1.0,0.99,0.08,0.28
PF11577,PF16574:PF09762:PF17045,4,4,0,4,4,1010,0.0,0.99,0.0,-0.0,1,0,4,1,1013,0.0,1.0,0.0,-0.0
PF06883,PF10385:PF04561:PF04563,5,22,3,2,19,994,0.14,0.98,0.6,0.28,5,2,3,3,1010,0.4,0.99,0.4,0.4
PF15157,PF10206:PF10014:PF08642,2,5,1,1,4,1012,0.2,1.0,0.5,0.31,1,1,1,0,1016,1.0,1.0,0.5,0.71
PF15835,PF00034:PF07062:PF10477,0,21,0,0,21,997,0.0,0.98,0,0,0,0,0,0,1018,0,1.0,0,0
PF02823,PF02560:PF05609:PF16839,6,6,2,4,4,1008,0.33,0.99,0.33,0.33,0,0,6,0,1012,0,0.99,0.0,0
PF14643,PF14644:PF15246:PF16529,5,7,3,2,4,1009,0.43,0.99,0.6,0.5,1,1,4,0,1013,1.0,1.0,0.2,0.45
PF12224,PF16091:PF15759:PF05677,9,1,0,9,1,1008,0.0,0.99,0.0,-0.0,0,0,9,0,1009,0,0.99,0.0,0
PF02430,PF02915:PF00499:PF06083,1,7,0,1,7,1010,0.0,0.99,0.0,-0.0,0,0,1,0,1017,0,1.0,0.0,0
PF07722,PF06083:PF08561:PF10218,3,8,2,1,6,1009,0.25,0.99,0.67,0.41,0,0,3,0,1015,0,1.0,0.0,0
PF00111,PF03450:PF00941:PF01315,40,23,20,20,3,975,0.87,0.98,0.5,0.65,22,20,20,2,976,0.91,0.98,0.5,0.67
PF00814,PF03091:PF01215:PF10190,30,23,9,21,14,974,0.39,0.97,0.3,0.33,5,3,27,2,986,0.6,0.97,0.1,0.24
PF06311,PF00640:PF12473:PF11830,2,40,2,0,38,978,0.05,0.96,1.0,0.22,10,2,0,8,1008,0.2,0.99,1.0,0.45
PF08203,PF01316:PF15212:PF03050,1,2,0,1,2,1015,0.0,1.0,0.0,-0.0,0,0,1,0,1017,0,1.0,0.0,0
PF10282,PF09724:PF01185:PF12296,14,20,7,7,13,991,0.35,0.98,0.5,0.41,3,2,12,1,1003,0.67,0.99,0.14,0.3
PF06748,PF10816:PF01645:PF00310,0,12,0,0,12,1006,0.0,0.99,0,0,6,0,0,6,1012,0.0,0.99,0,0
PF07019,PF06246:PF04930:PF15013,17,21,6,11,15,986,0.29,0.97,0.35,0.3,1,1,16,0,1001,1.0,0.98,0.06,0.24
PF17096,PF15392:PF07610:PF12178,0,3,0,0,3,1015,0.0,1.0,0,0,0,0,0,0,1018,0,1.0,0,0
PF15881,PF09494:PF10102:PF02676,2,20,1,1,19,997,0.05,0.98,0.5,0.15,3,1,1,2,1014,0.33,1.0,0.5,0.41
PF06196,PF03144:PF06299:PF06045,0,60,0,0,60,958,0.0,0.94,0,0,2,0,0,2,1016,0.0,1.0,0,0
PF01297,PF08299:PF07195:PF14882,4,2,0,4,2,1012,0.0,0.99,0.0,-0.0,0,0,4,0,1014,0,1.0,0.0,0
PF08362,PF07157:PF13722:PF01752,1,2,0,1,2,1015,0.0,1.0,0.0,-0.0,0,0,1,0,1017,0,1.0,0.0,0
PF17100,PF15512:PF11816:PF13925,20,20,5,15,15,983,0.25,0.97,0.25,0.23,3,2,18,1,997,0.67,0.98,0.1,0.25
PF08961,PF09049:PF09050:PF07334,1,1,0,1,1,1016,0.0,1.0,0.0,-0.0,0,0,1,0,1017,0,1.0,0.0,0
PF01694,PF04114:PF14923:PF13833,45,64,25,20,39,934,0.39,0.94,0.56,0.44,6,6,39,0,973,1.0,0.96,0.13,0.36
PF13259,PF01643:PF16320:PF01091,5,11,2,3,9,1004,0.18,0.99,0.4,0.26,1,0,5,1,1012,0.0,0.99,0.0,-0.0
PF13247,PF17206:PF05857:PF14841,0,2,0,0,2,1016,0.0,1.0,0,0,0,0,0,0,1018,0,1.0,0,0
PF05536,PF00475:PF13419:PF01687,3,66,2,1,64,951,0.03,0.94,0.67,0.13,9,2,1,7,1008,0.22,0.99,0.67,0.38
PF06792,PF02092:PF09370:PF14817,3,14,2,1,12,1003,0.14,0.99,0.67,0.3,2,1,2,1,1014,0.5,1.0,0.33,0.41
PF05903,PF15928:PF06201:PF09070,19,25,4,15,21,978,0.16,0.96,0.21,0.17,1,1,18,0,999,1.0,0.98,0.05,0.23
PF04118,PF09743:PF15917:PF11597,7,9,1,6,8,1003,0.11,0.99,0.14,0.12,2,1,6,1,1010,0.5,0.99,0.14,0.26
PF16928,PF11811:PF07439:PF10460,0,1,0,0,1,1017,0.0,1.0,0,0,0,0,0,0,1018,0,1.0,0,0
PF11626,PF08914:PF06732:PF16727,7,20,7,0,13,998,0.35,0.99,1.0,0.59,1,0,7,1,1010,0.0,0.99,0.0,-0.0
PF08386,PF04083:PF10329:PF16862,18,45,9,9,36,964,0.2,0.96,0.5,0.3,4,2,16,2,998,0.5,0.98,0.11,0.23
PF07506,PF11405:PF02543:PF01807,0,8,0,0,8,1010,0.0,0.99,0,0,1,0,0,1,1017,0.0,1.0,0,0
PF01766,PF04099:PF07672:PF09445,1,24,0,1,24,993,0.0,0.98,0.0,-0.0,3,0,1,3,1014,0.0,1.0,0.0,-0.0
PF04289,PF13897:PF08438:PF11952,0,14,0,0,14,1004,0.0,0.99,0,0,3,0,0,3,1015,0.0,1.0,0,0
PF01225,PF02875:PF07361:PF01098,11,23,10,1,13,994,0.43,0.99,0.91,0.62,9,8,3,1,1006,0.89,1.0,0.73,0.8
PF03379,PF02950:PF07327:PF01316,1,4,0,1,4,1013,0.0,1.0,0.0,-0.0,0,0,1,0,1017,0,1.0,0.0,0
PF12238,PF00499:PF06658:PF00421,0,21,0,0,21,997,0.0,0.98,0,0,1,0,0,1,1017,0.0,1.0,0,0
PF09744,PF04388:PF16471:PF09730,9,15,3,6,12,997,0.2,0.98,0.33,0.25,0,0,9,0,1009,0,0.99,0.0,0
PF09747,PF04253:PF01133:PF12298,10,21,6,4,15,993,0.29,0.98,0.6,0.41,3,3,7,0,1008,1.0,0.99,0.3,0.55
PF07474,PF12662:PF06119:PF09307,8,32,8,0,24,986,0.25,0.98,1.0,0.49,9,3,5,6,1004,0.33,0.99,0.38,0.35
PF06418,PF00697:PF08252:PF00977,19,21,7,12,14,985,0.33,0.97,0.37,0.34,0,0,19,0,999,0,0.98,0.0,0
PF10447,PF15985:PF07286:PF04756,8,20,2,6,18,992,0.1,0.98,0.25,0.15,5,2,6,3,1007,0.4,0.99,0.25,0.31
PF15808,PF16700:PF15898:PF16553,3,4,0,3,4,1011,0.0,0.99,0.0,-0.0,1,0,3,1,1014,0.0,1.0,0.0,-0.0
PF00649,PF15678:PF14611:PF09429,8,13,1,7,12,998,0.08,0.98,0.12,0.09,0,0,8,0,1010,0,0.99,0.0,0
PF11761,PF02979:PF13389:PF15681,0,6,0,0,6,1012,0.0,0.99,0,0,0,0,0,0,1018,0,1.0,0,0
PF15259,PF15241:PF15082:PF09322,1,3,0,1,3,1014,0.0,1.0,0.0,-0.0,0,0,1,0,1017,0,1.0,0.0,0
PF08347,PF13775:PF08517:PF09011,1,21,0,1,21,996,0.0,0.98,0.0,-0.0,2,0,1,2,1015,0.0,1.0,0.0,-0.0
PF11921,PF10428:PF15904:PF12534,1,8,1,0,7,1010,0.12,0.99,1.0,0.35,1,1,0,0,1017,1.0,1.0,1.0,1.0
PF03659,PF13472:PF10503:PF00457,19,42,9,10,33,966,0.21,0.96,0.47,0.3,9,4,15,5,994,0.44,0.98,0.21,0.3
PF07635,PF03548:PF15707:PF01514,0,3,0,0,3,1015,0.0,1.0,0,0,0,0,0,0,1018,0,1.0,0,0
PF15328,PF02116:PF11255:PF13270,0,4,0,0,4,1014,0.0,1.0,0,0,1,0,0,1,1017,0.0,1.0,0,0
PF03485,PF05746:PF00750:PF14510,17,40,15,2,25,976,0.38,0.97,0.88,0.57,26,14,3,12,989,0.54,0.99,0.82,0.66
PF12852,PF06719:PF08708:PF01514,2,2,2,0,0,1016,1.0,1.0,1.0,1.0,0,0,2,0,1016,0,1.0,0.0,0
PF05504,PF03592:PF14882:PF01514,8,0,0,8,0,1010,0,0.99,0.0,0,0,0,8,0,1010,0,0.99,0.0,0
PF13435,PF10567:PF14508:PF03729,0,1,0,0,1,1017,0.0,1.0,0,0,0,0,0,0,1018,0,1.0,0,0
PF01140,PF01141:PF02093:PF02337,5,6,4,1,2,1011,0.67,1.0,0.8,0.73,4,4,1,0,1013,1.0,1.0,0.8,0.89
PF04434,PF03108:PF03101:PF10551,24,68,23,1,45,949,0.34,0.95,0.96,0.55,27,17,7,10,984,0.63,0.98,0.71,0.66
PF12571,PF15726:PF01314:PF14882,0,4,0,0,4,1014,0.0,1.0,0,0,0,0,0,0,1018,0,1.0,0,0
PF09675,PF08503:PF08260:PF09337,0,15,0,0,15,1003,0.0,0.99,0,0,0,0,0,0,1018,0,1.0,0,0
PF08867,PF09498:PF14842:PF08453,0,2,0,0,2,1016,0.0,1.0,0,0,0,0,0,0,1018,0,1.0,0,0
PF13816,PF01385:PF15546:PF02306,1,2,0,1,2,1015,0.0,1.0,0.0,-0.0,0,0,1,0,1017,0,1.0,0.0,0
PF00392,PF07702:PF07729:PF07706,19,19,17,2,2,997,0.89,1.0,0.89,0.89,1,1,18,0,999,1.0,0.98,0.05,0.23
PF03319,PF15046:PF08945:PF15207,0,4,0,0,4,1014,0.0,1.0,0,0,0,0,0,0,1018,0,1.0,0,0
PF01073,PF02453:PF01370:PF14934,21,78,18,3,60,937,0.23,0.94,0.86,0.43,7,4,17,3,994,0.57,0.98,0.19,0.32
PF16714,PF01588:PF00579:PF14732,5,57,5,0,52,961,0.09,0.95,1.0,0.29,15,5,0,10,1003,0.33,0.99,1.0,0.57
PF03747,PF03381:PF01667:PF08122,12,28,4,8,24,982,0.14,0.97,0.33,0.2,2,2,10,0,1006,1.0,0.99,0.17,0.41
PF02064,PF15811:PF04603:PF05033,10,30,6,4,24,984,0.2,0.97,0.6,0.34,4,4,6,0,1008,1.0,0.99,0.4,0.63
PF12338,PF00101:PF08523:PF01091,4,10,4,0,6,1008,0.4,0.99,1.0,0.63,3,2,2,1,1013,0.67,1.0,0.5,0.58
PF17082,PF00170:PF00849:PF04101,1,64,0,1,64,953,0.0,0.94,0.0,-0.01,19,0,1,19,998,0.0,0.98,0.0,-0.0
PF02594,PF12716:PF06108:PF10244,10,13,4,6,9,999,0.31,0.99,0.4,0.34,1,0,10,1,1007,0.0,0.99,0.0,-0.0
PF13292,PF00456:PF02779:PF02449,3,51,3,0,48,967,0.06,0.95,1.0,0.24,11,0,3,11,1004,0.0,0.99,0.0,-0.01
PF06756,PF01810:PF11272:PF10951,0,8,0,0,8,1010,0.0,0.99,0,0,0,0,0,0,1018,0,1.0,0,0
PF06834,PF07511:PF01706:PF12080,0,1,0,0,1,1017,0.0,1.0,0,0,0,0,0,0,1018,0,1.0,0,0
PF01313,PF00813:PF06995:PF02501,0,2,0,0,2,1016,0.0,1.0,0,0,0,0,0,0,1018,0,1.0,0,0
PF16032,PF16003:PF03934:PF05134,0,3,0,0,3,1015,0.0,1.0,0,0,1,0,0,1,1017,0.0,1.0,0,0
PF03221,PF04218:PF03184:PF04236,55,61,39,16,22,941,0.64,0.96,0.71,0.65,14,12,43,2,961,0.86,0.96,0.22,0.42
PF12274,PF09733:PF12820:PF07762,8,22,3,5,19,991,0.14,0.98,0.38,0.22,2,1,7,1,1009,0.5,0.99,0.12,0.25
PF02038,PF04831:PF12301:PF04505,6,17,2,4,15,997,0.12,0.98,0.33,0.19,3,1,5,2,1010,0.33,0.99,0.17,0.23
PF11991,PF01828:PF10780:PF12296,5,13,3,2,10,1003,0.23,0.99,0.6,0.37,0,0,5,0,1013,0,1.0,0.0,0
PF09684,PF06082:PF06070:PF03729,1,1,0,1,1,1016,0.0,1.0,0.0,-0.0,0,0,1,0,1017,0,1.0,0.0,0
PF05337,PF07199:PF14626:PF04988,2,6,0,2,6,1010,0.0,0.99,0.0,-0.0,0,0,2,0,1016,0,1.0,0.0,0
PF14710,PF02613:PF02588:PF13090,2,4,1,1,3,1013,0.25,1.0,0.5,0.35,1,1,1,0,1016,1.0,1.0,0.5,0.71
PF03630,PF01937:PF06888:PF14535,14,19,7,7,12,992,0.37,0.98,0.5,0.42,3,2,12,1,1003,0.67,0.99,0.14,0.3
PF11160,PF03428:PF11593:PF08795,0,2,0,0,2,1016,0.0,1.0,0,0,0,0,0,0,1018,0,1.0,0,0
PF01138,PF03725:PF03726:PF08067,61,29,29,32,0,957,1.0,0.97,0.48,0.68,11,11,50,0,957,1.0,0.95,0.18,0.41
PF03226,PF05362:PF01434:PF02190,20,54,13,7,41,957,0.24,0.95,0.65,0.38,22,9,11,13,985,0.41,0.98,0.45,0.42
PF15070,PF10226:PF15921:PF15301,1,6,0,1,6,1011,0.0,0.99,0.0,-0.0,1,0,1,1,1016,0.0,1.0,0.0,-0.0
PF12256,PF03534:PF12255:PF09327,0,0,0,0,0,1018,0,1.0,0,0,0,0,0,0,1018,0,1.0,0,0
PF02580,PF05817:PF09734:PF02101,15,19,6,9,13,990,0.32,0.98,0.4,0.34,7,5,10,2,1001,0.71,0.99,0.33,0.48
PF04562,PF15485:PF07192:PF08795,0,0,0,0,0,1018,0,1.0,0,0,0,0,0,0,1018,0,1.0,0,0
PF03660,PF08400:PF06162:PF14609,4,1,1,3,0,1014,1.0,1.0,0.25,0.5,0,0,4,0,1014,0,1.0,0.0,0
PF16064,PF04500:PF15299:PF13873,7,39,5,2,34,977,0.13,0.96,0.71,0.29,8,5,2,3,1008,0.62,1.0,0.71,0.67
PF00620,PF00169:PF00611:PF00617,82,154,61,21,93,843,0.4,0.89,0.74,0.49,40,28,54,12,924,0.7,0.94,0.34,0.46
PF02684,PF12904:PF07171:PF07909,1,3,0,1,3,1014,0.0,1.0,0.0,-0.0,0,0,1,0,1017,0,1.0,0.0,0
PF01431,PF05649:PF02347:PF14498,38,44,34,4,10,970,0.77,0.99,0.89,0.82,8,7,31,1,979,0.88,0.97,0.18,0.39
PF08143,PF11627:PF12196:PF08081,1,2,1,0,1,1016,0.5,1.0,1.0,0.71,1,1,0,0,1017,1.0,1.0,1.0,1.0
PF06886,PF12214:PF04087:PF04000,5,21,4,1,17,996,0.19,0.98,0.8,0.39,2,0,5,2,1011,0.0,0.99,0.0,-0.0
PF01599,PF16455:PF10260:PF04758,6,19,3,3,16,996,0.16,0.98,0.5,0.27,1,1,5,0,1012,1.0,1.0,0.17,0.41
PF08954,PF05386:PF10647:PF15512,1,5,1,0,4,1013,0.2,1.0,1.0,0.45,1,1,0,0,1017,1.0,1.0,1.0,1.0
PF00836,PF03285:PF04597:PF14802,10,10,2,8,8,1000,0.2,0.98,0.2,0.19,0,0,10,0,1008,0,0.99,0.0,0
PF12853,PF03769:PF10785:PF08140,5,6,3,2,3,1010,0.5,1.0,0.6,0.55,0,0,5,0,1013,0,1.0,0.0,0
PF06089,PF02604:PF02767:PF07419,8,7,1,7,6,1004,0.14,0.99,0.12,0.13,1,0,8,1,1009,0.0,0.99,0.0,-0.0
PF01913,PF17006:PF05939:PF12477,1,0,0,1,0,1017,0,1.0,0.0,0,0,0,1,0,1017,0,1.0,0.0,0
PF09256,PF10567:PF01752:PF08708,0,3,0,0,3,1015,0.0,1.0,0,0,0,0,0,0,1018,0,1.0,0,0
PF12464,PF14602:PF06426:PF13720,14,31,10,4,21,983,0.32,0.98,0.71,0.47,6,4,10,2,1002,0.67,0.99,0.29,0.43
PF05672,PF14738:PF11500:PF14722,5,12,0,5,12,1001,0.0,0.98,0.0,-0.01,0,0,5,0,1013,0,1.0,0.0,0
PF08714,PF02277:PF02742:PF00419,2,7,0,2,7,1009,0.0,0.99,0.0,-0.0,0,0,2,0,1016,0,1.0,0.0,0
PF01276,PF03711:PF03709:PF12381,7,11,7,0,4,1007,0.64,1.0,1.0,0.8,2,2,5,0,1011,1.0,1.0,0.29,0.53
PF12392,PF01514:PF01136:PF03406,1,1,1,0,0,1017,1.0,1.0,1.0,1.0,0,0,1,0,1017,0,1.0,0.0,0
PF03712,PF01082:PF03351:PF10517,17,25,17,0,8,993,0.68,0.99,1.0,0.82,17,12,5,5,996,0.71,0.99,0.71,0.7
PF15135,PF15207:PF15175:PF03238,1,1,0,1,1,1016,0.0,1.0,0.0,-0.0,0,0,1,0,1017,0,1.0,0.0,0
PF09032,PF16273:PF05002:PF14050,3,21,2,1,19,996,0.1,0.98,0.67,0.25,0,0,3,0,1015,0,1.0,0.0,0
PF06775,PF07798:PF14612:PF04664,11,9,2,9,7,1000,0.22,0.98,0.18,0.19,1,0,11,1,1006,0.0,0.99,0.0,-0.0
PF16558,PF04699:PF03256:PF14377,7,23,2,5,21,990,0.09,0.97,0.29,0.15,5,2,5,3,1008,0.4,0.99,0.29,0.33
PF05327,PF04006:PF00462:PF05091,12,64,7,5,57,949,0.11,0.94,0.58,0.23,11,2,10,9,997,0.18,0.98,0.17,0.16
PF13511,PF13005:PF09979:PF04222,3,0,0,3,0,1015,0,1.0,0.0,0,0,0,3,0,1015,0,1.0,0.0,0
PF08293,PF09996:PF17062:PF06907,6,2,0,6,2,1010,0.0,0.99,0.0,-0.0,0,0,6,0,1012,0,0.99,0.0,0
PF02192,PF00792:PF02260:PF08771,10,44,10,0,34,974,0.23,0.97,1.0,0.47,11,2,8,9,999,0.18,0.98,0.2,0.18
PF15086,PF05128:PF06780:PF10662,3,2,1,2,1,1014,0.5,1.0,0.33,0.41,1,1,2,0,1015,1.0,1.0,0.33,0.58
PF10216,PF16836:PF03243:PF11027,0,5,0,0,5,1013,0.0,1.0,0,0,0,0,0,0,1018,0,1.0,0,0
PF14633,PF14878:PF09371:PF14641,13,14,13,0,1,1004,0.93,1.0,1.0,0.96,12,12,1,0,1005,1.0,1.0,0.92,0.96
PF05420,PF06406:PF12256:PF12255,0,0,0,0,0,1018,0,1.0,0,0,0,0,0,0,1018,0,1.0,0,0
PF03761,PF03703:PF15386:PF10542,4,2,1,3,1,1013,0.5,1.0,0.25,0.35,0,0,4,0,1014,0,1.0,0.0,0
PF12109,PF09193:PF10413:PF03827,2,4,1,1,3,1013,0.25,1.0,0.5,0.35,1,1,1,0,1016,1.0,1.0,0.5,0.71
PF08302,PF09511:PF08303:PF06165,4,12,4,0,8,1006,0.33,0.99,1.0,0.58,3,3,1,0,1014,1.0,1.0,0.75,0.87
PF15830,PF16888:PF07157:PF03428,0,0,0,0,0,1018,0,1.0,0,0,0,0,0,0,1018,0,1.0,0,0
PF15393,PF15478:PF01475:PF15460,6,6,1,5,5,1007,0.17,0.99,0.17,0.16,0,0,6,0,1012,0,0.99,0.0,0
PF08605,PF01834:PF05397:PF03120,1,20,0,1,20,997,0.0,0.98,0.0,-0.0,3,0,1,3,1014,0.0,1.0,0.0,-0.0
PF15964,PF16704:PF04108:PF15908,0,5,0,0,5,1013,0.0,1.0,0,0,1,0,0,1,1017,0.0,1.0,0,0
PF10534,PF06663:PF09246:PF00536,2,62,2,0,60,956,0.03,0.94,1.0,0.17,2,1,1,1,1015,0.5,1.0,0.5,0.5
PF01566,PF07984:PF02705:PF13911,20,26,5,15,21,977,0.19,0.96,0.25,0.2,7,4,16,3,995,0.57,0.98,0.2,0.33
PF10350,PF12612:PF07539:PF17034,11,22,4,7,18,989,0.18,0.98,0.36,0.25,6,2,9,4,1003,0.33,0.99,0.18,0.24
PF01288,PF00809:PF02152:PF02607,11,18,9,2,9,998,0.5,0.99,0.82,0.63,10,5,6,5,1002,0.5,0.99,0.45,0.47
PF16381,PF08752:PF14806:PF09066,5,19,5,0,14,999,0.26,0.99,1.0,0.51,5,2,3,3,1010,0.4,0.99,0.4,0.4
PF10529,PF14920:PF10488:PF14918,1,1,0,1,1,1016,0.0,1.0,0.0,-0.0,0,0,1,0,1017,0,1.0,0.0,0
PF03058,PF15823:PF04764:PF15150,0,0,0,0,0,1018,0,1.0,0,0,0,0,0,0,1018,0,1.0,0,0
PF03670,PF03488:PF06313:PF02827,5,2,0,5,2,1011,0.0,0.99,0.0,-0.0,0,0,5,0,1013,0,1.0,0.0,0
PF07776,PF05485:PF12017:PF15423,50,65,21,29,44,924,0.32,0.93,0.42,0.33,18,11,39,7,961,0.61,0.95,0.22,0.35
PF13313,PF13482:PF06651:PF02086,0,3,0,0,3,1015,0.0,1.0,0,0,0,0,0,0,1018,0,1.0,0,0
PF11146,PF16824:PF01970:PF04391,0,0,0,0,0,1018,0,1.0,0,0,0,0,0,0,1018,0,1.0,0,0
PF06209,PF10537:PF17105:PF17035,2,23,1,1,22,994,0.04,0.98,0.5,0.14,5,1,1,4,1012,0.2,1.0,0.5,0.31
PF16009,PF04839:PF00468:PF07939,1,6,0,1,6,1011,0.0,0.99,0.0,-0.0,2,0,1,2,1015,0.0,1.0,0.0,-0.0
PF06115,PF07270:PF09855:PF07413,0,0,0,0,0,1018,0,1.0,0,0,0,0,0,0,1018,0,1.0,0,0
PF12751,PF11510:PF15999:PF13824,1,11,0,1,11,1006,0.0,0.99,0.0,-0.0,2,0,1,2,1015,0.0,1.0,0.0,-0.0
PF09739,PF08303:PF08302:PF07159,11,8,0,11,8,999,0.0,0.98,0.0,-0.01,4,0,11,4,1003,0.0,0.99,0.0,-0.01
PF02893,PF16016:PF02141:PF06602,33,69,19,14,50,935,0.28,0.94,0.58,0.37,13,11,22,2,983,0.85,0.98,0.33,0.52
PF08225,PF08187:PF08348:PF17004,0,8,0,0,8,1010,0.0,0.99,0,0,0,0,0,0,1018,0,1.0,0,0
PF09134,PF13946:PF02572:PF08479,0,3,0,0,3,1015,0.0,1.0,0,0,0,0,0,0,1018,0,1.0,0,0
PF05325,PF09154:PF16657:PF13183,0,11,0,0,11,1007,0.0,0.99,0,0,1,0,0,1,1017,0.0,1.0,0,0
PF08332,PF12605:PF16579:PF14593,7,15,4,3,11,1000,0.27,0.99,0.57,0.38,4,3,4,1,1010,0.75,1.0,0.43,0.56
PF01683,PF14625:PF04942:PF00368,21,29,11,10,18,979,0.38,0.97,0.52,0.43,2,2,19,0,997,1.0,0.98,0.1,0.31
PF12617,PF12139:PF12800:PF02906,0,14,0,0,14,1004,0.0,0.99,0,0,1,0,0,1,1017,0.0,1.0,0,0
PF06394,PF06784:PF16860:PF06382,7,8,1,6,7,1004,0.12,0.99,0.14,0.13,1,1,6,0,1011,1.0,0.99,0.14,0.38
PF16579,PF08332:PF14593:PF11629,14,8,5,9,3,1001,0.62,0.99,0.36,0.47,3,3,11,0,1004,1.0,0.99,0.21,0.46
PF00121,PF02672:PF02800:PF00044,13,36,7,6,29,976,0.19,0.97,0.54,0.31,21,6,7,15,990,0.29,0.98,0.46,0.35
PF11468,PF07980:PF12897:PF08468,1,4,0,1,4,1013,0.0,1.0,0.0,-0.0,0,0,1,0,1017,0,1.0,0.0,0
PF07412,PF10276:PF07939:PF04949,5,12,2,3,10,1003,0.17,0.99,0.4,0.25,0,0,5,0,1013,0,1.0,0.0,0
PF09165,PF08802:PF02921:PF10399,4,16,4,0,12,1002,0.25,0.99,1.0,0.5,3,3,1,0,1014,1.0,1.0,0.75,0.87
PF00318,PF16122:PF04161:PF01866,25,34,13,12,21,972,0.38,0.97,0.52,0.43,5,4,21,1,992,0.8,0.98,0.16,0.35
PF14665,PF12129:PF10482:PF07001,0,10,0,0,10,1008,0.0,0.99,0,0,0,0,0,0,1018,0,1.0,0,0
PF06979,PF11927:PF04148:PF07859,4,78,3,1,75,939,0.04,0.93,0.75,0.16,8,2,2,6,1008,0.25,0.99,0.5,0.35
PF05157,PF03922:PF05466:PF03888,1,0,0,1,0,1017,0,1.0,0.0,0,0,0,1,0,1017,0,1.0,0.0,0
PF01845,PF03460:PF01077:PF11707,1,16,0,1,16,1001,0.0,0.98,0.0,-0.0,15,0,1,15,1002,0.0,0.98,0.0,-0.0
PF09197,PF08914:PF11626:PF06732,1,18,1,0,17,1000,0.06,0.98,1.0,0.23,8,1,0,7,1010,0.12,0.99,1.0,0.35
PF12462,PF00516:PF11862:PF06082,2,1,0,2,1,1015,0.0,1.0,0.0,-0.0,0,0,2,0,1016,0,1.0,0.0,0
PF01670,PF01083:PF03664:PF01099,6,18,3,3,15,997,0.17,0.98,0.5,0.28,5,2,4,3,1009,0.4,0.99,0.33,0.36
PF04757,PF06803:PF05495:PF13705,29,18,7,22,11,978,0.39,0.97,0.24,0.29,5,5,24,0,989,1.0,0.98,0.17,0.41
PF02372,PF15071:PF15370:PF00727,1,7,0,1,7,1010,0.0,0.99,0.0,-0.0,0,0,1,0,1017,0,1.0,0.0,0
PF16094,PF14829:PF07366:PF01709,6,17,3,3,14,998,0.18,0.98,0.5,0.29,1,0,6,1,1011,0.0,0.99,0.0,-0.0
PF00681,PF06202:PF14699:PF14702,7,4,1,6,3,1008,0.25,0.99,0.14,0.18,2,0,7,2,1009,0.0,0.99,0.0,-0.0
PF08308,PF17049:PF04451:PF03244,0,2,0,0,2,1016,0.0,1.0,0,0,0,0,0,0,1018,0,1.0,0,0
PF14612,PF04148:PF12223:PF03162,1,8,0,1,8,1009,0.0,0.99,0.0,-0.0,1,0,1,1,1016,0.0,1.0,0.0,-0.0
PF06745,PF13753:PF06890:PF17164,0,0,0,0,0,1018,0,1.0,0,0,0,0,0,0,1018,0,1.0,0,0
PF17098,PF15311:PF04090:PF02116,6,9,1,5,8,1004,0.11,0.99,0.17,0.13,1,0,6,1,1011,0.0,0.99,0.0,-0.0
PF08361,PF00813:PF07494:PF01136,1,2,0,1,2,1015,0.0,1.0,0.0,-0.0,0,0,1,0,1017,0,1.0,0.0,0
PF15792,PF14049:PF14047:PF15803,1,0,0,1,0,1017,0,1.0,0.0,0,0,0,1,0,1017,0,1.0,0.0,0
PF13691,PF12706:PF07522:PF08640,15,52,11,4,41,962,0.21,0.96,0.73,0.38,10,5,10,5,998,0.5,0.99,0.33,0.4
PF09384,PF14077:PF12265:PF08614,11,13,5,6,8,999,0.38,0.99,0.45,0.41,3,2,9,1,1006,0.67,0.99,0.18,0.34
PF06439,PF03422:PF04616:PF03442,1,41,1,0,40,977,0.02,0.96,1.0,0.15,11,1,0,10,1007,0.09,0.99,1.0,0.3
PF03717,PF00905:PF15710:PF00768,17,20,16,1,4,997,0.8,1.0,0.94,0.87,6,6,11,0,1001,1.0,0.99,0.35,0.59
PF14073,PF09073:PF05681:PF09772,3,11,0,3,11,1004,0.0,0.99,0.0,-0.01,0,0,3,0,1015,0,1.0,0.0,0
PF06680,PF01161:PF13472:PF00494,0,79,0,0,79,939,0.0,0.92,0,0,17,0,0,17,1001,0.0,0.98,0,0
PF11581,PF13367:PF06695:PF11341,0,5,0,0,5,1013,0.0,1.0,0,0,0,0,0,0,1018,0,1.0,0,0
PF09258,PF03016:PF06427:PF01501,13,62,11,2,51,954,0.18,0.95,0.85,0.37,18,7,6,11,994,0.39,0.98,0.54,0.45
PF12675,PF05001:PF04997:PF00180,0,57,0,0,57,961,0.0,0.94,0,0,11,0,0,11,1007,0.0,0.99,0,0
PF13404,PF03406:PF13007:PF01136,6,1,0,6,1,1011,0.0,0.99,0.0,-0.0,0,0,6,0,1012,0,0.99,0.0,0
PF15834,PF08411:PF00419:PF06890,0,2,0,0,2,1016,0.0,1.0,0,0,0,0,0,0,1018,0,1.0,0,0
PF07762,PF04859:PF06830:PF04833,18,5,2,16,3,997,0.4,0.98,0.11,0.2,0,0,18,0,1000,0,0.98,0.0,0
PF08284,PF00077:PF03732:PF12384,23,62,17,6,45,950,0.27,0.95,0.74,0.43,9,4,19,5,990,0.44,0.98,0.17,0.27
PF12584,PF12742:PF14649:PF11028,11,7,1,10,6,1001,0.14,0.98,0.09,0.11,1,0,11,1,1006,0.0,0.99,0.0,-0.0
PF05981,PF06070:PF11124:PF15312,4,1,0,4,1,1013,0.0,1.0,0.0,-0.0,0,0,4,0,1014,0,1.0,0.0,0
PF11498,PF04501:PF02561:PF07045,6,2,0,6,2,1010,0.0,0.99,0.0,-0.0,0,0,6,0,1012,0,0.99,0.0,0
PF05685,PF11291:PF13495:PF15233,1,4,0,1,4,1013,0.0,1.0,0.0,-0.0,1,0,1,1,1016,0.0,1.0,0.0,-0.0
PF11678,PF00514:PF14535:PF03673,0,63,0,0,63,955,0.0,0.94,0,0,2,0,0,2,1016,0.0,1.0,0,0
PF04168,PF02281:PF15196:PF03639,0,12,0,0,12,1006,0.0,0.99,0,0,0,0,0,0,1018,0,1.0,0,0
PF06356,PF06724:PF05939:PF14841,0,1,0,0,1,1017,0.0,1.0,0,0,0,0,0,0,1018,0,1.0,0,0
PF10501,PF13664:PF09769:PF02698,2,14,1,1,13,1003,0.07,0.99,0.5,0.19,3,0,2,3,1013,0.0,1.0,0.0,-0.0
PF15162,PF10994:PF16590:PF15134,0,2,0,0,2,1016,0.0,1.0,0,0,0,0,0,0,1018,0,1.0,0,0
PF04435,PF15362:PF12278:PF11052,7,2,0,7,2,1009,0.0,0.99,0.0,-0.0,0,0,7,0,1011,0,0.99,0.0,0
PF05849,PF04451:PF09826:PF04355,0,3,0,0,3,1015,0.0,1.0,0,0,0,0,0,0,1018,0,1.0,0,0
PF08146,PF13001:PF12397:PF11916,10,24,9,1,15,993,0.38,0.98,0.9,0.58,4,3,7,1,1007,0.75,0.99,0.3,0.47
PF14145,PF11035:PF05111:PF15060,0,3,0,0,3,1015,0.0,1.0,0,0,0,0,0,0,1018,0,1.0,0,0
PF06413,PF15247:PF10180:PF15264,7,18,3,4,15,996,0.17,0.98,0.43,0.26,1,0,7,1,1010,0.0,0.99,0.0,-0.0
PF16559,PF08518:PF12205:PF01412,2,50,2,0,48,968,0.04,0.95,1.0,0.2,5,2,0,3,1013,0.4,1.0,1.0,0.63
PF00328,PF00201:PF08443:PF03478,49,78,25,24,53,916,0.32,0.92,0.51,0.37,20,14,35,6,963,0.7,0.96,0.29,0.43
PF07458,PF15120:PF07259:PF15829,0,2,0,0,2,1016,0.0,1.0,0,0,1,0,0,1,1017,0.0,1.0,0,0
PF08964,PF03710:PF10856:PF03775,0,3,0,0,3,1015,0.0,1.0,0,0,0,0,0,0,1018,0,1.0,0,0
PF11811,PF08482:PF03923:PF08658,0,11,0,0,11,1007,0.0,0.99,0,0,4,0,0,4,1014,0.0,1.0,0,0
PF10453,PF09816:PF08634:PF03467,7,15,1,6,14,997,0.07,0.98,0.14,0.09,3,1,6,2,1009,0.33,0.99,0.14,0.21
PF01019,PF03091:PF07969:PF10165,36,31,10,26,21,961,0.32,0.95,0.28,0.28,6,5,31,1,981,0.83,0.97,0.14,0.33
PF07000,PF14033:PF07096:PF02284,11,26,4,7,22,985,0.15,0.97,0.36,0.22,3,1,10,2,1005,0.33,0.99,0.09,0.17
PF00730,PF00633:PF13002:PF15264,30,11,7,23,4,984,0.64,0.97,0.23,0.38,1,1,29,0,988,1.0,0.97,0.03,0.18
PF15435,PF05869:PF10917:PF03539,0,5,0,0,5,1013,0.0,1.0,0,0,0,0,0,0,1018,0,1.0,0,0
PF04545,PF04539:PF08281:PF00140,22,19,15,7,4,992,0.79,0.99,0.68,0.73,5,5,17,0,996,1.0,0.98,0.23,0.47
PF06312,PF05679:PF06237:PF03074,3,20,3,0,17,998,0.15,0.98,1.0,0.38,2,0,3,2,1013,0.0,1.0,0.0,-0.0
PF14691,PF04898:PF00310:PF01493,10,12,5,5,7,1001,0.42,0.99,0.5,0.45,7,5,5,2,1006,0.71,0.99,0.5,0.59
PF04964,PF11741:PF12571:PF09134,0,0,0,0,0,1018,0,1.0,0,0,0,0,0,0,1018,0,1.0,0,0
PF07947,PF04241:PF00210:PF00143,5,24,2,3,22,991,0.08,0.98,0.4,0.17,2,1,4,1,1012,0.5,1.0,0.2,0.31
PF03459,PF03412:PF00950:PF02694,3,5,2,1,3,1012,0.4,1.0,0.67,0.51,3,2,1,1,1014,0.67,1.0,0.67,0.67
PF02075,PF02773:PF10785:PF14767,3,7,3,0,4,1011,0.43,1.0,1.0,0.65,1,1,2,0,1015,1.0,1.0,0.33,0.58
PF07688,PF10318:PF00241:PF10319,0,36,0,0,36,982,0.0,0.96,0,0,5,0,0,5,1013,0.0,1.0,0,0
PF01186,PF00530:PF02449:PF03523,5,49,4,1,45,968,0.08,0.95,0.8,0.25,2,1,4,1,1012,0.5,1.0,0.2,0.31
PF14969,PF15062:PF13270:PF03692,3,4,1,2,3,1012,0.25,1.0,0.33,0.29,0,0,3,0,1015,0,1.0,0.0,0
PF10056,PF15082:PF15309:PF09441,2,7,1,1,6,1010,0.14,0.99,0.5,0.26,0,0,2,0,1016,0,1.0,0.0,0
PF02575,PF05419:PF11909:PF10454,6,1,0,6,1,1011,0.0,0.99,0.0,-0.0,0,0,6,0,1012,0,0.99,0.0,0
PF07418,PF07333:PF15370:PF00321,0,4,0,0,4,1014,0.0,1.0,0,0,0,0,0,0,1018,0,1.0,0,0
PF14107,PF11291:PF00524:PF16872,0,4,0,0,4,1014,0.0,1.0,0,0,0,0,0,0,1018,0,1.0,0,0
PF03107,PF13905:PF11835:PF14299,15,24,10,5,14,989,0.42,0.98,0.67,0.52,4,4,11,0,1003,1.0,0.99,0.27,0.51
PF01398,PF13012:PF10596:PF12134,46,38,31,15,7,965,0.82,0.98,0.67,0.73,17,12,34,5,967,0.71,0.96,0.26,0.41
PF08920,PF05672:PF14738:PF12329,10,18,2,8,16,992,0.11,0.98,0.2,0.14,2,0,10,2,1006,0.0,0.99,0.0,-0.0
PF02349,PF00261:PF14802:PF13851,0,10,0,0,10,1008,0.0,0.99,0,0,0,0,0,0,1018,0,1.0,0,0
PF00414,PF17007:PF05787:PF15168,0,3,0,0,3,1015,0.0,1.0,0,0,0,0,0,0,1018,0,1.0,0,0
PF15505,PF15119:PF00770:PF14866,1,2,0,1,2,1015,0.0,1.0,0.0,-0.0,0,0,1,0,1017,0,1.0,0.0,0
PF15453,PF10375:PF10490:PF13096,0,5,0,0,5,1013,0.0,1.0,0,0,0,0,0,0,1018,0,1.0,0,0
PF11109,PF05857:PF07149:PF02951,1,4,0,1,4,1013,0.0,1.0,0.0,-0.0,0,0,1,0,1017,0,1.0,0.0,0
PF16212,PF16209:PF12424:PF12409,44,54,39,5,15,959,0.72,0.98,0.89,0.79,8,7,37,1,973,0.88,0.96,0.16,0.36
PF14378,PF08643:PF10483:PF03095,5,16,1,4,15,998,0.06,0.98,0.2,0.1,2,0,5,2,1011,0.0,0.99,0.0,-0.0
PF04589,PF12031:PF12145:PF14638,1,17,1,0,16,1001,0.06,0.98,1.0,0.24,2,1,0,1,1016,0.5,1.0,1.0,0.71
PF12463,PF08568:PF04704:PF03385,2,8,0,2,8,1008,0.0,0.99,0.0,-0.0,0,0,2,0,1016,0,1.0,0.0,0
PF07301,PF05979:PF04352:PF05229,0,0,0,0,0,1018,0,1.0,0,0,0,0,0,0,1018,0,1.0,0,0
PF01074,PF09261:PF07748:PF12780,24,54,23,1,31,963,0.43,0.97,0.96,0.63,19,19,5,0,994,1.0,1.0,0.79,0.89
PF01443,PF00978:PF14307:PF12381,7,7,5,2,2,1009,0.71,1.0,0.71,0.71,2,2,5,0,1011,1.0,1.0,0.29,0.53
PF08288,PF15924:PF12038:PF13579,11,9,1,10,8,999,0.11,0.98,0.09,0.09,0,0,11,0,1007,0,0.99,0.0,0
PF15867,PF13877:PF05279:PF16546,5,18,4,1,14,999,0.22,0.99,0.8,0.42,1,1,4,0,1013,1.0,1.0,0.2,0.45
PF06444,PF01059:PF04241:PF00507,1,16,1,0,15,1002,0.06,0.99,1.0,0.25,1,0,1,1,1016,0.0,1.0,0.0,-0.0
PF05229,PF03241:PF11751:PF14842,0,0,0,0,0,1018,0,1.0,0,0,0,0,0,0,1018,0,1.0,0,0
PF09020,PF08843:PF05399:PF03243,0,3,0,0,3,1015,0.0,1.0,0,0,0,0,0,0,1018,0,1.0,0,0
PF15309,PF15392:PF09441:PF04357,3,1,0,3,1,1014,0.0,1.0,0.0,-0.0,0,0,3,0,1015,0,1.0,0.0,0
PF03297,PF00876:PF12223:PF06708,7,27,3,4,24,987,0.11,0.97,0.43,0.21,0,0,7,0,1011,0,0.99,0.0,0
PF02542,PF07080:PF11909:PF08883,3,14,1,2,13,1002,0.07,0.99,0.33,0.15,1,1,2,0,1015,1.0,1.0,0.33,0.58
PF01423,PF05907:PF07426:PF05180,69,18,13,56,5,944,0.72,0.94,0.19,0.35,4,4,65,0,949,1.0,0.94,0.06,0.23
PF03623,PF06760:PF09027:PF02019,3,4,1,2,3,1012,0.25,1.0,0.33,0.29,3,1,2,2,1013,0.33,1.0,0.33,0.33
PF09531,PF07574:PF16680:PF09748,12,25,4,8,21,985,0.16,0.97,0.33,0.22,5,3,9,2,1004,0.6,0.99,0.25,0.38
PF02569,PF09774:PF07080:PF05755,11,13,3,8,10,997,0.23,0.98,0.27,0.24,0,0,11,0,1007,0,0.99,0.0,0
PF15696,PF10295:PF15774:PF15337,0,5,0,0,5,1013,0.0,1.0,0,0,1,0,0,1,1017,0.0,1.0,0,0
PF06524,PF04643:PF15165:PF01387,3,2,1,2,1,1014,0.5,1.0,0.33,0.41,0,0,3,0,1015,0,1.0,0.0,0
PF02180,PF02731:PF07803:PF11303,2,9,0,2,9,1007,0.0,0.99,0.0,-0.0,0,0,2,0,1016,0,1.0,0.0,0
PF04087,PF05334:PF08634:PF15279,0,3,0,0,3,1015,0.0,1.0,0,0,0,0,0,0,1018,0,1.0,0,0
PF00159,PF00446:PF01279:PF10780,2,4,1,1,3,1013,0.25,1.0,0.5,0.35,1,1,1,0,1016,1.0,1.0,0.5,0.71
PF11834,PF08412:PF11601:PF16526,14,13,5,9,8,996,0.38,0.98,0.36,0.36,2,2,12,0,1004,1.0,0.99,0.14,0.38
PF08922,PF09074:PF11272:PF14903,1,0,0,1,0,1017,0,1.0,0.0,0,0,0,1,0,1017,0,1.0,0.0,0
PF03915,PF12126:PF15246:PF00643,6,55,4,2,51,961,0.07,0.95,0.67,0.21,5,3,3,2,1010,0.6,1.0,0.5,0.55
PF00890,PF02910:PF02424:PF12831,48,24,21,27,3,967,0.88,0.97,0.44,0.61,3,3,45,0,970,1.0,0.96,0.06,0.24
PF02729,PF00185:PF01808:PF00988,20,37,20,0,17,981,0.54,0.98,1.0,0.73,13,13,7,0,998,1.0,0.99,0.65,0.8
PF10531,PF01512:PF10589:PF03074,13,16,7,6,9,996,0.44,0.99,0.54,0.48,7,5,8,2,1003,0.71,0.99,0.38,0.52
PF05461,PF12605:PF08332:PF03822,15,11,5,10,6,997,0.45,0.98,0.33,0.38,2,2,13,0,1003,1.0,0.99,0.13,0.36
PF09468,PF07106:PF05676:PF14774,9,15,4,5,11,998,0.27,0.98,0.44,0.34,3,2,7,1,1008,0.67,0.99,0.22,0.38
PF00206,PF10397:PF10415:PF14698,44,33,33,11,0,974,1.0,0.99,0.75,0.86,7,7,37,0,974,1.0,0.96,0.16,0.39
PF00958,PF00977:PF00697:PF00425,17,34,6,11,28,973,0.18,0.96,0.35,0.23,4,2,15,2,999,0.5,0.98,0.12,0.24
PF11254,PF02863:PF14871:PF11876,1,3,0,1,3,1014,0.0,1.0,0.0,-0.0,0,0,1,0,1017,0,1.0,0.0,0
PF03932,PF06172:PF15008:PF12020,21,0,0,21,0,997,0,0.98,0.0,0,0,0,21,0,997,0,0.98,0.0,0
PF05499,PF05129:PF16858:PF08649,6,16,2,4,14,998,0.12,0.98,0.33,0.2,1,0,6,1,1011,0.0,0.99,0.0,-0.0
PF16203,PF13625:PF04313:PF09111,15,22,11,4,11,992,0.5,0.99,0.73,0.6,4,4,11,0,1003,1.0,0.99,0.27,0.51
PF07576,PF13436:PF13441:PF06547,10,3,2,8,1,1007,0.67,0.99,0.2,0.36,2,2,8,0,1008,1.0,0.99,0.2,0.45
PF14982,PF15207:PF05962:PF08453,0,4,0,0,4,1014,0.0,1.0,0,0,0,0,0,0,1018,0,1.0,0,0
PF16649,PF15211:PF15972:PF11630,1,0,0,1,0,1017,0,1.0,0.0,0,0,0,1,0,1017,0,1.0,0.0,0
PF10415,PF08328:PF14698:PF10397,19,22,6,13,16,983,0.27,0.97,0.32,0.28,3,2,17,1,998,0.67,0.98,0.11,0.26
PF15252,PF01415:PF01387:PF15551,0,2,0,0,2,1016,0.0,1.0,0,0,0,0,0,0,1018,0,1.0,0,0
PF14376,PF12080:PF11794:PF03090,3,0,0,3,0,1015,0,1.0,0.0,0,0,0,3,0,1015,0,1.0,0.0,0
PF05439,PF15925:PF08592:PF13095,6,8,2,4,6,1006,0.25,0.99,0.33,0.28,1,1,5,0,1012,1.0,1.0,0.17,0.41
PF15376,PF12509:PF14444:PF15273,1,7,1,0,6,1011,0.14,0.99,1.0,0.38,1,0,1,1,1016,0.0,1.0,0.0,-0.0
PF12595,PF04114:PF10427:PF14923,5,19,4,1,15,998,0.21,0.98,0.8,0.41,1,0,5,1,1012,0.0,0.99,0.0,-0.0
PF11957,PF09034:PF01335:PF00531,5,41,3,2,38,975,0.07,0.96,0.6,0.2,12,3,2,9,1004,0.25,0.99,0.6,0.38
PF12724,PF15555:PF05418:PF03379,0,3,0,0,3,1015,0.0,1.0,0,0,0,0,0,0,1018,0,1.0,0,0
PF13684,PF14052:PF13657:PF04196,1,5,0,1,5,1012,0.0,0.99,0.0,-0.0,0,0,1,0,1017,0,1.0,0.0,0
PF04848,PF00669:PF11124:PF09461,3,1,0,3,1,1014,0.0,1.0,0.0,-0.0,0,0,3,0,1015,0,1.0,0.0,0
PF02425,PF17078:PF15553:PF05874,0,2,0,0,2,1016,0.0,1.0,0,0,0,0,0,0,1018,0,1.0,0,0
PF01193,PF01066:PF03118:PF13344,16,49,12,4,37,965,0.24,0.96,0.75,0.41,17,7,9,10,992,0.41,0.98,0.44,0.41
PF02343,PF10322:PF03436:PF15362,2,2,1,1,1,1015,0.5,1.0,0.5,0.5,0,0,2,0,1016,0,1.0,0.0,0
PF16312,PF12772:PF12567:PF12453,1,2,1,0,1,1016,0.5,1.0,1.0,0.71,2,1,0,1,1016,0.5,1.0,1.0,0.71
PF11698,PF10155:PF09822:PF14764,10,14,0,10,14,994,0.0,0.98,0.0,-0.01,2,0,10,2,1006,0.0,0.99,0.0,-0.0
PF11780,PF16510:PF04352:PF01752,0,2,0,0,2,1016,0.0,1.0,0,0,0,0,0,0,1018,0,1.0,0,0
PF06651,PF03745:PF15482:PF08708,0,0,0,0,0,1018,0,1.0,0,0,0,0,0,0,1018,0,1.0,0,0
PF15301,PF03285:PF12180:PF04921,4,12,1,3,11,1003,0.08,0.99,0.25,0.14,0,0,4,0,1014,0,1.0,0.0,0
PF04997,PF04983:PF04992:PF00623,29,32,29,0,3,986,0.91,1.0,1.0,0.95,29,29,0,0,989,1.0,1.0,1.0,1.0
PF00357,PF00882:PF01788:PF08441,2,17,2,0,15,1001,0.12,0.99,1.0,0.34,0,0,2,0,1016,0,1.0,0.0,0
PF09325,PF12828:PF12825:PF03700,19,7,4,15,3,996,0.57,0.98,0.21,0.34,4,2,17,2,997,0.5,0.98,0.11,0.22
PF08498,PF12589:PF13532:PF05050,11,57,7,4,50,957,0.12,0.95,0.64,0.26,8,3,8,5,1002,0.38,0.99,0.27,0.31
PF00484,PF04178:PF06244:PF00504,19,33,8,11,25,974,0.24,0.96,0.42,0.3,5,4,15,1,998,0.8,0.98,0.21,0.41
PF05690,PF02589:PF11870:PF02901,6,11,3,3,8,1004,0.27,0.99,0.5,0.36,2,1,5,1,1011,0.5,0.99,0.17,0.29
PF03647,PF00301:PF02234:PF04367,13,12,1,12,11,994,0.08,0.98,0.08,0.07,0,0,13,0,1005,0,0.99,0.0,0
PF05989,PF05357:PF04301:PF09200,0,0,0,0,0,1018,0,1.0,0,0,0,0,0,0,1018,0,1.0,0,0
PF11282,PF11623:PF16007:PF08034,2,1,0,2,1,1015,0.0,1.0,0.0,-0.0,0,0,2,0,1016,0,1.0,0.0,0
PF00602,PF06122:PF00524:PF05138,1,4,0,1,4,1013,0.0,1.0,0.0,-0.0,0,0,1,0,1017,0,1.0,0.0,0
PF12498,PF03957:PF02173:PF08601,2,9,2,0,7,1009,0.22,0.99,1.0,0.47,2,2,0,0,1016,1.0,1.0,1.0,1.0
PF11642,PF15685:PF01254:PF08964,0,1,0,0,1,1017,0.0,1.0,0,0,0,0,0,0,1018,0,1.0,0,0
PF11316,PF08707:PF09677:PF12477,0,1,0,0,1,1017,0.0,1.0,0,0,0,0,0,0,1018,0,1.0,0,0
PF05832,PF04667:PF00115:PF00499,10,22,2,8,20,988,0.09,0.97,0.2,0.12,2,0,10,2,1006,0.0,0.99,0.0,-0.0
PF14847,PF16533:PF09246:PF12202,6,13,4,2,9,1003,0.31,0.99,0.67,0.45,1,1,5,0,1012,1.0,1.0,0.17,0.41
PF14532,PF08630:PF05496:PF13810,3,14,1,2,13,1002,0.07,0.99,0.33,0.15,0,0,3,0,1015,0,1.0,0.0,0
PF09917,PF12628:PF03525:PF02557,0,2,0,0,2,1016,0.0,1.0,0,0,0,0,0,0,1018,0,1.0,0,0
PF02503,PF13090:PF03090:PF05939,2,2,2,0,0,1016,1.0,1.0,1.0,1.0,0,0,2,0,1016,0,1.0,0.0,0
PF13681,PF08950:PF15848:PF07192,0,0,0,0,0,1018,0,1.0,0,0,0,0,0,0,1018,0,1.0,0,0
PF13300,PF00930:PF02897:PF11379,10,24,5,5,19,989,0.21,0.98,0.5,0.31,4,2,8,2,1006,0.5,0.99,0.2,0.31
PF07589,PF09722:PF02217:PF08291,0,3,0,0,3,1015,0.0,1.0,0,0,0,0,0,0,1018,0,1.0,0,0
PF11387,PF05621:PF00555:PF09074,0,2,0,0,2,1016,0.0,1.0,0,0,0,0,0,0,1018,0,1.0,0,0
PF04644,PF04643:PF01296:PF00220,1,4,1,0,3,1014,0.25,1.0,1.0,0.5,1,1,0,0,1017,1.0,1.0,1.0,1.0
PF01608,PF08913:PF09141:PF16511,22,17,9,13,8,988,0.53,0.98,0.41,0.46,10,8,14,2,994,0.8,0.98,0.36,0.53
PF00665,PF05585:PF05380:PF03732,113,77,52,61,25,880,0.68,0.92,0.46,0.51,22,21,92,1,904,0.95,0.91,0.19,0.4
PF15863,PF03907:PF06485:PF14877,1,9,1,0,8,1009,0.11,0.99,1.0,0.33,0,0,1,0,1017,0,1.0,0.0,0
PF03724,PF09149:PF15064:PF15302,0,5,0,0,5,1013,0.0,1.0,0,0,0,0,0,0,1018,0,1.0,0,0
PF04707,PF03765:PF13897:PF00650,13,69,11,2,58,947,0.16,0.94,0.85,0.35,26,7,6,19,986,0.27,0.98,0.54,0.37
PF05454,PF10383:PF06662:PF08161,2,11,1,1,10,1006,0.09,0.99,0.5,0.21,2,0,2,2,1014,0.0,1.0,0.0,-0.0
PF13287,PF12773:PF15898:PF16553,5,5,2,3,3,1010,0.4,0.99,0.4,0.4,1,1,4,0,1013,1.0,1.0,0.2,0.45
PF03038,PF17083:PF03405:PF07226,0,3,0,0,3,1015,0.0,1.0,0,0,0,0,0,0,1018,0,1.0,0,0
PF08208,PF13094:PF13013:PF15553,5,2,0,5,2,1011,0.0,0.99,0.0,-0.0,0,0,5,0,1013,0,1.0,0.0,0
PF03764,PF14492:PF00679:PF16004,23,59,23,0,36,959,0.39,0.96,1.0,0.61,30,23,0,7,988,0.77,0.99,1.0,0.87
PF13995,PF10279:PF05857:PF06798,0,0,0,0,0,1018,0,1.0,0,0,0,0,0,0,1018,0,1.0,0,0
PF03327,PF13619:PF15501:PF05999,1,2,0,1,2,1015,0.0,1.0,0.0,-0.0,0,0,1,0,1017,0,1.0,0.0,0
PF13304,PF12399:PF13732:PF08352,5,13,3,2,10,1003,0.23,0.99,0.6,0.37,3,2,3,1,1012,0.67,1.0,0.4,0.51
PF13364,PF13363:PF10435:PF01301,10,31,10,0,21,987,0.32,0.98,1.0,0.56,5,5,5,0,1008,1.0,1.0,0.5,0.71
PF03782,PF00094:PF10162:PF09175,12,42,11,1,31,975,0.26,0.97,0.92,0.48,5,4,8,1,1005,0.8,0.99,0.33,0.51
PF13783,PF00827:PF08449:PF08069,0,42,0,0,42,976,0.0,0.96,0,0,9,0,0,9,1009,0.0,0.99,0,0
PF15552,PF15180:PF08208:PF14216,1,9,1,0,8,1009,0.11,0.99,1.0,0.33,0,0,1,0,1017,0,1.0,0.0,0
PF14618,PF17124:PF09232:PF15055,0,0,0,0,0,1018,0,1.0,0,0,0,0,0,0,1018,0,1.0,0,0
PF01472,PF01509:PF16198:PF08068,16,19,7,9,12,990,0.37,0.98,0.44,0.39,10,6,10,4,998,0.6,0.99,0.38,0.47
PF11032,PF15109:PF15158:PF02448,3,0,0,3,0,1015,0,1.0,0.0,0,0,0,3,0,1015,0,1.0,0.0,0
PF05872,PF15442:PF05024:PF14050,0,9,0,0,9,1009,0.0,0.99,0,0,2,0,0,2,1016,0.0,1.0,0,0
PF08166,PF08167:PF11597:PF06333,3,12,3,0,9,1006,0.25,0.99,1.0,0.5,5,1,2,4,1011,0.2,0.99,0.33,0.26
PF12925,PF02177:PF10515:PF03494,8,10,8,0,2,1008,0.8,1.0,1.0,0.89,8,8,0,0,1010,1.0,1.0,1.0,1.0
PF12403,PF12360:PF04813:PF16557,1,4,1,0,3,1014,0.25,1.0,1.0,0.5,1,1,0,0,1017,1.0,1.0,1.0,1.0
PF01907,PF01922:PF01176:PF05676,9,24,6,3,18,991,0.25,0.98,0.67,0.4,3,2,7,1,1008,0.67,0.99,0.22,0.38
PF09673,PF03238:PF09074:PF06681,0,0,0,0,0,1018,0,1.0,0,0,0,0,0,0,1018,0,1.0,0,0
PF17215,PF17216:PF13638:PF07504,6,19,6,0,13,999,0.32,0.99,1.0,0.56,6,5,1,1,1011,0.83,1.0,0.83,0.83
PF00675,PF05193:PF16187:PF08367,57,58,51,6,7,954,0.88,0.99,0.89,0.88,25,21,36,4,957,0.84,0.96,0.37,0.54
PF14291,PF05699:PF14372:PF12017,26,80,17,9,63,929,0.21,0.93,0.65,0.35,21,12,14,9,983,0.57,0.98,0.46,0.5
PF07938,PF12118:PF06339:PF11720,4,7,0,4,7,1007,0.0,0.99,0.0,-0.01,0,0,4,0,1014,0,1.0,0.0,0
PF03818,PF00622:PF00829:PF00271,0,252,0,0,252,766,0.0,0.75,0,0,50,0,0,50,968,0.0,0.95,0,0
PF03028,PF12777:PF12780:PF08393,38,44,37,1,7,973,0.84,0.99,0.97,0.9,38,36,2,2,978,0.95,1.0,0.95,0.95
PF05754,PF02972:PF08591:PF03238,0,0,0,0,0,1018,0,1.0,0,0,0,0,0,0,1018,0,1.0,0,0
PF04073,PF08907:PF02403:PF01927,13,29,8,5,21,984,0.28,0.97,0.62,0.4,3,3,10,0,1005,1.0,0.99,0.23,0.48
PF01420,PF11751:PF16861:PF13588,2,5,2,0,3,1013,0.4,1.0,1.0,0.63,0,0,2,0,1016,0,1.0,0.0,0
PF07520,PF10139:PF10908:PF11245,0,0,0,0,0,1018,0,1.0,0,0,0,0,0,0,1018,0,1.0,0,0
PF01480,PF16131:PF10378:PF15815,24,19,9,15,10,984,0.47,0.98,0.38,0.41,3,3,21,0,994,1.0,0.98,0.12,0.35
PF00468,PF04839:PF13225:PF16009,5,5,2,3,3,1010,0.4,0.99,0.4,0.4,0,0,5,0,1013,0,1.0,0.0,0
PF08827,PF05437:PF07277:PF04672,0,0,0,0,0,1018,0,1.0,0,0,0,0,0,0,1018,0,1.0,0,0
PF13542,PF00669:PF17164:PF04392,0,3,0,0,3,1015,0.0,1.0,0,0,0,0,0,0,1018,0,1.0,0,0
PF04719,PF08692:PF08508:PF11016,12,2,0,12,2,1004,0.0,0.99,0.0,-0.0,0,0,12,0,1006,0,0.99,0.0,0
PF12066,PF08729:PF15778:PF11261,16,12,6,10,6,996,0.5,0.98,0.38,0.43,1,1,15,0,1002,1.0,0.99,0.06,0.25
PF10262,PF00159:PF01987:PF08695,8,11,1,7,10,1000,0.09,0.98,0.12,0.1,1,0,8,1,1009,0.0,0.99,0.0,-0.0
PF01505,PF11978:PF02762:PF02761,2,7,2,0,5,1011,0.29,1.0,1.0,0.53,5,2,0,3,1013,0.4,1.0,1.0,0.63
PF17095,PF08683:PF15246:PF10377,6,11,6,0,5,1007,0.55,1.0,1.0,0.74,2,1,5,1,1011,0.5,0.99,0.17,0.29
PF01865,PF09738:PF08250:PF05523,0,1,0,0,1,1017,0.0,1.0,0,0,0,0,0,0,1018,0,1.0,0,0
PF10193,PF16018:PF08161:PF05041,15,12,2,13,10,993,0.17,0.98,0.13,0.14,2,0,15,2,1001,0.0,0.98,0.0,-0.01
PF11346,PF03238:PF04222:PF17206,1,1,0,1,1,1016,0.0,1.0,0.0,-0.0,0,0,1,0,1017,0,1.0,0.0,0
PF11878,PF14429:PF06920:PF16172,8,20,7,1,13,997,0.35,0.99,0.88,0.55,6,5,3,1,1009,0.83,1.0,0.62,0.72
PF05997,PF05030:PF15619:PF09429,10,18,2,8,16,992,0.11,0.98,0.2,0.14,1,0,10,1,1007,0.0,0.99,0.0,-0.0
PF08170,PF06978:PF09797:PF12733,6,13,6,0,7,1005,0.46,0.99,1.0,0.68,4,3,3,1,1011,0.75,1.0,0.5,0.61
PF07434,PF15976:PF16967:PF11874,0,0,0,0,0,1018,0,1.0,0,0,0,0,0,0,1018,0,1.0,0,0
PF06114,PF08805:PF10279:PF04917,3,1,1,2,0,1015,1.0,1.0,0.33,0.58,1,1,2,0,1015,1.0,1.0,0.33,0.58
PF14475,PF08528:PF10332:PF10361,0,5,0,0,5,1013,0.0,1.0,0,0,0,0,0,0,1018,0,1.0,0,0
PF12554,PF03760:PF04852:PF13805,5,14,1,4,13,1000,0.07,0.98,0.2,0.11,1,0,5,1,1012,0.0,0.99,0.0,-0.0
PF13502,PF08345:PF12241:PF13722,1,2,0,1,2,1015,0.0,1.0,0.0,-0.0,0,0,1,0,1017,0,1.0,0.0,0
PF11764,PF11616:PF15811:PF05965,7,24,4,3,20,991,0.17,0.98,0.57,0.3,3,2,5,1,1010,0.67,0.99,0.29,0.43
PF08250,PF10322:PF05181:PF01865,0,8,0,0,8,1010,0.0,0.99,0,0,0,0,0,0,1018,0,1.0,0,0
PF03264,PF02217:PF13753:PF13742,0,5,0,0,5,1013,0.0,1.0,0,0,0,0,0,0,1018,0,1.0,0,0
PF02209,PF16182:PF04810:PF06165,13,30,5,8,25,980,0.17,0.97,0.38,0.24,4,3,10,1,1004,0.75,0.99,0.23,0.41
PF00224,PF02887:PF02727:PF01179,39,44,28,11,16,963,0.64,0.97,0.72,0.66,20,12,27,8,971,0.6,0.97,0.31,0.41
PF04768,PF00696:PF13840:PF01118,10,50,7,3,43,965,0.14,0.95,0.7,0.3,13,6,4,7,1001,0.46,0.99,0.6,0.52
PF16282,PF14958:PF07572:PF06239,7,12,4,3,8,1003,0.33,0.99,0.57,0.43,0,0,7,0,1011,0,0.99,0.0,0
PF08124,PF02278:PF02884:PF04425,2,2,2,0,0,1016,1.0,1.0,1.0,1.0,1,1,1,0,1016,1.0,1.0,0.5,0.71
PF15765,PF15856:PF17049:PF06681,0,2,0,0,2,1016,0.0,1.0,0,0,0,0,0,0,1018,0,1.0,0,0
PF02156,PF16990:PF02013:PF01341,7,15,7,0,8,1003,0.47,0.99,1.0,0.68,4,4,3,0,1011,1.0,1.0,0.57,0.75
PF09699,PF15834:PF15049:PF00841,0,1,0,0,1,1017,0.0,1.0,0,0,0,0,0,0,1018,0,1.0,0,0
PF15220,PF11044:PF07392:PF05611,0,0,0,0,0,1018,0,1.0,0,0,0,0,0,0,1018,0,1.0,0,0
PF02124,PF10570:PF09291:PF02439,0,3,0,0,3,1015,0.0,1.0,0,0,0,0,0,0,1018,0,1.0,0,0
PF14344,PF07505:PF04671:PF05939,0,1,0,0,1,1017,0.0,1.0,0,0,0,0,0,0,1018,0,1.0,0,0
PF06546,PF00447:PF02954:PF03310,4,33,4,0,29,985,0.12,0.97,1.0,0.34,6,4,0,2,1012,0.67,1.0,1.0,0.82
PF07771,PF15370:PF15071:PF00214,0,4,0,0,4,1014,0.0,1.0,0,0,0,0,0,0,1018,0,1.0,0,0
PF15250,PF15803:PF15805:PF07260,1,1,0,1,1,1016,0.0,1.0,0.0,-0.0,0,0,1,0,1017,0,1.0,0.0,0
PF03374,PF04451:PF02413:PF09669,1,2,1,0,1,1016,0.5,1.0,1.0,0.71,0,0,1,0,1017,0,1.0,0.0,0
PF08097,PF17086:PF17023:PF04293,0,0,0,0,0,1018,0,1.0,0,0,0,0,0,0,1018,0,1.0,0,0
PF12482,PF06357:PF06403:PF11245,1,2,0,1,2,1015,0.0,1.0,0.0,-0.0,0,0,1,0,1017,0,1.0,0.0,0
PF07703,PF00207:PF01835:PF07677,13,20,13,0,7,998,0.65,0.99,1.0,0.8,12,11,2,1,1004,0.92,1.0,0.85,0.88
PF10249,PF06342:PF02525:PF03073,7,4,1,6,3,1008,0.25,0.99,0.14,0.18,1,0,7,1,1010,0.0,0.99,0.0,-0.0
PF11070,PF06890:PF03845:PF06826,0,9,0,0,9,1009,0.0,0.99,0,0,0,0,0,0,1018,0,1.0,0,0
PF03178,PF07035:PF14498:PF12036,29,17,8,21,9,980,0.47,0.97,0.28,0.35,2,2,27,0,989,1.0,0.97,0.07,0.26
PF03352,PF07545:PF10332:PF03703,4,1,0,4,1,1013,0.0,1.0,0.0,-0.0,1,0,4,1,1013,0.0,1.0,0.0,-0.0
PF15759,PF15918:PF10295:PF13810,0,4,0,0,4,1014,0.0,1.0,0,0,0,0,0,0,1018,0,1.0,0,0
PF05596,PF04691:PF15760:PF14986,0,1,0,0,1,1017,0.0,1.0,0,0,0,0,0,0,1018,0,1.0,0,0
PF01346,PF03704:PF16546:PF07219,4,14,2,2,12,1002,0.14,0.99,0.5,0.26,1,1,3,0,1014,1.0,1.0,0.25,0.5
PF03572,PF13180:PF12812:PF08144,17,35,9,8,26,975,0.26,0.97,0.53,0.35,2,2,15,0,1001,1.0,0.99,0.12,0.34
PF08023,PF16047:PF16048:PF08018,0,0,0,0,0,1018,0,1.0,0,0,0,0,0,0,1018,0,1.0,0,0
PF16134,PF11732:PF11262:PF03993,7,8,6,1,2,1009,0.75,1.0,0.86,0.8,6,6,1,0,1011,1.0,1.0,0.86,0.93
PF15091,PF15556:PF17050:PF09690,0,1,0,0,1,1017,0.0,1.0,0,0,0,0,0,0,1018,0,1.0,0,0
PF12693,PF00813:PF01313:PF14842,2,0,0,2,0,1016,0,1.0,0.0,0,0,0,2,0,1016,0,1.0,0.0,0
PF05681,PF05683:PF06742:PF07171,3,11,3,0,8,1007,0.27,0.99,1.0,0.52,1,0,3,1,1014,0.0,1.0,0.0,-0.0
PF14971,PF11052:PF16173:PF11035,1,3,0,1,3,1014,0.0,1.0,0.0,-0.0,0,0,1,0,1017,0,1.0,0.0,0
PF09613,PF02252:PF06464:PF12456,0,27,0,0,27,991,0.0,0.97,0,0,4,0,0,4,1014,0.0,1.0,0,0
PF04098,PF08081:PF16131:PF03467,9,23,2,7,21,988,0.09,0.97,0.22,0.13,5,2,7,3,1006,0.4,0.99,0.22,0.29
PF06842,PF09495:PF14542:PF05047,9,11,4,5,7,1002,0.36,0.99,0.44,0.4,2,1,8,1,1008,0.5,0.99,0.11,0.23
PF05044,PF09462:PF10407:PF10056,6,3,1,5,2,1010,0.33,0.99,0.17,0.23,1,0,6,1,1011,0.0,0.99,0.0,-0.0
PF07172,PF15129:PF06373:PF06206,1,2,0,1,2,1015,0.0,1.0,0.0,-0.0,0,0,1,0,1017,0,1.0,0.0,0
PF12832,PF03647:PF04831:PF04729,13,20,4,9,16,989,0.2,0.98,0.31,0.24,3,2,11,1,1004,0.67,0.99,0.15,0.32
PF09860,PF02217:PF08093:PF08744,0,4,0,0,4,1014,0.0,1.0,0,0,0,0,0,0,1018,0,1.0,0,0
PF11672,PF09967:PF09444:PF06586,2,3,2,0,1,1015,0.67,1.0,1.0,0.82,1,1,1,0,1016,1.0,1.0,0.5,0.71
PF00697,PF00218:PF00977:PF06418,5,31,2,3,29,984,0.06,0.97,0.4,0.15,7,0,5,7,1006,0.0,0.99,0.0,-0.01
PF05343,PF13471:PF14804:PF04225,10,11,1,9,10,998,0.09,0.98,0.1,0.09,1,0,10,1,1007,0.0,0.99,0.0,-0.0
PF09796,PF04229:PF05870:PF07080,6,10,2,4,8,1004,0.2,0.99,0.33,0.25,0,0,6,0,1012,0,0.99,0.0,0
PF01226,PF15245:PF09716:PF11327,8,4,2,6,2,1008,0.5,0.99,0.25,0.35,0,0,8,0,1010,0,0.99,0.0,0
PF05448,PF03745:PF09962:PF09428,2,2,0,2,2,1014,0.0,1.0,0.0,-0.0,0,0,2,0,1016,0,1.0,0.0,0
PF15866,PF15248:PF12240:PF14988,5,7,3,2,4,1009,0.43,0.99,0.6,0.5,2,1,4,1,1012,0.5,1.0,0.2,0.31
PF06941,PF07298:PF04839:PF15346,9,5,1,8,4,1005,0.2,0.99,0.11,0.14,0,0,9,0,1009,0,0.99,0.0,0
PF03501,PF00159:PF07106:PF04667,7,14,4,3,10,1001,0.29,0.99,0.57,0.4,0,0,7,0,1011,0,0.99,0.0,0
PF12024,PF17035:PF17105:PF00439,7,80,6,1,74,937,0.07,0.93,0.86,0.24,13,1,6,12,999,0.08,0.98,0.14,0.1
PF10138,PF11179:PF12628:PF15460,2,3,0,2,3,1013,0.0,1.0,0.0,-0.0,0,0,2,0,1016,0,1.0,0.0,0
PF01910,PF15744:PF13933:PF06907,1,2,0,1,2,1015,0.0,1.0,0.0,-0.0,0,0,1,0,1017,0,1.0,0.0,0
PF01345,PF15334:PF15748:PF05355,0,3,0,0,3,1015,0.0,1.0,0,0,0,0,0,0,1018,0,1.0,0,0
PF09678,PF08274:PF08886:PF06007,1,2,0,1,2,1015,0.0,1.0,0.0,-0.0,0,0,1,0,1017,0,1.0,0.0,0
PF00537,PF10839:PF06351:PF07333,1,3,0,1,3,1014,0.0,1.0,0.0,-0.0,0,0,1,0,1017,0,1.0,0.0,0
PF09380,PF09379:PF08736:PF04382,32,41,31,1,10,976,0.76,0.99,0.97,0.85,15,15,17,0,986,1.0,0.98,0.47,0.68
PF09707,PF08188:PF02377:PF12316,0,8,0,0,8,1010,0.0,0.99,0,0,3,0,0,3,1015,0.0,1.0,0,0
PF05781,PF14662:PF15501:PF15246,4,3,2,2,1,1013,0.67,1.0,0.5,0.58,1,1,3,0,1014,1.0,1.0,0.25,0.5
PF12955,PF15798:PF08297:PF15089,4,1,0,4,1,1013,0.0,1.0,0.0,-0.0,0,0,4,0,1014,0,1.0,0.0,0
PF02167,PF10259:PF01791:PF01625,9,37,6,3,31,978,0.16,0.97,0.67,0.32,4,3,6,1,1008,0.75,0.99,0.33,0.5
PF08068,PF16198:PF01472:PF01509,5,28,5,0,23,990,0.18,0.98,1.0,0.42,11,5,0,6,1007,0.45,0.99,1.0,0.67
PF14910,PF14911:PF14950:PF14951,3,2,1,2,1,1014,0.5,1.0,0.33,0.41,0,0,3,0,1015,0,1.0,0.0,0
PF06253,PF09261:PF01074:PF07748,1,25,0,1,25,992,0.0,0.97,0.0,-0.0,22,0,1,22,995,0.0,0.98,0.0,-0.0
PF00431,PF01382:PF01400:PF01133,73,47,29,44,18,927,0.62,0.94,0.4,0.47,4,4,69,0,945,1.0,0.93,0.05,0.23
PF09698,PF04740:PF04375:PF09684,0,2,0,0,2,1016,0.0,1.0,0,0,1,0,0,1,1017,0.0,1.0,0,0
PF04608,PF03082:PF09655:PF00241,1,26,0,1,26,991,0.0,0.97,0.0,-0.01,0,0,1,0,1017,0,1.0,0.0,0
PF06189,PF07354:PF15008:PF15053,3,4,0,3,4,1011,0.0,0.99,0.0,-0.0,0,0,3,0,1015,0,1.0,0.0,0
PF07442,PF10101:PF03400:PF09827,0,2,0,0,2,1016,0.0,1.0,0,0,0,0,0,0,1018,0,1.0,0,0
PF09752,PF15794:PF07344:PF06382,8,9,1,7,8,1002,0.11,0.99,0.12,0.11,1,1,7,0,1010,1.0,0.99,0.12,0.35
PF04784,PF14389:PF00610:PF12257,16,46,13,3,33,969,0.28,0.96,0.81,0.47,7,3,13,4,998,0.43,0.98,0.19,0.28
PF02757,PF02756:PF00353:PF10937,1,3,0,1,3,1014,0.0,1.0,0.0,-0.0,0,0,1,0,1017,0,1.0,0.0,0
PF06781,PF11625:PF06181:PF15553,0,0,0,0,0,1018,0,1.0,0,0,0,0,0,0,1018,0,1.0,0,0
PF04960,PF16553:PF09310:PF11904,6,9,1,5,8,1004,0.11,0.99,0.17,0.13,1,1,5,0,1012,1.0,1.0,0.17,0.41
PF03896,PF05676:PF00831:PF03386,12,16,4,8,12,994,0.25,0.98,0.33,0.28,1,0,12,1,1005,0.0,0.99,0.0,-0.0
PF06835,PF03968:PF17088:PF15079,1,1,1,0,0,1017,1.0,1.0,1.0,1.0,0,0,1,0,1017,0,1.0,0.0,0
PF17112,PF15207:PF05836:PF15186,0,2,0,0,2,1016,0.0,1.0,0,0,0,0,0,0,1018,0,1.0,0,0
PF14057,PF08119:PF10938:PF13321,0,1,0,0,1,1017,0.0,1.0,0,0,0,0,0,0,1018,0,1.0,0,0
PF08247,PF10673:PF01778:PF01798,0,38,0,0,38,980,0.0,0.96,0,0,4,0,0,4,1014,0.0,1.0,0,0
PF11623,PF11282:PF08636:PF07052,0,15,0,0,15,1003,0.0,0.99,0,0,1,0,0,1,1017,0.0,1.0,0,0
PF10290,PF10287:PF05683:PF06742,1,11,1,0,10,1007,0.09,0.99,1.0,0.3,1,0,1,1,1016,0.0,1.0,0.0,-0.0
PF12330,PF08311:PF12202:PF16797,11,17,4,7,13,994,0.24,0.98,0.36,0.28,3,3,8,0,1007,1.0,0.99,0.27,0.52
PF13375,PF15483:PF15162:PF10073,0,1,0,0,1,1017,0.0,1.0,0,0,0,0,0,0,1018,0,1.0,0,0
PF02734,PF02733:PF14831:PF10660,17,17,13,4,4,997,0.76,0.99,0.76,0.76,1,1,16,0,1001,1.0,0.98,0.06,0.24
PF02886,PF01273:PF01144:PF04833,13,29,12,1,17,988,0.41,0.98,0.92,0.61,4,3,10,1,1004,0.75,0.99,0.23,0.41
PF04516,PF15996:PF04087:PF05334,8,9,3,5,6,1004,0.33,0.99,0.38,0.35,0,0,8,0,1010,0,0.99,0.0,0
PF14494,PF09715:PF03601:PF09962,0,1,0,0,1,1017,0.0,1.0,0,0,0,0,0,0,1018,0,1.0,0,0
PF15949,PF10358:PF12130:PF12510,5,26,2,3,24,989,0.08,0.97,0.4,0.17,2,1,4,1,1012,0.5,1.0,0.2,0.31
PF00916,PF01740:PF15098:PF01055,37,59,31,6,28,953,0.53,0.97,0.84,0.65,15,14,23,1,980,0.93,0.98,0.38,0.59
PF00274,PF05617:PF05051:PF07994,13,12,1,12,11,994,0.08,0.98,0.08,0.07,2,0,13,2,1003,0.0,0.99,0.0,-0.01
PF07830,PF04471:PF00481:PF04689,9,73,9,0,64,945,0.12,0.94,1.0,0.34,8,3,6,5,1004,0.38,0.99,0.33,0.35
PF16273,PF09032:PF05002:PF14050,0,22,0,0,22,996,0.0,0.98,0,0,2,0,0,2,1016,0.0,1.0,0,0
PF08404,PF07804:PF15483:PF08497,0,2,0,0,2,1016,0.0,1.0,0,0,0,0,0,0,1018,0,1.0,0,0
PF11559,PF10506:PF15784:PF11577,7,8,0,7,8,1003,0.0,0.99,0.0,-0.01,0,0,7,0,1011,0,0.99,0.0,0
PF00134,PF02984:PF08268:PF00847,69,61,42,27,19,930,0.69,0.95,0.61,0.62,16,14,55,2,947,0.88,0.94,0.2,0.41
PF04717,PF03729:PF15529:PF01580,0,5,0,0,5,1013,0.0,1.0,0,0,0,0,0,0,1018,0,1.0,0,0
PF15225,PF08924:PF02638:PF13406,2,5,1,1,4,1012,0.2,1.0,0.5,0.31,0,0,2,0,1016,0,1.0,0.0,0
PF07800,PF02186:PF02291:PF07946,4,22,0,4,22,992,0.0,0.97,0.0,-0.01,4,0,4,4,1010,0.0,0.99,0.0,-0.0
PF09766,PF07978:PF00769:PF04382,9,24,4,5,20,989,0.17,0.98,0.44,0.26,6,3,6,3,1006,0.5,0.99,0.33,0.4
PF16931,PF10279:PF04355:PF07157,0,0,0,0,0,1018,0,1.0,0,0,0,0,0,0,1018,0,1.0,0,0
PF04384,PF02072:PF17053:PF15097,0,1,0,0,1,1017,0.0,1.0,0,0,0,0,0,0,1018,0,1.0,0,0
PF13811,PF08610:PF01744:PF09396,0,15,0,0,15,1003,0.0,0.99,0,0,4,0,0,4,1014,0.0,1.0,0,0
PF00229,PF03523:PF00386:PF01868,8,31,4,4,27,983,0.13,0.97,0.5,0.24,4,0,8,4,1006,0.0,0.99,0.0,-0.01
PF05093,PF12589:PF16803:PF08498,16,20,8,8,12,990,0.4,0.98,0.5,0.44,3,2,14,1,1001,0.67,0.99,0.12,0.28
PF03445,PF07721:PF14280:PF07720,11,10,1,10,9,998,0.1,0.98,0.09,0.09,3,1,10,2,1005,0.33,0.99,0.09,0.17
PF06305,PF13400:PF15847:PF15729,3,4,1,2,3,1012,0.25,1.0,0.33,0.29,0,0,3,0,1015,0,1.0,0.0,0
PF02901,PF01228:PF10105:PF07963,7,4,2,5,2,1009,0.5,0.99,0.29,0.37,2,2,5,0,1011,1.0,1.0,0.29,0.53
PF11489,PF06420:PF10330:PF04090,0,4,0,0,4,1014,0.0,1.0,0,0,1,0,0,1,1017,0.0,1.0,0,0
PF09036,PF16018:PF06395:PF09128,9,11,4,5,7,1002,0.36,0.99,0.44,0.4,2,2,7,0,1009,1.0,0.99,0.22,0.47
PF12883,PF13471:PF04335:PF04060,2,9,2,0,7,1009,0.22,0.99,1.0,0.47,4,2,0,2,1014,0.5,1.0,1.0,0.71
PF03358,PF06244:PF01987:PF04667,16,19,4,12,15,987,0.21,0.97,0.25,0.22,3,1,15,2,1000,0.33,0.98,0.06,0.14
PF12397,PF13001:PF08146:PF11919,10,28,10,0,18,990,0.36,0.98,1.0,0.59,3,3,7,0,1008,1.0,0.99,0.3,0.55
PF16492,PF08374:PF15974:PF01282,2,8,2,0,6,1010,0.25,0.99,1.0,0.5,1,1,1,0,1016,1.0,1.0,0.5,0.71
PF12658,PF17015:PF15207:PF15047,1,1,0,1,1,1016,0.0,1.0,0.0,-0.0,0,0,1,0,1017,0,1.0,0.0,0
PF08445,PF06021:PF08444:PF08622,10,6,4,6,2,1006,0.67,0.99,0.4,0.51,2,1,9,1,1007,0.5,0.99,0.1,0.22
PF07463,PF14849:PF11209:PF16273,4,3,0,4,3,1011,0.0,0.99,0.0,-0.0,0,0,4,0,1014,0,1.0,0.0,0
PF00809,PF02607:PF02965:PF02574,13,18,7,6,11,994,0.39,0.98,0.54,0.45,5,4,9,1,1004,0.8,0.99,0.31,0.49
PF07881,PF02952:PF07882:PF05974,1,1,1,0,0,1017,1.0,1.0,1.0,1.0,1,1,0,0,1017,1.0,1.0,1.0,1.0
PF16991,PF17007:PF05466:PF13505,0,0,0,0,0,1018,0,1.0,0,0,0,0,0,0,1018,0,1.0,0,0
PF08924,PF15225:PF13406:PF02638,0,6,0,0,6,1012,0.0,0.99,0,0,1,0,0,1,1017,0.0,1.0,0,0
PF10961,PF07449:PF15928:PF15378,6,1,0,6,1,1011,0.0,0.99,0.0,-0.0,0,0,6,0,1012,0,0.99,0.0,0
PF05573,PF11775:PF06798:PF08886,0,0,0,0,0,1018,0,1.0,0,0,0,0,0,0,1018,0,1.0,0,0
PF03713,PF07209:PF14539:PF10951,0,1,0,0,1,1017,0.0,1.0,0,0,0,0,0,0,1018,0,1.0,0,0
PF07799,PF15856:PF15775:PF17188,0,1,0,0,1,1017,0.0,1.0,0,0,0,0,0,0,1018,0,1.0,0,0
PF00361,PF00690:PF03810:PF00880,26,94,13,13,81,911,0.14,0.91,0.5,0.23,21,9,17,12,980,0.43,0.97,0.35,0.37
PF16060,PF03703:PF06485:PF12855,5,7,2,3,5,1008,0.29,0.99,0.4,0.33,0,0,5,0,1013,0,1.0,0.0,0
PF14641,PF14632:PF14639:PF14635,12,14,12,0,2,1004,0.86,1.0,1.0,0.92,13,12,0,1,1005,0.92,1.0,1.0,0.96
PF08832,PF16279:PF08815:PF07469,6,6,6,0,0,1012,1.0,1.0,1.0,1.0,6,6,0,0,1012,1.0,1.0,1.0,1.0
PF07911,PF06645:PF05676:PF09793,2,18,0,2,18,998,0.0,0.98,0.0,-0.01,2,0,2,2,1014,0.0,1.0,0.0,-0.0
PF07802,PF06907:PF15549:PF03883,4,5,1,3,4,1010,0.2,0.99,0.25,0.22,0,0,4,0,1014,0,1.0,0.0,0
PF05138,PF08651:PF06122:PF00602,0,2,0,0,2,1016,0.0,1.0,0,0,0,0,0,0,1018,0,1.0,0,0
PF05021,PF05020:PF11543:PF05340,10,12,10,0,2,1006,0.83,1.0,1.0,0.91,7,7,3,0,1008,1.0,1.0,0.7,0.84
PF04451,PF04355:PF11751:PF04076,1,0,0,1,0,1017,0,1.0,0.0,0,0,0,1,0,1017,0,1.0,0.0,0
PF05282,PF05197:PF03073:PF05871,12,16,4,8,12,994,0.25,0.98,0.33,0.28,2,1,11,1,1005,0.5,0.99,0.08,0.2
PF04258,PF02225:PF01532:PF04389,24,84,18,6,66,928,0.21,0.93,0.75,0.38,34,10,14,24,970,0.29,0.96,0.42,0.33
PF08759,PF08856:PF16168:PF13644,0,1,0,0,1,1017,0.0,1.0,0,0,0,0,0,0,1018,0,1.0,0,0
PF10225,PF11282:PF11250:PF04765,9,13,1,8,12,997,0.08,0.98,0.11,0.08,1,0,9,1,1008,0.0,0.99,0.0,-0.0
PF04310,PF03389:PF11767:PF02472,2,8,0,2,8,1008,0.0,0.99,0.0,-0.0,0,0,2,0,1016,0,1.0,0.0,0
PF12937,PF00646:PF16862:PF06985,96,133,54,42,79,843,0.41,0.88,0.56,0.41,36,26,70,10,912,0.72,0.92,0.27,0.41
PF14804,PF12631:PF16712:PF16709,2,8,1,1,7,1009,0.12,0.99,0.5,0.25,1,0,2,1,1015,0.0,1.0,0.0,-0.0
PF04748,PF10403:PF04224:PF08620,1,16,0,1,16,1001,0.0,0.98,0.0,-0.0,1,0,1,1,1016,0.0,1.0,0.0,-0.0
PF15397,PF06485:PF12855:PF03596,5,6,3,2,3,1010,0.5,1.0,0.6,0.55,0,0,5,0,1013,0,1.0,0.0,0
PF14846,PF12297:PF05104:PF11577,3,4,0,3,4,1011,0.0,0.99,0.0,-0.0,0,0,3,0,1015,0,1.0,0.0,0
PF06391,PF17121:PF16954:PF00590,7,23,4,3,19,992,0.17,0.98,0.57,0.31,1,1,6,0,1011,1.0,0.99,0.14,0.38
PF00519,PF15856:PF08026:PF17076,5,1,0,5,1,1012,0.0,0.99,0.0,-0.0,0,0,5,0,1013,0,1.0,0.0,0
PF08167,PF08166:PF11597:PF06333,5,10,3,2,7,1006,0.3,0.99,0.6,0.42,5,1,4,4,1009,0.2,0.99,0.2,0.2
PF02035,PF08847:PF15838:PF08856,0,0,0,0,0,1018,0,1.0,0,0,0,0,0,0,1018,0,1.0,0,0
PF01374,PF04085:PF09979:PF13005,1,0,0,1,0,1017,0,1.0,0.0,0,0,0,1,0,1017,0,1.0,0.0,0
PF05551,PF15673:PF07353:PF15050,0,5,0,0,5,1013,0.0,1.0,0,0,0,0,0,0,1018,0,1.0,0,0
PF00908,PF02397:PF02719:PF11803,6,5,2,4,3,1009,0.4,0.99,0.33,0.36,2,2,4,0,1012,1.0,1.0,0.33,0.58
PF16870,PF16078:PF02779:PF00456,14,44,14,0,30,974,0.32,0.97,1.0,0.56,13,6,8,7,997,0.46,0.99,0.43,0.44
PF02057,PF10285:PF10284:PF12904,1,0,0,1,0,1017,0,1.0,0.0,0,0,0,1,0,1017,0,1.0,0.0,0
PF14294,PF05509:PF06864:PF05513,2,2,1,1,1,1015,0.5,1.0,0.5,0.5,1,1,1,0,1016,1.0,1.0,0.5,0.71
PF05991,PF03703:PF10571:PF02620,3,9,1,2,8,1007,0.11,0.99,0.33,0.19,0,0,3,0,1015,0,1.0,0.0,0
PF13151,PF06681:PF15856:PF17010,0,1,0,0,1,1017,0.0,1.0,0,0,0,0,0,0,1018,0,1.0,0,0
PF14998,PF06596:PF06581:PF04402,2,7,1,1,6,1010,0.14,0.99,0.5,0.26,0,0,2,0,1016,0,1.0,0.0,0
PF14543,PF14541:PF00722:PF04406,27,66,24,3,42,949,0.36,0.96,0.89,0.55,16,9,18,7,984,0.56,0.98,0.33,0.42
PF05770,PF10263:PF06179:PF04720,12,32,8,4,24,982,0.25,0.97,0.67,0.4,6,2,10,4,1002,0.33,0.99,0.17,0.23
PF07521,PF11718:PF13299:PF16661,24,38,21,3,17,977,0.55,0.98,0.88,0.69,16,10,14,6,988,0.62,0.98,0.42,0.5
PF06320,PF10542:PF03918:PF10868,7,1,1,6,0,1011,1.0,0.99,0.14,0.38,0,0,7,0,1011,0,0.99,0.0,0
PF14484,PF02758:PF13355:PF08709,11,20,5,6,15,992,0.25,0.98,0.45,0.33,2,2,9,0,1007,1.0,0.99,0.18,0.42
PF02818,PF12509:PF09441:PF14644,4,8,0,4,8,1006,0.0,0.99,0.0,-0.01,0,0,4,0,1014,0,1.0,0.0,0
PF08917,PF14786:PF06760:PF11629,4,4,2,2,2,1012,0.5,1.0,0.5,0.5,2,2,2,0,1014,1.0,1.0,0.5,0.71
PF06350,PF07859:PF15610:PF00772,7,71,7,0,64,947,0.1,0.94,1.0,0.3,5,2,5,3,1008,0.4,0.99,0.29,0.33
PF12824,PF07856:PF07681:PF14249,7,10,2,5,8,1003,0.2,0.99,0.29,0.23,1,1,6,0,1011,1.0,0.99,0.14,0.38
PF09533,PF15212:PF05234:PF15119,0,2,0,0,2,1016,0.0,1.0,0,0,0,0,0,0,1018,0,1.0,0,0
PF08580,PF04988:PF16043:PF12606,2,7,0,2,7,1009,0.0,0.99,0.0,-0.0,1,0,2,1,1015,0.0,1.0,0.0,-0.0
PF03912,PF02427:PF15125:PF06109,0,3,0,0,3,1015,0.0,1.0,0,0,0,0,0,0,1018,0,1.0,0,0
PF00769,PF09766:PF16705:PF04382,10,13,5,5,8,1000,0.38,0.99,0.5,0.43,2,2,8,0,1008,1.0,0.99,0.2,0.45
PF02011,PF15143:PF02543:PF07411,2,3,0,2,3,1013,0.0,1.0,0.0,-0.0,0,0,2,0,1016,0,1.0,0.0,0
PF10706,PF08497:PF05509:PF05513,1,1,0,1,1,1016,0.0,1.0,0.0,-0.0,1,0,1,1,1016,0.0,1.0,0.0,-0.0
PF08020,PF01591:PF16322:PF00789,0,35,0,0,35,983,0.0,0.97,0,0,8,0,0,8,1010,0.0,0.99,0,0
PF13355,PF15027:PF10441:PF17034,2,10,1,1,9,1007,0.1,0.99,0.5,0.22,1,1,1,0,1016,1.0,1.0,0.5,0.71
PF15241,PF15259:PF15082:PF09322,0,4,0,0,4,1014,0.0,1.0,0,0,0,0,0,0,1018,0,1.0,0,0
PF14362,PF01752:PF03831:PF00669,0,3,0,0,3,1015,0.0,1.0,0,0,0,0,0,0,1018,0,1.0,0,0
PF11671,PF12278:PF15362:PF15374,0,1,0,0,1,1017,0.0,1.0,0,0,0,0,0,0,1018,0,1.0,0,0
PF15000,PF04892:PF09216:PF05919,1,2,0,1,2,1015,0.0,1.0,0.0,-0.0,0,0,1,0,1017,0,1.0,0.0,0
PF15545,PF02741:PF01706:PF03729,0,2,0,0,2,1016,0.0,1.0,0,0,0,0,0,0,1018,0,1.0,0,0
PF10659,PF13206:PF00913:PF03409,1,2,0,1,2,1015,0.0,1.0,0.0,-0.0,0,0,1,0,1017,0,1.0,0.0,0
PF09432,PF10279:PF03729:PF09904,0,0,0,0,0,1018,0,1.0,0,0,0,0,0,0,1018,0,1.0,0,0
PF03125,PF10317:PF10319:PF10318,8,22,4,4,18,992,0.18,0.98,0.5,0.29,2,0,8,2,1008,0.0,0.99,0.0,-0.0
PF07510,PF03745:PF08611:PF08058,1,6,0,1,6,1011,0.0,0.99,0.0,-0.0,0,0,1,0,1017,0,1.0,0.0,0
PF12271,PF04418:PF08649:PF04729,7,12,3,4,9,1002,0.25,0.99,0.43,0.32,2,1,6,1,1010,0.5,0.99,0.14,0.26
PF08075,PF10443:PF12220:PF04098,9,17,3,6,14,995,0.18,0.98,0.33,0.23,2,1,8,1,1008,0.5,0.99,0.11,0.23
PF09685,PF04714:PF03754:PF06916,0,14,0,0,14,1004,0.0,0.99,0,0,1,0,0,1,1017,0.0,1.0,0,0
PF10280,PF01279:PF10775:PF02044,6,2,0,6,2,1010,0.0,0.99,0.0,-0.0,0,0,6,0,1012,0,0.99,0.0,0
PF05309,PF06586:PF07178:PF05509,1,1,1,0,0,1017,1.0,1.0,1.0,1.0,1,1,0,0,1017,1.0,1.0,1.0,1.0
PF06736,PF08204:PF02165:PF04549,1,0,0,1,0,1017,0,1.0,0.0,0,0,0,1,0,1017,0,1.0,0.0,0
PF03488,PF10705:PF14972:PF00727,1,6,0,1,6,1011,0.0,0.99,0.0,-0.0,0,0,1,0,1017,0,1.0,0.0,0
PF13211,PF15155:PF08751:PF15333,0,8,0,0,8,1010,0.0,0.99,0,0,0,0,0,0,1018,0,1.0,0,0
PF01047,PF06804:PF02694:PF01654,16,7,2,14,5,997,0.29,0.98,0.12,0.18,3,2,14,1,1001,0.67,0.99,0.12,0.28
PF08642,PF15553:PF15460:PF03601,0,1,0,0,1,1017,0.0,1.0,0,0,0,0,0,0,1018,0,1.0,0,0
PF14908,PF13020:PF12726:PF11028,5,10,2,3,8,1005,0.2,0.99,0.4,0.28,0,0,5,0,1013,0,1.0,0.0,0
PF07863,PF00141:PF08115:PF14402,0,37,0,0,37,981,0.0,0.96,0,0,0,0,0,0,1018,0,1.0,0,0
PF07082,PF05055:PF06206:PF10693,2,4,0,2,4,1012,0.0,0.99,0.0,-0.0,0,0,2,0,1016,0,1.0,0.0,0
PF15433,PF06783:PF00995:PF05050,10,42,6,4,36,972,0.14,0.96,0.6,0.28,7,3,7,4,1004,0.43,0.99,0.3,0.35
PF02068,PF08291:PF06724:PF08308,1,0,0,1,0,1017,0,1.0,0.0,0,0,0,1,0,1017,0,1.0,0.0,0
PF14114,PF10566:PF07505:PF06007,1,2,0,1,2,1015,0.0,1.0,0.0,-0.0,0,0,1,0,1017,0,1.0,0.0,0
PF16868,PF12477:PF14690:PF08334,2,1,0,2,1,1015,0.0,1.0,0.0,-0.0,0,0,2,0,1016,0,1.0,0.0,0
PF16689,PF05956:PF05924:PF05937,3,9,3,0,6,1009,0.33,0.99,1.0,0.58,3,3,0,0,1015,1.0,1.0,1.0,1.0
PF13965,PF08445:PF07801:PF08652,4,17,3,1,14,1000,0.18,0.99,0.75,0.36,3,2,2,1,1013,0.67,1.0,0.5,0.58
PF03364,PF11303:PF10275:PF00452,13,15,4,9,11,994,0.27,0.98,0.31,0.28,3,1,12,2,1003,0.33,0.99,0.08,0.16
PF13001,PF11916:PF12755:PF08146,14,19,5,9,14,990,0.26,0.98,0.36,0.3,7,2,12,5,999,0.29,0.98,0.14,0.19
PF04473,PF03234:PF03326:PF09311,0,13,0,0,13,1005,0.0,0.99,0,0,0,0,0,0,1018,0,1.0,0,0
PF10828,PF08119:PF09827:PF00801,0,11,0,0,11,1007,0.0,0.99,0,0,0,0,0,0,1018,0,1.0,0,0
PF06093,PF02284:PF04176:PF05995,2,18,2,0,16,1000,0.11,0.98,1.0,0.33,5,2,0,3,1013,0.4,1.0,1.0,0.63
PF00721,PF09704:PF11289:PF15338,1,0,0,1,0,1017,0,1.0,0.0,0,0,0,1,0,1017,0,1.0,0.0,0
PF07127,PF16029:PF16594:PF01291,8,7,3,5,4,1006,0.43,0.99,0.38,0.4,1,1,7,0,1010,1.0,0.99,0.12,0.35
PF03904,PF13553:PF09169:PF12721,0,14,0,0,14,1004,0.0,0.99,0,0,3,0,0,3,1015,0.0,1.0,0,0
PF00058,PF16472:PF12662:PF07593,21,24,10,11,14,983,0.42,0.98,0.48,0.43,5,5,16,0,997,1.0,0.98,0.24,0.48
PF06296,PF15763:PF04892:PF02511,0,2,0,0,2,1016,0.0,1.0,0,0,0,0,0,0,1018,0,1.0,0,0
PF01883,PF10609:PF02195:PF02668,16,55,6,10,49,953,0.11,0.94,0.38,0.18,11,5,11,6,996,0.45,0.98,0.31,0.37
PF05000,PF04983:PF04998:PF04990,31,37,31,0,6,981,0.84,0.99,1.0,0.91,29,29,2,0,987,1.0,1.0,0.94,0.97
PF04727,PF11841:PF16457:PF07763,16,16,9,7,7,995,0.56,0.99,0.56,0.56,7,7,9,0,1002,1.0,0.99,0.44,0.66
PF03827,PF08983:PF09193:PF10413,2,3,1,1,2,1014,0.33,1.0,0.5,0.41,1,1,1,0,1016,1.0,1.0,0.5,0.71
PF11363,PF02277:PF06074:PF11794,0,3,0,0,3,1015,0.0,1.0,0,0,0,0,0,0,1018,0,1.0,0,0
PF00444,PF10244:PF11779:PF10780,7,11,2,5,9,1002,0.18,0.99,0.29,0.22,3,0,7,3,1008,0.0,0.99,0.0,-0.0
PF02199,PF03489:PF05184:PF03227,2,23,1,1,22,994,0.04,0.98,0.5,0.14,6,0,2,6,1010,0.0,0.99,0.0,-0.0
PF04172,PF14022:PF12751:PF16692,2,5,1,1,4,1012,0.2,1.0,0.5,0.31,2,0,2,2,1014,0.0,1.0,0.0,-0.0
PF09785,PF08156:PF01798:PF16387,5,32,5,0,27,986,0.16,0.97,1.0,0.39,20,2,3,18,995,0.1,0.98,0.4,0.19
PF10612,PF12037:PF16582:PF02684,0,4,0,0,4,1014,0.0,1.0,0,0,0,0,0,0,1018,0,1.0,0,0
PF10569,PF07678:PF07703:PF01835,13,17,13,0,4,1001,0.76,1.0,1.0,0.87,11,11,2,0,1005,1.0,1.0,0.85,0.92
PF13005,PF05065:PF16872:PF10490,0,5,0,0,5,1013,0.0,1.0,0,0,0,0,0,0,1018,0,1.0,0,0
PF11080,PF14551:PF01974:PF08747,1,56,0,1,56,961,0.0,0.94,0.0,-0.01,10,0,1,10,1007,0.0,0.99,0.0,-0.0
PF13932,PF01134:PF16044:PF03343,17,26,17,0,9,992,0.65,0.99,1.0,0.8,4,4,13,0,1001,1.0,0.99,0.24,0.48
PF03538,PF16967:PF07434:PF01752,0,2,0,0,2,1016,0.0,1.0,0,0,0,0,0,0,1018,0,1.0,0,0
PF02338,PF01754:PF01428:PF08123,42,39,14,28,25,951,0.36,0.95,0.33,0.32,8,6,36,2,974,0.75,0.96,0.14,0.32
PF04043,PF01095:PF00156:PF02449,16,61,12,4,49,953,0.2,0.95,0.75,0.37,12,5,11,7,995,0.42,0.98,0.31,0.35
PF10410,PF01807:PF08345:PF04865,4,6,4,0,2,1012,0.67,1.0,1.0,0.82,1,0,4,1,1013,0.0,1.0,0.0,-0.0
PF15027,PF13910:PF08168:PF10441,0,7,0,0,7,1011,0.0,0.99,0,0,0,0,0,0,1018,0,1.0,0,0
PF09415,PF11032:PF16054:PF13301,3,5,2,1,3,1012,0.4,1.0,0.67,0.51,2,2,1,0,1015,1.0,1.0,0.67,0.82
PF16214,PF06327:PF07700:PF08376,9,19,6,3,13,996,0.32,0.98,0.67,0.45,4,3,6,1,1008,0.75,0.99,0.33,0.5
PF02005,PF06881:PF02586:PF09425,10,18,4,6,14,994,0.22,0.98,0.4,0.29,2,0,10,2,1006,0.0,0.99,0.0,-0.0
PF01610,PF14690:PF02211:PF13861,2,3,0,2,3,1013,0.0,1.0,0.0,-0.0,0,0,2,0,1016,0,1.0,0.0,0
PF05179,PF16050:PF01634:PF14642,5,14,5,0,9,1004,0.36,0.99,1.0,0.59,1,1,4,0,1013,1.0,1.0,0.2,0.45
PF02753,PF11614:PF08299:PF13954,3,9,3,0,6,1009,0.33,0.99,1.0,0.58,0,0,3,0,1015,0,1.0,0.0,0
PF01477,PF02010:PF00305:PF08016,32,49,25,7,24,962,0.51,0.97,0.78,0.62,9,9,23,0,986,1.0,0.98,0.28,0.52
PF14679,PF14676:PF14680:PF14677,1,1,1,0,0,1017,1.0,1.0,1.0,1.0,1,1,0,0,1017,1.0,1.0,1.0,1.0
PF16019,PF15279:PF04109:PF14909,0,13,0,0,13,1005,0.0,0.99,0,0,1,0,0,1,1017,0.0,1.0,0,0
PF06151,PF08395:PF08925:PF14713,2,29,2,0,27,989,0.07,0.97,1.0,0.26,4,0,2,4,1012,0.0,0.99,0.0,-0.0
PF02985,PF12755:PF12074:PF08506,35,27,12,23,15,968,0.44,0.96,0.34,0.37,6,5,30,1,982,0.83,0.97,0.14,0.34
PF15787,PF14844:PF06469:PF12657,11,25,6,5,19,988,0.24,0.98,0.55,0.35,6,1,10,5,1002,0.17,0.99,0.09,0.12
PF14686,PF06045:PF14683:PF09284,15,17,15,0,2,1001,0.88,1.0,1.0,0.94,11,11,4,0,1003,1.0,1.0,0.73,0.85
PF09093,PF04984:PF04552:PF02501,1,3,0,1,3,1014,0.0,1.0,0.0,-0.0,0,0,1,0,1017,0,1.0,0.0,0
PF01888,PF07538:PF04967:PF16117,1,1,0,1,1,1016,0.0,1.0,0.0,-0.0,0,0,1,0,1017,0,1.0,0.0,0
PF08374,PF16492:PF15974:PF07953,1,5,1,0,4,1013,0.2,1.0,1.0,0.45,2,1,0,1,1016,0.5,1.0,1.0,0.71
PF09758,PF04048:PF08638:PF14649,2,22,0,2,22,994,0.0,0.98,0.0,-0.01,2,0,2,2,1014,0.0,1.0,0.0,-0.0
PF02867,PF00317:PF03477:PF07047,14,16,11,3,5,999,0.69,0.99,0.79,0.73,7,7,7,0,1004,1.0,0.99,0.5,0.7
PF07702,PF00392:PF04288:PF04247,4,19,4,0,15,999,0.21,0.99,1.0,0.46,0,0,4,0,1014,0,1.0,0.0,0
PF01090,PF02285:PF14954:PF15884,12,8,1,11,7,999,0.12,0.98,0.08,0.09,1,0,12,1,1005,0.0,0.99,0.0,-0.0
PF06412,PF06134:PF11237:PF01659,0,2,0,0,2,1016,0.0,1.0,0,0,0,0,0,0,1018,0,1.0,0,0
PF11510,PF15337:PF07175:PF04642,6,4,2,4,2,1010,0.5,0.99,0.33,0.41,0,0,6,0,1012,0,0.99,0.0,0
PF01436,PF01082:PF03712:PF13905,37,30,17,20,13,968,0.57,0.97,0.46,0.49,17,13,24,4,977,0.76,0.97,0.35,0.51
PF15072,PF16002:PF15353:PF15045,7,8,2,5,6,1005,0.25,0.99,0.29,0.26,1,0,7,1,1010,0.0,0.99,0.0,-0.0
PF14775,PF13166:PF15877:PF01076,4,1,0,4,1,1013,0.0,1.0,0.0,-0.0,0,0,4,0,1014,0,1.0,0.0,0
PF07411,PF03090:PF08299:PF12081,0,2,0,0,2,1016,0.0,1.0,0,0,0,0,0,0,1018,0,1.0,0,0
PF12838,PF10371:PF13187:PF01558,23,13,7,16,6,989,0.54,0.98,0.3,0.39,5,5,18,0,995,1.0,0.98,0.22,0.46
PF09867,PF02413:PF02277:PF01752,0,5,0,0,5,1013,0.0,1.0,0,0,0,0,0,0,1018,0,1.0,0,0
PF03894,PF09363:PF09364:PF03185,2,9,2,0,7,1009,0.22,0.99,1.0,0.47,2,2,0,0,1016,1.0,1.0,1.0,1.0
PF03814,PF02669:PF06798:PF02277,1,4,1,0,3,1014,0.25,1.0,1.0,0.5,0,0,1,0,1017,0,1.0,0.0,0
PF02391,PF05176:PF13023:PF08315,10,22,5,5,17,991,0.23,0.98,0.5,0.33,5,2,8,3,1005,0.4,0.99,0.2,0.28
PF05942,PF03739:PF12628:PF07996,0,7,0,0,7,1011,0.0,0.99,0,0,1,0,0,1,1017,0.0,1.0,0,0
PF11719,PF16783:PF03159:PF07652,10,25,8,2,17,991,0.32,0.98,0.8,0.5,3,3,7,0,1008,1.0,0.99,0.3,0.55
PF01114,PF12904:PF02740:PF15722,1,1,1,0,0,1017,1.0,1.0,1.0,1.0,0,0,1,0,1017,0,1.0,0.0,0
PF12022,PF10474:PF08303:PF08302,5,5,2,3,3,1010,0.4,0.99,0.4,0.4,3,1,4,2,1011,0.33,0.99,0.2,0.26
PF15178,PF05418:PF06681:PF15758,0,1,0,0,1,1017,0.0,1.0,0,0,0,0,0,0,1018,0,1.0,0,0
PF14392,PF14111:PF02337:PF00607,29,62,24,5,38,951,0.39,0.96,0.83,0.55,9,6,23,3,986,0.67,0.97,0.21,0.36
PF04142,PF14975:PF01126:PF00638,21,37,13,8,24,973,0.35,0.97,0.62,0.45,6,5,16,1,996,0.83,0.98,0.24,0.44
PF14552,PF00669:PF05707:PF11304,1,1,0,1,1,1016,0.0,1.0,0.0,-0.0,0,0,1,0,1017,0,1.0,0.0,0
PF14063,PF06143:PF09643:PF08908,0,0,0,0,0,1018,0,1.0,0,0,0,0,0,0,1018,0,1.0,0,0
PF09587,PF07327:PF08576:PF17124,5,4,1,4,3,1010,0.25,0.99,0.2,0.22,0,0,5,0,1013,0,1.0,0.0,0
PF12738,PF00533:PF16892:PF01834,24,54,21,3,33,961,0.39,0.96,0.88,0.57,6,3,21,3,991,0.5,0.98,0.12,0.24
PF05579,PF02075:PF02445:PF04607,1,16,0,1,16,1001,0.0,0.98,0.0,-0.0,0,0,1,0,1017,0,1.0,0.0,0
PF06844,PF03454:PF03453:PF08668,0,29,0,0,29,989,0.0,0.97,0,0,14,0,0,14,1004,0.0,0.99,0,0
PF05822,PF00965:PF05719:PF15008,15,11,1,14,10,993,0.09,0.98,0.07,0.07,0,0,15,0,1003,0,0.99,0.0,0
PF08477,PF16095:PF12799:PF13676,30,58,24,6,34,954,0.41,0.96,0.8,0.56,17,14,16,3,985,0.82,0.98,0.47,0.61
PF08626,PF12739:PF00988:PF14222,12,27,5,7,22,984,0.19,0.97,0.42,0.27,6,4,8,2,1004,0.67,0.99,0.33,0.47
PF08727,PF00947:PF02226:PF08411,12,13,12,0,1,1005,0.92,1.0,1.0,0.96,12,12,0,0,1006,1.0,1.0,1.0,1.0
PF03781,PF12867:PF10017:PF00463,11,21,8,3,13,994,0.38,0.98,0.73,0.52,2,2,9,0,1007,1.0,0.99,0.18,0.42
PF01321,PF16188:PF05195:PF15801,12,23,5,7,18,988,0.22,0.98,0.42,0.29,6,2,10,4,1002,0.33,0.99,0.17,0.23
PF01959,PF11017:PF02371:PF15252,3,3,1,2,2,1013,0.33,1.0,0.33,0.33,0,0,3,0,1015,0,1.0,0.0,0
PF07376,PF02659:PF10281:PF02913,0,32,0,0,32,986,0.0,0.97,0,0,5,0,0,5,1013,0.0,1.0,0,0
PF00129,PF04833:PF07654:PF04859,6,19,6,0,13,999,0.32,0.99,1.0,0.56,2,2,4,0,1012,1.0,1.0,0.33,0.58
PF00189,PF12333:PF14959:PF07810,10,16,2,8,14,994,0.12,0.98,0.2,0.15,2,0,10,2,1006,0.0,0.99,0.0,-0.0
PF16265,PF13482:PF09374:PF12840,0,1,0,0,1,1017,0.0,1.0,0,0,0,0,0,0,1018,0,1.0,0,0
PF15771,PF15754:PF11044:PF15333,0,0,0,0,0,1018,0,1.0,0,0,0,0,0,0,1018,0,1.0,0,0
PF03426,PF02770:PF00441:PF07905,0,69,0,0,69,949,0.0,0.93,0,0,58,0,0,58,960,0.0,0.94,0,0
PF01935,PF08886:PF06744:PF06864,0,1,0,0,1,1017,0.0,1.0,0,0,0,0,0,0,1018,0,1.0,0,0
PF12640,PF17043:PF06852:PF02070,2,0,0,2,0,1016,0,1.0,0.0,0,0,0,2,0,1016,0,1.0,0.0,0
PF08103,PF13632:PF00703:PF02836,0,39,0,0,39,979,0.0,0.96,0,0,17,0,0,17,1001,0.0,0.98,0,0
PF08558,PF07988:PF16772:PF14379,4,10,2,2,8,1006,0.2,0.99,0.5,0.31,0,0,4,0,1014,0,1.0,0.0,0
PF03059,PF02897:PF01960:PF00930,5,31,4,1,27,986,0.13,0.97,0.8,0.31,7,2,3,5,1008,0.29,0.99,0.4,0.33
PF00107,PF08240:PF16912:PF08242,95,109,81,14,28,895,0.74,0.96,0.85,0.77,28,26,69,2,921,0.93,0.93,0.27,0.48
PF16330,PF12128:PF08466:PF07324,2,4,0,2,4,1012,0.0,0.99,0.0,-0.0,0,0,2,0,1016,0,1.0,0.0,0
PF02393,PF02427:PF07961:PF02950,0,1,0,0,1,1017,0.0,1.0,0,0,0,0,0,0,1018,0,1.0,0,0
PF05691,PF10288:PF11899:PF12831,12,18,6,6,12,994,0.33,0.98,0.5,0.4,0,0,12,0,1006,0,0.99,0.0,0
PF09064,PF03954:PF08391:PF09006,3,2,2,1,0,1015,1.0,1.0,0.67,0.82,0,0,3,0,1015,0,1.0,0.0,0
PF01129,PF12020:PF00143:PF10160,9,1,0,9,1,1008,0.0,0.99,0.0,-0.0,0,0,9,0,1009,0,0.99,0.0,0
PF01311,PF01752:PF17049:PF15207,0,4,0,0,4,1014,0.0,1.0,0,0,0,0,0,0,1018,0,1.0,0,0
PF13475,PF03516:PF08332:PF02420,11,8,3,8,5,1002,0.38,0.99,0.27,0.31,0,0,11,0,1007,0,0.99,0.0,0
PF13808,PF15518:PF14841:PF01706,2,2,0,2,2,1014,0.0,1.0,0.0,-0.0,1,0,2,1,1015,0.0,1.0,0.0,-0.0
PF03167,PF15342:PF09282:PF13864,21,11,3,18,8,989,0.27,0.97,0.14,0.19,1,1,20,0,997,1.0,0.98,0.05,0.22
PF07713,PF12457:PF13821:PF09750,11,27,6,5,21,986,0.22,0.97,0.55,0.34,4,3,8,1,1006,0.75,0.99,0.27,0.45
PF16018,PF10193:PF06972:PF02040,1,24,0,1,24,993,0.0,0.98,0.0,-0.0,2,0,1,2,1015,0.0,1.0,0.0,-0.0
PF16327,PF01578:PF11817:PF05758,1,10,1,0,9,1008,0.1,0.99,1.0,0.31,2,0,1,2,1015,0.0,1.0,0.0,-0.0
PF15555,PF15809:PF14866:PF12724,1,0,0,1,0,1017,0,1.0,0.0,0,0,0,1,0,1017,0,1.0,0.0,0
PF06079,PF02290:PF02127:PF03803,10,28,7,3,21,987,0.25,0.98,0.7,0.41,5,3,7,2,1006,0.6,0.99,0.3,0.42
PF16530,PF11057:PF15837:PF08040,0,1,0,0,1,1017,0.0,1.0,0,0,0,0,0,0,1018,0,1.0,0,0
PF02262,PF02762:PF02761:PF04571,5,15,5,0,10,1003,0.33,0.99,1.0,0.57,5,4,1,1,1012,0.8,1.0,0.8,0.8
PF12255,PF12256:PF03534:PF09327,0,0,0,0,0,1018,0,1.0,0,0,0,0,0,0,1018,0,1.0,0,0
PF00544,PF12146:PF03634:PF02517,25,60,14,11,46,947,0.23,0.94,0.56,0.34,9,4,21,5,988,0.44,0.97,0.16,0.26
PF05335,PF00468:PF07172:PF06446,2,6,0,2,6,1010,0.0,0.99,0.0,-0.0,0,0,2,0,1016,0,1.0,0.0,0
PF04013,PF07805:PF05513:PF11874,1,2,0,1,2,1015,0.0,1.0,0.0,-0.0,0,0,1,0,1017,0,1.0,0.0,0
PF00750,PF03485:PF05746:PF12739,28,36,26,2,10,980,0.72,0.99,0.93,0.81,18,17,11,1,989,0.94,0.99,0.61,0.75
PF02369,PF15518:PF03710:PF17060,0,5,0,0,5,1013,0.0,1.0,0,0,0,0,0,0,1018,0,1.0,0,0
PF16088,PF07914:PF04277:PF03718,1,11,1,0,10,1007,0.09,0.99,1.0,0.3,0,0,1,0,1017,0,1.0,0.0,0
PF02756,PF02757:PF00353:PF10937,0,4,0,0,4,1014,0.0,1.0,0,0,0,0,0,0,1018,0,1.0,0,0
PF08092,PF08089:PF11317:PF02531,1,2,0,1,2,1015,0.0,1.0,0.0,-0.0,0,0,1,0,1017,0,1.0,0.0,0
PF08537,PF08210:PF08766:PF15943,0,38,0,0,38,980,0.0,0.96,0,0,2,0,0,2,1016,0.0,1.0,0,0
PF15831,PF15063:PF06907:PF15055,0,2,0,0,2,1016,0.0,1.0,0,0,0,0,0,0,1018,0,1.0,0,0
PF08104,PF13368:PF12047:PF16885,0,17,0,0,17,1001,0.0,0.98,0,0,3,0,0,3,1015,0.0,1.0,0,0
PF10260,PF01599:PF10213:PF15810,2,15,1,1,14,1002,0.07,0.99,0.5,0.18,2,1,1,1,1015,0.5,1.0,0.5,0.5
PF00877,PF01810:PF09991:PF06756,2,8,0,2,8,1008,0.0,0.99,0.0,-0.0,0,0,2,0,1016,0,1.0,0.0,0
PF05047,PF02284:PF00210:PF04176,10,21,6,4,15,993,0.29,0.98,0.6,0.41,6,3,7,3,1005,0.5,0.99,0.3,0.38
PF14666,PF14663:PF14664:PF14668,10,12,10,0,2,1006,0.83,1.0,1.0,0.91,12,10,0,2,1006,0.83,1.0,1.0,0.91
PF12169,PF15862:PF10395:PF14952,1,3,0,1,3,1014,0.0,1.0,0.0,-0.0,2,0,1,2,1015,0.0,1.0,0.0,-0.0
PF01370,PF13460:PF01073:PF16363,71,74,34,37,40,907,0.46,0.92,0.48,0.43,22,22,49,0,947,1.0,0.95,0.31,0.54
PF14773,PF09463:PF10446:PF05030,8,6,0,8,6,1004,0.0,0.99,0.0,-0.01,1,0,8,1,1009,0.0,0.99,0.0,-0.0
PF06683,PF12121:PF01114:PF00323,0,1,0,0,1,1017,0.0,1.0,0,0,0,0,0,0,1018,0,1.0,0,0
PF08822,PF13901:PF12430:PF10367,0,37,0,0,37,981,0.0,0.96,0,0,6,0,0,6,1012,0.0,0.99,0,0
PF16875,PF16874:PF02065:PF16711,1,6,1,0,5,1012,0.17,1.0,1.0,0.41,1,1,0,0,1017,1.0,1.0,1.0,1.0
PF00218,PF00697:PF00977:PF04715,4,30,3,1,27,987,0.1,0.97,0.75,0.27,3,1,3,2,1012,0.33,1.0,0.25,0.29
PF13700,PF02217:PF01752:PF04349,1,5,1,0,4,1013,0.2,1.0,1.0,0.45,0,0,1,0,1017,0,1.0,0.0,0
PF11958,PF16871:PF07085:PF00073,5,17,1,4,16,997,0.06,0.98,0.2,0.1,1,1,4,0,1013,1.0,1.0,0.2,0.45
PF03987,PF03986:PF10381:PF01106,15,25,12,3,13,990,0.48,0.98,0.8,0.61,9,9,6,0,1003,1.0,0.99,0.6,0.77
PF08120,PF05284:PF04927:PF00333,2,21,0,2,21,995,0.0,0.98,0.0,-0.01,1,0,2,1,1015,0.0,1.0,0.0,-0.0
PF03601,PF05874:PF08642:PF15553,0,1,0,0,1,1017,0.0,1.0,0,0,0,0,0,0,1018,0,1.0,0,0
PF11955,PF02431:PF14368:PF04690,7,17,4,3,13,998,0.24,0.98,0.57,0.36,2,2,5,0,1011,1.0,1.0,0.29,0.53
PF06803,PF08941:PF15451:PF04757,9,33,4,5,29,980,0.12,0.97,0.44,0.22,4,3,6,1,1008,0.75,0.99,0.33,0.5
PF08145,PF04494:PF04158:PF10313,4,18,2,2,16,998,0.11,0.98,0.5,0.23,2,1,3,1,1013,0.5,1.0,0.25,0.35
PF07681,PF01654:PF07954:PF05218,2,8,2,0,6,1010,0.25,0.99,1.0,0.5,0,0,2,0,1016,0,1.0,0.0,0
PF16787,PF12550:PF08655:PF05508,18,11,8,10,3,997,0.73,0.99,0.44,0.56,0,0,18,0,1000,0,0.98,0.0,0
PF07991,PF01450:PF08622:PF17187,8,13,8,0,5,1005,0.62,1.0,1.0,0.78,2,0,8,2,1008,0.0,0.99,0.0,-0.0
PF15387,PF05838:PF16259:PF06505,2,0,0,2,0,1016,0,1.0,0.0,0,0,0,2,0,1016,0,1.0,0.0,0
PF01155,PF03831:PF01943:PF13247,2,0,0,2,0,1016,0,1.0,0.0,0,0,0,2,0,1016,0,1.0,0.0,0
PF14803,PF15916:PF09297:PF05026,4,17,3,1,14,1000,0.18,0.99,0.75,0.36,4,1,3,3,1011,0.25,0.99,0.25,0.25
PF09429,PF00649:PF14661:PF15678,9,9,1,8,8,1001,0.11,0.98,0.11,0.1,0,0,9,0,1009,0,0.99,0.0,0
PF10370,PF05913:PF04993:PF13026,1,1,0,1,1,1016,0.0,1.0,0.0,-0.0,0,0,1,0,1017,0,1.0,0.0,0
PF16049,PF10410:PF03865:PF14564,0,5,0,0,5,1013,0.0,1.0,0,0,0,0,0,0,1018,0,1.0,0,0
PF15758,PF00796:PF06681:PF01312,0,0,0,0,0,1018,0,1.0,0,0,0,0,0,0,1018,0,1.0,0,0
PF12064,PF10513:PF17105:PF12157,3,29,1,2,28,987,0.03,0.97,0.33,0.1,4,1,2,3,1012,0.25,1.0,0.33,0.29
PF02606,PF01701:PF15252:PF10166,2,3,0,2,3,1013,0.0,1.0,0.0,-0.0,0,0,2,0,1016,0,1.0,0.0,0
PF01133,PF04253:PF09112:PF04481,3,18,0,3,18,997,0.0,0.98,0.0,-0.01,0,0,3,0,1015,0,1.0,0.0,0
PF04859,PF04833:PF06830:PF12579,3,2,0,3,2,1013,0.0,1.0,0.0,-0.0,0,0,3,0,1015,0,1.0,0.0,0
PF03370,PF15247:PF02045:PF09756,6,15,3,3,12,1000,0.2,0.99,0.5,0.31,3,1,5,2,1010,0.33,0.99,0.17,0.23
PF14252,PF06395:PF15720:PF15441,5,8,2,3,6,1007,0.25,0.99,0.4,0.31,2,2,3,0,1013,1.0,1.0,0.4,0.63
PF15038,PF08034:PF12926:PF04852,1,5,1,0,4,1013,0.2,1.0,1.0,0.45,0,0,1,0,1017,0,1.0,0.0,0
PF03603,PF06005:PF00004:PF11811,3,157,1,2,156,859,0.01,0.84,0.33,0.03,0,0,3,0,1015,0,1.0,0.0,0
PF00488,PF05192:PF05188:PF05190,43,39,36,7,3,972,0.92,0.99,0.84,0.87,28,25,18,3,972,0.89,0.98,0.58,0.71
PF04986,PF03050:PF15186:PF10974,2,1,0,2,1,1015,0.0,1.0,0.0,-0.0,0,0,2,0,1016,0,1.0,0.0,0
PF01302,PF14560:PF16641:PF15898,46,15,10,36,5,967,0.67,0.96,0.22,0.37,1,1,45,0,972,1.0,0.96,0.02,0.14
PF05648,PF04371:PF11807:PF03972,14,16,5,9,11,993,0.31,0.98,0.36,0.32,4,3,11,1,1003,0.75,0.99,0.21,0.4
PF15448,PF15447:PF05104:PF07133,1,1,1,0,0,1017,1.0,1.0,1.0,1.0,1,1,0,0,1017,1.0,1.0,1.0,1.0
PF00647,PF02798:PF06441:PF16780,11,56,9,2,47,960,0.16,0.95,0.82,0.35,6,2,9,4,1003,0.33,0.99,0.18,0.24
PF02046,PF16053:PF10244:PF01470,3,23,1,2,22,993,0.04,0.98,0.33,0.11,5,1,2,4,1011,0.2,0.99,0.33,0.26
PF11397,PF09132:PF05636:PF05507,7,7,1,6,6,1005,0.14,0.99,0.14,0.14,0,0,7,0,1011,0,0.99,0.0,0
PF03162,PF07896:PF04410:PF11927,4,36,2,2,34,980,0.06,0.96,0.5,0.16,5,2,2,3,1011,0.4,1.0,0.5,0.44
PF08089,PF08092:PF04691:PF14986,0,2,0,0,2,1016,0.0,1.0,0,0,0,0,0,0,1018,0,1.0,0,0
PF14529,PF12009:PF13966:PF00075,45,121,27,18,94,879,0.22,0.89,0.6,0.32,20,10,35,10,963,0.5,0.96,0.22,0.31
PF15149,PF15395:PF16748:PF15027,1,0,0,1,0,1017,0,1.0,0.0,0,0,0,1,0,1017,0,1.0,0.0,0
PF10566,PF10908:PF07157:PF06798,0,0,0,0,0,1018,0,1.0,0,0,0,0,0,0,1018,0,1.0,0,0
PF15209,PF03317:PF08189:PF05155,0,5,0,0,5,1013,0.0,1.0,0,0,0,0,0,0,1018,0,1.0,0,0
PF00325,PF10137:PF15666:PF13545,1,3,1,0,2,1015,0.33,1.0,1.0,0.58,0,0,1,0,1017,0,1.0,0.0,0
PF08542,PF14629:PF08740:PF14363,18,26,7,11,19,981,0.27,0.97,0.39,0.31,4,4,14,0,1000,1.0,0.99,0.22,0.47
PF04383,PF10544:PF04665:PF03288,5,12,2,3,10,1003,0.17,0.99,0.4,0.25,3,1,4,2,1011,0.33,0.99,0.2,0.26
PF00297,PF01012:PF00252:PF00203,17,50,8,9,42,959,0.16,0.95,0.47,0.25,9,6,11,3,998,0.67,0.99,0.35,0.48
PF15383,PF00127:PF15503:PF11016,9,4,0,9,4,1005,0.0,0.99,0.0,-0.01,0,0,9,0,1009,0,0.99,0.0,0
PF10522,PF05716:PF15499:PF14644,5,12,2,3,10,1003,0.17,0.99,0.4,0.25,0,0,5,0,1013,0,1.0,0.0,0
PF01376,PF04366:PF11464:PF02894,0,35,0,0,35,983,0.0,0.97,0,0,5,0,0,5,1013,0.0,1.0,0,0
PF11614,PF13746:PF04984:PF02501,4,6,4,0,2,1012,0.67,1.0,1.0,0.82,0,0,4,0,1014,0,1.0,0.0,0
PF12222,PF03981:PF01040:PF14159,9,39,5,4,34,975,0.13,0.96,0.56,0.25,4,1,8,3,1006,0.25,0.99,0.11,0.16
PF01049,PF00028:PF00054:PF01463,7,57,7,0,50,961,0.12,0.95,1.0,0.34,9,2,5,7,1004,0.22,0.99,0.29,0.25
PF12679,PF12040:PF12080:PF10566,0,0,0,0,0,1018,0,1.0,0,0,0,0,0,0,1018,0,1.0,0,0
PF09580,PF13828:PF01825:PF05613,0,33,0,0,33,985,0.0,0.97,0,0,0,0,0,0,1018,0,1.0,0,0
PF05186,PF00334:PF16553:PF03666,20,28,6,14,22,976,0.21,0.96,0.3,0.24,2,2,18,0,998,1.0,0.98,0.1,0.31
PF12026,PF08824:PF03983:PF08397,4,13,2,2,11,1003,0.15,0.99,0.5,0.27,1,1,3,0,1014,1.0,1.0,0.25,0.5
PF13174,PF05279:PF08492:PF17004,14,9,4,10,5,999,0.44,0.99,0.29,0.35,6,4,10,2,1002,0.67,0.99,0.29,0.43
PF00573,PF14374:PF03386:PF04063,18,14,10,8,4,996,0.71,0.99,0.56,0.62,1,1,17,0,1000,1.0,0.98,0.06,0.23
PF04348,PF12437:PF04556:PF12867,1,10,0,1,10,1007,0.0,0.99,0.0,-0.0,0,0,1,0,1017,0,1.0,0.0,0
PF10150,PF09371:PF16921:PF08206,4,3,1,3,2,1012,0.33,1.0,0.25,0.29,3,1,3,2,1012,0.33,1.0,0.25,0.29
PF10551,PF04434:PF03101:PF03108,56,43,30,26,13,949,0.7,0.96,0.54,0.59,20,17,39,3,959,0.85,0.96,0.3,0.49
PF07224,PF11017:PF01701:PF15319,3,1,0,3,1,1014,0.0,1.0,0.0,-0.0,0,0,3,0,1015,0,1.0,0.0,0
PF10347,PF10293:PF10351:PF10344,5,8,5,0,3,1010,0.62,1.0,1.0,0.79,5,5,0,0,1013,1.0,1.0,1.0,1.0
PF09598,PF16174:PF04432:PF15285,1,2,0,1,2,1015,0.0,1.0,0.0,-0.0,0,0,1,0,1017,0,1.0,0.0,0
PF02109,PF12006:PF14832:PF14955,5,13,1,4,12,1001,0.08,0.98,0.2,0.12,3,1,4,2,1011,0.33,0.99,0.2,0.26
PF15680,PF14866:PF15085:PF15809,0,2,0,0,2,1016,0.0,1.0,0,0,0,0,0,0,1018,0,1.0,0,0
PF00036,PF13833:PF13405:PF13499,37,144,32,5,112,869,0.22,0.89,0.86,0.4,50,26,11,24,957,0.52,0.97,0.7,0.59
PF13254,PF12520:PF12830:PF04811,2,34,1,1,33,983,0.03,0.97,0.5,0.12,4,0,2,4,1012,0.0,0.99,0.0,-0.0
PF08768,PF01549:PF05507:PF07210,3,47,3,0,44,971,0.06,0.96,1.0,0.25,3,0,3,3,1012,0.0,0.99,0.0,-0.0
PF15652,PF15756:PF07157:PF14196,0,1,0,0,1,1017,0.0,1.0,0,0,0,0,0,0,1018,0,1.0,0,0
PF14920,PF14918:PF14919:PF14654,0,0,0,0,0,1018,0,1.0,0,0,0,0,0,0,1018,0,1.0,0,0
PF07105,PF05926:PF02556:PF07348,0,5,0,0,5,1013,0.0,1.0,0,0,0,0,0,0,1018,0,1.0,0,0
PF00915,PF15518:PF15976:PF13722,1,1,0,1,1,1016,0.0,1.0,0.0,-0.0,0,0,1,0,1017,0,1.0,0.0,0
PF03575,PF05405:PF01632:PF10218,1,12,0,1,12,1005,0.0,0.99,0.0,-0.0,1,0,1,1,1016,0.0,1.0,0.0,-0.0
PF02482,PF16829:PF15722:PF00323,2,0,0,2,0,1016,0,1.0,0.0,0,0,0,2,0,1016,0,1.0,0.0,0
PF15452,PF15912:PF15326:PF15914,5,6,1,4,5,1008,0.17,0.99,0.2,0.18,0,0,5,0,1013,0,1.0,0.0,0
PF15247,PF06413:PF10180:PF15264,7,17,2,5,15,996,0.12,0.98,0.29,0.17,2,0,7,2,1009,0.0,0.99,0.0,-0.0
PF14388,PF12680:PF01083:PF01670,13,23,4,9,19,986,0.17,0.97,0.31,0.22,6,4,9,2,1003,0.67,0.99,0.31,0.45
PF03381,PF07896:PF04176:PF02104,18,19,6,12,13,987,0.32,0.98,0.33,0.31,2,1,17,1,999,0.5,0.98,0.06,0.16
PF15666,PF11317:PF05564:PF02448,0,1,0,0,1,1017,0.0,1.0,0,0,0,0,0,0,1018,0,1.0,0,0
PF14092,PF11249:PF12357:PF08116,0,7,0,0,7,1011,0.0,0.99,0,0,0,0,0,0,1018,0,1.0,0,0
PF02113,PF02277:PF06890:PF14882,1,3,0,1,3,1014,0.0,1.0,0.0,-0.0,0,0,1,0,1017,0,1.0,0.0,0
PF16653,PF04455:PF05222:PF02233,13,20,10,3,10,995,0.5,0.99,0.77,0.61,8,6,7,2,1003,0.75,0.99,0.46,0.58
PF07086,PF09347:PF15384:PF06937,0,5,0,0,5,1013,0.0,1.0,0,0,0,0,0,0,1018,0,1.0,0,0
PF15270,PF09937:PF16980:PF00571,1,59,0,1,59,958,0.0,0.94,0.0,-0.01,0,0,1,0,1017,0,1.0,0.0,0
PF13091,PF00614:PF13918:PF12357,29,21,14,15,7,982,0.67,0.98,0.48,0.56,7,5,24,2,987,0.71,0.97,0.17,0.34
PF05517,PF03607:PF12474:PF02755,9,24,4,5,20,989,0.17,0.98,0.44,0.26,9,2,7,7,1002,0.22,0.99,0.22,0.22
PF01198,PF02284:PF00143:PF00124,24,9,2,22,7,987,0.22,0.97,0.08,0.12,0,0,24,0,994,0,0.98,0.0,0
PF10238,PF07139:PF07260:PF15298,6,5,1,5,4,1008,0.2,0.99,0.17,0.18,0,0,6,0,1012,0,0.99,0.0,0
PF07813,PF07421:PF15667:PF15775,0,1,0,0,1,1017,0.0,1.0,0,0,0,0,0,0,1018,0,1.0,0,0
PF14607,PF13205:PF13746:PF13663,0,9,0,0,9,1009,0.0,0.99,0,0,0,0,0,0,1018,0,1.0,0,0
PF12516,PF11822:PF10309:PF15249,0,21,0,0,21,997,0.0,0.98,0,0,4,0,0,4,1014,0.0,1.0,0,0
PF08634,PF16944:PF05508:PF12927,2,5,0,2,5,1011,0.0,0.99,0.0,-0.0,1,0,2,1,1015,0.0,1.0,0.0,-0.0
PF06374,PF16752:PF13735:PF09287,2,6,0,2,6,1010,0.0,0.99,0.0,-0.0,0,0,2,0,1016,0,1.0,0.0,0
PF15129,PF14984:PF11630:PF00758,1,3,1,0,2,1015,0.33,1.0,1.0,0.58,0,0,1,0,1017,0,1.0,0.0,0
PF13683,PF08298:PF07411:PF11202,8,0,0,8,0,1010,0,0.99,0.0,0,0,0,8,0,1010,0,0.99,0.0,0
PF09788,PF15905:PF03470:PF07651,5,22,4,1,18,995,0.18,0.98,0.8,0.38,2,1,4,1,1012,0.5,1.0,0.2,0.31
PF12686,PF04222:PF03831:PF10995,0,0,0,0,0,1018,0,1.0,0,0,0,0,0,0,1018,0,1.0,0,0
PF09272,PF02983:PF16030:PF15494,4,18,2,2,16,998,0.11,0.98,0.5,0.23,2,1,3,1,1013,0.5,1.0,0.25,0.35
PF00394,PF07732:PF07731:PF00891,43,73,43,0,30,945,0.59,0.97,1.0,0.76,47,41,2,6,969,0.87,0.99,0.95,0.91
PF15824,PF11863:PF07411:PF06744,1,0,0,1,0,1017,0,1.0,0.0,0,0,0,1,0,1017,0,1.0,0.0,0
PF08483,PF05857:PF13247:PF12241,1,1,0,1,1,1016,0.0,1.0,0.0,-0.0,0,0,1,0,1017,0,1.0,0.0,0
PF14838,PF14837:PF02128:PF07504,4,5,3,1,2,1012,0.6,1.0,0.75,0.67,3,1,3,2,1012,0.33,1.0,0.25,0.29
PF06396,PF16594:PF08656:PF15055,3,3,2,1,1,1014,0.67,1.0,0.67,0.67,0,0,3,0,1015,0,1.0,0.0,0
PF16717,PF08558:PF07988:PF14379,10,12,2,8,10,998,0.17,0.98,0.2,0.17,0,0,10,0,1008,0,0.99,0.0,0
PF10691,PF11861:PF01585:PF07780,1,71,1,0,70,947,0.01,0.93,1.0,0.11,15,1,0,14,1003,0.07,0.99,1.0,0.26
PF16486,PF08699:PF16488:PF02170,33,48,33,0,15,970,0.69,0.99,1.0,0.82,40,33,0,7,978,0.82,0.99,1.0,0.91
PF15932,PF09697:PF08538:PF07080,0,7,0,0,7,1011,0.0,0.99,0,0,1,0,0,1,1017,0.0,1.0,0,0
PF02256,PF02906:PF00037:PF12617,4,25,4,0,21,993,0.16,0.98,1.0,0.4,4,2,2,2,1012,0.5,1.0,0.5,0.5
PF07821,PF16028:PF02922:PF02806,9,23,4,5,19,990,0.17,0.98,0.44,0.27,13,4,5,9,1000,0.31,0.99,0.44,0.36
PF00885,PF03488:PF10868:PF11264,10,2,0,10,2,1006,0.0,0.99,0.0,-0.0,0,0,10,0,1008,0,0.99,0.0,0
PF09360,PF10660:PF00525:PF10261,16,7,2,14,5,997,0.29,0.98,0.12,0.18,1,0,16,1,1001,0.0,0.98,0.0,-0.0
PF03118,PF01333:PF16639:PF01000,6,15,4,2,11,1001,0.27,0.99,0.67,0.42,5,0,6,5,1007,0.0,0.99,0.0,-0.01
PF08514,PF04048:PF14649:PF11028,13,16,5,8,11,994,0.31,0.98,0.38,0.34,0,0,13,0,1005,0,0.99,0.0,0
PF13136,PF05129:PF13564:PF10203,4,22,1,3,21,993,0.05,0.98,0.25,0.1,1,0,4,1,1013,0.0,1.0,0.0,-0.0
PF10032,PF15378:PF12294:PF01303,4,0,0,4,0,1014,0,1.0,0.0,0,0,0,4,0,1014,0,1.0,0.0,0
PF13694,PF15400:PF16670:PF06724,0,1,0,0,1,1017,0.0,1.0,0,0,0,0,0,0,1018,0,1.0,0,0
PF11601,PF11879:PF11933:PF11404,3,7,3,0,4,1011,0.43,1.0,1.0,0.65,1,1,2,0,1015,1.0,1.0,0.33,0.58
PF05676,PF01279:PF10775:PF13741,7,4,1,6,3,1008,0.25,0.99,0.14,0.18,0,0,7,0,1011,0,0.99,0.0,0
PF03821,PF03261:PF02988:PF11069,0,8,0,0,8,1010,0.0,0.99,0,0,0,0,0,0,1018,0,1.0,0,0
PF10034,PF08925:PF12150:PF07324,13,11,4,9,7,998,0.36,0.98,0.31,0.33,0,0,13,0,1005,0,0.99,0.0,0
PF04387,PF01370:PF05089:PF12972,19,76,8,11,68,931,0.11,0.92,0.42,0.18,10,4,15,6,993,0.4,0.98,0.21,0.28
PF12051,PF10276:PF09805:PF09340,6,15,0,6,15,997,0.0,0.98,0.0,-0.01,1,0,6,1,1011,0.0,0.99,0.0,-0.0
PF07757,PF04516:PF03359:PF10179,12,17,3,9,14,992,0.18,0.98,0.25,0.2,3,1,11,2,1004,0.33,0.99,0.08,0.16
PF09200,PF01419:PF15919:PF00393,0,22,0,0,22,996,0.0,0.98,0,0,5,0,0,5,1013,0.0,1.0,0,0
PF13183,PF17221:PF10303:PF02754,9,9,7,2,2,1007,0.78,1.0,0.78,0.78,0,0,9,0,1009,0,0.99,0.0,0
PF00612,PF10580:PF06614:PF13178,62,6,5,57,1,955,0.83,0.94,0.08,0.25,1,1,61,0,956,1.0,0.94,0.02,0.12
PF02377,PF12316:PF00778:PF09007,4,10,3,1,7,1007,0.3,0.99,0.75,0.47,3,2,2,1,1013,0.67,1.0,0.5,0.58
PF01529,PF00710:PF01734:PF17175,56,65,23,33,42,920,0.35,0.93,0.41,0.34,13,9,47,4,958,0.69,0.95,0.16,0.32
PF10205,PF17045:PF15905:PF09762,2,3,1,1,2,1014,0.33,1.0,0.5,0.41,1,1,1,0,1016,1.0,1.0,0.5,0.71
PF06887,PF01580:PF10618:PF05065,0,6,0,0,6,1012,0.0,0.99,0,0,0,0,0,0,1018,0,1.0,0,0
PF03177,PF08801:PF05593:PF03511,15,20,14,1,6,997,0.7,0.99,0.93,0.81,1,1,14,0,1003,1.0,0.99,0.07,0.26
PF03943,PF09162:PF02136:PF05620,5,21,4,1,17,996,0.19,0.98,0.8,0.39,5,3,2,2,1011,0.6,1.0,0.6,0.6
PF04921,PF09496:PF02083:PF03908,11,16,3,8,13,994,0.19,0.98,0.27,0.22,2,0,11,2,1005,0.0,0.99,0.0,-0.0
PF06176,PF07930:PF11954:PF01427,0,10,0,0,10,1008,0.0,0.99,0,0,0,0,0,0,1018,0,1.0,0,0
PF01744,PF11617:PF02983:PF15494,9,12,3,6,9,1000,0.25,0.99,0.33,0.28,1,1,8,0,1009,1.0,0.99,0.11,0.33
PF15039,PF08002:PF06573:PF13588,0,4,0,0,4,1014,0.0,1.0,0,0,0,0,0,0,1018,0,1.0,0,0
PF07303,PF01284:PF10390:PF12886,10,33,9,1,24,984,0.27,0.98,0.9,0.49,8,6,4,2,1006,0.75,0.99,0.6,0.67
PF05793,PF10200:PF08661:PF07477,10,16,4,6,12,996,0.25,0.98,0.4,0.31,2,1,9,1,1007,0.5,0.99,0.1,0.22
PF15577,PF15856:PF04610:PF11751,3,4,1,2,3,1012,0.25,1.0,0.33,0.29,0,0,3,0,1015,0,1.0,0.0,0
PF15636,PF05593:PF06484:PF17205,1,10,1,0,9,1008,0.1,0.99,1.0,0.31,1,1,0,0,1017,1.0,1.0,1.0,1.0
PF02023,PF12417:PF01352:PF03732,15,78,11,4,67,936,0.14,0.93,0.73,0.3,25,10,5,15,988,0.4,0.98,0.67,0.51
PF04252,PF08345:PF12080:PF14292,4,2,0,4,2,1012,0.0,0.99,0.0,-0.0,0,0,4,0,1014,0,1.0,0.0,0
PF06309,PF07542:PF01758:PF01733,4,33,2,2,31,983,0.06,0.97,0.5,0.17,4,2,2,2,1012,0.5,1.0,0.5,0.5
PF15784,PF10506:PF15368:PF11559,0,11,0,0,11,1007,0.0,0.99,0,0,0,0,0,0,1018,0,1.0,0,0
PF06398,PF06462:PF08150:PF00337,15,33,6,9,27,976,0.18,0.96,0.4,0.25,5,3,12,2,1001,0.6,0.99,0.2,0.34
PF01126,PF09805:PF10276:PF10248,10,13,2,8,11,997,0.15,0.98,0.2,0.17,0,0,10,0,1008,0,0.99,0.0,0
PF02353,PF01593:PF02027:PF07103,13,65,8,5,57,948,0.12,0.94,0.62,0.26,1,1,12,0,1005,1.0,0.99,0.08,0.28
PF01815,PF04958:PF17009:PF09655,0,3,0,0,3,1015,0.0,1.0,0,0,0,0,0,0,1018,0,1.0,0,0
PF08195,PF05811:PF08096:PF10327,0,9,0,0,9,1009,0.0,0.99,0,0,0,0,0,0,1018,0,1.0,0,0
PF01571,PF08669:PF16350:PF10170,26,28,24,2,4,988,0.86,0.99,0.92,0.89,10,10,16,0,992,1.0,0.98,0.38,0.62
PF16621,PF08944:PF03700:PF13924,2,8,2,0,6,1010,0.25,0.99,1.0,0.5,2,2,0,0,1016,1.0,1.0,1.0,1.0
PF08194,PF11630:PF15972:PF14672,0,0,0,0,0,1018,0,1.0,0,0,0,0,0,0,1018,0,1.0,0,0
PF01428,PF01754:PF05839:PF02099,26,19,8,18,11,981,0.42,0.97,0.31,0.35,3,2,24,1,991,0.67,0.98,0.08,0.22
PF04899,PF10056:PF08632:PF06626,0,7,0,0,7,1011,0.0,0.99,0,0,1,0,0,1,1017,0.0,1.0,0,0
PF15388,PF03298:PF05308:PF15390,2,6,1,1,5,1011,0.17,0.99,0.5,0.29,0,0,2,0,1016,0,1.0,0.0,0
PF15923,PF15997:PF02200:PF14465,1,3,0,1,3,1014,0.0,1.0,0.0,-0.0,0,0,1,0,1017,0,1.0,0.0,0
PF16112,PF14114:PF09498:PF10566,1,1,1,0,0,1017,1.0,1.0,1.0,1.0,0,0,1,0,1017,0,1.0,0.0,0
PF08818,PF02369:PF15155:PF13211,0,4,0,0,4,1014,0.0,1.0,0,0,0,0,0,0,1018,0,1.0,0,0
PF13915,PF16788:PF12885:PF12830,6,13,3,3,10,1002,0.23,0.99,0.5,0.33,1,1,5,0,1012,1.0,1.0,0.17,0.41
PF14902,PF05762:PF06586:PF11542,1,6,1,0,5,1012,0.17,1.0,1.0,0.41,0,0,1,0,1017,0,1.0,0.0,0
PF07919,PF12742:PF11817:PF12584,3,14,3,0,11,1004,0.21,0.99,1.0,0.46,4,2,1,2,1013,0.5,1.0,0.67,0.58
PF12006,PF14087:PF10340:PF03379,6,10,1,5,9,1003,0.1,0.99,0.17,0.12,0,0,6,0,1012,0,0.99,0.0,0
PF15364,PF06541:PF15715:PF15063,0,0,0,0,0,1018,0,1.0,0,0,0,0,0,0,1018,0,1.0,0,0
PF09079,PF16725:PF14630:PF12002,10,21,3,7,18,990,0.14,0.98,0.3,0.2,3,2,8,1,1007,0.67,0.99,0.2,0.36
PF02824,PF16897:PF01018:PF09269,24,17,13,11,4,990,0.76,0.99,0.54,0.64,5,5,19,0,994,1.0,0.98,0.21,0.45
PF08183,PF15082:PF04610:PF15407,0,6,0,0,6,1012,0.0,0.99,0,0,0,0,0,0,1018,0,1.0,0,0
PF06959,PF02107:PF16833:PF12753,2,3,0,2,3,1013,0.0,1.0,0.0,-0.0,0,0,2,0,1016,0,1.0,0.0,0
PF14923,PF02187:PF08976:PF06039,2,19,2,0,17,999,0.11,0.98,1.0,0.32,3,1,1,2,1014,0.33,1.0,0.5,0.41
PF07593,PF10393:PF09064:PF10912,1,4,1,0,3,1014,0.25,1.0,1.0,0.5,2,1,0,1,1016,0.5,1.0,1.0,0.71
PF07763,PF06083:PF00811:PF15383,1,18,0,1,18,999,0.0,0.98,0.0,-0.0,3,0,1,3,1014,0.0,1.0,0.0,-0.0
PF04183,PF06276:PF14231:PF09051,2,2,2,0,0,1016,1.0,1.0,1.0,1.0,0,0,2,0,1016,0,1.0,0.0,0
PF04124,PF04981:PF05334:PF09804,8,9,1,7,8,1002,0.11,0.99,0.12,0.11,0,0,8,0,1010,0,0.99,0.0,0
PF05638,PF00796:PF15556:PF17076,1,0,0,1,0,1017,0,1.0,0.0,0,0,0,1,0,1017,0,1.0,0.0,0
PF16574,PF16830:PF11577:PF12297,2,4,0,2,4,1012,0.0,0.99,0.0,-0.0,0,0,2,0,1016,0,1.0,0.0,0
PF17007,PF11751:PF05513:PF08479,0,1,0,0,1,1017,0.0,1.0,0,0,0,0,0,0,1018,0,1.0,0,0
PF15268,PF16415:PF12842:PF14676,1,13,0,1,13,1004,0.0,0.99,0.0,-0.0,11,0,1,11,1006,0.0,0.99,0.0,-0.0
PF15826,PF03406:PF08497:PF12856,0,1,0,0,1,1017,0.0,1.0,0,0,0,0,0,0,1018,0,1.0,0,0
PF04627,PF08367:PF15098:PF16187,12,27,3,9,24,982,0.11,0.97,0.25,0.15,1,0,12,1,1005,0.0,0.99,0.0,-0.0
PF10583,PF06994:PF00904:PF15362,0,1,0,0,1,1017,0.0,1.0,0,0,0,0,0,0,1018,0,1.0,0,0
PF15369,PF08528:PF06365:PF15669,2,11,1,1,10,1006,0.09,0.99,0.5,0.21,0,0,2,0,1016,0,1.0,0.0,0
PF11250,PF02234:PF15264:PF17098,2,15,1,1,14,1002,0.07,0.99,0.5,0.18,1,0,2,1,1015,0.0,1.0,0.0,-0.0
PF16551,PF16568:PF16274:PF16544,1,5,1,0,4,1013,0.2,1.0,1.0,0.45,1,1,0,0,1017,1.0,1.0,1.0,1.0
PF14881,PF10644:PF08631:PF00940,10,22,7,3,15,993,0.32,0.98,0.7,0.46,3,0,10,3,1005,0.0,0.99,0.0,-0.01
PF09088,PF09090:PF02854:PF02847,11,38,11,0,27,980,0.29,0.97,1.0,0.53,21,9,2,12,995,0.43,0.99,0.82,0.59
PF05787,PF08411:PF08334:PF07964,0,3,0,0,3,1015,0.0,1.0,0,0,0,0,0,0,1018,0,1.0,0,0
PF03921,PF11465:PF07204:PF06583,4,6,2,2,4,1010,0.33,0.99,0.5,0.41,1,1,3,0,1014,1.0,1.0,0.25,0.5
PF08040,PF15664:PF04691:PF05355,1,3,0,1,3,1014,0.0,1.0,0.0,-0.0,1,0,1,1,1016,0.0,1.0,0.0,-0.0
PF11523,PF04990:PF04992:PF04983,8,32,5,3,27,983,0.16,0.97,0.62,0.3,4,3,5,1,1009,0.75,0.99,0.38,0.53
PF15382,PF15033:PF15748:PF10412,2,2,2,0,0,1016,1.0,1.0,1.0,1.0,0,0,2,0,1016,0,1.0,0.0,0
PF01765,PF12483:PF10173:PF14769,10,10,1,9,9,999,0.1,0.98,0.1,0.09,1,0,10,1,1007,0.0,0.99,0.0,-0.0
PF09141,PF08913:PF01608:PF16511,10,30,10,0,20,988,0.33,0.98,1.0,0.57,9,8,2,1,1007,0.89,1.0,0.8,0.84
PF06056,PF03553:PF16055:PF06890,1,1,0,1,1,1016,0.0,1.0,0.0,-0.0,0,0,1,0,1017,0,1.0,0.0,0
PF12873,PF14251:PF12658:PF07209,0,4,0,0,4,1014,0.0,1.0,0,0,0,0,0,0,1018,0,1.0,0,0
PF10236,PF05602:PF02186:PF01786,7,30,5,2,25,986,0.17,0.97,0.71,0.34,5,5,2,0,1011,1.0,1.0,0.71,0.84
PF05647,PF14654:PF14920:PF14919,0,0,0,0,0,1018,0,1.0,0,0,0,0,0,0,1018,0,1.0,0,0
PF03945,PF16401:PF12600:PF14022,3,3,0,3,3,1012,0.0,0.99,0.0,-0.0,0,0,3,0,1015,0,1.0,0.0,0
PF12499,PF11765:PF02415:PF09770,1,7,0,1,7,1010,0.0,0.99,0.0,-0.0,0,0,1,0,1017,0,1.0,0.0,0
PF03465,PF03464:PF03463:PF04927,9,10,8,1,2,1007,0.8,1.0,0.89,0.84,8,8,1,0,1009,1.0,1.0,0.89,0.94
PF15077,PF08601:PF12498:PF03957,3,5,3,0,2,1013,0.6,1.0,1.0,0.77,2,2,1,0,1015,1.0,1.0,0.67,0.82
PF15099,PF15725:PF15097:PF14512,0,1,0,0,1,1017,0.0,1.0,0,0,0,0,0,0,1018,0,1.0,0,0
PF16980,PF05944:PF04849:PF15270,0,5,0,0,5,1013,0.0,1.0,0,0,0,0,0,0,1018,0,1.0,0,0
PF08761,PF01668:PF01316:PF10994,1,4,0,1,4,1013,0.0,1.0,0.0,-0.0,0,0,1,0,1017,0,1.0,0.0,0
PF01704,PF01652:PF09439:PF00119,27,36,8,19,28,963,0.22,0.95,0.3,0.23,5,2,25,3,988,0.4,0.97,0.07,0.16
PF09607,PF04236:PF09026:PF04218,10,17,3,7,14,994,0.18,0.98,0.3,0.22,5,2,8,3,1005,0.4,0.99,0.2,0.28
PF02333,PF02012:PF15636:PF06484,4,2,0,4,2,1012,0.0,0.99,0.0,-0.0,1,0,4,1,1013,0.0,1.0,0.0,-0.0
PF14914,PF15304:PF05866:PF07394,2,6,0,2,6,1010,0.0,0.99,0.0,-0.0,0,0,2,0,1016,0,1.0,0.0,0
PF04192,PF15512:PF13271:PF11816,8,20,4,4,16,994,0.2,0.98,0.5,0.31,4,2,6,2,1008,0.5,0.99,0.25,0.35
PF12903,PF15681:PF10216:PF05135,0,3,0,0,3,1015,0.0,1.0,0,0,0,0,0,0,1018,0,1.0,0,0
PF16582,PF02776:PF02775:PF13378,2,47,2,0,45,971,0.04,0.96,1.0,0.2,24,2,0,22,994,0.08,0.98,1.0,0.29
PF15760,PF04691:PF05836:PF15770,0,1,0,0,1,1017,0.0,1.0,0,0,0,0,0,0,1018,0,1.0,0,0
PF15785,PF08163:PF11640:PF08064,11,18,4,7,14,993,0.22,0.98,0.36,0.27,4,3,8,1,1006,0.75,0.99,0.27,0.45
PF15093,PF07891:PF15073:PF12600,2,2,0,2,2,1014,0.0,1.0,0.0,-0.0,0,0,2,0,1016,0,1.0,0.0,0
PF07061,PF04099:PF13334:PF12326,9,20,3,6,17,992,0.15,0.98,0.33,0.21,2,1,8,1,1008,0.5,0.99,0.11,0.23
PF15961,PF14664:PF14663:PF14666,1,12,0,1,12,1005,0.0,0.99,0.0,-0.0,10,0,1,10,1007,0.0,0.99,0.0,-0.0
PF07746,PF11800:PF12081:PF15150,0,0,0,0,0,1018,0,1.0,0,0,0,0,0,0,1018,0,1.0,0,0
PF00574,PF13664:PF04535:PF06749,18,17,5,13,12,988,0.29,0.98,0.28,0.27,3,3,15,0,1000,1.0,0.99,0.17,0.41
PF13842,PF13843:PF01710:PF12760,2,49,2,0,47,969,0.04,0.95,1.0,0.2,1,0,2,1,1015,0.0,1.0,0.0,-0.0
PF08825,PF16420:PF00899:PF16191,6,57,6,0,51,961,0.11,0.95,1.0,0.32,14,2,4,12,1000,0.14,0.98,0.33,0.21
PF04285,PF14841:PF01514:PF05513,0,2,0,0,2,1016,0.0,1.0,0,0,0,0,0,0,1018,0,1.0,0,0
PF13918,PF13091:PF12357:PF00614,6,35,5,1,30,982,0.14,0.97,0.83,0.34,14,3,3,11,1001,0.21,0.99,0.5,0.32
PF02565,PF04355:PF13247:PF06890,0,0,0,0,0,1018,0,1.0,0,0,0,0,0,0,1018,0,1.0,0,0
PF08095,PF03219:PF15072:PF15820,0,12,0,0,12,1006,0.0,0.99,0,0,0,0,0,0,1018,0,1.0,0,0
PF08281,PF04539:PF04545:PF00140,5,24,3,2,21,992,0.12,0.98,0.6,0.27,15,3,2,12,1001,0.2,0.99,0.6,0.34
PF01960,PF01680:PF06172:PF01774,11,13,1,10,12,995,0.08,0.98,0.09,0.07,1,1,10,0,1007,1.0,0.99,0.09,0.3
PF12247,PF12246:PF00867:PF00752,2,39,2,0,37,979,0.05,0.96,1.0,0.22,30,1,1,29,987,0.03,0.97,0.5,0.12
PF12891,PF11214:PF15798:PF09510,2,0,0,2,0,1016,0,1.0,0.0,0,0,0,2,0,1016,0,1.0,0.0,0
PF05992,PF03459:PF02694:PF05936,3,3,2,1,1,1014,0.67,1.0,0.67,0.67,2,2,1,0,1015,1.0,1.0,0.67,0.82
PF00500,PF15273:PF15258:PF16685,1,6,0,1,6,1011,0.0,0.99,0.0,-0.0,0,0,1,0,1017,0,1.0,0.0,0
PF11941,PF09154:PF16657:PF16028,1,3,1,0,2,1015,0.33,1.0,1.0,0.58,1,1,0,0,1017,1.0,1.0,1.0,1.0
PF03547,PF00610:PF12257:PF00686,16,66,10,6,56,946,0.15,0.94,0.62,0.29,16,3,13,13,989,0.19,0.97,0.19,0.17
PF02428,PF15302:PF03842:PF14963,2,2,0,2,2,1014,0.0,1.0,0.0,-0.0,0,0,2,0,1016,0,1.0,0.0,0
PF14509,PF03592:PF06381:PF06070,0,1,0,0,1,1017,0.0,1.0,0,0,0,0,0,0,1018,0,1.0,0,0
PF15512,PF14077:PF13925:PF11816,2,22,1,1,21,995,0.05,0.98,0.5,0.15,3,1,1,2,1014,0.33,1.0,0.5,0.41
PF00515,PF07719:PF13414:PF03661,55,65,36,19,29,934,0.55,0.95,0.65,0.58,22,18,37,4,959,0.82,0.96,0.33,0.5
PF16856,PF12125:PF04300:PF11566,1,18,1,0,17,1000,0.06,0.98,1.0,0.23,2,1,0,1,1016,0.5,1.0,1.0,0.71
PF12138,PF09117:PF06377:PF08738,3,2,0,3,2,1013,0.0,1.0,0.0,-0.0,0,0,3,0,1015,0,1.0,0.0,0
PF02668,PF10609:PF05141:PF06155,38,31,13,25,18,962,0.42,0.96,0.34,0.36,7,7,31,0,980,1.0,0.97,0.18,0.42
PF12646,PF06695:PF11016:PF04359,0,1,0,0,1,1017,0.0,1.0,0,0,0,0,0,0,1018,0,1.0,0,0
PF08943,PF08894:PF04286:PF15029,1,3,0,1,3,1014,0.0,1.0,0.0,-0.0,0,0,1,0,1017,0,1.0,0.0,0
PF07196,PF01258:PF10458:PF06827,0,17,0,0,17,1001,0.0,0.98,0,0,4,0,0,4,1014,0.0,1.0,0,0
PF15487,PF09310:PF09372:PF15898,3,3,1,2,2,1013,0.33,1.0,0.33,0.33,0,0,3,0,1015,0,1.0,0.0,0
PF13472,PF03659:PF04199:PF10503,39,39,19,20,20,959,0.49,0.96,0.49,0.47,8,7,32,1,978,0.88,0.97,0.18,0.39
PF04826,PF08609:PF01705:PF16689,3,15,1,2,14,1001,0.07,0.98,0.33,0.14,1,1,2,0,1015,1.0,1.0,0.33,0.58
PF13486,PF10974:PF07421:PF05857,0,1,0,0,1,1017,0.0,1.0,0,0,0,0,0,0,1018,0,1.0,0,0
PF08585,PF16099:PF09429:PF16944,13,12,4,9,8,997,0.33,0.98,0.31,0.31,0,0,13,0,1005,0,0.99,0.0,0
PF07729,PF00392:PF03958:PF01228,14,21,13,1,8,996,0.62,0.99,0.93,0.75,2,2,12,0,1004,1.0,0.99,0.14,0.38
PF10561,PF01106:PF14378:PF08712,4,23,1,3,22,992,0.04,0.98,0.25,0.1,15,1,3,14,1000,0.07,0.98,0.25,0.12
PF14948,PF11548:PF09414:PF00102,3,56,3,0,53,962,0.05,0.95,1.0,0.23,8,3,0,5,1010,0.38,1.0,1.0,0.61
PF08245,PF10288:PF13813:PF10022,32,22,8,24,14,972,0.36,0.96,0.25,0.28,4,2,30,2,984,0.5,0.97,0.06,0.17
PF01373,PF05687:PF03181:PF00982,8,29,5,3,24,986,0.17,0.97,0.62,0.32,3,2,6,1,1009,0.67,0.99,0.25,0.41
PF03100,PF02531:PF09117:PF09232,0,2,0,0,2,1016,0.0,1.0,0,0,0,0,0,0,1018,0,1.0,0,0
PF09990,PF03379:PF08843:PF12724,0,1,0,0,1,1017,0.0,1.0,0,0,0,0,0,0,1018,0,1.0,0,0
PF05168,PF08579:PF16756:PF12255,3,1,0,3,1,1014,0.0,1.0,0.0,-0.0,0,0,3,0,1015,0,1.0,0.0,0
PF04390,PF10458:PF03320:PF13603,4,17,1,3,16,998,0.06,0.98,0.25,0.11,5,1,3,4,1010,0.2,0.99,0.25,0.22
PF10801,PF02907:PF11523:PF01590,0,41,0,0,41,977,0.0,0.96,0,0,3,0,0,3,1015,0.0,1.0,0,0
PF05625,PF04756:PF06090:PF14943,9,28,4,5,24,985,0.14,0.97,0.44,0.24,4,3,6,1,1008,0.75,0.99,0.33,0.5
PF15291,PF08308:PF03548:PF05838,1,3,0,1,3,1014,0.0,1.0,0.0,-0.0,0,0,1,0,1017,0,1.0,0.0,0
PF01625,PF05047:PF02284:PF06749,20,19,4,16,15,983,0.21,0.97,0.2,0.19,3,2,18,1,997,0.67,0.98,0.1,0.25
PF12549,PF00351:PF01842:PF10369,3,46,3,0,43,972,0.07,0.96,1.0,0.25,7,1,2,6,1009,0.14,0.99,0.33,0.21
PF12148,PF16843:PF09055:PF12057,5,6,1,4,5,1008,0.17,0.99,0.2,0.18,1,1,4,0,1013,1.0,1.0,0.2,0.45
PF01174,PF03102:PF09363:PF04775,3,7,0,3,7,1008,0.0,0.99,0.0,-0.0,0,0,3,0,1015,0,1.0,0.0,0
PF17111,PF15898:PF14420:PF17106,20,16,5,15,11,987,0.31,0.97,0.25,0.27,3,1,19,2,996,0.33,0.98,0.05,0.12
PF06150,PF04023:PF04160:PF01359,0,46,0,0,46,972,0.0,0.95,0,0,0,0,0,0,1018,0,1.0,0,0
PF11187,PF15318:PF03048:PF04892,2,1,1,1,0,1016,1.0,1.0,0.5,0.71,0,0,2,0,1016,0,1.0,0.0,0
PF13553,PF02760:PF02758:PF00619,6,31,4,2,27,985,0.13,0.97,0.67,0.29,6,2,4,4,1008,0.33,0.99,0.33,0.33
PF03443,PF02015:PF03664:PF01083,32,21,10,22,11,975,0.48,0.97,0.31,0.37,6,6,26,0,986,1.0,0.97,0.19,0.43
PF06407,PF06890:PF05359:PF12080,0,0,0,0,0,1018,0,1.0,0,0,0,0,0,0,1018,0,1.0,0,0
PF15852,PF07359:PF03819:PF08040,0,2,0,0,2,1016,0.0,1.0,0,0,0,0,0,0,1018,0,1.0,0,0
PF08423,PF04005:PF03162:PF13088,32,19,5,27,14,972,0.26,0.96,0.16,0.18,2,2,30,0,986,1.0,0.97,0.06,0.25
PF05416,PF10106:PF02465:PF15366,2,1,0,2,1,1015,0.0,1.0,0.0,-0.0,0,0,2,0,1016,0,1.0,0.0,0
PF09694,PF01722:PF15433:PF06775,0,26,0,0,26,992,0.0,0.97,0,0,8,0,0,8,1010,0.0,0.99,0,0
PF00164,PF00177:PF01058:PF04716,10,46,6,4,40,968,0.13,0.96,0.6,0.27,9,3,7,6,1002,0.33,0.99,0.3,0.31
PF08540,PF01154:PF08445:PF14784,17,29,17,0,12,989,0.59,0.99,1.0,0.76,1,1,16,0,1001,1.0,0.98,0.06,0.24
PF17219,PF08604:PF16764:PF00641,1,48,1,0,47,970,0.02,0.95,1.0,0.14,7,1,0,6,1011,0.14,0.99,1.0,0.38
PF05830,PF02654:PF05962:PF11245,1,4,0,1,4,1013,0.0,1.0,0.0,-0.0,0,0,1,0,1017,0,1.0,0.0,0
PF06711,PF05336:PF02452:PF10106,0,5,0,0,5,1013,0.0,1.0,0,0,0,0,0,0,1018,0,1.0,0,0
PF07209,PF03713:PF05962:PF11124,1,1,0,1,1,1016,0.0,1.0,0.0,-0.0,0,0,1,0,1017,0,1.0,0.0,0
PF06783,PF00995:PF15433:PF10510,2,41,2,0,39,977,0.05,0.96,1.0,0.22,10,1,1,9,1007,0.1,0.99,0.5,0.22
PF00555,PF15529:PF10109:PF10995,2,0,0,2,0,1016,0,1.0,0.0,0,0,0,2,0,1016,0,1.0,0.0,0
PF13990,PF07699:PF07973:PF04566,0,46,0,0,46,972,0.0,0.95,0,0,9,0,0,9,1009,0.0,0.99,0,0
PF16732,PF03613:PF06744:PF10279,0,0,0,0,0,1018,0,1.0,0,0,0,0,0,0,1018,0,1.0,0,0
PF15257,PF04988:PF05337:PF16043,2,8,1,1,7,1009,0.12,0.99,0.5,0.25,0,0,2,0,1016,0,1.0,0.0,0
PF04484,PF12023:PF07011:PF06351,8,6,1,7,5,1005,0.17,0.99,0.12,0.14,0,0,8,0,1010,0,0.99,0.0,0
PF11038,PF12385:PF10924:PF15212,0,0,0,0,0,1018,0,1.0,0,0,0,0,0,0,1018,0,1.0,0,0
PF02812,PF05088:PF00208:PF02781,14,28,14,0,14,990,0.5,0.99,1.0,0.7,13,8,6,5,999,0.62,0.99,0.57,0.59
PF05104,PF12297:PF10481:PF07926,0,13,0,0,13,1005,0.0,0.99,0,0,0,0,0,0,1018,0,1.0,0,0
PF07817,PF11527:PF13851:PF11831,5,17,1,4,16,997,0.06,0.98,0.2,0.1,2,0,5,2,1011,0.0,0.99,0.0,-0.0
PF07305,PF11075:PF10366:PF04797,0,14,0,0,14,1004,0.0,0.99,0,0,0,0,0,0,1018,0,1.0,0,0
PF11961,PF07540:PF05672:PF08920,2,17,2,0,15,1001,0.12,0.99,1.0,0.34,2,0,2,2,1014,0.0,1.0,0.0,-0.0
PF00153,PF13833:PF13499:PF13202,125,152,63,62,89,804,0.41,0.85,0.5,0.37,62,37,88,25,868,0.6,0.89,0.3,0.37
PF15300,PF13519:PF14771:PF15057,2,42,2,0,40,976,0.05,0.96,1.0,0.21,4,0,2,4,1012,0.0,0.99,0.0,-0.0
PF05957,PF03901:PF05916:PF00834,0,51,0,0,51,967,0.0,0.95,0,0,14,0,0,14,1004,0.0,0.99,0,0
PF12177,PF05494:PF11892:PF03706,2,2,0,2,2,1014,0.0,1.0,0.0,-0.0,0,0,2,0,1016,0,1.0,0.0,0
PF01634,PF08029:PF00674:PF05179,6,10,6,0,4,1008,0.6,1.0,1.0,0.77,1,1,5,0,1012,1.0,1.0,0.17,0.41
PF01938,PF00919:PF01967:PF06969,18,23,14,4,9,991,0.61,0.99,0.78,0.68,6,5,13,1,999,0.83,0.99,0.28,0.48
PF00398,PF09813:PF14828:PF03029,19,26,8,11,18,981,0.31,0.97,0.42,0.35,3,3,16,0,999,1.0,0.98,0.16,0.39
PF06724,PF08795:PF02557:PF05939,0,2,0,0,2,1016,0.0,1.0,0,0,0,0,0,0,1018,0,1.0,0,0
PF05659,PF12061:PF07725:PF00619,5,34,4,1,30,983,0.12,0.97,0.8,0.3,9,3,2,6,1007,0.33,0.99,0.6,0.44
PF07819,PF12612:PF07035:PF14498,12,24,5,7,19,987,0.21,0.97,0.42,0.28,5,1,11,4,1002,0.2,0.99,0.08,0.12
PF06892,PF09095:PF02066:PF01118,0,14,0,0,14,1004,0.0,0.99,0,0,1,0,0,1,1017,0.0,1.0,0,0
PF14743,PF04679:PF01068:PF11411,3,19,3,0,16,999,0.16,0.98,1.0,0.39,18,2,1,16,999,0.11,0.98,0.67,0.27
PF03837,PF08203:PF07243:PF15202,1,1,0,1,1,1016,0.0,1.0,0.0,-0.0,0,0,1,0,1017,0,1.0,0.0,0
PF00126,PF00220:PF14232:PF03466,6,11,6,0,5,1007,0.55,1.0,1.0,0.74,0,0,6,0,1012,0,0.99,0.0,0
PF03969,PF04144:PF03619:PF10275,15,36,8,7,28,975,0.22,0.97,0.53,0.33,8,3,12,5,998,0.38,0.98,0.2,0.27
PF14970,PF05111:PF15254:PF14992,3,3,0,3,3,1012,0.0,0.99,0.0,-0.0,0,0,3,0,1015,0,1.0,0.0,0
PF15851,PF04865:PF14882:PF06761,0,0,0,0,0,1018,0,1.0,0,0,0,0,0,0,1018,0,1.0,0,0
PF06945,PF17017:PF12615:PF05939,0,0,0,0,0,1018,0,1.0,0,0,0,0,0,0,1018,0,1.0,0,0
PF11539,PF01312:PF00796:PF06573,0,2,0,0,2,1016,0.0,1.0,0,0,0,0,0,0,1018,0,1.0,0,0
PF11942,PF03439:PF00467:PF02357,7,23,7,0,16,995,0.3,0.98,1.0,0.55,5,2,5,3,1008,0.4,0.99,0.29,0.33
PF04299,PF06912:PF06766:PF10161,11,6,1,10,5,1002,0.17,0.99,0.09,0.12,0,0,11,0,1007,0,0.99,0.0,0
PF04895,PF00626:PF08024:PF11392,0,48,0,0,48,970,0.0,0.95,0,0,0,0,0,0,1018,0,1.0,0,0
PF10275,PF11303:PF03162:PF08265,7,15,3,4,12,999,0.2,0.98,0.43,0.29,1,1,6,0,1011,1.0,0.99,0.14,0.38
PF07402,PF13471:PF13277:PF13286,0,11,0,0,11,1007,0.0,0.99,0,0,0,0,0,0,1018,0,1.0,0,0
PF07472,PF17025:PF13371:PF01801,0,1,0,0,1,1017,0.0,1.0,0,0,0,0,0,0,1018,0,1.0,0,0
PF06466,PF17105:PF16199:PF12064,9,14,4,5,10,999,0.29,0.99,0.44,0.35,1,1,8,0,1009,1.0,0.99,0.11,0.33
PF12881,PF11265:PF03516:PF11235,1,7,1,0,6,1011,0.14,0.99,1.0,0.38,0,0,1,0,1017,0,1.0,0.0,0
PF06054,PF03846:PF03708:PF14684,0,4,0,0,4,1014,0.0,1.0,0,0,0,0,0,0,1018,0,1.0,0,0
PF05076,PF12470:PF16173:PF02799,3,17,3,0,14,1001,0.18,0.99,1.0,0.42,4,3,0,1,1014,0.75,1.0,1.0,0.87
PF10234,PF09755:PF11708:PF09282,3,15,0,3,15,1000,0.0,0.98,0.0,-0.01,3,0,3,3,1012,0.0,0.99,0.0,-0.0
PF11466,PF11587:PF08023:PF16047,0,0,0,0,0,1018,0,1.0,0,0,0,0,0,0,1018,0,1.0,0,0
PF00103,PF02267:PF12301:PF00711,4,5,1,3,4,1010,0.2,0.99,0.25,0.22,0,0,4,0,1014,0,1.0,0.0,0
PF12628,PF06724:PF03544:PF15337,0,7,0,0,7,1011,0.0,0.99,0,0,0,0,0,0,1018,0,1.0,0,0
PF03214,PF06219:PF09044:PF05238,3,4,0,3,4,1011,0.0,0.99,0.0,-0.0,0,0,3,0,1015,0,1.0,0.0,0
PF01283,PF06404:PF04690:PF01997,19,12,4,15,8,991,0.33,0.98,0.21,0.25,0,0,19,0,999,0,0.98,0.0,0
PF16059,PF07001:PF16501:PF15557,5,5,1,4,4,1009,0.2,0.99,0.2,0.2,0,0,5,0,1013,0,1.0,0.0,0
PF10650,PF16574:PF16830:PF14858,3,2,1,2,1,1014,0.5,1.0,0.33,0.41,0,0,3,0,1015,0,1.0,0.0,0
PF05228,PF16697:PF09967:PF03135,1,8,0,1,8,1009,0.0,0.99,0.0,-0.0,2,0,1,2,1015,0.0,1.0,0.0,-0.0
PF07926,PF10481:PF12297:PF16830,9,4,0,9,4,1005,0.0,0.99,0.0,-0.01,0,0,9,0,1009,0,0.99,0.0,0
PF01132,PF09285:PF08207:PF14693,6,11,6,0,5,1007,0.55,1.0,1.0,0.74,6,6,0,0,1012,1.0,1.0,1.0,1.0
PF09643,PF09281:PF14063:PF12780,0,39,0,0,39,979,0.0,0.96,0,0,0,0,0,0,1018,0,1.0,0,0
PF06761,PF03241:PF04865:PF07411,0,0,0,0,0,1018,0,1.0,0,0,0,0,0,0,1018,0,1.0,0,0
PF03711,PF01276:PF03709:PF14008,7,29,7,0,22,989,0.24,0.98,1.0,0.49,5,5,2,0,1011,1.0,1.0,0.71,0.84
PF07739,PF13096:PF15934:PF05837,1,1,0,1,1,1016,0.0,1.0,0.0,-0.0,0,0,1,0,1017,0,1.0,0.0,0
PF05480,PF02556:PF04494:PF08953,0,21,0,0,21,997,0.0,0.98,0,0,3,0,0,3,1015,0.0,1.0,0,0
PF00170,PF07716:PF11538:PF02701,33,43,14,19,29,956,0.33,0.95,0.42,0.35,6,4,29,2,983,0.67,0.97,0.12,0.28
PF09902,PF12719:PF01206:PF15354,0,8,0,0,8,1010,0.0,0.99,0,0,0,0,0,0,1018,0,1.0,0,0
PF14384,PF02633:PF07157:PF09278,0,4,0,0,4,1014,0.0,1.0,0,0,0,0,0,0,1018,0,1.0,0,0
PF14624,PF13757:PF08487:PF06668,8,11,3,5,8,1002,0.27,0.99,0.38,0.31,3,1,7,2,1008,0.33,0.99,0.12,0.2
PF02121,PF02862:PF09751:PF04006,12,27,7,5,20,986,0.26,0.98,0.58,0.38,4,2,10,2,1004,0.5,0.99,0.17,0.28
PF01866,PF03981:PF02636:PF03416,14,32,4,10,28,976,0.12,0.96,0.29,0.17,5,1,13,4,1000,0.2,0.98,0.07,0.11
PF13843,PF13842:PF12259:PF07530,49,9,8,41,1,968,0.89,0.96,0.16,0.37,3,3,46,0,969,1.0,0.95,0.06,0.24
PF00493,PF17207:PF14551:PF12619,49,50,47,2,3,966,0.94,1.0,0.96,0.95,44,44,5,0,969,1.0,1.0,0.9,0.95
PF15142,PF03819:PF15809:PF15036,2,2,0,2,2,1014,0.0,1.0,0.0,-0.0,0,0,2,0,1016,0,1.0,0.0,0
PF09648,PF07435:PF13876:PF07523,0,1,0,0,1,1017,0.0,1.0,0,0,0,0,0,0,1018,0,1.0,0,0
PF15466,PF14885:PF05797:PF00796,0,1,0,0,1,1017,0.0,1.0,0,0,0,0,0,0,1018,0,1.0,0,0
PF05068,PF17188:PF04754:PF01752,0,3,0,0,3,1015,0.0,1.0,0,0,0,0,0,0,1018,0,1.0,0,0
PF06200,PF09425:PF11891:PF04765,12,21,11,1,10,996,0.52,0.99,0.92,0.69,2,2,10,0,1006,1.0,0.99,0.17,0.41
PF13761,PF14328:PF12479:PF13677,1,0,0,1,0,1017,0,1.0,0.0,0,0,0,1,0,1017,0,1.0,0.0,0
PF00343,PF01896:PF04819:PF07156,22,22,5,17,17,979,0.23,0.97,0.23,0.21,3,3,19,0,996,1.0,0.98,0.14,0.37
PF03867,PF10525:PF04617:PF12407,1,4,1,0,3,1014,0.25,1.0,1.0,0.5,1,1,0,0,1017,1.0,1.0,1.0,1.0
PF06583,PF13882:PF12355:PF05473,1,6,1,0,5,1012,0.17,1.0,1.0,0.41,1,1,0,0,1017,1.0,1.0,1.0,1.0
PF10394,PF10496:PF04437:PF06466,13,29,6,7,23,982,0.21,0.97,0.46,0.3,6,1,12,5,1000,0.17,0.98,0.08,0.11
PF01455,PF01706:PF06834:PF04350,0,1,0,0,1,1017,0.0,1.0,0,0,0,0,0,0,1018,0,1.0,0,0
PF04408,PF07717:PF08320:PF04568,80,79,72,8,7,931,0.91,0.99,0.9,0.9,7,7,73,0,938,1.0,0.93,0.09,0.28
PF12776,PF13359:PF13613:PF14392,27,60,17,10,43,948,0.28,0.95,0.63,0.4,18,7,20,11,980,0.39,0.97,0.26,0.3
PF03104,PF00136:PF14260:PF12254,36,37,35,1,2,980,0.95,1.0,0.97,0.96,25,24,12,1,981,0.96,0.99,0.67,0.79
PF11681,PF05974:PF03428:PF08497,0,0,0,0,0,1018,0,1.0,0,0,0,0,0,0,1018,0,1.0,0,0
PF16859,PF02129:PF06073:PF08783,0,26,0,0,26,992,0.0,0.97,0,0,1,0,0,1,1017,0.0,1.0,0,0
PF03898,PF08795:PF12843:PF15464,0,0,0,0,0,1018,0,1.0,0,0,0,0,0,0,1018,0,1.0,0,0
PF11347,PF15085:PF15333:PF15212,1,2,0,1,2,1015,0.0,1.0,0.0,-0.0,0,0,1,0,1017,0,1.0,0.0,0
PF04989,PF02595:PF01292:PF15105,2,7,0,2,7,1009,0.0,0.99,0.0,-0.0,0,0,2,0,1016,0,1.0,0.0,0
PF00867,PF12247:PF12246:PF05700,38,10,7,31,3,977,0.7,0.97,0.18,0.35,2,1,37,1,979,0.5,0.96,0.03,0.11
PF16679,PF08839:PF09369:PF09382,3,22,2,1,20,995,0.09,0.98,0.67,0.24,5,0,3,5,1010,0.0,0.99,0.0,-0.0
PF01084,PF00329:PF00886:PF00159,12,23,3,9,20,986,0.13,0.97,0.25,0.17,3,2,10,1,1005,0.67,0.99,0.17,0.33
PF09317,PF12806:PF08028:PF12418,3,3,3,0,0,1015,1.0,1.0,1.0,1.0,3,3,0,0,1015,1.0,1.0,1.0,1.0
PF09979,PF05164:PF10375:PF13495,0,2,0,0,2,1016,0.0,1.0,0,0,0,0,0,0,1018,0,1.0,0,0
PF00735,PF04548:PF03673:PF16066,32,22,9,23,13,973,0.41,0.96,0.28,0.32,1,1,31,0,986,1.0,0.97,0.03,0.17
PF02687,PF12704:PF17167:PF15994,10,7,5,5,2,1006,0.71,0.99,0.5,0.59,2,2,8,0,1008,1.0,0.99,0.2,0.45
PF12331,PF10999:PF15482:PF09428,3,1,0,3,1,1014,0.0,1.0,0.0,-0.0,0,0,3,0,1015,0,1.0,0.0,0
PF05703,PF08458:PF00591:PF07831,6,11,6,0,5,1007,0.55,1.0,1.0,0.74,2,0,6,2,1010,0.0,0.99,0.0,-0.0
PF06328,PF09067:PF07227:PF05473,4,6,1,3,5,1009,0.17,0.99,0.25,0.2,1,1,3,0,1014,1.0,1.0,0.25,0.5
PF00038,PF10042:PF16208:PF00932,22,10,7,15,3,993,0.7,0.98,0.32,0.46,2,2,20,0,996,1.0,0.98,0.09,0.3
PF14024,PF17017:PF03739:PF11402,0,5,0,0,5,1013,0.0,1.0,0,0,0,0,0,0,1018,0,1.0,0,0
PF13676,PF16095:PF00531:PF01335,21,48,16,5,32,965,0.33,0.96,0.76,0.49,16,11,10,5,992,0.69,0.99,0.52,0.59
PF17209,PF00856:PF00676:PF02780,1,132,1,0,131,886,0.01,0.87,1.0,0.08,32,1,0,31,986,0.03,0.97,1.0,0.17
PF08536,PF07011:PF09366:PF10775,4,6,1,3,5,1009,0.17,0.99,0.25,0.2,0,0,4,0,1014,0,1.0,0.0,0
PF15484,PF07805:PF16965:PF06805,2,2,0,2,2,1014,0.0,1.0,0.0,-0.0,0,0,2,0,1016,0,1.0,0.0,0
PF03633,PF03636:PF03632:PF03413,1,12,1,0,11,1006,0.08,0.99,1.0,0.29,4,1,0,3,1014,0.25,1.0,1.0,0.5
PF01841,PF00868:PF00927:PF04721,26,11,11,15,0,992,1.0,0.99,0.42,0.65,7,7,19,0,992,1.0,0.98,0.27,0.51
PF05679,PF02434:PF06312:PF05652,13,34,11,2,23,982,0.32,0.98,0.85,0.51,7,3,10,4,1001,0.43,0.99,0.23,0.31
PF14347,PF15186:PF01514:PF10974,0,1,0,0,1,1017,0.0,1.0,0,0,0,0,0,0,1018,0,1.0,0,0
PF16658,PF09173:PF09107:PF14492,1,37,1,0,36,981,0.03,0.96,1.0,0.16,5,1,0,4,1013,0.2,1.0,1.0,0.45
PF14736,PF01775:PF09778:PF00197,3,11,0,3,11,1004,0.0,0.99,0.0,-0.01,1,0,3,1,1014,0.0,1.0,0.0,-0.0
PF16346,PF16352:PF11837:PF08975,0,3,0,0,3,1015,0.0,1.0,0,0,0,0,0,0,1018,0,1.0,0,0
PF10217,PF07052:PF10173:PF14769,1,17,0,1,17,1000,0.0,0.98,0.0,-0.0,2,0,1,2,1015,0.0,1.0,0.0,-0.0
PF16455,PF01599:PF16843:PF13373,8,10,3,5,7,1003,0.3,0.99,0.38,0.33,1,1,7,0,1010,1.0,0.99,0.12,0.35
PF09726,PF10491:PF14674:PF14678,5,6,1,4,5,1008,0.17,0.99,0.2,0.18,1,0,5,1,1012,0.0,0.99,0.0,-0.0
PF08111,PF16041:PF11852:PF10084,1,9,0,1,9,1008,0.0,0.99,0.0,-0.0,0,0,1,0,1017,0,1.0,0.0,0
PF01580,PF06070:PF02554:PF03592,5,1,0,5,1,1012,0.0,0.99,0.0,-0.0,0,0,5,0,1013,0,1.0,0.0,0
PF12345,PF13597:PF10105:PF06969,2,4,2,0,2,1014,0.5,1.0,1.0,0.71,2,2,0,0,1016,1.0,1.0,1.0,1.0
PF09716,PF11093:PF05387:PF15673,0,1,0,0,1,1017,0.0,1.0,0,0,0,0,0,0,1018,0,1.0,0,0
PF04361,PF09731:PF09248:PF01074,0,32,0,0,32,986,0.0,0.97,0,0,5,0,0,5,1013,0.0,1.0,0,0
PF09056,PF06369:PF12351:PF08738,4,4,0,4,4,1010,0.0,0.99,0.0,-0.0,0,0,4,0,1014,0,1.0,0.0,0
PF10142,PF10370:PF13026:PF07238,6,2,0,6,2,1010,0.0,0.99,0.0,-0.0,0,0,6,0,1012,0,0.99,0.0,0
PF08758,PF08266:PF08374:PF07953,2,8,1,1,7,1009,0.12,0.99,0.5,0.25,1,1,1,0,1016,1.0,1.0,0.5,0.71
PF15741,PF17085:PF01840:PF10856,1,0,0,1,0,1017,0,1.0,0.0,0,0,0,1,0,1017,0,1.0,0.0,0
PF15817,PF11751:PF02979:PF06890,1,3,0,1,3,1014,0.0,1.0,0.0,-0.0,0,0,1,0,1017,0,1.0,0.0,0
PF10309,PF12516:PF05182:PF14722,10,23,5,5,18,990,0.22,0.98,0.5,0.32,1,0,10,1,1007,0.0,0.99,0.0,-0.0
PF01974,PF02778:PF01648:PF16123,20,41,15,5,26,972,0.37,0.97,0.75,0.51,12,8,12,4,994,0.67,0.98,0.4,0.51
PF03417,PF07542:PF09995:PF03583,6,18,2,4,16,996,0.11,0.98,0.33,0.18,5,1,5,4,1008,0.2,0.99,0.17,0.18
PF11264,PF07333:PF06351:PF06232,1,7,0,1,7,1010,0.0,0.99,0.0,-0.0,0,0,1,0,1017,0,1.0,0.0,0
PF15253,PF12887:PF12090:PF08729,3,6,1,2,5,1010,0.17,0.99,0.33,0.23,0,0,3,0,1015,0,1.0,0.0,0
PF05340,PF03219:PF05021:PF05020,2,13,1,1,12,1004,0.08,0.99,0.5,0.19,9,1,1,8,1008,0.11,0.99,0.5,0.23
PF14521,PF16089:PF00708:PF08738,7,7,1,6,6,1005,0.14,0.99,0.14,0.14,0,0,7,0,1011,0,0.99,0.0,0
PF07207,PF15186:PF00796:PF15838,3,1,1,2,0,1015,1.0,1.0,0.33,0.58,0,0,3,0,1015,0,1.0,0.0,0
PF11827,PF15518:PF08411:PF12603,0,2,0,0,2,1016,0.0,1.0,0,0,1,0,0,1,1017,0.0,1.0,0,0
PF05735,PF02412:PF07452:PF10577,3,7,3,0,4,1011,0.43,1.0,1.0,0.65,2,2,1,0,1015,1.0,1.0,0.67,0.82
PF04778,PF15856:PF15141:PF15482,0,1,0,0,1,1017,0.0,1.0,0,0,0,0,0,0,1018,0,1.0,0,0
PF01206,PF07945:PF09902:PF01239,1,27,0,1,27,990,0.0,0.97,0.0,-0.01,0,0,1,0,1017,0,1.0,0.0,0
PF15625,PF16056:PF11618:PF08151,3,11,1,2,10,1005,0.09,0.99,0.33,0.17,1,1,2,0,1015,1.0,1.0,0.33,0.58
PF02305,PF11751:PF07157:PF06890,1,0,0,1,0,1017,0,1.0,0.0,0,0,0,1,0,1017,0,1.0,0.0,0
PF11318,PF10782:PF06719:PF02113,0,3,0,0,3,1015,0.0,1.0,0,0,0,0,0,0,1018,0,1.0,0,0
PF15004,PF15841:PF15834:PF05100,1,0,0,1,0,1017,0,1.0,0.0,0,0,0,1,0,1017,0,1.0,0.0,0
PF12423,PF16183:PF12473:PF16540,14,28,14,0,14,990,0.5,0.99,1.0,0.7,16,14,0,2,1002,0.88,1.0,1.0,0.93
PF01223,PF01663:PF04987:PF01033,23,49,15,8,34,961,0.31,0.96,0.65,0.43,19,10,13,9,986,0.53,0.98,0.43,0.47
PF14476,PF07712:PF05910:PF03767,1,17,1,0,16,1001,0.06,0.98,1.0,0.24,0,0,1,0,1017,0,1.0,0.0,0
PF00321,PF06232:PF05479:PF06376,0,6,0,0,6,1012,0.0,0.99,0,0,1,0,0,1,1017,0.0,1.0,0,0
PF03080,PF14365:PF04127:PF03951,10,17,5,5,12,996,0.29,0.98,0.5,0.38,3,0,10,3,1005,0.0,0.99,0.0,-0.01
PF01326,PF00391:PF02896:PF05524,14,21,11,3,10,994,0.52,0.99,0.79,0.64,13,10,4,3,1001,0.77,0.99,0.71,0.74
PF10406,PF04139:PF03715:PF04000,9,30,3,6,27,982,0.1,0.97,0.33,0.17,8,2,7,6,1003,0.25,0.99,0.22,0.23
PF11327,PF14610:PF15245:PF04852,4,8,2,2,6,1008,0.25,0.99,0.5,0.35,0,0,4,0,1014,0,1.0,0.0,0
PF15722,PF16829:PF10630:PF15234,0,0,0,0,0,1018,0,1.0,0,0,0,0,0,0,1018,0,1.0,0,0
PF03700,PF12825:PF12828:PF08944,1,8,1,0,7,1010,0.12,0.99,1.0,0.35,4,1,0,3,1014,0.25,1.0,1.0,0.5
PF01453,PF08276:PF11883:PF00954,39,28,24,15,4,975,0.86,0.98,0.62,0.72,18,17,22,1,978,0.94,0.98,0.44,0.63
PF02126,PF14931:PF10251:PF15551,8,3,1,7,2,1008,0.33,0.99,0.12,0.2,1,1,7,0,1010,1.0,0.99,0.12,0.35
PF00489,PF02024:PF14653:PF06875,1,1,0,1,1,1016,0.0,1.0,0.0,-0.0,0,0,1,0,1017,0,1.0,0.0,0
PF02028,PF04380:PF11493:PF06876,1,0,0,1,0,1017,0,1.0,0.0,0,0,0,1,0,1017,0,1.0,0.0,0
PF02752,PF05404:PF00339:PF00852,30,50,28,2,22,966,0.56,0.98,0.93,0.71,8,6,24,2,986,0.75,0.97,0.2,0.38
PF15343,PF15776:PF02950:PF15207,0,4,0,0,4,1014,0.0,1.0,0,0,0,0,0,0,1018,0,1.0,0,0
PF08007,PF15249:PF10309:PF05182,16,27,8,8,19,983,0.3,0.97,0.5,0.37,7,4,12,3,999,0.57,0.99,0.25,0.37
PF03412,PF03459:PF05936:PF02694,4,3,2,2,1,1013,0.67,1.0,0.5,0.58,2,2,2,0,1014,1.0,1.0,0.5,0.71
PF02843,PF02844:PF01071:PF00586,13,21,13,0,8,997,0.62,0.99,1.0,0.78,13,13,0,0,1005,1.0,1.0,1.0,1.0
PF06484,PF05593:PF15636:PF17205,2,9,1,1,8,1008,0.11,0.99,0.5,0.23,1,1,1,0,1016,1.0,1.0,0.5,0.71
PF02977,PF15556:PF06729:PF15119,0,1,0,0,1,1017,0.0,1.0,0,0,0,0,0,0,1018,0,1.0,0,0
PF05994,PF07159:PF04704:PF01175,9,12,7,2,5,1004,0.58,0.99,0.78,0.67,1,1,8,0,1009,1.0,0.99,0.11,0.33
PF17210,PF00746:PF00526:PF14910,6,3,0,6,3,1009,0.0,0.99,0.0,-0.0,1,0,6,1,1011,0.0,0.99,0.0,-0.0
PF07924,PF08287:PF13093:PF14616,0,8,0,0,8,1010,0.0,0.99,0,0,1,0,0,1,1017,0.0,1.0,0,0
PF04893,PF03208:PF07896:PF00499,14,14,6,8,8,996,0.43,0.98,0.43,0.42,1,1,13,0,1004,1.0,0.99,0.07,0.27
PF15016,PF15146:PF12886:PF15025,2,5,2,0,3,1013,0.4,1.0,1.0,0.63,1,1,1,0,1016,1.0,1.0,0.5,0.71
PF08703,PF03490:PF15303:PF08101,4,3,1,3,2,1012,0.33,1.0,0.25,0.29,1,1,3,0,1014,1.0,1.0,0.25,0.5
PF00623,PF04983:PF04997:PF04992,29,32,29,0,3,986,0.91,1.0,1.0,0.95,29,29,0,0,989,1.0,1.0,1.0,1.0
PF12505,PF07173:PF10355:PF10348,5,12,1,4,11,1002,0.08,0.99,0.2,0.12,6,1,4,5,1008,0.17,0.99,0.2,0.18
PF08357,PF15037:PF14441:PF01285,9,9,5,4,4,1005,0.56,0.99,0.56,0.55,0,0,9,0,1009,0,0.99,0.0,0
PF07978,PF09766:PF01733:PF02222,17,29,8,9,21,980,0.28,0.97,0.47,0.35,4,1,16,3,998,0.25,0.98,0.06,0.11
PF13423,PF15870:PF00929:PF02878,16,73,12,4,61,941,0.16,0.94,0.75,0.33,18,3,13,15,987,0.17,0.97,0.19,0.16
PF00068,PF09777:PF16906:PF05823,10,17,2,8,15,993,0.12,0.98,0.2,0.14,0,0,10,0,1008,0,0.99,0.0,0
PF09725,PF07052:PF11623:PF12926,9,12,1,8,11,998,0.08,0.98,0.11,0.09,0,0,9,0,1009,0,0.99,0.0,0
PF14452,PF03069:PF16286:PF14085,0,12,0,0,12,1006,0.0,0.99,0,0,0,0,0,0,1018,0,1.0,0,0
PF14820,PF15119:PF15556:PF06952,0,1,0,0,1,1017,0.0,1.0,0,0,0,0,0,0,1018,0,1.0,0,0
PF04143,PF12716:PF07464:PF12973,3,4,0,3,4,1011,0.0,0.99,0.0,-0.0,0,0,3,0,1015,0,1.0,0.0,0
PF09400,PF04917:PF17030:PF03589,0,2,0,0,2,1016,0.0,1.0,0,0,0,0,0,0,1018,0,1.0,0,0
PF16766,PF16768:PF07394:PF16704,1,7,1,0,6,1011,0.14,0.99,1.0,0.38,0,0,1,0,1017,0,1.0,0.0,0
PF16862,PF06964:PF04842:PF12036,17,20,3,14,17,984,0.15,0.97,0.18,0.15,0,0,17,0,1001,0,0.98,0.0,0
PF14519,PF03379:PF04691:PF02950,0,3,0,0,3,1015,0.0,1.0,0,0,0,0,0,0,1018,0,1.0,0,0
PF16878,PF00157:PF03792:PF13293,14,8,4,10,4,1000,0.5,0.99,0.29,0.37,4,2,12,2,1002,0.5,0.99,0.14,0.26
PF12510,PF15147:PF10358:PF15949,1,23,1,0,22,995,0.04,0.98,1.0,0.21,1,1,0,0,1017,1.0,1.0,1.0,1.0
PF10228,PF10283:PF03993:PF16759,8,20,4,4,16,994,0.2,0.98,0.5,0.31,4,1,7,3,1007,0.25,0.99,0.12,0.17
PF12357,PF16165:PF08150:PF00614,7,23,6,1,17,994,0.26,0.98,0.86,0.47,4,3,4,1,1010,0.75,1.0,0.43,0.56
PF10699,PF14611:PF11331:PF15862,1,9,0,1,9,1008,0.0,0.99,0.0,-0.0,0,0,1,0,1017,0,1.0,0.0,0
PF00167,PF14798:PF05308:PF00048,9,16,3,6,13,996,0.19,0.98,0.33,0.24,1,1,8,0,1009,1.0,0.99,0.11,0.33
PF14724,PF10221:PF00241:PF04188,3,37,3,0,34,981,0.08,0.97,1.0,0.28,7,1,2,6,1009,0.14,0.99,0.33,0.21
PF13537,PF00733:PF06075:PF00215,11,41,10,1,31,976,0.24,0.97,0.91,0.46,8,4,7,4,1003,0.5,0.99,0.36,0.42
PF07497,PF11421:PF16886:PF07498,3,27,3,0,24,991,0.11,0.98,1.0,0.33,3,1,2,2,1013,0.33,1.0,0.33,0.33
PF00498,PF15308:PF13325:PF15276,82,10,8,74,2,934,0.8,0.93,0.1,0.26,3,3,79,0,936,1.0,0.92,0.04,0.18
PF14646,PF14909:PF15279:PF16019,6,4,0,6,4,1008,0.0,0.99,0.0,-0.0,0,0,6,0,1012,0,0.99,0.0,0
PF04199,PF11807:PF14027:PF12296,22,26,13,9,13,983,0.5,0.98,0.59,0.53,8,8,14,0,996,1.0,0.99,0.36,0.6
PF07231,PF07014:PF05594:PF14920,0,0,0,0,0,1018,0,1.0,0,0,0,0,0,0,1018,0,1.0,0,0
PF02931,PF02932:PF04406:PF06237,78,80,67,11,13,927,0.84,0.98,0.86,0.84,8,8,70,0,940,1.0,0.93,0.1,0.31
PF08434,PF15300:PF03839:PF13519,9,38,3,6,35,974,0.08,0.96,0.33,0.15,8,1,8,7,1002,0.12,0.99,0.11,0.11
PF01171,PF00266:PF10288:PF06041,20,54,9,11,45,953,0.17,0.94,0.45,0.25,6,3,17,3,995,0.5,0.98,0.15,0.27
PF00323,PF02740:PF15722:PF01114,0,1,0,0,1,1017,0.0,1.0,0,0,1,0,0,1,1017,0.0,1.0,0,0
PF06162,PF01051:PF15169:PF15356,0,1,0,0,1,1017,0.0,1.0,0,0,0,0,0,0,1018,0,1.0,0,0
PF12106,PF01514:PF12191:PF06070,1,1,0,1,1,1016,0.0,1.0,0.0,-0.0,0,0,1,0,1017,0,1.0,0.0,0
PF04856,PF00714:PF14653:PF06875,0,1,0,0,1,1017,0.0,1.0,0,0,0,0,0,0,1018,0,1.0,0,0
PF02774,PF01118:PF09290:PF13840,14,24,10,4,14,990,0.42,0.98,0.71,0.54,3,2,12,1,1003,0.67,0.99,0.14,0.3
PF12095,PF08843:PF15825:PF11317,1,0,0,1,0,1017,0,1.0,0.0,0,0,0,1,0,1017,0,1.0,0.0,0
PF12532,PF01339:PF12431:PF07695,0,6,0,0,6,1012,0.0,0.99,0,0,1,0,0,1,1017,0.0,1.0,0,0
PF02106,PF15302:PF15467:PF15398,0,1,0,0,1,1017,0.0,1.0,0,0,0,0,0,0,1018,0,1.0,0,0
PF16003,PF16032:PF15805:PF14047,1,0,0,1,0,1017,0,1.0,0.0,0,0,0,1,0,1017,0,1.0,0.0,0
PF14028,PF13322:PF03888:PF03428,0,0,0,0,0,1018,0,1.0,0,0,0,0,0,0,1018,0,1.0,0,0
PF13090,PF02503:PF13089:PF03090,2,2,2,0,0,1016,1.0,1.0,1.0,1.0,1,1,1,0,1016,1.0,1.0,0.5,0.71
PF02650,PF00008:PF01940:PF00572,0,90,0,0,90,928,0.0,0.91,0,0,13,0,0,13,1005,0.0,0.99,0,0
PF15367,PF05857:PF11751:PF06890,2,0,0,2,0,1016,0,1.0,0.0,0,0,0,2,0,1016,0,1.0,0.0,0
PF01401,PF16959:PF08326:PF00289,12,34,5,7,29,977,0.15,0.96,0.42,0.23,14,4,8,10,996,0.29,0.98,0.33,0.3
PF16360,PF13167:PF15086:PF09269,4,10,1,3,9,1005,0.1,0.99,0.25,0.15,1,1,3,0,1014,1.0,1.0,0.25,0.5
PF12900,PF12716:PF06912:PF06108,5,9,0,5,9,1004,0.0,0.99,0.0,-0.01,0,0,5,0,1013,0,1.0,0.0,0
PF05662,PF07409:PF14690:PF02465,3,0,0,3,0,1015,0,1.0,0.0,0,0,0,3,0,1015,0,1.0,0.0,0
PF13787,PF04911:PF03548:PF04392,0,6,0,0,6,1012,0.0,0.99,0,0,1,0,0,1,1017,0.0,1.0,0,0
PF04347,PF15681:PF15195:PF08036,0,4,0,0,4,1014,0.0,1.0,0,0,0,0,0,0,1018,0,1.0,0,0
PF12076,PF08079:PF13687:PF04116,5,35,5,0,30,983,0.14,0.97,1.0,0.37,9,2,3,7,1006,0.22,0.99,0.4,0.29
PF01733,PF03194:PF01159:PF03662,16,33,6,10,27,975,0.18,0.96,0.38,0.24,4,3,13,1,1001,0.75,0.99,0.19,0.37
PF08385,PF08393:PF12780:PF12777,26,44,24,2,20,972,0.55,0.98,0.92,0.7,38,22,4,16,976,0.58,0.98,0.85,0.69
PF10065,PF08498:PF12589:PF17086,0,14,0,0,14,1004,0.0,0.99,0,0,3,0,0,3,1015,0.0,1.0,0,0
PF11728,PF10559:PF05608:PF03492,0,17,0,0,17,1001,0.0,0.98,0,0,3,0,0,3,1015,0.0,1.0,0,0
PF15809,PF15555:PF15119:PF15664,0,2,0,0,2,1016,0.0,1.0,0,0,0,0,0,0,1018,0,1.0,0,0
PF04739,PF00478:PF00654:PF16561,6,57,6,0,51,961,0.11,0.95,1.0,0.32,14,4,2,10,1002,0.29,0.99,0.67,0.43
PF09187,PF06890:PF15817:PF02955,0,5,0,0,5,1013,0.0,1.0,0,0,0,0,0,0,1018,0,1.0,0,0
PF05125,PF10964:PF10172:PF08813,0,5,0,0,5,1013,0.0,1.0,0,0,0,0,0,0,1018,0,1.0,0,0
PF09159,PF07080:PF11909:PF01194,1,8,0,1,8,1009,0.0,0.99,0.0,-0.0,0,0,1,0,1017,0,1.0,0.0,0
PF09932,PF14433:PF11478:PF04023,0,1,0,0,1,1017,0.0,1.0,0,0,0,0,0,0,1018,0,1.0,0,0
PF05137,PF04917:PF05513:PF11751,0,2,0,0,2,1016,0.0,1.0,0,0,0,0,0,0,1018,0,1.0,0,0
PF06055,PF05325:PF00496:PF01080,4,25,2,2,23,991,0.08,0.98,0.5,0.19,1,0,4,1,1013,0.0,1.0,0.0,-0.0
PF02951,PF15976:PF02955:PF06592,4,5,4,0,1,1013,0.8,1.0,1.0,0.89,0,0,4,0,1014,0,1.0,0.0,0
PF00400,PF14077:PF15512:PF04192,259,12,10,249,2,757,0.83,0.75,0.04,0.15,1,1,258,0,759,1.0,0.75,0.0,0.05
PF16121,PF08071:PF00900:PF17136,14,25,13,1,12,992,0.52,0.99,0.93,0.69,12,11,3,1,1003,0.92,1.0,0.79,0.85
PF01343,PF08496:PF05003:PF10108,15,6,5,10,1,1002,0.83,0.99,0.33,0.52,1,1,14,0,1003,1.0,0.99,0.07,0.26
PF00016,PF02788:PF01328:PF02244,5,32,3,2,29,984,0.09,0.97,0.6,0.23,6,0,5,6,1007,0.0,0.99,0.0,-0.01
PF02926,PF01170:PF00125:PF04788,12,53,7,5,46,960,0.13,0.95,0.58,0.26,9,5,7,4,1002,0.56,0.99,0.42,0.48
PF10381,PF03986:PF03987:PF13284,9,16,9,0,7,1002,0.56,0.99,1.0,0.75,9,9,0,0,1009,1.0,1.0,1.0,1.0
PF10744,PF10264:PF08729:PF04802,2,13,1,1,12,1004,0.08,0.99,0.5,0.19,3,1,1,2,1014,0.33,1.0,0.5,0.41
PF14687,PF14688:PF07837:PF04961,8,15,8,0,7,1003,0.53,0.99,1.0,0.73,4,1,7,3,1007,0.25,0.99,0.12,0.17
PF12451,PF17122:PF12816:PF00637,8,31,8,0,23,987,0.26,0.98,1.0,0.5,7,6,2,1,1009,0.86,1.0,0.75,0.8
PF13453,PF06666:PF05621:PF11325,3,0,0,3,0,1015,0,1.0,0.0,0,0,0,3,0,1015,0,1.0,0.0,0
PF15043,PF03819:PF06805:PF02522,1,2,0,1,2,1015,0.0,1.0,0.0,-0.0,0,0,1,0,1017,0,1.0,0.0,0
PF13914,PF05548:PF10104:PF15274,7,9,2,5,7,1004,0.22,0.99,0.29,0.25,1,1,6,0,1011,1.0,0.99,0.14,0.38
PF16130,PF17070:PF06651:PF04296,0,0,0,0,0,1018,0,1.0,0,0,0,0,0,0,1018,0,1.0,0,0
PF03253,PF03285:PF15237:PF04144,6,15,5,1,10,1002,0.33,0.99,0.83,0.52,1,1,5,0,1012,1.0,1.0,0.17,0.41
PF10490,PF13005:PF16588:PF10375,4,3,0,4,3,1011,0.0,0.99,0.0,-0.0,1,0,4,1,1013,0.0,1.0,0.0,-0.0
PF15226,PF05135:PF15121:PF15043,0,2,0,0,2,1016,0.0,1.0,0,0,0,0,0,0,1018,0,1.0,0,0
PF03411,PF11245:PF09861:PF05913,1,1,0,1,1,1016,0.0,1.0,0.0,-0.0,0,0,1,0,1017,0,1.0,0.0,0
PF15730,PF10951:PF11124:PF14251,1,2,0,1,2,1015,0.0,1.0,0.0,-0.0,0,0,1,0,1017,0,1.0,0.0,0
PF06644,PF06127:PF02284:PF00499,11,12,3,8,9,998,0.25,0.98,0.27,0.25,0,0,11,0,1007,0,0.99,0.0,0
PF05208,PF07096:PF02133:PF01597,11,44,5,6,39,968,0.11,0.96,0.45,0.21,6,3,8,3,1004,0.5,0.99,0.27,0.36
PF02420,PF02084:PF10578:PF07276,0,0,0,0,0,1018,0,1.0,0,0,0,0,0,0,1018,0,1.0,0,0
PF14021,PF08591:PF10664:PF15125,0,4,0,0,4,1014,0.0,1.0,0,0,0,0,0,0,1018,0,1.0,0,0
PF04166,PF15623:PF06798:PF00997,6,0,0,6,0,1012,0,0.99,0.0,0,0,0,6,0,1012,0,0.99,0.0,0
PF03427,PF08329:PF02839:PF14856,3,17,2,1,15,1000,0.12,0.98,0.67,0.28,2,0,3,2,1013,0.0,1.0,0.0,-0.0
PF00368,PF13323:PF16414:PF02460,16,44,9,7,35,967,0.2,0.96,0.56,0.32,19,6,10,13,989,0.32,0.98,0.38,0.33
PF05594,PF03958:PF07014:PF01228,0,4,0,0,4,1014,0.0,1.0,0,0,0,0,0,0,1018,0,1.0,0,0
PF05032,PF11093:PF08228:PF13933,9,3,0,9,3,1006,0.0,0.99,0.0,-0.01,0,0,9,0,1009,0,0.99,0.0,0
PF01469,PF09289:PF00050:PF07648,4,34,2,2,32,982,0.06,0.97,0.5,0.16,12,1,3,11,1003,0.08,0.99,0.25,0.14
PF08063,PF00645:PF05406:PF02877,7,35,5,2,30,981,0.14,0.97,0.71,0.31,19,5,2,14,997,0.26,0.98,0.71,0.43
PF16028,PF16657:PF09154:PF11941,1,3,1,0,2,1015,0.33,1.0,1.0,0.58,1,1,0,0,1017,1.0,1.0,1.0,1.0
PF01243,PF10590:PF10342:PF06212,12,22,10,2,12,994,0.45,0.99,0.83,0.61,0,0,12,0,1006,0,0.99,0.0,0
PF04370,PF15621:PF08291:PF06724,0,0,0,0,0,1018,0,1.0,0,0,0,0,0,0,1018,0,1.0,0,0
PF08512,PF03531:PF10155:PF08517,18,20,10,8,10,990,0.5,0.98,0.56,0.52,2,2,16,0,1000,1.0,0.98,0.11,0.33
PF00700,PF07409:PF00669:PF03241,1,1,1,0,0,1017,1.0,1.0,1.0,1.0,0,0,1,0,1017,0,1.0,0.0,0
PF03552,PF14569:PF13632:PF04043,13,32,9,4,23,982,0.28,0.97,0.69,0.43,6,4,9,2,1003,0.67,0.99,0.31,0.45
PF00657,PF10604:PF00141:PF03489,39,49,22,17,27,952,0.45,0.96,0.56,0.48,10,9,30,1,978,0.9,0.97,0.23,0.45
PF01699,PF03733:PF16494:PF01553,41,65,20,21,45,932,0.31,0.94,0.49,0.36,3,3,38,0,977,1.0,0.96,0.07,0.27
PF08515,PF01064:PF08917:PF14786,8,20,8,0,12,998,0.4,0.99,1.0,0.63,2,2,6,0,1010,1.0,0.99,0.25,0.5
PF16531,PF07989:PF05104:PF03801,3,20,1,2,19,996,0.05,0.98,0.33,0.12,2,0,3,2,1013,0.0,1.0,0.0,-0.0
PF14764,PF09822:PF15296:PF09759,5,14,1,4,13,1000,0.07,0.98,0.2,0.11,3,1,4,2,1011,0.33,0.99,0.2,0.26
PF07546,PF00147:PF16034:PF00386,5,60,4,1,56,957,0.07,0.94,0.8,0.22,15,3,2,12,1001,0.2,0.99,0.6,0.34
PF04775,PF08840:PF05076:PF12470,3,7,2,1,5,1010,0.29,0.99,0.67,0.43,3,1,2,2,1013,0.33,1.0,0.33,0.33
PF15811,PF11616:PF11764:PF02064,7,14,3,4,11,1000,0.21,0.99,0.43,0.3,4,2,5,2,1009,0.5,0.99,0.29,0.37
PF04837,PF06355:PF02977:PF15556,0,2,0,0,2,1016,0.0,1.0,0,0,0,0,0,0,1018,0,1.0,0,0
PF15103,PF07310:PF17017:PF15756,2,2,0,2,2,1014,0.0,1.0,0.0,-0.0,0,0,2,0,1016,0,1.0,0.0,0
PF06217,PF02531:PF06876:PF11909,0,3,0,0,3,1015,0.0,1.0,0,0,0,0,0,0,1018,0,1.0,0,0
PF10131,PF15340:PF08808:PF13011,0,2,0,0,2,1016,0.0,1.0,0,0,0,0,0,0,1018,0,1.0,0,0
PF10528,PF00624:PF07977:PF12371,2,15,2,0,13,1003,0.13,0.99,1.0,0.36,1,1,1,0,1016,1.0,1.0,0.5,0.71
PF16771,PF05947:PF14015:PF11245,0,0,0,0,0,1018,0,1.0,0,0,0,0,0,0,1018,0,1.0,0,0
PF01061,PF06472:PF14510:PF01851,54,36,22,32,14,950,0.61,0.95,0.41,0.48,4,4,50,0,964,1.0,0.95,0.07,0.27
PF06268,PF06229:PF01087:PF00150,8,55,6,2,49,961,0.11,0.95,0.75,0.27,10,4,4,6,1004,0.4,0.99,0.5,0.44
PF15676,PF15134:PF11111:PF09074,0,2,0,0,2,1016,0.0,1.0,0,0,0,0,0,0,1018,0,1.0,0,0
PF00480,PF02350:PF17167:PF08303,10,7,1,9,6,1002,0.14,0.99,0.1,0.11,1,0,10,1,1007,0.0,0.99,0.0,-0.0
PF08890,PF00383:PF00749:PF07147,0,71,0,0,71,947,0.0,0.93,0,0,20,0,0,20,998,0.0,0.98,0,0
PF06315,PF16216:PF01796:PF04093,8,3,1,7,2,1008,0.33,0.99,0.12,0.2,0,0,8,0,1010,0,0.99,0.0,0
PF00728,PF14845:PF07555:PF02838,36,27,25,11,2,980,0.93,0.99,0.69,0.8,4,4,32,0,982,1.0,0.97,0.11,0.33
PF06426,PF13720:PF14602:PF12464,10,31,6,4,25,983,0.19,0.97,0.6,0.33,10,4,6,6,1002,0.4,0.99,0.4,0.39
PF00858,PF02320:PF03409:PF15880,57,17,7,50,10,951,0.41,0.94,0.12,0.2,1,1,56,0,961,1.0,0.94,0.02,0.13
PF07133,PF15447:PF15445:PF12377,1,1,1,0,0,1017,1.0,1.0,1.0,1.0,1,1,0,0,1017,1.0,1.0,1.0,1.0
PF05960,PF15377:PF14936:PF05612,1,0,0,1,0,1017,0,1.0,0.0,0,0,0,1,0,1017,0,1.0,0.0,0
PF08072,PF09382:PF16204:PF16202,7,17,7,0,10,1001,0.41,0.99,1.0,0.64,7,7,0,0,1011,1.0,1.0,1.0,1.0
PF02837,PF02929:PF16353:PF02836,16,18,12,4,6,996,0.67,0.99,0.75,0.7,5,5,11,0,1002,1.0,0.99,0.31,0.56
PF08354,PF16073:PF01575:PF14765,10,56,10,0,46,962,0.18,0.95,1.0,0.41,24,10,0,14,994,0.42,0.99,1.0,0.64
PF11306,PF09922:PF08173:PF00361,0,26,0,0,26,992,0.0,0.97,0,0,0,0,0,0,1018,0,1.0,0,0
PF12201,PF09690:PF02972:PF00519,0,5,0,0,5,1013,0.0,1.0,0,0,0,0,0,0,1018,0,1.0,0,0
PF05602,PF10236:PF02186:PF04111,11,25,5,6,20,987,0.2,0.97,0.45,0.29,6,3,8,3,1004,0.5,0.99,0.27,0.36
PF04671,PF13753:PF15150:PF16325,1,1,0,1,1,1016,0.0,1.0,0.0,-0.0,0,0,1,0,1017,0,1.0,0.0,0
PF05028,PF10257:PF10309:PF04821,15,22,4,11,18,985,0.18,0.97,0.27,0.21,4,3,12,1,1002,0.75,0.99,0.2,0.38
PF05001,PF04990:PF04992:PF08343,7,7,4,3,3,1008,0.57,0.99,0.57,0.57,2,2,5,0,1011,1.0,1.0,0.29,0.53
PF10693,PF06954:PF12046:PF16851,0,1,0,0,1,1017,0.0,1.0,0,0,0,0,0,0,1018,0,1.0,0,0
PF01528,PF11851:PF14762:PF15951,0,3,0,0,3,1015,0.0,1.0,0,0,1,0,0,1,1017,0.0,1.0,0,0
PF02204,PF01754:PF02493:PF00415,34,95,27,7,68,916,0.28,0.93,0.79,0.45,24,16,18,8,976,0.67,0.97,0.47,0.55
PF12585,PF08591:PF07961:PF10454,2,0,0,2,0,1016,0,1.0,0.0,0,0,0,2,0,1016,0,1.0,0.0,0
PF15884,PF11029:PF10161:PF15071,3,3,1,2,2,1013,0.33,1.0,0.33,0.33,0,0,3,0,1015,0,1.0,0.0,0
PF08571,PF17221:PF14934:PF10706,8,4,0,8,4,1006,0.0,0.99,0.0,-0.01,0,0,8,0,1010,0,0.99,0.0,0
PF09138,PF08228:PF15180:PF15158,8,6,3,5,3,1007,0.5,0.99,0.38,0.43,0,0,8,0,1010,0,0.99,0.0,0
PF13784,PF08091:PF16804:PF14814,0,0,0,0,0,1018,0,1.0,0,0,0,0,0,0,1018,0,1.0,0,0
PF05444,PF15489:PF08925:PF07857,3,14,0,3,14,1001,0.0,0.98,0.0,-0.01,2,0,3,2,1013,0.0,1.0,0.0,-0.0
PF02405,PF09383:PF08352:PF12800,3,4,2,1,2,1013,0.5,1.0,0.67,0.58,2,2,1,0,1015,1.0,1.0,0.67,0.82
PF10255,PF01896:PF04819:PF01702,9,21,3,6,18,991,0.14,0.98,0.33,0.21,4,3,6,1,1008,0.75,0.99,0.33,0.5
PF13774,PF00957:PF09426:PF07542,20,43,17,3,26,972,0.4,0.97,0.85,0.57,5,3,17,2,996,0.6,0.98,0.15,0.29
PF00831,PF00159:PF01279:PF05676,10,9,1,9,8,1000,0.11,0.98,0.1,0.1,2,1,9,1,1007,0.5,0.99,0.1,0.22
PF02477,PF07434:PF16967:PF15976,0,0,0,0,0,1018,0,1.0,0,0,0,0,0,0,1018,0,1.0,0,0
PF00154,PF03198:PF00332:PF07983,16,42,9,7,33,969,0.21,0.96,0.56,0.33,11,4,12,7,995,0.36,0.98,0.25,0.29
PF10599,PF09950:PF12603:PF10035,5,3,0,5,3,1010,0.0,0.99,0.0,-0.0,0,0,5,0,1013,0,1.0,0.0,0
PF00630,PF12780:PF08393:PF07691,24,49,16,8,33,961,0.33,0.96,0.67,0.45,32,13,11,19,975,0.41,0.97,0.54,0.45
PF14578,PF04760:PF09093:PF08361,1,11,1,0,10,1007,0.09,0.99,1.0,0.3,0,0,1,0,1017,0,1.0,0.0,0
PF16840,PF15318:PF10357:PF00022,0,64,0,0,64,954,0.0,0.94,0,0,8,0,0,8,1010,0.0,0.99,0,0
PF00635,PF03567:PF00650:PF03765,38,76,21,17,55,925,0.28,0.93,0.55,0.36,26,12,26,14,966,0.46,0.96,0.32,0.36
PF14822,PF07406:PF15003:PF09784,2,3,0,2,3,1013,0.0,1.0,0.0,-0.0,0,0,2,0,1016,0,1.0,0.0,0
PF15712,PF03963:PF02501:PF08361,0,4,0,0,4,1014,0.0,1.0,0,0,0,0,0,0,1018,0,1.0,0,0
PF07910,PF07782:PF13890:PF03615,18,16,3,15,13,987,0.19,0.97,0.17,0.16,5,3,15,2,998,0.6,0.98,0.17,0.31
PF08578,PF15862:PF15997:PF07891,5,3,1,4,2,1011,0.33,0.99,0.2,0.26,0,0,5,0,1013,0,1.0,0.0,0
PF11249,PF14092:PF00160:PF06201,0,82,0,0,82,936,0.0,0.92,0,0,9,0,0,9,1009,0.0,0.99,0,0
PF04874,PF01778:PF15431:PF01113,7,23,5,2,18,993,0.22,0.98,0.71,0.39,1,0,7,1,1010,0.0,0.99,0.0,-0.0
PF12435,PF02041:PF15519:PF08080,5,12,1,4,11,1002,0.08,0.99,0.2,0.12,1,0,5,1,1012,0.0,0.99,0.0,-0.0
PF01738,PF03211:PF04199:PF04979,19,35,9,10,26,973,0.26,0.96,0.47,0.33,14,9,10,5,994,0.64,0.99,0.47,0.54
PF06780,PF05128:PF15086:PF10662,1,4,1,0,3,1014,0.25,1.0,1.0,0.5,1,1,0,0,1017,1.0,1.0,1.0,1.0
PF06427,PF01501:PF06241:PF08530,10,54,8,2,46,962,0.15,0.95,0.8,0.33,6,2,8,4,1004,0.33,0.99,0.2,0.25
PF02350,PF00480:PF02065:PF16874,2,15,0,2,15,1001,0.0,0.98,0.0,-0.01,1,0,2,1,1015,0.0,1.0,0.0,-0.0
PF13054,PF03748:PF07411:PF04671,0,1,0,0,1,1017,0.0,1.0,0,0,0,0,0,0,1018,0,1.0,0,0
PF08528,PF04090:PF10104:PF02116,5,10,1,4,9,1004,0.1,0.99,0.2,0.14,2,0,5,2,1011,0.0,0.99,0.0,-0.0
PF01261,PF12296:PF06244:PF04667,22,21,1,21,20,976,0.05,0.96,0.05,0.03,1,0,22,1,995,0.0,0.98,0.0,-0.0
PF06131,PF06007:PF06070:PF06798,2,3,0,2,3,1013,0.0,1.0,0.0,-0.0,0,0,2,0,1016,0,1.0,0.0,0
PF13861,PF07157:PF07409:PF13722,0,0,0,0,0,1018,0,1.0,0,0,0,0,0,0,1018,0,1.0,0,0
PF11900,PF12313:PF16553:PF09310,4,4,4,0,0,1014,1.0,1.0,1.0,1.0,1,1,3,0,1014,1.0,1.0,0.25,0.5
PF08005,PF08239:PF09494:PF03256,4,28,4,0,24,990,0.14,0.98,1.0,0.37,6,3,1,3,1011,0.5,1.0,0.75,0.61
PF06083,PF01632:PF08561:PF10218,3,10,0,3,10,1005,0.0,0.99,0.0,-0.01,0,0,3,0,1015,0,1.0,0.0,0
PF00670,PF05221:PF02812:PF03071,6,30,6,0,24,988,0.2,0.98,1.0,0.44,4,3,3,1,1011,0.75,1.0,0.5,0.61
PF11830,PF15733:PF12068:PF12473,4,29,3,1,26,988,0.1,0.97,0.75,0.27,0,0,4,0,1014,0,1.0,0.0,0
PF08637,PF10022:PF14764:PF09822,8,16,2,6,14,996,0.12,0.98,0.25,0.17,1,0,8,1,1009,0.0,0.99,0.0,-0.0
PF05728,PF13094:PF15032:PF05707,4,1,0,4,1,1013,0.0,1.0,0.0,-0.0,0,0,4,0,1014,0,1.0,0.0,0
PF14513,PF00609:PF16901:PF00036,7,51,5,2,46,965,0.1,0.95,0.71,0.25,12,3,4,9,1002,0.25,0.99,0.43,0.32
PF04612,PF11612:PF01580:PF10566,1,6,1,0,5,1012,0.17,1.0,1.0,0.41,1,1,0,0,1017,1.0,1.0,1.0,1.0
PF04335,PF12883:PF13471:PF04060,7,6,4,3,2,1009,0.67,1.0,0.57,0.61,2,2,5,0,1011,1.0,1.0,0.29,0.53
PF06589,PF16979:PF00986:PF09130,0,28,0,0,28,990,0.0,0.97,0,0,1,0,0,1,1017,0.0,1.0,0,0
PF00282,PF05637:PF00494:PF02517,46,55,19,27,36,936,0.35,0.94,0.41,0.35,10,7,39,3,969,0.7,0.96,0.15,0.31
PF08488,PF14380:PF13947:PF08515,6,27,6,0,21,991,0.22,0.98,1.0,0.47,6,4,2,2,1010,0.67,1.0,0.67,0.66
PF05395,PF15260:PF03488:PF05281,2,5,0,2,5,1011,0.0,0.99,0.0,-0.0,0,0,2,0,1016,0,1.0,0.0,0
PF07092,PF12456:PF08952:PF16726,6,13,1,5,12,1000,0.08,0.98,0.17,0.11,2,1,5,1,1011,0.5,0.99,0.17,0.29
PF02661,PF02430:PF02517:PF10211,11,17,3,8,14,993,0.18,0.98,0.27,0.21,2,2,9,0,1007,1.0,0.99,0.18,0.42
PF15768,PF05202:PF10009:PF17060,0,1,0,0,1,1017,0.0,1.0,0,0,0,0,0,0,1018,0,1.0,0,0
PF03868,PF01159:PF04265:PF01729,13,34,9,4,25,980,0.26,0.97,0.69,0.42,7,4,9,3,1002,0.57,0.99,0.31,0.41
PF16769,PF16768:PF03399:PF16766,1,23,1,0,22,995,0.04,0.98,1.0,0.21,2,1,0,1,1016,0.5,1.0,1.0,0.71
PF02245,PF14473:PF00214:PF00236,4,1,0,4,1,1013,0.0,1.0,0.0,-0.0,1,0,4,1,1013,0.0,1.0,0.0,-0.0
PF04280,PF16516:PF15558:PF09730,7,11,0,7,11,1000,0.0,0.98,0.0,-0.01,0,0,7,0,1011,0,0.99,0.0,0
PF15087,PF02106:PF10630:PF15398,1,1,0,1,1,1016,0.0,1.0,0.0,-0.0,0,0,1,0,1017,0,1.0,0.0,0
PF08753,PF02951:PF14258:PF04865,0,4,0,0,4,1014,0.0,1.0,0,0,0,0,0,0,1018,0,1.0,0,0
PF13414,PF00515:PF13181:PF07719,40,130,35,5,95,883,0.27,0.9,0.88,0.45,48,28,12,20,958,0.58,0.97,0.7,0.62
PF16491,PF01435:PF12735:PF00273,17,24,15,2,9,992,0.62,0.99,0.88,0.74,0,0,17,0,1001,0,0.98,0.0,0
PF01607,PF15002:PF01522:PF09347,55,42,13,42,29,934,0.31,0.93,0.24,0.23,7,7,48,0,963,1.0,0.95,0.13,0.35
PF15114,PF15141:PF15212:PF03050,0,0,0,0,0,1018,0,1.0,0,0,0,0,0,0,1018,0,1.0,0,0
PF00333,PF03719:PF01132:PF09285,20,25,18,2,7,991,0.72,0.99,0.9,0.8,6,1,19,5,993,0.17,0.98,0.05,0.08
PF14800,PF04129:PF05942:PF15091,4,18,2,2,16,998,0.11,0.98,0.5,0.23,0,0,4,0,1014,0,1.0,0.0,0
PF13655,PF08388:PF06817:PF08284,6,29,6,0,23,989,0.21,0.98,1.0,0.45,4,3,3,1,1011,0.75,1.0,0.5,0.61
PF00232,PF14498:PF05577:PF06964,36,40,13,23,27,955,0.33,0.95,0.36,0.32,10,6,30,4,978,0.6,0.97,0.17,0.3
PF05762,PF10407:PF09967:PF09462,4,4,1,3,3,1011,0.25,0.99,0.25,0.25,0,0,4,0,1014,0,1.0,0.0,0
PF09991,PF15289:PF12646:PF02620,0,8,0,0,8,1010,0.0,0.99,0,0,0,0,0,0,1018,0,1.0,0,0
PF03754,PF07939:PF07052:PF04949,2,19,0,2,19,997,0.0,0.98,0.0,-0.01,4,0,2,4,1012,0.0,0.99,0.0,-0.0
PF03211,PF00457:PF01083:PF12296,12,20,4,8,16,990,0.2,0.98,0.33,0.25,6,3,9,3,1003,0.5,0.99,0.25,0.35
PF05766,PF07022:PF05969:PF07310,0,2,0,0,2,1016,0.0,1.0,0,0,0,0,0,0,1018,0,1.0,0,0
PF16457,PF11841:PF04727:PF00388,15,33,13,2,20,983,0.39,0.98,0.87,0.58,9,8,7,1,1002,0.89,0.99,0.53,0.69
PF09815,PF10744:PF02755:PF04906,18,15,3,15,12,988,0.2,0.97,0.17,0.17,1,1,17,0,1000,1.0,0.98,0.06,0.23
PF04321,PF11803:PF14524:PF16363,16,39,10,6,29,973,0.26,0.97,0.62,0.39,3,2,14,1,1001,0.67,0.99,0.12,0.28
PF15349,PF07807:PF17100:PF17107,0,37,0,0,37,981,0.0,0.96,0,0,12,0,0,12,1006,0.0,0.99,0,0
PF12220,PF08081:PF15519:PF12196,5,10,2,3,8,1005,0.2,0.99,0.4,0.28,1,1,4,0,1013,1.0,1.0,0.2,0.45
PF02884,PF02278:PF08124:PF04425,1,2,1,0,1,1016,0.5,1.0,1.0,0.71,2,1,0,1,1016,0.5,1.0,1.0,0.71
PF01603,PF04729:PF15998:PF09756,21,19,8,13,11,986,0.42,0.98,0.38,0.39,1,1,20,0,997,1.0,0.98,0.05,0.22
PF05890,PF09814:PF03981:PF06632,8,19,3,5,16,994,0.16,0.98,0.38,0.23,2,0,8,2,1008,0.0,0.99,0.0,-0.0
PF01705,PF07809:PF09756:PF15298,8,6,0,8,6,1004,0.0,0.99,0.0,-0.01,0,0,8,0,1010,0,0.99,0.0,0
PF04377,PF04376:PF02750:PF02112,7,11,6,1,5,1006,0.55,0.99,0.86,0.68,0,0,7,0,1011,0,0.99,0.0,0
PF08329,PF03427:PF02839:PF06483,1,10,0,1,10,1007,0.0,0.99,0.0,-0.0,1,0,1,1,1016,0.0,1.0,0.0,-0.0
PF00855,PF10513:PF11467:PF05965,35,40,17,18,23,960,0.42,0.96,0.49,0.43,8,6,29,2,981,0.75,0.97,0.17,0.35
PF08492,PF13174:PF05279:PF09976,8,19,4,4,15,995,0.21,0.98,0.5,0.32,2,2,6,0,1010,1.0,0.99,0.25,0.5
PF10562,PF10565:PF04069:PF08636,5,11,4,1,7,1006,0.36,0.99,0.8,0.54,0,0,5,0,1013,0,1.0,0.0,0
PF03373,PF08657:PF15165:PF12150,1,4,0,1,4,1013,0.0,1.0,0.0,-0.0,0,0,1,0,1017,0,1.0,0.0,0
PF05089,PF12971:PF12972:PF03648,11,13,11,0,2,1005,0.85,1.0,1.0,0.92,6,6,5,0,1007,1.0,1.0,0.55,0.74
PF01943,PF02465:PF10566:PF08497,0,0,0,0,0,1018,0,1.0,0,0,0,0,0,0,1018,0,1.0,0,0
PF12377,PF12361:PF15445:PF15447,1,1,1,0,0,1017,1.0,1.0,1.0,1.0,1,1,0,0,1017,1.0,1.0,1.0,1.0
PF11619,PF07710:PF08563:PF00870,1,5,1,0,4,1013,0.2,1.0,1.0,0.45,2,1,0,1,1016,0.5,1.0,1.0,0.71
PF16274,PF16544:PF16568:PF08067,2,7,1,1,6,1010,0.14,0.99,0.5,0.26,1,1,1,0,1016,1.0,1.0,0.5,0.71
PF03796,PF02132:PF06683:PF07364,12,4,1,11,3,1003,0.25,0.99,0.08,0.14,0,0,12,0,1006,0,0.99,0.0,0
PF13374,PF01048:PF12807:PF05303,52,36,21,31,15,951,0.58,0.95,0.4,0.46,5,5,47,0,966,1.0,0.95,0.1,0.3
PF06513,PF03344:PF09038:PF15030,0,2,0,0,2,1016,0.0,1.0,0,0,0,0,0,0,1018,0,1.0,0,0
PF15032,PF09108:PF00669:PF15976,0,1,0,0,1,1017,0.0,1.0,0,0,0,0,0,0,1018,0,1.0,0,0
PF13445,PF00097:PF14634:PF00643,60,105,48,12,57,901,0.46,0.93,0.8,0.57,29,22,38,7,951,0.76,0.96,0.37,0.51
PF04273,PF03200:PF04864:PF03368,1,23,1,0,22,995,0.04,0.98,1.0,0.21,4,1,0,3,1014,0.25,1.0,1.0,0.5
PF08596,PF12490:PF08159:PF03451,7,22,4,3,18,993,0.18,0.98,0.57,0.31,5,3,4,2,1009,0.6,0.99,0.43,0.5
PF09084,PF02653:PF08402:PF05141,18,18,7,11,11,989,0.39,0.98,0.39,0.38,5,3,15,2,998,0.6,0.98,0.17,0.31
PF15671,PF04232:PF11703:PF16416,0,3,0,0,3,1015,0.0,1.0,0,0,0,0,0,0,1018,0,1.0,0,0
PF01231,PF01070:PF13875:PF15161,18,47,12,6,35,965,0.26,0.96,0.67,0.4,2,2,16,0,1000,1.0,0.98,0.11,0.33
PF06639,PF10566:PF07195:PF02277,0,3,0,0,3,1015,0.0,1.0,0,0,0,0,0,0,1018,0,1.0,0,0
PF04556,PF07496:PF04425:PF02008,2,31,1,1,30,986,0.03,0.97,0.5,0.12,6,1,1,5,1011,0.17,0.99,0.5,0.29
PF08619,PF16644:PF02254:PF01026,2,31,1,1,30,986,0.03,0.97,0.5,0.12,4,1,1,3,1013,0.25,1.0,0.5,0.35
PF02387,PF04355:PF04451:PF17014,0,1,0,0,1,1017,0.0,1.0,0,0,0,0,0,0,1018,0,1.0,0,0
PF08545,PF08392:PF02504:PF00195,3,29,3,0,26,989,0.1,0.97,1.0,0.32,4,3,0,1,1014,0.75,1.0,1.0,0.87
PF04736,PF11029:PF15071:PF06679,1,2,0,1,2,1015,0.0,1.0,0.0,-0.0,0,0,1,0,1017,0,1.0,0.0,0
PF16972,PF11069:PF17223:PF17054,2,10,1,1,9,1007,0.1,0.99,0.5,0.22,0,0,2,0,1016,0,1.0,0.0,0
PF00603,PF06890:PF10080:PF15504,2,1,0,2,1,1015,0.0,1.0,0.0,-0.0,0,0,2,0,1016,0,1.0,0.0,0
PF04418,PF15003:PF03386:PF05512,6,4,0,6,4,1008,0.0,0.99,0.0,-0.0,0,0,6,0,1012,0,0.99,0.0,0
PF15156,PF17061:PF16001:PF06952,1,1,0,1,1,1016,0.0,1.0,0.0,-0.0,0,0,1,0,1017,0,1.0,0.0,0
PF08396,PF02950:PF09232:PF17124,0,1,0,0,1,1017,0.0,1.0,0,0,0,0,0,0,1018,0,1.0,0,0
PF01820,PF07478:PF16353:PF02929,1,13,1,0,12,1005,0.08,0.99,1.0,0.28,5,0,1,5,1012,0.0,0.99,0.0,-0.0
PF10714,PF08497:PF14690:PF11019,3,0,0,3,0,1015,0,1.0,0.0,0,0,0,3,0,1015,0,1.0,0.0,0
PF14048,PF16564:PF01429:PF09791,8,34,7,1,27,983,0.21,0.97,0.88,0.42,3,3,5,0,1010,1.0,1.0,0.38,0.61
PF11732,PF16134:PF11262:PF03993,6,9,6,0,3,1009,0.67,1.0,1.0,0.82,6,6,0,0,1012,1.0,1.0,1.0,1.0
PF10141,PF12779:PF15096:PF02369,1,0,0,1,0,1017,0,1.0,0.0,0,0,0,1,0,1017,0,1.0,0.0,0
PF02494,PF07699:PF00084:PF01120,20,64,19,1,45,953,0.3,0.95,0.95,0.52,18,14,6,4,994,0.78,0.99,0.7,0.73
PF05627,PF06136:PF07798:PF04570,8,15,3,5,12,998,0.2,0.98,0.38,0.27,1,1,7,0,1010,1.0,0.99,0.12,0.35
PF02696,PF04960:PF01241:PF16053,11,14,2,9,12,995,0.14,0.98,0.18,0.15,1,1,10,0,1007,1.0,0.99,0.09,0.3
PF15107,PF15085:PF15119:PF01316,0,5,0,0,5,1013,0.0,1.0,0,0,0,0,0,0,1018,0,1.0,0,0
PF05977,PF07523:PF01136:PF15518,7,2,0,7,2,1009,0.0,0.99,0.0,-0.0,0,0,7,0,1011,0,0.99,0.0,0
PF15883,PF07240:PF09252:PF00489,0,1,0,0,1,1017,0.0,1.0,0,0,0,0,0,0,1018,0,1.0,0,0
PF10048,PF13015:PF08086:PF01296,1,14,0,1,14,1003,0.0,0.99,0.0,-0.0,0,0,1,0,1017,0,1.0,0.0,0
PF12718,PF00261:PF03285:PF13851,1,10,1,0,9,1008,0.1,0.99,1.0,0.31,0,0,1,0,1017,0,1.0,0.0,0
PF08399,PF08473:PF02743:PF08487,10,24,8,2,16,992,0.33,0.98,0.8,0.51,5,4,6,1,1007,0.8,0.99,0.4,0.56
PF14648,PF14647:PF09494:PF16876,3,19,3,0,16,999,0.16,0.98,1.0,0.39,3,1,2,2,1013,0.33,1.0,0.33,0.33
PF07243,PF03428:PF01913:PF10566,0,1,0,0,1,1017,0.0,1.0,0,0,0,0,0,0,1018,0,1.0,0,0
PF06187,PF08846:PF01627:PF05721,0,41,0,0,41,977,0.0,0.96,0,0,5,0,0,5,1013,0.0,1.0,0,0
PF13041,PF12854:PF02363:PF10674,130,64,60,70,4,884,0.94,0.93,0.46,0.63,5,5,125,0,888,1.0,0.88,0.04,0.18
PF00713,PF03812:PF08906:PF05145,1,1,0,1,1,1016,0.0,1.0,0.0,-0.0,0,0,1,0,1017,0,1.0,0.0,0
PF02571,PF00999:PF09676:PF04100,1,57,0,1,57,960,0.0,0.94,0.0,-0.01,4,0,1,4,1013,0.0,1.0,0.0,-0.0
PF05884,PF11703:PF15053:PF15814,0,2,0,0,2,1016,0.0,1.0,0,0,0,0,0,0,1018,0,1.0,0,0
PF05241,PF07106:PF04667:PF01680,9,18,2,7,16,993,0.11,0.98,0.22,0.15,1,0,9,1,1008,0.0,0.99,0.0,-0.0
PF04001,PF11517:PF15082:PF08183,0,3,0,0,3,1015,0.0,1.0,0,0,0,0,0,0,1018,0,1.0,0,0
PF09772,PF15390:PF06382:PF14822,6,3,0,6,3,1009,0.0,0.99,0.0,-0.0,0,0,6,0,1012,0,0.99,0.0,0
PF00263,PF17084:PF02501:PF11614,3,6,2,1,4,1011,0.33,1.0,0.67,0.47,0,0,3,0,1015,0,1.0,0.0,0
PF15557,PF07001:PF10482:PF15624,0,10,0,0,10,1008,0.0,0.99,0,0,0,0,0,0,1018,0,1.0,0,0
PF05491,PF06934:PF09850:PF01364,5,3,0,5,3,1010,0.0,0.99,0.0,-0.0,0,0,5,0,1013,0,1.0,0.0,0
PF16118,PF15730:PF15763:PF10951,1,1,0,1,1,1016,0.0,1.0,0.0,-0.0,0,0,1,0,1017,0,1.0,0.0,0
PF07024,PF11026:PF12603:PF17007,0,1,0,0,1,1017,0.0,1.0,0,0,0,0,0,0,1018,0,1.0,0,0
PF14808,PF06951:PF01294:PF15065,3,20,0,3,20,995,0.0,0.98,0.0,-0.01,3,0,3,3,1012,0.0,0.99,0.0,-0.0
PF16041,PF12936:PF09332:PF11970,7,14,4,3,10,1001,0.29,0.99,0.57,0.4,1,0,7,1,1010,0.0,0.99,0.0,-0.0
PF00072,PF03924:PF00512:PF08448,71,48,43,28,5,942,0.9,0.97,0.61,0.72,12,12,59,0,947,1.0,0.94,0.17,0.4
PF06586,PF05309:PF07178:PF05509,1,1,1,0,0,1017,1.0,1.0,1.0,1.0,1,1,0,0,1017,1.0,1.0,1.0,1.0
PF07016,PF01514:PF03428:PF01752,0,2,0,0,2,1016,0.0,1.0,0,0,0,0,0,0,1018,0,1.0,0,0
PF14297,PF02557:PF01913:PF15482,0,3,0,0,3,1015,0.0,1.0,0,0,0,0,0,0,1018,0,1.0,0,0
PF03256,PF11515:PF10557:PF00888,16,41,9,7,32,970,0.22,0.96,0.56,0.34,29,7,9,22,980,0.24,0.97,0.44,0.31
PF01508,PF13948:PF06671:PF15789,0,5,0,0,5,1013,0.0,1.0,0,0,0,0,0,0,1018,0,1.0,0,0
PF17200,PF06228:PF12106:PF02654,0,4,0,0,4,1014,0.0,1.0,0,0,0,0,0,0,1018,0,1.0,0,0
PF11788,PF15916:PF14803:PF00828,17,27,5,12,22,979,0.19,0.97,0.29,0.22,4,3,14,1,1000,0.75,0.99,0.18,0.36
PF08535,PF02305:PF06890:PF04687,1,1,0,1,1,1016,0.0,1.0,0.0,-0.0,1,0,1,1,1016,0.0,1.0,0.0,-0.0
PF13898,PF15019:PF01758:PF07139,9,15,2,7,13,996,0.13,0.98,0.22,0.16,1,1,8,0,1009,1.0,0.99,0.11,0.33
PF01676,PF06415:PF10143:PF04987,15,20,14,1,6,997,0.7,0.99,0.93,0.81,2,2,13,0,1003,1.0,0.99,0.13,0.36
PF13636,PF08298:PF05401:PF14258,1,1,0,1,1,1016,0.0,1.0,0.0,-0.0,0,0,1,0,1017,0,1.0,0.0,0
PF12736,PF05640:PF10296:PF06741,8,22,2,6,20,990,0.09,0.97,0.25,0.14,2,1,7,1,1009,0.5,0.99,0.12,0.25
PF10267,PF13865:PF14782:PF08081,9,16,3,6,13,996,0.19,0.98,0.33,0.24,3,2,7,1,1008,0.67,0.99,0.22,0.38
PF08205,PF07686:PF13895:PF03921,29,68,24,5,44,945,0.35,0.95,0.83,0.52,18,11,18,7,982,0.61,0.98,0.38,0.47
PF02664,PF07906:PF03835:PF07915,2,27,0,2,27,989,0.0,0.97,0.0,-0.01,4,0,2,4,1012,0.0,0.99,0.0,-0.0
PF07809,PF15298:PF04367:PF02576,0,2,0,0,2,1016,0.0,1.0,0,0,0,0,0,0,1018,0,1.0,0,0
PF04381,PF00887:PF00378:PF16113,1,92,1,0,91,926,0.01,0.91,1.0,0.1,26,1,0,25,992,0.04,0.98,1.0,0.19
PF16190,PF16191:PF10585:PF16195,3,6,3,0,3,1012,0.5,1.0,1.0,0.71,3,3,0,0,1015,1.0,1.0,1.0,1.0
PF15293,PF15068:PF15053:PF15814,1,3,0,1,3,1014,0.0,1.0,0.0,-0.0,0,0,1,0,1017,0,1.0,0.0,0
PF01383,PF00502:PF01228:PF15130,1,3,1,0,2,1015,0.33,1.0,1.0,0.58,0,0,1,0,1017,0,1.0,0.0,0
PF01531,PF04901:PF09631:PF10218,4,12,0,4,12,1002,0.0,0.98,0.0,-0.01,0,0,4,0,1014,0,1.0,0.0,0
PF14560,PF01302:PF16641:PF13446,13,48,9,4,39,966,0.19,0.96,0.69,0.35,3,2,11,1,1004,0.67,0.99,0.15,0.32
PF12178,PF10407:PF15235:PF01430,2,2,0,2,2,1014,0.0,1.0,0.0,-0.0,0,0,2,0,1016,0,1.0,0.0,0
PF06306,PF15876:PF09673:PF15832,0,0,0,0,0,1018,0,1.0,0,0,0,0,0,0,1018,0,1.0,0,0
PF16973,PF15143:PF03831:PF05280,0,4,0,0,4,1014,0.0,1.0,0,0,0,0,0,0,1018,0,1.0,0,0
PF13966,PF14529:PF12009:PF14111,91,94,44,47,50,877,0.47,0.9,0.48,0.42,13,11,80,2,925,0.85,0.92,0.12,0.3
PF08344,PF00710:PF16799:PF15808,8,21,3,5,18,992,0.14,0.98,0.38,0.22,0,0,8,0,1010,0,0.99,0.0,0
PF10322,PF02343:PF10319:PF15362,0,4,0,0,4,1014,0.0,1.0,0,0,0,0,0,0,1018,0,1.0,0,0
PF11515,PF03256:PF06701:PF00888,9,53,9,0,44,965,0.17,0.96,1.0,0.4,14,8,1,6,1003,0.57,0.99,0.89,0.71
PF13380,PF13607:PF15161:PF14996,8,3,2,6,1,1009,0.67,0.99,0.25,0.41,1,1,7,0,1010,1.0,0.99,0.12,0.35
PF12680,PF08787:PF01828:PF10224,7,15,2,5,13,998,0.13,0.98,0.29,0.19,0,0,7,0,1011,0,0.99,0.0,0
PF04196,PF15518:PF11751:PF09327,1,1,1,0,0,1017,1.0,1.0,1.0,1.0,0,0,1,0,1017,0,1.0,0.0,0
PF12236,PF06122:PF05065:PF10099,0,1,0,0,1,1017,0.0,1.0,0,0,0,0,0,0,1018,0,1.0,0,0
PF13906,PF13520:PF00154:PF02727,18,85,17,1,68,932,0.2,0.93,0.94,0.42,19,8,10,11,989,0.42,0.98,0.44,0.42
PF15013,PF10244:PF03980:PF08561,1,15,0,1,15,1002,0.0,0.98,0.0,-0.0,1,0,1,1,1016,0.0,1.0,0.0,-0.0
PF09092,PF03971:PF00381:PF09093,1,2,1,0,1,1016,0.5,1.0,1.0,0.71,0,0,1,0,1017,0,1.0,0.0,0
PF11380,PF17101:PF17103:PF17102,7,9,7,0,2,1009,0.78,1.0,1.0,0.88,5,4,3,1,1010,0.8,1.0,0.57,0.67
PF14826,PF08644:PF16188:PF01321,10,18,8,2,10,998,0.44,0.99,0.8,0.59,6,3,7,3,1005,0.5,0.99,0.3,0.38
PF06730,PF15991:PF16007:PF07052,5,12,0,5,12,1001,0.0,0.98,0.0,-0.01,1,0,5,1,1012,0.0,0.99,0.0,-0.0
PF07893,PF14800:PF00762:PF15091,20,19,8,12,11,987,0.42,0.98,0.4,0.4,3,3,17,0,998,1.0,0.98,0.15,0.38
PF04440,PF16516:PF08234:PF00835,0,8,0,0,8,1010,0.0,0.99,0,0,0,0,0,0,1018,0,1.0,0,0
PF05710,PF02557:PF03739:PF11288,0,7,0,0,7,1011,0.0,0.99,0,0,0,0,0,0,1018,0,1.0,0,0
PF02558,PF08546:PF00120:PF04572,27,35,20,7,15,976,0.57,0.98,0.74,0.64,7,7,20,0,991,1.0,0.98,0.26,0.5
PF00204,PF00986:PF16898:PF00521,19,25,18,1,7,992,0.72,0.99,0.95,0.82,13,12,7,1,998,0.92,0.99,0.63,0.76
PF03180,PF16358:PF12241:PF09677,3,1,0,3,1,1014,0.0,1.0,0.0,-0.0,0,0,3,0,1015,0,1.0,0.0,0
PF06105,PF11815:PF01249:PF15816,10,22,6,4,16,992,0.27,0.98,0.6,0.4,3,2,8,1,1007,0.67,0.99,0.2,0.36
PF07645,PF07679:PF12662:PF07593,60,95,39,21,56,902,0.41,0.92,0.65,0.48,21,21,39,0,958,1.0,0.96,0.35,0.58
PF12384,PF05869:PF02337:PF15435,2,8,2,0,6,1010,0.25,0.99,1.0,0.5,0,0,2,0,1016,0,1.0,0.0,0
PF14939,PF15997:PF08578:PF10336,7,6,1,6,5,1006,0.17,0.99,0.14,0.15,0,0,7,0,1011,0,0.99,0.0,0
PF09111,PF09110:PF13892:PF16203,14,29,14,0,15,989,0.48,0.99,1.0,0.69,13,12,2,1,1003,0.92,1.0,0.86,0.89
PF06911,PF10505:PF04059:PF03467,21,22,9,12,13,984,0.41,0.98,0.43,0.41,2,2,19,0,997,1.0,0.98,0.1,0.31
PF05430,PF08245:PF06813:PF03109,1,65,0,1,65,952,0.0,0.94,0.0,-0.01,14,0,1,14,1003,0.0,0.99,0.0,-0.0
PF08770,PF01943:PF08017:PF10731,0,7,0,0,7,1011,0.0,0.99,0,0,0,0,0,0,1018,0,1.0,0,0
PF09837,PF04138:PF09776:PF10044,1,1,0,1,1,1016,0.0,1.0,0.0,-0.0,0,0,1,0,1017,0,1.0,0.0,0
PF14893,PF16297:PF02093:PF01107,5,9,2,3,7,1006,0.22,0.99,0.4,0.29,2,2,3,0,1013,1.0,1.0,0.4,0.63
PF11260,PF12042:PF16763:PF03382,0,3,0,0,3,1015,0.0,1.0,0,0,0,0,0,0,1018,0,1.0,0,0
PF12428,PF02622:PF06454:PF09425,3,18,2,1,16,999,0.11,0.98,0.67,0.27,4,1,2,3,1012,0.25,1.0,0.33,0.29
PF09713,PF11669:PF12579:PF08265,10,14,1,9,13,995,0.07,0.98,0.1,0.07,0,0,10,0,1008,0,0.99,0.0,0
PF05010,PF12372:PF08638:PF15912,5,16,1,4,15,998,0.06,0.98,0.2,0.1,1,0,5,1,1012,0.0,0.99,0.0,-0.0
PF08644,PF14826:PF16188:PF03531,7,20,7,0,13,998,0.35,0.99,1.0,0.59,4,3,4,1,1010,0.75,1.0,0.43,0.56
PF14621,PF11522:PF11640:PF15785,2,15,1,1,14,1002,0.07,0.99,0.5,0.18,3,1,1,2,1014,0.33,1.0,0.5,0.41
PF15960,PF16716:PF06581:PF10716,0,1,0,0,1,1017,0.0,1.0,0,0,0,0,0,0,1018,0,1.0,0,0
PF14248,PF08093:PF15220:PF03743,0,8,0,0,8,1010,0.0,0.99,0,0,0,0,0,0,1018,0,1.0,0,0
PF14237,PF11926:PF11875:PF13355,6,9,2,4,7,1005,0.22,0.99,0.33,0.27,0,0,6,0,1012,0,0.99,0.0,0
PF00701,PF04479:PF04199:PF14027,22,39,13,9,26,970,0.33,0.97,0.59,0.43,15,8,14,7,989,0.53,0.98,0.36,0.43
PF06691,PF11130:PF05707:PF02572,1,2,0,1,2,1015,0.0,1.0,0.0,-0.0,0,0,1,0,1017,0,1.0,0.0,0
PF13656,PF00411:PF01121:PF10256,15,45,11,4,34,969,0.24,0.96,0.73,0.41,7,6,9,1,1002,0.86,0.99,0.4,0.58
PF06663,PF10534:PF04629:PF09246,1,8,1,0,7,1010,0.12,0.99,1.0,0.35,1,1,0,0,1017,1.0,1.0,1.0,1.0
PF15310,PF05874:PF15443:PF15553,3,2,0,3,2,1013,0.0,1.0,0.0,-0.0,0,0,3,0,1015,0,1.0,0.0,0
PF10342,PF12243:PF00871:PF07950,13,11,2,11,9,996,0.18,0.98,0.15,0.16,0,0,13,0,1005,0,0.99,0.0,0
PF04668,PF00159:PF01470:PF01279,3,14,1,2,13,1002,0.07,0.99,0.33,0.15,2,1,2,1,1014,0.5,1.0,0.33,0.41
PF11701,PF12770:PF16669:PF08640,11,23,4,7,19,988,0.17,0.97,0.36,0.24,6,3,8,3,1004,0.5,0.99,0.27,0.36
PF09835,PF12046:PF08092:PF15173,3,1,0,3,1,1014,0.0,1.0,0.0,-0.0,0,0,3,0,1015,0,1.0,0.0,0
PF08803,PF10460:PF08850:PF10867,0,0,0,0,0,1018,0,1.0,0,0,0,0,0,0,1018,0,1.0,0,0
PF13103,PF03749:PF03739:PF12856,4,8,4,0,4,1010,0.5,1.0,1.0,0.71,0,0,4,0,1014,0,1.0,0.0,0
PF06505,PF06070:PF17206:PF01913,0,3,0,0,3,1015,0.0,1.0,0,0,0,0,0,0,1018,0,1.0,0,0
PF08886,PF14842:PF04740:PF01136,0,1,0,0,1,1017,0.0,1.0,0,0,0,0,0,0,1018,0,1.0,0,0
PF04572,PF04488:PF09296:PF15916,2,33,2,0,31,985,0.06,0.97,1.0,0.24,8,1,1,7,1009,0.12,0.99,0.5,0.25
PF01286,PF09775:PF05181:PF04432,4,8,4,0,4,1010,0.5,1.0,1.0,0.71,0,0,4,0,1014,0,1.0,0.0,0
PF06211,PF13096:PF02083:PF13870,1,6,0,1,6,1011,0.0,0.99,0.0,-0.0,0,0,1,0,1017,0,1.0,0.0,0
PF11435,PF13247:PF07805:PF05857,1,1,0,1,1,1016,0.0,1.0,0.0,-0.0,0,0,1,0,1017,0,1.0,0.0,0
PF16760,PF08323:PF00862:PF04413,2,15,1,1,14,1002,0.07,0.99,0.5,0.18,2,0,2,2,1014,0.0,1.0,0.0,-0.0
PF16220,PF04546:PF03979:PF13490,7,6,3,4,3,1008,0.5,0.99,0.43,0.46,4,3,4,1,1010,0.75,1.0,0.43,0.56
PF03831,PF05513:PF11751:PF05509,0,1,0,0,1,1017,0.0,1.0,0,0,1,0,0,1,1017,0.0,1.0,0,0
PF02720,PF07016:PF08345:PF03428,2,1,0,2,1,1015,0.0,1.0,0.0,-0.0,0,0,2,0,1016,0,1.0,0.0,0
PF12001,PF05837:PF13096:PF15934,3,1,0,3,1,1014,0.0,1.0,0.0,-0.0,0,0,3,0,1015,0,1.0,0.0,0
PF09285,PF01132:PF08207:PF14693,6,11,6,0,5,1007,0.55,1.0,1.0,0.74,6,6,0,0,1012,1.0,1.0,1.0,1.0
PF06467,PF12012:PF08394:PF10683,4,11,4,0,7,1007,0.36,0.99,1.0,0.6,2,1,3,1,1013,0.5,1.0,0.25,0.35
PF05042,PF06376:PF04520:PF01627,4,8,1,3,7,1007,0.12,0.99,0.25,0.17,2,0,4,2,1012,0.0,0.99,0.0,-0.0
PF13088,PF07896:PF04979:PF05915,6,22,2,4,20,992,0.09,0.98,0.33,0.17,5,2,4,3,1009,0.4,0.99,0.33,0.36
PF06830,PF04833:PF01458:PF04646,0,9,0,0,9,1009,0.0,0.99,0,0,2,0,0,2,1016,0.0,1.0,0,0
PF03034,PF04831:PF10246:PF14895,8,14,2,6,12,998,0.14,0.98,0.25,0.18,1,0,8,1,1009,0.0,0.99,0.0,-0.0
PF05013,PF03841:PF02613:PF05797,1,2,1,0,1,1016,0.5,1.0,1.0,0.71,0,0,1,0,1017,0,1.0,0.0,0
PF00075,PF12259:PF01693:PF14529,45,61,25,20,36,937,0.41,0.94,0.56,0.45,10,8,37,2,971,0.8,0.96,0.18,0.37
PF10557,PF00888:PF08672:PF03256,28,49,28,0,21,969,0.57,0.98,1.0,0.75,14,8,20,6,984,0.57,0.97,0.29,0.39
PF07885,PF03530:PF02888:PF03493,62,23,21,41,2,954,0.91,0.96,0.34,0.54,10,9,53,1,955,0.9,0.95,0.15,0.35
PF14617,PF08641:PF15359:PF15370,4,9,1,3,8,1006,0.11,0.99,0.25,0.16,0,0,4,0,1014,0,1.0,0.0,0
PF10401,PF00605:PF13336:PF03189,9,26,8,1,18,991,0.31,0.98,0.89,0.52,4,2,7,2,1007,0.5,0.99,0.22,0.33
PF01050,PF04613:PF13720:PF06426,6,18,0,6,18,994,0.0,0.98,0.0,-0.01,2,0,6,2,1010,0.0,0.99,0.0,-0.0
PF06831,PF09292:PF17219:PF01149,16,9,9,7,0,1002,1.0,0.99,0.56,0.75,4,4,12,0,1002,1.0,0.99,0.25,0.5
PF17075,PF15144:PF10467:PF13519,0,36,0,0,36,982,0.0,0.96,0,0,0,0,0,0,1018,0,1.0,0,0
PF14052,PF10995:PF11272:PF06834,0,0,0,0,0,1018,0,1.0,0,0,0,0,0,0,1018,0,1.0,0,0
PF01584,PF06580:PF04397:PF00158,7,17,4,3,13,998,0.24,0.98,0.57,0.36,4,1,6,3,1008,0.25,0.99,0.14,0.18
PF03281,PF07693:PF00710:PF04960,13,23,5,8,18,987,0.22,0.97,0.38,0.28,5,3,10,2,1003,0.6,0.99,0.23,0.37
PF12313,PF11900:PF09494:PF13606,4,54,4,0,50,964,0.07,0.95,1.0,0.27,8,3,1,5,1009,0.38,0.99,0.75,0.53
PF16078,PF16870:PF02779:PF00676,6,56,6,0,50,962,0.11,0.95,1.0,0.32,21,6,0,15,997,0.29,0.99,1.0,0.53
PF00796,PF15207:PF03244:PF15758,0,1,0,0,1,1017,0.0,1.0,0,0,0,0,0,0,1018,0,1.0,0,0
PF04892,PF09216:PF17015:PF01668,0,2,0,0,2,1016,0.0,1.0,0,0,0,0,0,0,1018,0,1.0,0,0
PF04138,PF14322:PF09837:PF01673,0,1,0,0,1,1017,0.0,1.0,0,0,0,0,0,0,1018,0,1.0,0,0
PF02415,PF00746:PF12499:PF14950,3,1,0,3,1,1014,0.0,1.0,0.0,-0.0,0,0,3,0,1015,0,1.0,0.0,0
PF04290,PF12857:PF13478:PF16326,6,9,6,0,3,1009,0.67,1.0,1.0,0.82,2,2,4,0,1012,1.0,1.0,0.33,0.58
PF08061,PF03880:PF11648:PF03461,2,14,2,0,12,1004,0.14,0.99,1.0,0.38,2,2,0,0,1016,1.0,1.0,1.0,1.0
PF12769,PF02233:PF05222:PF01262,6,20,6,0,14,998,0.3,0.99,1.0,0.54,9,6,0,3,1009,0.67,1.0,1.0,0.82
PF12620,PF11568:PF12204:PF11016,2,4,1,1,3,1013,0.25,1.0,0.5,0.35,0,0,2,0,1016,0,1.0,0.0,0
PF05159,PF13477:PF11997:PF03960,0,1,0,0,1,1017,0.0,1.0,0,0,0,0,0,0,1018,0,1.0,0,0
PF14077,PF15512:PF17005:PF09384,4,11,1,3,10,1004,0.09,0.99,0.25,0.15,2,1,3,1,1013,0.5,1.0,0.25,0.35
PF10933,PF08744:PF16071:PF08291,0,0,0,0,0,1018,0,1.0,0,0,0,0,0,0,1018,0,1.0,0,0
PF02008,PF16866:PF12047:PF12269,17,17,10,7,7,994,0.59,0.99,0.59,0.58,4,4,13,0,1001,1.0,0.99,0.24,0.48
PF14486,PF12628:PF00770:PF06993,0,1,0,0,1,1017,0.0,1.0,0,0,0,0,0,0,1018,0,1.0,0,0
PF03098,PF08030:PF08022:PF01794,28,53,17,11,36,954,0.32,0.95,0.61,0.42,42,15,13,27,963,0.36,0.96,0.54,0.42
PF13739,PF08708:PF14690:PF03922,0,0,0,0,0,1018,0,1.0,0,0,0,0,0,0,1018,0,1.0,0,0
PF11697,PF17206:PF10106:PF09498,0,2,0,0,2,1016,0.0,1.0,0,0,0,0,0,0,1018,0,1.0,0,0
PF10158,PF06907:PF15115:PF07448,5,2,0,5,2,1011,0.0,0.99,0.0,-0.0,0,0,5,0,1013,0,1.0,0.0,0
PF15672,PF00419:PF05167:PF03244,0,2,0,0,2,1016,0.0,1.0,0,0,0,0,0,0,1018,0,1.0,0,0
PF11211,PF08093:PF11402:PF05962,0,2,0,0,2,1016,0.0,1.0,0,0,0,0,0,0,1018,0,1.0,0,0
PF06814,PF03195:PF04765:PF01746,15,30,6,9,24,979,0.2,0.97,0.4,0.27,5,4,11,1,1002,0.8,0.99,0.27,0.46
PF09497,PF08729:PF10744:PF04182,9,10,5,4,5,1004,0.5,0.99,0.56,0.52,2,2,7,0,1009,1.0,0.99,0.22,0.47
PF06985,PF01048:PF01328:PF14420,67,43,26,41,17,934,0.6,0.94,0.39,0.46,11,11,56,0,951,1.0,0.94,0.16,0.39
PF13716,PF01661:PF09036:PF15720,29,36,15,14,21,968,0.42,0.97,0.52,0.45,4,4,25,0,989,1.0,0.98,0.14,0.37
PF13276,PF02022:PF01623:PF01141,7,5,0,7,5,1006,0.0,0.99,0.0,-0.01,4,0,7,4,1007,0.0,0.99,0.0,-0.01
PF12348,PF09743:PF04821:PF12074,13,11,3,10,8,997,0.27,0.98,0.23,0.24,4,0,13,4,1001,0.0,0.98,0.0,-0.01
PF08925,PF00821:PF05884:PF16720,6,4,0,6,4,1008,0.0,0.99,0.0,-0.0,0,0,6,0,1012,0,0.99,0.0,0
PF09316,PF07988:PF08558:PF16496,5,12,3,2,9,1004,0.25,0.99,0.6,0.38,0,0,5,0,1013,0,1.0,0.0,0
PF02589,PF11870:PF13808:PF01706,6,3,0,6,3,1009,0.0,0.99,0.0,-0.0,0,0,6,0,1012,0,0.99,0.0,0
PF01075,PF10446:PF10924:PF03832,3,5,0,3,5,1010,0.0,0.99,0.0,-0.0,0,0,3,0,1015,0,1.0,0.0,0
PF00334,PF05186:PF06565:PF01956,24,31,6,18,25,969,0.19,0.96,0.25,0.2,5,3,21,2,992,0.6,0.98,0.12,0.27
PF06773,PF14882:PF09074:PF11435,0,1,0,0,1,1017,0.0,1.0,0,0,0,0,0,0,1018,0,1.0,0,0
PF15374,PF16829:PF15238:PF15872,0,1,0,0,1,1017,0.0,1.0,0,0,0,0,0,0,1018,0,1.0,0,0
PF12245,PF12583:PF12580:PF03797,3,5,1,2,4,1011,0.2,0.99,0.33,0.26,1,1,2,0,1015,1.0,1.0,0.33,0.58
PF02158,PF07204:PF11465:PF03921,4,8,2,2,6,1008,0.25,0.99,0.5,0.35,2,2,2,0,1014,1.0,1.0,0.5,0.71
PF00050,PF09289:PF07648:PF01469,19,29,12,7,17,982,0.41,0.98,0.63,0.5,3,2,17,1,998,0.67,0.98,0.11,0.26
PF04307,PF14985:PF15832:PF07209,1,3,0,1,3,1014,0.0,1.0,0.0,-0.0,0,0,1,0,1017,0,1.0,0.0,0
PF10963,PF04960:PF02446:PF01204,0,30,0,0,30,988,0.0,0.97,0,0,1,0,0,1,1017,0.0,1.0,0,0
PF01476,PF14856:PF01551:PF00704,39,66,28,11,38,941,0.42,0.95,0.72,0.53,15,14,25,1,978,0.93,0.97,0.36,0.57
PF15501,PF14722:PF05781:PF14662,2,11,1,1,10,1006,0.09,0.99,0.5,0.21,2,1,1,1,1015,0.5,1.0,0.5,0.5
PF15370,PF15071:PF15359:PF05039,3,2,0,3,2,1013,0.0,1.0,0.0,-0.0,0,0,3,0,1015,0,1.0,0.0,0
PF07725,PF12061:PF05659:PF00931,14,83,13,1,70,934,0.16,0.93,0.93,0.37,5,5,9,0,1004,1.0,0.99,0.36,0.59
PF07201,PF07411:PF10411:PF11902,0,0,0,0,0,1018,0,1.0,0,0,0,0,0,0,1018,0,1.0,0,0
PF03057,PF05287:PF09775:PF03640,3,0,0,3,0,1015,0,1.0,0.0,0,0,0,3,0,1015,0,1.0,0.0,0
PF12407,PF10525:PF04617:PF03867,1,4,1,0,3,1014,0.25,1.0,1.0,0.5,1,1,0,0,1017,1.0,1.0,1.0,1.0
PF02787,PF00115:PF01578:PF01039,20,44,5,15,39,959,0.11,0.95,0.25,0.14,10,2,18,8,990,0.2,0.97,0.1,0.13
PF11378,PF03913:PF15080:PF14987,0,4,0,0,4,1014,0.0,1.0,0,0,0,0,0,0,1018,0,1.0,0,0
PF13013,PF13094:PF08398:PF15097,1,3,0,1,3,1014,0.0,1.0,0.0,-0.0,0,0,1,0,1017,0,1.0,0.0,0
PF01630,PF06083:PF12273:PF10246,8,20,4,4,16,994,0.2,0.98,0.5,0.31,2,1,7,1,1009,0.5,0.99,0.12,0.25
PF08079,PF12076:PF03986:PF00081,11,33,3,8,30,977,0.09,0.96,0.27,0.14,4,0,11,4,1003,0.0,0.99,0.0,-0.01
PF04382,PF05902:PF08736:PF11819,5,20,5,0,15,998,0.25,0.99,1.0,0.5,10,5,0,5,1008,0.5,1.0,1.0,0.71
PF03714,PF11852:PF09087:PF10438,2,3,2,0,1,1015,0.67,1.0,1.0,0.82,1,0,2,1,1015,0.0,1.0,0.0,-0.0
PF03061,PF10457:PF01852:PF09724,31,36,14,17,22,965,0.39,0.96,0.45,0.4,11,6,25,5,982,0.55,0.97,0.19,0.31
PF04034,PF12800:PF11953:PF02405,13,3,1,12,2,1003,0.33,0.99,0.08,0.16,2,1,12,1,1004,0.5,0.99,0.08,0.19
PF14576,PF14577:PF14767:PF04927,0,3,0,0,3,1015,0.0,1.0,0,0,1,0,0,1,1017,0.0,1.0,0,0
PF04681,PF09428:PF05151:PF00737,5,2,0,5,2,1011,0.0,0.99,0.0,-0.0,0,0,5,0,1013,0,1.0,0.0,0
PF15399,PF02253:PF04264:PF12081,0,1,0,0,1,1017,0.0,1.0,0,0,0,0,0,0,1018,0,1.0,0,0
PF03534,PF12256:PF12255:PF04196,0,1,0,0,1,1017,0.0,1.0,0,0,0,0,0,0,1018,0,1.0,0,0
PF17132,PF12735:PF05450:PF12955,6,14,2,4,12,1000,0.14,0.98,0.33,0.21,1,0,6,1,1011,0.0,0.99,0.0,-0.0
PF08916,PF08174:PF16018:PF02174,3,20,1,2,19,996,0.05,0.98,0.33,0.12,3,1,2,2,1013,0.33,1.0,0.33,0.33
PF10474,PF07928:PF10475:PF12022,1,12,1,0,11,1006,0.08,0.99,1.0,0.29,4,1,0,3,1014,0.25,1.0,1.0,0.5
PF10429,PF15212:PF15114:PF10567,0,1,0,0,1,1017,0.0,1.0,0,0,0,0,0,0,1018,0,1.0,0,0
PF01306,PF01292:PF14993:PF15212,0,6,0,0,6,1012,0.0,0.99,0,0,0,0,0,0,1018,0,1.0,0,0
PF16741,PF16099:PF12542:PF07217,2,16,1,1,15,1001,0.06,0.98,0.5,0.17,3,0,2,3,1013,0.0,1.0,0.0,-0.0
PF01918,PF02704:PF12023:PF10018,11,21,3,8,18,989,0.14,0.97,0.27,0.19,4,2,9,2,1005,0.5,0.99,0.18,0.3
PF08443,PF00328:PF15675:PF09713,3,56,3,0,53,962,0.05,0.95,1.0,0.23,4,0,3,4,1011,0.0,0.99,0.0,-0.0
PF07062,PF05822:PF10681:PF06324,1,18,0,1,18,999,0.0,0.98,0.0,-0.0,0,0,1,0,1017,0,1.0,0.0,0
PF15058,PF15620:PF16832:PF15059,4,3,3,1,0,1014,1.0,1.0,0.75,0.87,0,0,4,0,1014,0,1.0,0.0,0
PF11066,PF12513:PF02475:PF11938,0,40,0,0,40,978,0.0,0.96,0,0,3,0,0,3,1015,0.0,1.0,0,0
PF00240,PF09055:PF16843:PF14621,88,7,7,81,0,930,1.0,0.92,0.08,0.27,1,1,87,0,930,1.0,0.91,0.01,0.1
PF04529,PF05979:PF12968:PF01623,1,4,1,0,3,1014,0.25,1.0,1.0,0.5,0,0,1,0,1017,0,1.0,0.0,0
PF12034,PF13400:PF16754:PF06305,0,3,0,0,3,1015,0.0,1.0,0,0,0,0,0,0,1018,0,1.0,0,0
PF16858,PF16869:PF06278:PF00926,5,12,4,1,8,1005,0.33,0.99,0.8,0.51,1,1,4,0,1013,1.0,1.0,0.2,0.45
PF05951,PF00555:PF09614:PF17017,0,2,0,0,2,1016,0.0,1.0,0,0,0,0,0,0,1018,0,1.0,0,0
PF05613,PF16834:PF09580:PF09747,0,10,0,0,10,1008,0.0,0.99,0,0,0,0,0,0,1018,0,1.0,0,0
PF08066,PF01927:PF00570:PF01612,11,63,11,0,52,955,0.17,0.95,1.0,0.41,24,10,1,14,993,0.42,0.99,0.91,0.61
PF07119,PF10106:PF14328:PF08093,0,2,0,0,2,1016,0.0,1.0,0,0,0,0,0,0,1018,0,1.0,0,0
PF00008,PF12661:PF00028:PF01382,77,71,52,25,19,922,0.73,0.96,0.68,0.68,19,19,58,0,941,1.0,0.94,0.25,0.48
PF07787,PF10252:PF10218:PF13092,5,7,1,4,6,1007,0.14,0.99,0.2,0.16,1,1,4,0,1013,1.0,1.0,0.2,0.45
PF04564,PF14847:PF10408:PF08606,56,30,21,35,9,953,0.7,0.96,0.38,0.49,5,5,51,0,962,1.0,0.95,0.09,0.29
PF00947,PF08727:PF01706:PF01552,12,13,12,0,1,1005,0.92,1.0,1.0,0.96,12,12,0,0,1006,1.0,1.0,1.0,1.0
PF05825,PF15071:PF00727:PF00714,2,5,0,2,5,1011,0.0,0.99,0.0,-0.0,0,0,2,0,1016,0,1.0,0.0,0
PF17221,PF13183:PF03948:PF13335,1,14,0,1,14,1003,0.0,0.99,0.0,-0.0,1,0,1,1,1016,0.0,1.0,0.0,-0.0
PF14334,PF04187:PF08321:PF05705,0,23,0,0,23,995,0.0,0.98,0,0,3,0,0,3,1015,0.0,1.0,0,0
PF06230,PF11764:PF11616:PF05266,0,8,0,0,8,1010,0.0,0.99,0,0,1,0,0,1,1017,0.0,1.0,0,0
PF07311,PF05109:PF15518:PF03831,0,1,0,0,1,1017,0.0,1.0,0,0,0,0,0,0,1018,0,1.0,0,0
PF02344,PF01056:PF11851:PF09427,5,13,4,1,9,1004,0.31,0.99,0.8,0.49,1,1,4,0,1013,1.0,1.0,0.2,0.45
PF03033,PF13579:PF06925:PF00201,23,68,18,5,50,945,0.26,0.95,0.78,0.44,3,2,21,1,994,0.67,0.98,0.09,0.24
PF02417,PF05422:PF04425:PF10287,7,6,1,6,5,1006,0.17,0.99,0.14,0.15,0,0,7,0,1011,0,0.99,0.0,0
PF10431,PF07724:PF02151:PF02861,26,37,25,1,12,980,0.68,0.99,0.96,0.8,12,12,14,0,992,1.0,0.99,0.46,0.67
PF06880,PF06830:PF04833:PF05450,2,12,1,1,11,1005,0.08,0.99,0.5,0.2,1,0,2,1,1015,0.0,1.0,0.0,-0.0
PF08258,PF02277:PF15482:PF02503,0,5,0,0,5,1013,0.0,1.0,0,0,0,0,0,0,1018,0,1.0,0,0
PF11124,PF15775:PF09461:PF06890,0,0,0,0,0,1018,0,1.0,0,0,0,0,0,0,1018,0,1.0,0,0
PF02652,PF06826:PF07523:PF15750,4,2,0,4,2,1012,0.0,0.99,0.0,-0.0,0,0,4,0,1014,0,1.0,0.0,0
PF02337,PF00607:PF02093:PF12384,5,12,5,0,7,1006,0.42,0.99,1.0,0.64,4,4,1,0,1013,1.0,1.0,0.8,0.89
PF13729,PF09394:PF17026:PF06224,0,0,0,0,0,1018,0,1.0,0,0,0,0,0,0,1018,0,1.0,0,0
PF13663,PF02565:PF07805:PF13247,2,1,0,2,1,1015,0.0,1.0,0.0,-0.0,0,0,2,0,1016,0,1.0,0.0,0
PF08936,PF04222:PF04445:PF04835,0,2,0,0,2,1016,0.0,1.0,0,0,0,0,0,0,1018,0,1.0,0,0
PF00827,PF08449:PF05180:PF05019,14,33,7,7,26,978,0.21,0.97,0.5,0.31,8,4,10,4,1000,0.5,0.99,0.29,0.37
PF08313,PF03110:PF08729:PF15996,13,14,3,10,11,994,0.21,0.98,0.23,0.21,3,1,12,2,1003,0.33,0.99,0.08,0.16
PF04760,PF14578:PF11987:PF10383,9,31,9,0,22,987,0.29,0.98,1.0,0.53,4,1,8,3,1006,0.25,0.99,0.11,0.16
PF04099,PF07061:PF01762:PF12326,16,45,7,9,38,964,0.16,0.95,0.44,0.24,7,4,12,3,999,0.57,0.99,0.25,0.37
PF05432,PF07343:PF00799:PF08283,2,2,0,2,2,1014,0.0,1.0,0.0,-0.0,1,0,2,1,1015,0.0,1.0,0.0,-0.0
PF00572,PF01192:PF10780:PF01470,20,16,5,15,11,987,0.31,0.97,0.25,0.27,1,1,19,0,998,1.0,0.98,0.05,0.22
PF09095,PF06892:PF02304:PF01721,2,0,0,2,0,1016,0,1.0,0.0,0,0,0,2,0,1016,0,1.0,0.0,0
PF08630,PF12927:PF08634:PF05841,3,5,0,3,5,1010,0.0,0.99,0.0,-0.0,0,0,3,0,1015,0,1.0,0.0,0
PF04191,PF03388:PF06258:PF08633,4,21,3,1,18,996,0.14,0.98,0.75,0.32,2,1,3,1,1013,0.5,1.0,0.25,0.35
PF02694,PF03459:PF05936:PF01032,2,6,2,0,4,1012,0.33,1.0,1.0,0.58,2,2,0,0,1016,1.0,1.0,1.0,1.0
PF01749,PF16186:PF00514:PF02933,21,66,18,3,48,949,0.27,0.95,0.86,0.47,22,16,5,6,991,0.73,0.99,0.76,0.74
PF17201,PF01000:PF12496:PF00169,0,144,0,0,144,874,0.0,0.86,0,0,8,0,0,8,1010,0.0,0.99,0,0
PF15084,PF15292:PF15232:PF12516,3,0,0,3,0,1015,0,1.0,0.0,0,0,0,3,0,1015,0,1.0,0.0,0
PF12973,PF09056:PF15825:PF14534,3,4,2,1,2,1013,0.5,1.0,0.67,0.58,0,0,3,0,1015,0,1.0,0.0,0
PF07654,PF07686:PF00129:PF08205,16,66,12,4,54,948,0.18,0.94,0.75,0.35,21,7,9,14,988,0.33,0.98,0.44,0.37
PF15325,PF06876:PF03050:PF06952,1,0,0,1,0,1017,0,1.0,0.0,0,0,0,1,0,1017,0,1.0,0.0,0
PF06283,PF03883:PF15314:PF10664,3,3,0,3,3,1012,0.0,0.99,0.0,-0.0,0,0,3,0,1015,0,1.0,0.0,0
PF06221,PF04087:PF05334:PF11928,12,1,0,12,1,1005,0.0,0.99,0.0,-0.0,0,0,12,0,1006,0,0.99,0.0,0
PF02354,PF02191:PF02140:PF12308,2,39,2,0,37,979,0.05,0.96,1.0,0.22,7,2,0,5,1011,0.29,1.0,1.0,0.53
PF06028,PF06718:PF17076:PF16966,3,0,0,3,0,1015,0,1.0,0.0,0,0,0,3,0,1015,0,1.0,0.0,0
PF17193,PF01312:PF11245:PF03739,0,5,0,0,5,1013,0.0,1.0,0,0,0,0,0,0,1018,0,1.0,0,0
PF13184,PF08529:PF08206:PF09876,4,4,4,0,0,1014,1.0,1.0,1.0,1.0,1,1,3,0,1014,1.0,1.0,0.25,0.5
PF11128,PF14975:PF09912:PF01015,0,12,0,0,12,1006,0.0,0.99,0,0,2,0,0,2,1016,0.0,1.0,0,0
PF01827,PF07735:PF10442:PF08268,15,22,9,6,13,990,0.41,0.98,0.6,0.49,3,1,14,2,1001,0.33,0.98,0.07,0.14
PF00294,PF04227:PF01081:PF01328,41,21,11,30,10,967,0.52,0.96,0.27,0.36,4,4,37,0,977,1.0,0.96,0.1,0.31
PF14229,PF07652:PF10927:PF12137,2,8,1,1,7,1009,0.12,0.99,0.5,0.25,2,1,1,1,1015,0.5,1.0,0.5,0.5
PF10185,PF12020:PF04176:PF04901,2,11,1,1,10,1006,0.09,0.99,0.5,0.21,0,0,2,0,1016,0,1.0,0.0,0
PF15677,PF15119:PF15085:PF15224,0,3,0,0,3,1015,0.0,1.0,0,0,0,0,0,0,1018,0,1.0,0,0
PF11223,PF10933:PF14216:PF08744,1,1,0,1,1,1016,0.0,1.0,0.0,-0.0,0,0,1,0,1017,0,1.0,0.0,0
PF16217,PF13722:PF07409:PF03090,0,0,0,0,0,1018,0,1.0,0,0,0,0,0,0,1018,0,1.0,0,0
PF13096,PF06211:PF02083:PF05837,0,5,0,0,5,1013,0.0,1.0,0,0,0,0,0,0,1018,0,1.0,0,0
PF14903,PF10554:PF02399:PF01706,0,2,0,0,2,1016,0.0,1.0,0,0,1,0,0,1,1017,0.0,1.0,0,0
PF00188,PF08562:PF01497:PF04406,53,25,11,42,14,951,0.44,0.94,0.21,0.28,2,2,51,0,965,1.0,0.95,0.04,0.19
PF12762,PF07889:PF01632:PF10181,19,20,5,14,15,984,0.25,0.97,0.26,0.24,0,0,19,0,999,0,0.98,0.0,0
PF14653,PF06875:PF00489:PF02024,0,2,0,0,2,1016,0.0,1.0,0,0,0,0,0,0,1018,0,1.0,0,0
PF15700,PF15972:PF14539:PF17049,0,1,0,0,1,1017,0.0,1.0,0,0,0,0,0,0,1018,0,1.0,0,0
PF11735,PF09687:PF13092:PF08598,9,12,2,7,10,999,0.17,0.98,0.22,0.18,1,1,8,0,1009,1.0,0.99,0.11,0.33
PF14819,PF14690:PF15029:PF13753,1,0,0,1,0,1017,0,1.0,0.0,0,0,0,1,0,1017,0,1.0,0.0,0
PF00997,PF13588:PF16590:PF02951,0,5,0,0,5,1013,0.0,1.0,0,0,2,0,0,2,1016,0.0,1.0,0,0
PF14281,PF04881:PF05728:PF15047,0,5,0,0,5,1013,0.0,1.0,0,0,0,0,0,0,1018,0,1.0,0,0
PF04911,PF02565:PF14885:PF04355,2,1,0,2,1,1015,0.0,1.0,0.0,-0.0,0,0,2,0,1016,0,1.0,0.0,0
PF06884,PF12296:PF11991:PF06127,7,15,3,4,12,999,0.2,0.98,0.43,0.29,0,0,7,0,1011,0,0.99,0.0,0
PF09265,PF02913:PF04030:PF02873,15,45,5,10,40,963,0.11,0.95,0.33,0.17,8,4,11,4,999,0.5,0.99,0.27,0.36
PF00627,PF08585:PF02149:PF06025,51,30,13,38,17,950,0.43,0.95,0.25,0.31,3,3,48,0,967,1.0,0.95,0.06,0.24
PF11766,PF15427:PF10279:PF05100,0,1,0,0,1,1017,0.0,1.0,0,0,0,0,0,0,1018,0,1.0,0,0
PF12696,PF08722:PF12168:PF15153,1,2,1,0,1,1016,0.5,1.0,1.0,0.71,0,0,1,0,1017,0,1.0,0.0,0
PF07904,PF06989:PF02116:PF10180,3,12,0,3,12,1003,0.0,0.99,0.0,-0.01,0,0,3,0,1015,0,1.0,0.0,0
PF00085,PF04777:PF15928:PF07449,99,27,22,77,5,914,0.81,0.92,0.22,0.4,0,0,99,0,919,0,0.9,0.0,0
PF16061,PF04437:PF08318:PF12309,3,28,2,1,26,989,0.07,0.97,0.67,0.21,6,0,3,6,1009,0.0,0.99,0.0,-0.0
PF04157,PF16988:PF11605:PF12767,10,8,6,4,2,1006,0.75,0.99,0.6,0.67,3,3,7,0,1008,1.0,0.99,0.3,0.55
PF16153,PF04567:PF01529:PF08344,0,61,0,0,61,957,0.0,0.94,0,0,13,0,0,13,1005,0.0,0.99,0,0
PF15308,PF13325:PF15276:PF16508,8,10,3,5,7,1003,0.3,0.99,0.38,0.33,2,2,6,0,1010,1.0,0.99,0.25,0.5
PF04032,PF04640:PF12304:PF01922,8,13,3,5,10,1000,0.23,0.99,0.38,0.29,1,0,8,1,1009,0.0,0.99,0.0,-0.0
PF16984,PF06585:PF06757:PF08840,3,14,2,1,12,1003,0.14,0.99,0.67,0.3,2,1,2,1,1014,0.5,1.0,0.33,0.41
PF09736,PF15280:PF08624:PF14611,5,9,0,5,9,1004,0.0,0.99,0.0,-0.01,1,0,5,1,1012,0.0,0.99,0.0,-0.0
PF04214,PF01249:PF01484:PF03211,0,53,0,0,53,965,0.0,0.95,0,0,9,0,0,9,1009,0.0,0.99,0,0
PF15053,PF11017:PF15814:PF07464,2,1,0,2,1,1015,0.0,1.0,0.0,-0.0,0,0,2,0,1016,0,1.0,0.0,0
PF09335,PF01789:PF02915:PF13225,22,10,2,20,8,988,0.2,0.97,0.09,0.12,1,1,21,0,996,1.0,0.98,0.05,0.21
PF06197,PF09699:PF09614:PF00555,0,2,0,0,2,1016,0.0,1.0,0,0,0,0,0,0,1018,0,1.0,0,0
PF00412,PF15936:PF12315:PF06297,88,17,15,73,2,928,0.88,0.93,0.17,0.37,2,2,86,0,930,1.0,0.92,0.02,0.14
PF15916,PF09297:PF14803:PF09296,4,11,3,1,8,1006,0.27,0.99,0.75,0.45,6,1,3,5,1009,0.17,0.99,0.25,0.2
PF01147,PF00711:PF05497:PF00965,0,11,0,0,11,1007,0.0,0.99,0,0,0,0,0,0,1018,0,1.0,0,0
PF14972,PF00714:PF10705:PF02427,2,1,0,2,1,1015,0.0,1.0,0.0,-0.0,0,0,2,0,1016,0,1.0,0.0,0
PF15379,PF11652:PF15553:PF06485,0,5,0,0,5,1013,0.0,1.0,0,0,0,0,0,0,1018,0,1.0,0,0
PF11932,PF11992:PF06288:PF16864,0,12,0,0,12,1006,0.0,0.99,0,0,0,0,0,0,1018,0,1.0,0,0
PF15299,PF05334:PF16019:PF04087,8,1,0,8,1,1009,0.0,0.99,0.0,-0.0,0,0,8,0,1010,0,0.99,0.0,0
PF15819,PF14539:PF11210:PF14494,0,0,0,0,0,1018,0,1.0,0,0,0,0,0,0,1018,0,1.0,0,0
PF02173,PF12498:PF03957:PF08601,6,5,2,4,3,1009,0.4,0.99,0.33,0.36,2,2,4,0,1012,1.0,1.0,0.33,0.58
PF05096,PF04107:PF04452:PF10693,3,7,0,3,7,1008,0.0,0.99,0.0,-0.0,0,0,3,0,1015,0,1.0,0.0,0
PF01275,PF14798:PF05197:PF01294,5,9,1,4,8,1005,0.11,0.99,0.2,0.14,2,0,5,2,1011,0.0,0.99,0.0,-0.0
PF10458,PF06827:PF13603:PF09334,7,42,5,2,37,974,0.12,0.96,0.71,0.28,10,3,4,7,1004,0.3,0.99,0.43,0.35
PF10504,PF15550:PF15814:PF06313,1,0,0,1,0,1017,0,1.0,0.0,0,0,0,1,0,1017,0,1.0,0.0,0
PF10380,PF09818:PF05939:PF01514,1,1,0,1,1,1016,0.0,1.0,0.0,-0.0,0,0,1,0,1017,0,1.0,0.0,0
PF01388,PF12031:PF08169:PF08429,31,22,18,13,4,983,0.82,0.98,0.58,0.68,2,2,29,0,987,1.0,0.97,0.06,0.25
PF13698,PF15047:PF08792:PF12658,0,1,0,0,1,1017,0.0,1.0,0,0,0,0,0,0,1018,0,1.0,0,0
PF09130,PF14833:PF00393:PF17042,4,29,2,2,27,987,0.07,0.97,0.5,0.18,12,2,2,10,1004,0.17,0.99,0.5,0.28
PF03551,PF16908:PF07250:PF01276,0,26,0,0,26,992,0.0,0.97,0,0,6,0,0,6,1012,0.0,0.99,0,0
PF15940,PF02881:PF05926:PF05661,0,31,0,0,31,987,0.0,0.97,0,0,0,0,0,0,1018,0,1.0,0,0
PF07944,PF07173:PF00150:PF13813,12,60,8,4,52,954,0.13,0.94,0.67,0.28,7,3,9,4,1002,0.43,0.99,0.25,0.32
PF17172,PF10568:PF10806:PF04092,6,10,3,3,7,1005,0.3,0.99,0.5,0.38,1,1,5,0,1012,1.0,1.0,0.17,0.41
PF14778,PF05719:PF14943:PF06870,3,23,3,0,20,995,0.13,0.98,1.0,0.36,3,1,2,2,1013,0.33,1.0,0.33,0.33
PF03099,PF09825:PF10210:PF01578,17,11,3,14,8,993,0.27,0.98,0.18,0.21,1,1,16,0,1001,1.0,0.98,0.06,0.24
PF03439,PF11942:PF00467:PF02357,14,18,9,5,9,995,0.5,0.99,0.64,0.56,4,3,11,1,1003,0.75,0.99,0.21,0.4
PF04691,PF15760:PF02950:PF15055,1,1,0,1,1,1016,0.0,1.0,0.0,-0.0,0,0,1,0,1017,0,1.0,0.0,0
PF10457,PF07059:PF08923:PF03061,7,34,4,3,30,981,0.12,0.97,0.57,0.25,6,3,4,3,1008,0.5,0.99,0.43,0.46
PF01333,PF16639:PF03118:PF03951,5,22,5,0,17,996,0.23,0.98,1.0,0.47,3,2,3,1,1012,0.67,1.0,0.4,0.51
PF14311,PF14743:PF01068:PF03119,2,21,2,0,19,997,0.1,0.98,1.0,0.31,4,2,0,2,1014,0.5,1.0,1.0,0.71
PF09291,PF10570:PF02124:PF02439,0,3,0,0,3,1015,0.0,1.0,0,0,0,0,0,0,1018,0,1.0,0,0
PF03611,PF02302:PF00874:PF02909,2,7,1,1,6,1010,0.14,0.99,0.5,0.26,1,1,1,0,1016,1.0,1.0,0.5,0.71
PF10664,PF17062:PF03907:PF11371,1,1,0,1,1,1016,0.0,1.0,0.0,-0.0,0,0,1,0,1017,0,1.0,0.0,0
PF03320,PF08299:PF15518:PF14842,5,3,1,4,2,1011,0.33,0.99,0.2,0.26,0,0,5,0,1013,0,1.0,0.0,0
PF10461,PF09034:PF17217:PF11957,1,8,1,0,7,1010,0.12,0.99,1.0,0.35,1,1,0,0,1017,1.0,1.0,1.0,1.0
PF12213,PF08418:PF16002:PF08451,7,11,4,3,7,1004,0.36,0.99,0.57,0.45,3,3,4,0,1011,1.0,1.0,0.43,0.65
PF07711,PF16833:PF01239:PF08256,4,27,4,0,23,991,0.15,0.98,1.0,0.38,0,0,4,0,1014,0,1.0,0.0,0
PF01291,PF15055:PF15063:PF06541,1,0,0,1,0,1017,0,1.0,0.0,0,0,0,1,0,1017,0,1.0,0.0,0
PF08573,PF07557:PF14775:PF15784,4,11,0,4,11,1003,0.0,0.99,0.0,-0.01,1,0,4,1,1013,0.0,1.0,0.0,-0.0
PF08618,PF02076:PF15991:PF03479,1,10,0,1,10,1007,0.0,0.99,0.0,-0.0,0,0,1,0,1017,0,1.0,0.0,0
PF00646,PF12937:PF08387:PF03478,94,112,49,45,63,861,0.44,0.89,0.52,0.42,28,22,72,6,918,0.79,0.92,0.23,0.4
PF12972,PF12971:PF05089:PF08530,9,25,9,0,16,993,0.36,0.98,1.0,0.6,8,6,3,2,1007,0.75,1.0,0.67,0.7
PF07491,PF13023:PF08315:PF00831,7,28,3,4,25,986,0.11,0.97,0.43,0.2,5,1,6,4,1007,0.2,0.99,0.14,0.16
PF08643,PF14610:PF02325:PF12317,5,6,0,5,6,1007,0.0,0.99,0.0,-0.01,0,0,5,0,1013,0,1.0,0.0,0
PF13499,PF13833:PF00036:PF13405,125,78,54,71,24,869,0.69,0.91,0.43,0.5,31,29,96,2,891,0.94,0.9,0.23,0.44
PF13249,PF13243:PF16711:PF01645,16,22,16,0,6,996,0.73,0.99,1.0,0.85,2,2,14,0,1002,1.0,0.99,0.12,0.35
PF13344,PF04577:PF01066:PF02517,26,50,17,9,33,959,0.34,0.96,0.65,0.45,16,9,17,7,985,0.56,0.98,0.35,0.43
PF04181,PF08733:PF15862:PF08624,8,7,2,6,5,1005,0.29,0.99,0.25,0.26,1,1,7,0,1010,1.0,0.99,0.12,0.35
PF04675,PF01068:PF04679:PF10345,18,19,18,0,1,999,0.95,1.0,1.0,0.97,19,18,0,1,999,0.95,1.0,1.0,0.97
PF14436,PF17206:PF10951:PF17188,0,1,0,0,1,1017,0.0,1.0,0,0,0,0,0,0,1018,0,1.0,0,0
PF16557,PF16534:PF02376:PF12403,2,8,2,0,6,1010,0.25,0.99,1.0,0.5,3,2,0,1,1015,0.67,1.0,1.0,0.82
PF11517,PF04001:PF10933:PF15082,0,3,0,0,3,1015,0.0,1.0,0,0,0,0,0,0,1018,0,1.0,0,0
PF11272,PF04963:PF14052:PF17206,0,1,0,0,1,1017,0.0,1.0,0,0,1,0,0,1,1017,0.0,1.0,0,0
PF08098,PF03891:PF03898:PF08278,1,4,0,1,4,1013,0.0,1.0,0.0,-0.0,0,0,1,0,1017,0,1.0,0.0,0
PF03594,PF17028:PF11352:PF08121,2,1,0,2,1,1015,0.0,1.0,0.0,-0.0,0,0,2,0,1016,0,1.0,0.0,0
PF06738,PF14231:PF00345:PF15750,5,4,1,4,3,1010,0.25,0.99,0.2,0.22,0,0,5,0,1013,0,1.0,0.0,0
PF09057,PF07464:PF06875:PF00489,0,2,0,0,2,1016,0.0,1.0,0,0,0,0,0,0,1018,0,1.0,0,0
PF06456,PF09007:PF09058:PF15936,14,8,3,11,5,999,0.38,0.98,0.21,0.28,3,1,13,2,1002,0.33,0.99,0.07,0.15
PF10204,PF03036:PF09755:PF05301,3,13,2,1,11,1004,0.15,0.99,0.67,0.32,1,0,3,1,1014,0.0,1.0,0.0,-0.0
PF00176,PF08797:PF08774:PF06465,115,28,23,92,5,898,0.82,0.9,0.2,0.38,7,6,109,1,902,0.86,0.89,0.05,0.2
PF05178,PF12936:PF05508:PF15279,8,8,8,0,0,1010,1.0,1.0,1.0,1.0,1,1,7,0,1010,1.0,0.99,0.12,0.35
PF07017,PF04465:PF06794:PF07565,0,7,0,0,7,1011,0.0,0.99,0,0,0,0,0,0,1018,0,1.0,0,0
PF05999,PF08780:PF01219:PF14065,0,1,0,0,1,1017,0.0,1.0,0,0,0,0,0,0,1018,0,1.0,0,0
PF15384,PF15828:PF02979:PF03050,0,5,0,0,5,1013,0.0,1.0,0,0,0,0,0,0,1018,0,1.0,0,0
PF08442,PF02629:PF00285:PF00549,16,43,15,1,28,974,0.35,0.97,0.94,0.56,19,7,9,12,990,0.37,0.98,0.44,0.39
PF15062,PF06695:PF07961:PF09428,0,1,0,0,1,1017,0.0,1.0,0,0,0,0,0,0,1018,0,1.0,0,0
PF10178,PF06127:PF06644:PF10224,6,18,4,2,14,998,0.22,0.98,0.67,0.38,1,1,5,0,1012,1.0,1.0,0.17,0.41
PF14364,PF13724:PF10533:PF06830,1,4,0,1,4,1013,0.0,1.0,0.0,-0.0,0,0,1,0,1017,0,1.0,0.0,0
PF04218,PF03221:PF04236:PF03184,14,77,14,0,63,941,0.18,0.94,1.0,0.41,39,12,2,27,977,0.31,0.97,0.86,0.5
PF09813,PF00398:PF14828:PF08507,3,26,3,0,23,992,0.12,0.98,1.0,0.34,2,0,3,2,1013,0.0,1.0,0.0,-0.0
PF02373,PF02375:PF02928:PF10497,38,27,19,19,8,972,0.7,0.97,0.5,0.58,11,11,27,0,980,1.0,0.97,0.29,0.53
PF15211,PF07400:PF16649:PF08792,0,1,0,0,1,1017,0.0,1.0,0,0,0,0,0,0,1018,0,1.0,0,0
PF16507,PF11919:PF16547:PF13001,9,21,8,1,13,996,0.38,0.99,0.89,0.58,4,4,5,0,1009,1.0,1.0,0.44,0.67
PF14843,PF01030:PF00757:PF15913,8,14,7,1,7,1003,0.5,0.99,0.88,0.66,7,6,2,1,1009,0.86,1.0,0.75,0.8
PF14080,PF01466:PF03931:PF02419,0,33,0,0,33,985,0.0,0.97,0,0,19,0,0,19,999,0.0,0.98,0,0
PF16920,PF11921:PF02158:PF10428,2,7,2,0,5,1011,0.29,1.0,1.0,0.53,1,1,1,0,1016,1.0,1.0,0.5,0.71
PF15274,PF05483:PF15717:PF15090,1,5,0,1,5,1012,0.0,0.99,0.0,-0.0,0,0,1,0,1017,0,1.0,0.0,0
PF07365,PF06227:PF04233:PF15482,1,0,0,1,0,1017,0,1.0,0.0,0,0,0,1,0,1017,0,1.0,0.0,0
PF11579,PF15334:PF05448:PF15770,0,2,0,0,2,1016,0.0,1.0,0,0,0,0,0,0,1018,0,1.0,0,0
PF08019,PF12411:PF06406:PF10035,4,3,1,3,2,1012,0.33,1.0,0.25,0.29,0,0,4,0,1014,0,1.0,0.0,0
PF09279,PF00388:PF00387:PF03490,9,24,9,0,15,994,0.38,0.99,1.0,0.61,18,9,0,9,1000,0.5,0.99,1.0,0.7
PF16740,PF11703:PF15703:PF15672,4,0,0,4,0,1014,0,1.0,0.0,0,0,0,4,0,1014,0,1.0,0.0,0
PF16835,PF12240:PF16782:PF12001,12,4,2,10,2,1004,0.5,0.99,0.17,0.28,1,1,11,0,1006,1.0,0.99,0.08,0.29
PF03085,PF15067:PF05841:PF07931,0,7,0,0,7,1011,0.0,0.99,0,0,0,0,0,0,1018,0,1.0,0,0
PF12388,PF15207:PF02413:PF14290,0,1,0,0,1,1017,0.0,1.0,0,0,0,0,0,0,1018,0,1.0,0,0
PF14136,PF11245:PF04932:PF06678,0,0,0,0,0,1018,0,1.0,0,0,0,0,0,0,1018,0,1.0,0,0
PF04093,PF13502:PF01673:PF15143,2,1,1,1,0,1016,1.0,1.0,0.5,0.71,0,0,2,0,1016,0,1.0,0.0,0
PF06174,PF00736:PF03736:PF10587,0,35,0,0,35,983,0.0,0.97,0,0,18,0,0,18,1000,0.0,0.98,0,0
PF02271,PF12680:PF06330:PF07366,11,9,4,7,5,1002,0.44,0.99,0.36,0.4,4,2,9,2,1005,0.5,0.99,0.18,0.3
PF16670,PF03601:PF15460:PF01051,1,2,0,1,2,1015,0.0,1.0,0.0,-0.0,0,0,1,0,1017,0,1.0,0.0,0
PF10147,PF10244:PF14935:PF10161,3,10,0,3,10,1005,0.0,0.99,0.0,-0.01,1,0,3,1,1014,0.0,1.0,0.0,-0.0
PF06454,PF12906:PF12428:PF01044,8,38,3,5,35,975,0.08,0.96,0.38,0.16,5,2,6,3,1007,0.4,0.99,0.25,0.31
PF11538,PF14909:PF05508:PF10198,4,8,1,3,7,1007,0.12,0.99,0.25,0.17,1,1,3,0,1014,1.0,1.0,0.25,0.5
PF08984,PF14850:PF06813:PF04489,0,10,0,0,10,1008,0.0,0.99,0,0,0,0,0,0,1018,0,1.0,0,0
PF07980,PF10618:PF01580:PF03428,0,5,0,0,5,1013,0.0,1.0,0,0,0,0,0,0,1018,0,1.0,0,0
PF09812,PF01784:PF04716:PF04667,2,20,1,1,19,997,0.05,0.98,0.5,0.15,1,1,1,0,1016,1.0,1.0,0.5,0.71
PF11560,PF14877:PF05556:PF17015,4,9,1,3,8,1006,0.11,0.99,0.25,0.16,0,0,4,0,1014,0,1.0,0.0,0
PF01351,PF10498:PF08617:PF09696,16,18,7,9,11,991,0.39,0.98,0.44,0.4,2,2,14,0,1002,1.0,0.99,0.12,0.35
PF17125,PF01029:PF01189:PF17126,10,30,10,0,20,988,0.33,0.98,1.0,0.57,4,3,7,1,1007,0.75,0.99,0.3,0.47
PF04706,PF01980:PF09496:PF03908,7,13,5,2,8,1003,0.38,0.99,0.71,0.52,2,2,5,0,1011,1.0,1.0,0.29,0.53
PF01501,PF06427:PF03016:PF03407,42,48,18,24,30,946,0.38,0.95,0.43,0.37,10,8,34,2,974,0.8,0.96,0.19,0.38
PF04698,PF02318:PF08151:PF16056,3,13,2,1,11,1004,0.15,0.99,0.67,0.32,3,0,3,3,1012,0.0,0.99,0.0,-0.0
PF08976,PF13833:PF14923:PF00036,5,65,5,0,60,953,0.08,0.94,1.0,0.27,25,4,1,21,992,0.16,0.98,0.8,0.35
PF02421,PF08155:PF13878:PF11958,3,24,1,2,23,992,0.04,0.98,0.33,0.11,2,0,3,2,1013,0.0,1.0,0.0,-0.0
PF14878,PF14633:PF14635:PF14641,13,13,13,0,0,1005,1.0,1.0,1.0,1.0,13,13,0,0,1005,1.0,1.0,1.0,1.0
PF15112,PF09432:PF15118:PF00263,3,5,0,3,5,1010,0.0,0.99,0.0,-0.0,1,0,3,1,1014,0.0,1.0,0.0,-0.0
PF04849,PF12448:PF15705:PF16979,2,15,2,0,13,1003,0.13,0.99,1.0,0.36,1,1,1,0,1016,1.0,1.0,0.5,0.71
PF13695,PF00468:PF16009:PF04839,4,6,0,4,6,1008,0.0,0.99,0.0,-0.0,1,0,4,1,1013,0.0,1.0,0.0,-0.0
PF13657,PF02399:PF10554:PF14323,4,2,1,3,1,1013,0.5,1.0,0.25,0.35,0,0,4,0,1014,0,1.0,0.0,0
PF03437,PF14931:PF14963:PF15302,2,3,1,1,2,1014,0.33,1.0,0.5,0.41,0,0,2,0,1016,0,1.0,0.0,0
PF08168,PF15027:PF13910:PF16748,0,2,0,0,2,1016,0.0,1.0,0,0,0,0,0,0,1018,0,1.0,0,0
PF01660,PF15476:PF12255:PF09327,6,0,0,6,0,1012,0,0.99,0.0,0,0,0,6,0,1012,0,0.99,0.0,0
PF10451,PF02938:PF09170:PF09924,1,9,0,1,9,1008,0.0,0.99,0.0,-0.0,4,0,1,4,1013,0.0,1.0,0.0,-0.0
PF00177,PF01058:PF00124:PF00507,26,21,6,20,15,977,0.29,0.97,0.23,0.24,3,0,26,3,989,0.0,0.97,0.0,-0.01
PF15546,PF12241:PF02399:PF16216,1,3,0,1,3,1014,0.0,1.0,0.0,-0.0,0,0,1,0,1017,0,1.0,0.0,0
PF16034,PF04423:PF07989:PF06918,2,18,0,2,18,998,0.0,0.98,0.0,-0.01,1,0,2,1,1015,0.0,1.0,0.0,-0.0
PF14713,PF15551:PF15252:PF14931,2,1,0,2,1,1015,0.0,1.0,0.0,-0.0,0,0,2,0,1016,0,1.0,0.0,0
PF08683,PF17095:PF15246:PF10358,8,24,7,1,17,993,0.29,0.98,0.88,0.5,1,1,7,0,1010,1.0,0.99,0.12,0.35
PF01981,PF01451:PF03208:PF05529,15,25,6,9,19,984,0.24,0.97,0.4,0.3,3,3,12,0,1003,1.0,0.99,0.2,0.44
PF07130,PF05488:PF13675:PF16670,0,2,0,0,2,1016,0.0,1.0,0,0,0,0,0,0,1018,0,1.0,0,0
PF10602,PF05470:PF08375:PF09440,15,24,5,10,19,984,0.21,0.97,0.33,0.25,4,1,14,3,1000,0.25,0.98,0.07,0.12
PF01156,PF00797:PF05212:PF00793,21,31,9,12,22,975,0.29,0.97,0.43,0.34,5,2,19,3,994,0.4,0.98,0.1,0.19
PF14493,PF09382:PF00570:PF11408,5,31,4,1,27,986,0.13,0.97,0.8,0.31,16,4,1,12,1001,0.25,0.99,0.8,0.44
PF08517,PF13775:PF08347:PF16090,6,6,1,5,5,1007,0.17,0.99,0.17,0.16,0,0,6,0,1012,0,0.99,0.0,0
PF03936,PF01397:PF00278:PF06237,22,36,19,3,17,979,0.53,0.98,0.86,0.67,2,2,20,0,996,1.0,0.98,0.09,0.3
PF10927,PF07652:PF14229:PF12137,0,9,0,0,9,1009,0.0,0.99,0,0,2,0,0,2,1016,0.0,1.0,0,0
PF00865,PF15467:PF16829:PF15398,0,1,0,0,1,1017,0.0,1.0,0,0,0,0,0,0,1018,0,1.0,0,0
PF13333,PF01514:PF15976:PF04559,0,0,0,0,0,1018,0,1.0,0,0,0,0,0,0,1018,0,1.0,0,0
PF10726,PF01735:PF01957:PF08264,0,52,0,0,52,966,0.0,0.95,0,0,5,0,0,5,1013,0.0,1.0,0,0
PF07511,PF06834:PF12080:PF01706,0,1,0,0,1,1017,0.0,1.0,0,0,0,0,0,0,1018,0,1.0,0,0
PF01546,PF07687:PF00291:PF03417,37,64,18,19,46,935,0.28,0.94,0.49,0.34,7,6,31,1,980,0.86,0.97,0.16,0.36
PF10169,PF15916:PF14803:PF09297,3,10,1,2,9,1006,0.1,0.99,0.33,0.18,3,1,2,2,1013,0.33,1.0,0.33,0.33
PF10427,PF12938:PF16608:PF06012,2,11,1,1,10,1006,0.09,0.99,0.5,0.21,2,1,1,1,1015,0.5,1.0,0.5,0.5
PF15348,PF02337:PF07533:PF10127,5,22,2,3,20,993,0.09,0.98,0.4,0.18,2,0,5,2,1011,0.0,0.99,0.0,-0.0
PF11727,PF10361:PF15311:PF12527,0,6,0,0,6,1012,0.0,0.99,0,0,0,0,0,0,1018,0,1.0,0,0
PF12621,PF13967:PF02714:PF14703,10,24,10,0,14,994,0.42,0.99,1.0,0.64,21,10,0,11,997,0.48,0.99,1.0,0.69
PF12310,PF02198:PF04621:PF11620,2,19,2,0,17,999,0.11,0.98,1.0,0.32,2,2,0,0,1016,1.0,1.0,1.0,1.0
PF14956,PF00272:PF14935:PF06679,1,2,1,0,1,1016,0.5,1.0,1.0,0.71,0,0,1,0,1017,0,1.0,0.0,0
PF09851,PF05488:PF06210:PF11363,4,0,0,4,0,1014,0,1.0,0.0,0,0,0,4,0,1014,0,1.0,0.0,0
PF12494,PF02448:PF06541:PF15055,4,0,0,4,0,1014,0,1.0,0.0,0,0,0,4,0,1014,0,1.0,0.0,0
PF01212,PF02347:PF11991:PF01965,24,39,12,12,27,967,0.31,0.96,0.5,0.37,10,5,19,5,989,0.5,0.98,0.21,0.31
PF02879,PF02880:PF00408:PF02878,34,40,33,1,7,977,0.82,0.99,0.97,0.89,38,33,1,5,979,0.87,0.99,0.97,0.92
PF02897,PF00930:PF07676:PF03059,15,30,5,10,25,978,0.17,0.97,0.33,0.22,7,3,12,4,999,0.43,0.98,0.2,0.29
PF02087,PF09252:PF05355:PF15119,2,3,0,2,3,1013,0.0,1.0,0.0,-0.0,1,0,2,1,1015,0.0,1.0,0.0,-0.0
PF11627,PF08143:PF12220:PF12196,2,5,1,1,4,1012,0.2,1.0,0.5,0.31,1,1,1,0,1016,1.0,1.0,0.5,0.71
PF06782,PF15185:PF02336:PF08964,0,4,0,0,4,1014,0.0,1.0,0,0,0,0,0,0,1018,0,1.0,0,0
PF09270,PF09271:PF16422:PF16423,13,15,13,0,2,1003,0.87,1.0,1.0,0.93,3,2,11,1,1004,0.67,0.99,0.15,0.32
PF05362,PF03226:PF12002:PF02933,20,34,9,11,25,973,0.26,0.96,0.45,0.33,7,4,16,3,995,0.57,0.98,0.2,0.33
PF01368,PF02833:PF07971:PF03074,21,30,11,10,19,978,0.37,0.97,0.52,0.42,5,3,18,2,995,0.6,0.98,0.14,0.29
PF11913,PF07816:PF06244:PF09754,17,15,2,15,13,988,0.13,0.97,0.12,0.11,2,1,16,1,1000,0.5,0.98,0.06,0.17
PF09763,PF15277:PF11707:PF16201,8,12,7,1,5,1005,0.58,0.99,0.88,0.71,2,0,8,2,1008,0.0,0.99,0.0,-0.0
PF15703,PF15872:PF15068:PF06937,0,1,0,0,1,1017,0.0,1.0,0,0,0,0,0,0,1018,0,1.0,0,0
PF10796,PF10146:PF07273:PF06160,0,3,0,0,3,1015,0.0,1.0,0,0,0,0,0,0,1018,0,1.0,0,0
PF15362,PF12278:PF10583:PF10578,1,0,0,1,0,1017,0,1.0,0.0,0,0,0,1,0,1017,0,1.0,0.0,0
PF00139,PF03822:PF14593:PF00314,23,22,12,11,10,985,0.55,0.98,0.52,0.52,4,4,19,0,995,1.0,0.98,0.17,0.41
PF07918,PF10295:PF03525:PF11162,0,3,0,0,3,1015,0.0,1.0,0,0,0,0,0,0,1018,0,1.0,0,0
PF08246,PF00112:PF08773:PF08127,35,60,32,3,28,955,0.53,0.97,0.91,0.69,3,3,32,0,983,1.0,0.97,0.09,0.29
PF06303,PF02020:PF17146:PF01343,1,46,1,0,45,972,0.02,0.96,1.0,0.14,8,0,1,8,1009,0.0,0.99,0.0,-0.0
PF02597,PF02391:PF06249:PF02502,13,19,4,9,15,990,0.21,0.98,0.31,0.24,1,1,12,0,1005,1.0,0.99,0.08,0.28
PF08787,PF06108:PF06912:PF06232,4,13,1,3,12,1002,0.08,0.99,0.25,0.13,0,0,4,0,1014,0,1.0,0.0,0
PF04561,PF10385:PF06883:PF04563,4,23,3,1,20,994,0.13,0.98,0.75,0.31,5,2,2,3,1011,0.4,1.0,0.5,0.44
PF11628,PF16680:PF02189:PF03298,4,7,1,3,6,1008,0.14,0.99,0.25,0.18,1,1,3,0,1014,1.0,1.0,0.25,0.5
PF09177,PF11416:PF00804:PF02269,7,34,3,4,31,980,0.09,0.97,0.43,0.18,7,1,6,6,1005,0.14,0.99,0.14,0.14
PF02518,PF03924:PF00672:PF00183,75,51,38,37,13,930,0.75,0.95,0.51,0.59,9,9,66,0,943,1.0,0.94,0.12,0.33
PF06013,PF14985:PF00770:PF09990,0,3,0,0,3,1015,0.0,1.0,0,0,0,0,0,0,1018,0,1.0,0,0
PF05224,PF13887:PF13888:PF13884,16,8,6,10,2,1000,0.75,0.99,0.38,0.53,6,6,10,0,1002,1.0,0.99,0.38,0.61
PF14206,PF04261:PF10401:PF11879,0,25,0,0,25,993,0.0,0.98,0,0,1,0,0,1,1017,0.0,1.0,0,0
PF02714,PF13967:PF14703:PF12621,22,23,21,1,2,994,0.91,1.0,0.95,0.93,21,21,1,0,996,1.0,1.0,0.95,0.98
PF02347,PF01212:PF08427:PF11817,9,31,6,3,25,984,0.19,0.97,0.67,0.35,7,2,7,5,1004,0.29,0.99,0.22,0.25
PF12859,PF09743:PF04182:PF10264,3,14,1,2,13,1002,0.07,0.99,0.33,0.15,1,0,3,1,1014,0.0,1.0,0.0,-0.0
PF15172,PF14672:PF02448:PF15559,1,0,0,1,0,1017,0,1.0,0.0,0,0,0,1,0,1017,0,1.0,0.0,0
PF16452,PF06805:PF14052:PF12603,1,1,0,1,1,1016,0.0,1.0,0.0,-0.0,0,0,1,0,1017,0,1.0,0.0,0
PF06542,PF06581:PF04402:PF02024,2,7,1,1,6,1010,0.14,0.99,0.5,0.26,0,0,2,0,1016,0,1.0,0.0,0
PF14863,PF14864:PF00874:PF16123,4,18,4,0,14,1000,0.22,0.99,1.0,0.47,3,2,2,1,1013,0.67,1.0,0.5,0.58
PF00753,PF16123:PF07521:PF10996,72,41,23,49,18,928,0.56,0.93,0.32,0.39,22,10,62,12,934,0.45,0.93,0.14,0.22
PF02665,PF08856:PF11946:PF15878,0,0,0,0,0,1018,0,1.0,0,0,0,0,0,0,1018,0,1.0,0,0
PF16735,PF10580:PF06614:PF00784,3,24,3,0,21,994,0.12,0.98,1.0,0.35,1,1,2,0,1015,1.0,1.0,0.33,0.58
PF13328,PF04607:PF13291:PF14923,10,10,6,4,4,1004,0.6,0.99,0.6,0.6,4,4,6,0,1008,1.0,0.99,0.4,0.63
PF14841,PF14842:PF01706:PF08299,1,2,1,0,1,1016,0.5,1.0,1.0,0.71,1,1,0,0,1017,1.0,1.0,1.0,1.0
PF02488,PF16541:PF06446:PF00446,0,5,0,0,5,1013,0.0,1.0,0,0,0,0,0,0,1018,0,1.0,0,0
PF07574,PF08746:PF01091:PF00244,13,29,10,3,19,986,0.34,0.98,0.77,0.51,4,4,9,0,1005,1.0,0.99,0.31,0.55
PF09388,PF04052:PF12903:PF11650,0,0,0,0,0,1018,0,1.0,0,0,0,0,0,0,1018,0,1.0,0,0
PF04303,PF03972:PF13577:PF08229,13,14,6,7,8,997,0.43,0.99,0.46,0.44,3,3,10,0,1005,1.0,0.99,0.23,0.48
PF05204,PF07157:PF07409:PF02305,5,1,0,5,1,1012,0.0,0.99,0.0,-0.0,0,0,5,0,1013,0,1.0,0.0,0
PF08427,PF07035:PF08696:PF10350,9,21,3,6,18,991,0.14,0.98,0.33,0.21,5,1,8,4,1005,0.2,0.99,0.11,0.14
PF15315,PF05135:PF15119:PF15776,0,3,0,0,3,1015,0.0,1.0,0,0,0,0,0,0,1018,0,1.0,0,0
PF08544,PF10509:PF00288:PF07959,35,46,33,2,13,970,0.72,0.99,0.94,0.82,15,12,23,3,980,0.8,0.97,0.34,0.51
PF11608,PF01936:PF14418:PF17182,3,11,2,1,9,1006,0.18,0.99,0.67,0.34,1,0,3,1,1014,0.0,1.0,0.0,-0.0
PF15282,PF15090:PF06485:PF08632,5,10,1,4,9,1004,0.1,0.99,0.2,0.14,0,0,5,0,1013,0,1.0,0.0,0
PF14763,PF14761:PF14762:PF14679,0,3,0,0,3,1015,0.0,1.0,0,0,0,0,0,0,1018,0,1.0,0,0
PF03234,PF08564:PF08565:PF07334,7,12,7,0,5,1006,0.58,1.0,1.0,0.76,9,6,1,3,1008,0.67,1.0,0.86,0.75
PF08945,PF15175:PF15046:PF11371,0,3,0,0,3,1015,0.0,1.0,0,0,0,0,0,0,1018,0,1.0,0,0
PF10673,PF08247:PF01217:PF13352,0,46,0,0,46,972,0.0,0.95,0,0,1,0,0,1,1017,0.0,1.0,0,0
PF01725,PF09297:PF09296:PF03912,14,8,2,12,6,998,0.25,0.98,0.14,0.18,6,2,12,4,1000,0.33,0.98,0.14,0.21
PF14715,PF08093:PF15758:PF15355,0,1,0,0,1,1017,0.0,1.0,0,0,0,0,0,0,1018,0,1.0,0,0
PF09441,PF15624:PF05397:PF13945,1,15,0,1,15,1002,0.0,0.98,0.0,-0.0,1,0,1,1,1016,0.0,1.0,0.0,-0.0
PF08912,PF06918:PF11559:PF16034,7,10,1,6,9,1002,0.1,0.99,0.14,0.11,1,0,7,1,1010,0.0,0.99,0.0,-0.0
PF12919,PF06651:PF09669:PF03745,1,1,0,1,1,1016,0.0,1.0,0.0,-0.0,0,0,1,0,1017,0,1.0,0.0,0
PF15303,PF07001:PF10482:PF15557,2,6,1,1,5,1011,0.17,0.99,0.5,0.29,0,0,2,0,1016,0,1.0,0.0,0
PF13764,PF16399:PF02916:PF02617,9,17,3,6,14,995,0.18,0.98,0.33,0.23,4,2,7,2,1007,0.5,0.99,0.22,0.33
PF07444,PF12046:PF00737:PF00489,0,2,0,0,2,1016,0.0,1.0,0,0,0,0,0,0,1018,0,1.0,0,0
PF17192,PF03882:PF17193:PF10106,0,1,0,0,1,1017,0.0,1.0,0,0,0,0,0,0,1018,0,1.0,0,0
PF01338,PF00706:PF15119:PF07327,0,2,0,0,2,1016,0.0,1.0,0,0,0,0,0,0,1018,0,1.0,0,0
PF06993,PF12467:PF06834:PF11751,0,5,0,0,5,1013,0.0,1.0,0,0,0,0,0,0,1018,0,1.0,0,0
PF01667,PF04667:PF03942:PF11326,9,24,6,3,18,991,0.25,0.98,0.67,0.4,2,0,9,2,1007,0.0,0.99,0.0,-0.0
PF02237,PF09825:PF10437:PF10210,3,8,1,2,7,1008,0.12,0.99,0.33,0.2,2,1,2,1,1014,0.5,1.0,0.33,0.41
PF01979,PF07969:PF02142:PF00547,47,38,16,31,22,949,0.42,0.95,0.34,0.35,6,6,41,0,971,1.0,0.96,0.13,0.35
PF06071,PF01018:PF08701:PF05128,9,12,3,6,9,1000,0.25,0.99,0.33,0.28,1,1,8,0,1009,1.0,0.99,0.11,0.33
PF02464,PF02371:PF14659:PF08761,7,5,0,7,5,1006,0.0,0.99,0.0,-0.01,1,0,7,1,1010,0.0,0.99,0.0,-0.0
PF09453,PF13925:PF07304:PF15512,13,11,4,9,7,998,0.36,0.98,0.31,0.33,1,1,12,0,1005,1.0,0.99,0.08,0.28
PF15804,PF16766:PF11767:PF06429,1,9,0,1,9,1008,0.0,0.99,0.0,-0.0,1,0,1,1,1016,0.0,1.0,0.0,-0.0
PF01990,PF02392:PF15060:PF03842,2,8,1,1,7,1009,0.12,0.99,0.5,0.25,0,0,2,0,1016,0,1.0,0.0,0
PF12038,PF13439:PF15924:PF04413,2,26,0,2,26,990,0.0,0.97,0.0,-0.01,2,0,2,2,1014,0.0,1.0,0.0,-0.0
PF07786,PF16401:PF01458:PF06237,5,6,2,3,4,1009,0.33,0.99,0.4,0.36,0,0,5,0,1013,0,1.0,0.0,0
PF11651,PF10460:PF16286:PF03420,0,1,0,0,1,1017,0.0,1.0,0,0,0,0,0,0,1018,0,1.0,0,0
PF16399,PF15917:PF12166:PF02368,14,10,4,10,6,998,0.4,0.98,0.29,0.33,4,2,12,2,1002,0.5,0.99,0.14,0.26
PF03400,PF05634:PF04797:PF01750,2,10,0,2,10,1006,0.0,0.99,0.0,-0.0,0,0,2,0,1016,0,1.0,0.0,0
PF15843,PF15623:PF02277:PF00419,0,4,0,0,4,1014,0.0,1.0,0,0,0,0,0,0,1018,0,1.0,0,0
PF02148,PF06337:PF07576:PF00443,39,117,36,3,81,898,0.31,0.92,0.92,0.51,19,13,26,6,973,0.68,0.97,0.33,0.46
PF10539,PF14738:PF07202:PF02213,9,24,3,6,21,988,0.12,0.97,0.33,0.19,3,1,8,2,1007,0.33,0.99,0.11,0.19
PF02117,PF01387:PF10319:PF10322,2,1,0,2,1,1015,0.0,1.0,0.0,-0.0,0,0,2,0,1016,0,1.0,0.0,0
PF03474,PF08828:PF15791:PF12374,2,2,1,1,1,1015,0.5,1.0,0.5,0.5,1,1,1,0,1016,1.0,1.0,0.5,0.71
PF15119,PF14866:PF05355:PF06729,1,3,1,0,2,1015,0.33,1.0,1.0,0.58,0,0,1,0,1017,0,1.0,0.0,0
PF15350,PF14022:PF14421:PF02350,0,4,0,0,4,1014,0.0,1.0,0,0,0,0,0,0,1018,0,1.0,0,0
PF06144,PF16725:PF08519:PF09850,5,16,4,1,12,1001,0.25,0.99,0.8,0.44,1,1,4,0,1013,1.0,1.0,0.2,0.45
PF12029,PF07999:PF02559:PF07077,2,4,2,0,2,1014,0.5,1.0,1.0,0.71,2,2,0,0,1016,1.0,1.0,1.0,1.0
PF09175,PF06448:PF09172:PF01347,2,19,2,0,17,999,0.11,0.98,1.0,0.32,10,1,1,9,1007,0.1,0.99,0.5,0.22
PF12837,PF00950:PF11953:PF16590,0,5,0,0,5,1013,0.0,1.0,0,0,0,0,0,0,1018,0,1.0,0,0
PF07366,PF12006:PF03576:PF08843,4,6,0,4,6,1008,0.0,0.99,0.0,-0.0,0,0,4,0,1014,0,1.0,0.0,0
PF01290,PF03466:PF11937:PF10261,4,15,1,3,14,1000,0.07,0.98,0.25,0.12,1,0,4,1,1013,0.0,1.0,0.0,-0.0
PF00639,PF09445:PF01846:PF09068,14,28,7,7,21,983,0.25,0.97,0.5,0.34,9,2,12,7,997,0.22,0.98,0.14,0.17
PF04220,PF15556:PF03548:PF03050,1,3,0,1,3,1014,0.0,1.0,0.0,-0.0,0,0,1,0,1017,0,1.0,0.0,0
PF04722,PF10166:PF10376:PF09367,10,3,1,9,2,1006,0.33,0.99,0.1,0.18,0,0,10,0,1008,0,0.99,0.0,0
PF13181,PF13176:PF07719:PF05279,108,59,41,67,18,892,0.69,0.92,0.38,0.47,17,16,92,1,909,0.94,0.91,0.15,0.35
PF07718,PF14806:PF09066:PF08752,8,19,8,0,11,999,0.42,0.99,1.0,0.65,5,5,3,0,1010,1.0,1.0,0.62,0.79
PF12417,PF02023:PF09514:PF01352,5,48,3,2,45,968,0.06,0.95,0.6,0.18,11,3,2,8,1005,0.27,0.99,0.6,0.4
PF17124,PF07327:PF05355:PF03379,0,5,0,0,5,1013,0.0,1.0,0,0,0,0,0,0,1018,0,1.0,0,0
PF08123,PF14722:PF10309:PF16529,13,19,5,8,14,991,0.26,0.98,0.38,0.31,3,3,10,0,1005,1.0,0.99,0.23,0.48
PF08299,PF14841:PF14882:PF14467,2,1,1,1,0,1016,1.0,1.0,0.5,0.71,0,0,2,0,1016,0,1.0,0.0,0
PF05357,PF11954:PF07930:PF06176,0,6,0,0,6,1012,0.0,0.99,0,0,0,0,0,0,1018,0,1.0,0,0
PF02788,PF00016:PF01328:PF16401,2,21,2,0,19,997,0.1,0.98,1.0,0.31,0,0,2,0,1016,0,1.0,0.0,0
PF09606,PF06401:PF14654:PF17187,6,5,0,6,5,1007,0.0,0.99,0.0,-0.01,0,0,6,0,1012,0,0.99,0.0,0
PF03247,PF17014:PF15681:PF15119,5,4,0,5,4,1009,0.0,0.99,0.0,-0.0,0,0,5,0,1013,0,1.0,0.0,0
PF11815,PF11856:PF09551:PF17106,9,3,0,9,3,1006,0.0,0.99,0.0,-0.01,0,0,9,0,1009,0,0.99,0.0,0
PF00399,PF09285:PF02747:PF08523,3,20,0,3,20,995,0.0,0.98,0.0,-0.01,3,0,3,3,1012,0.0,0.99,0.0,-0.0
PF16097,PF16098:PF16096:PF12235,1,7,1,0,6,1011,0.14,0.99,1.0,0.38,5,1,0,4,1013,0.2,1.0,1.0,0.45
PF09821,PF09383:PF01032:PF16326,2,8,2,0,6,1010,0.25,0.99,1.0,0.5,2,2,0,0,1016,1.0,1.0,1.0,1.0
PF01264,PF01680:PF01997:PF06172,5,15,1,4,14,999,0.07,0.98,0.2,0.11,1,0,5,1,1012,0.0,0.99,0.0,-0.0
PF11709,PF01226:PF13564:PF13933,6,16,2,4,14,998,0.12,0.98,0.33,0.2,1,0,6,1,1011,0.0,0.99,0.0,-0.0
PF07855,PF06749:PF05915:PF05498,9,14,3,6,11,998,0.21,0.98,0.33,0.26,1,0,9,1,1008,0.0,0.99,0.0,-0.0
PF05971,PF16019:PF09804:PF04189,10,15,3,7,12,996,0.2,0.98,0.3,0.24,0,0,10,0,1008,0,0.99,0.0,0
PF11033,PF00025:PF08249:PF15840,0,65,0,0,65,953,0.0,0.94,0,0,1,0,0,1,1017,0.0,1.0,0,0
PF16969,PF07767:PF05693:PF09751,11,21,5,6,16,991,0.24,0.98,0.45,0.32,6,4,7,2,1005,0.67,0.99,0.36,0.49
PF02326,PF09363:PF08369:PF09364,4,3,1,3,2,1012,0.33,1.0,0.25,0.29,2,0,4,2,1012,0.0,0.99,0.0,-0.0
PF05326,PF08404:PF05666:PF06890,0,0,0,0,0,1018,0,1.0,0,0,0,0,0,0,1018,0,1.0,0,0
PF14370,PF02919:PF01028:PF05392,6,11,6,0,5,1007,0.55,1.0,1.0,0.74,6,6,0,0,1012,1.0,1.0,1.0,1.0
PF15690,PF15689:PF15688:PF15687,0,0,0,0,0,1018,0,1.0,0,0,0,0,0,0,1018,0,1.0,0,0
PF08071,PF16121:PF00900:PF17136,14,24,12,2,12,992,0.5,0.99,0.86,0.65,13,11,3,2,1002,0.85,1.0,0.79,0.81
PF11909,PF02531:PF05355:PF15339,1,5,0,1,5,1012,0.0,0.99,0.0,-0.0,0,0,1,0,1017,0,1.0,0.0,0
PF14917,PF10375:PF11291:PF15453,1,1,0,1,1,1016,0.0,1.0,0.0,-0.0,0,0,1,0,1017,0,1.0,0.0,0
PF14909,PF05508:PF15279:PF10198,4,4,0,4,4,1010,0.0,0.99,0.0,-0.0,1,0,4,1,1013,0.0,1.0,0.0,-0.0
PF16016,PF02893:PF16056:PF15625,16,36,9,7,27,975,0.25,0.97,0.56,0.36,2,1,15,1,1001,0.5,0.98,0.06,0.17
PF12204,PF17062:PF17056:PF12724,2,0,0,2,0,1016,0,1.0,0.0,0,0,0,2,0,1016,0,1.0,0.0,0
PF06579,PF10259:PF00965:PF10244,5,22,3,2,19,994,0.14,0.98,0.6,0.28,2,1,4,1,1012,0.5,1.0,0.2,0.31
PF06876,PF15325:PF14290:PF02087,0,3,0,0,3,1015,0.0,1.0,0,0,0,0,0,0,1018,0,1.0,0,0
PF13875,PF01297:PF08894:PF03063,2,6,1,1,5,1011,0.17,0.99,0.5,0.29,1,1,1,0,1016,1.0,1.0,0.5,0.71
PF00789,PF04000:PF00627:PF15275,23,64,12,11,52,943,0.19,0.94,0.52,0.29,7,3,20,4,991,0.43,0.98,0.13,0.23
PF07969,PF01979:PF05721:PF03659,17,79,8,9,71,930,0.1,0.92,0.47,0.19,22,7,10,15,986,0.32,0.98,0.41,0.35
PF08424,PF08514:PF14973:PF11374,13,30,6,7,24,981,0.2,0.97,0.46,0.29,3,3,10,0,1005,1.0,0.99,0.23,0.48
PF07985,PF00181:PF03947:PF08294,12,28,7,5,21,985,0.25,0.97,0.58,0.37,14,5,7,9,997,0.36,0.98,0.42,0.38
PF02852,PF14691:PF14962:PF01645,29,12,3,26,9,980,0.25,0.97,0.1,0.15,5,2,27,3,986,0.4,0.97,0.07,0.16
PF07538,PF17164:PF05065:PF01051,0,2,0,0,2,1016,0.0,1.0,0,0,0,0,0,0,1018,0,1.0,0,0
PF00132,PF00483:PF14602:PF06426,59,54,41,18,13,946,0.76,0.97,0.69,0.71,8,8,51,0,959,1.0,0.95,0.14,0.36
PF16874,PF16875:PF02065:PF16711,1,6,1,0,5,1012,0.17,1.0,1.0,0.41,1,1,0,0,1017,1.0,1.0,1.0,1.0
PF08118,PF14942:PF05460:PF09073,1,6,0,1,6,1011,0.0,0.99,0.0,-0.0,1,0,1,1,1016,0.0,1.0,0.0,-0.0
PF12735,PF12955:PF17132:PF04239,0,11,0,0,11,1007,0.0,0.99,0,0,2,0,0,2,1016,0.0,1.0,0,0
PF06719,PF12852:PF05272:PF02113,2,3,2,0,1,1015,0.67,1.0,1.0,0.82,0,0,2,0,1016,0,1.0,0.0,0
PF15849,PF07259:PF15120:PF15839,0,3,0,0,3,1015,0.0,1.0,0,0,0,0,0,0,1018,0,1.0,0,0
PF03537,PF06206:PF01670:PF07172,6,8,2,4,6,1006,0.25,0.99,0.33,0.28,0,0,6,0,1012,0,0.99,0.0,0
PF03120,PF01653:PF03119:PF08605,6,9,6,0,3,1009,0.67,1.0,1.0,0.82,3,3,3,0,1012,1.0,1.0,0.5,0.71
PF04552,PF04963:PF08479:PF07805,1,2,1,0,1,1016,0.5,1.0,1.0,0.71,0,0,1,0,1017,0,1.0,0.0,0
PF03832,PF04965:PF13929:PF03729,4,0,0,4,0,1014,0,1.0,0.0,0,0,0,4,0,1014,0,1.0,0.0,0
PF10310,PF10775:PF13741:PF15879,2,7,2,0,5,1011,0.29,1.0,1.0,0.53,0,0,2,0,1016,0,1.0,0.0,0
PF09770,PF03993:PF00073:PF05594,3,14,0,3,14,1001,0.0,0.98,0.0,-0.01,0,0,3,0,1015,0,1.0,0.0,0
PF16976,PF13629:PF07195:PF05666,1,1,1,0,0,1017,1.0,1.0,1.0,1.0,0,0,1,0,1017,0,1.0,0.0,0
PF13266,PF06683:PF10950:PF07279,1,1,0,1,1,1016,0.0,1.0,0.0,-0.0,0,0,1,0,1017,0,1.0,0.0,0
PF11752,PF10118:PF09685:PF09095,0,5,0,0,5,1013,0.0,1.0,0,0,1,0,0,1,1017,0.0,1.0,0,0
PF02816,PF16519:PF08729:PF12231,10,12,6,4,6,1002,0.5,0.99,0.6,0.54,3,3,7,0,1008,1.0,0.99,0.3,0.55
PF09263,PF09262:PF16725:PF09247,3,14,3,0,11,1004,0.21,0.99,1.0,0.46,2,1,2,1,1014,0.5,1.0,0.33,0.41
PF16897,PF16360:PF02824:PF13167,10,29,10,0,19,989,0.34,0.98,1.0,0.58,3,3,7,0,1008,1.0,0.99,0.3,0.55
PF09750,PF12230:PF01805:PF16566,18,41,13,5,28,972,0.32,0.97,0.72,0.47,14,5,13,9,991,0.36,0.98,0.28,0.3
PF15306,PF07889:PF07107:PF06351,3,14,3,0,11,1004,0.21,0.99,1.0,0.46,1,1,2,0,1015,1.0,1.0,0.33,0.58
PF10638,PF17084:PF11369:PF02501,0,2,0,0,2,1016,0.0,1.0,0,0,0,0,0,0,1018,0,1.0,0,0
PF13335,PF03090:PF11751:PF08805,0,1,0,0,1,1017,0.0,1.0,0,0,0,0,0,0,1018,0,1.0,0,0
PF06074,PF17206:PF04233:PF07505,0,1,0,0,1,1017,0.0,1.0,0,0,0,0,0,0,1018,0,1.0,0,0
PF15071,PF15370:PF11029:PF02285,0,8,0,0,8,1010,0.0,0.99,0,0,1,0,0,1,1017,0.0,1.0,0,0
PF13389,PF10856:PF15623:PF02979,0,3,0,0,3,1015,0.0,1.0,0,0,0,0,0,0,1018,0,1.0,0,0
PF01548,PF09829:PF00419:PF06890,2,1,0,2,1,1015,0.0,1.0,0.0,-0.0,0,0,2,0,1016,0,1.0,0.0,0
PF05067,PF06651:PF07955:PF09428,0,2,0,0,2,1016,0.0,1.0,0,0,1,0,0,1,1017,0.0,1.0,0,0
PF00633,PF10576:PF07934:PF11995,6,18,5,1,13,999,0.28,0.99,0.83,0.48,2,2,4,0,1012,1.0,1.0,0.33,0.58
PF15012,PF02366:PF16192:PF04339,1,16,0,1,16,1001,0.0,0.98,0.0,-0.0,13,0,1,13,1004,0.0,0.99,0.0,-0.0
PF15766,PF15052:PF12488:PF03588,0,5,0,0,5,1013,0.0,1.0,0,0,0,0,0,0,1018,0,1.0,0,0
PF16098,PF16097:PF12235:PF16096,4,7,4,0,3,1011,0.57,1.0,1.0,0.75,2,1,3,1,1013,0.5,1.0,0.25,0.35
PF13629,PF16976:PF01943:PF06934,1,1,1,0,0,1017,1.0,1.0,1.0,1.0,0,0,1,0,1017,0,1.0,0.0,0
PF04284,PF12209:PF04993:PF12098,0,0,0,0,0,1018,0,1.0,0,0,0,0,0,0,1018,0,1.0,0,0
PF03710,PF00419:PF02277:PF08964,3,4,0,3,4,1011,0.0,0.99,0.0,-0.0,0,0,3,0,1015,0,1.0,0.0,0
PF10397,PF08328:PF14698:PF10415,15,26,6,9,20,983,0.23,0.97,0.4,0.29,3,2,13,1,1002,0.67,0.99,0.13,0.29
PF05184,PF03489:PF02199:PF03227,11,18,5,6,13,994,0.28,0.98,0.45,0.35,3,1,10,2,1005,0.33,0.99,0.09,0.17
PF07794,PF02740:PF11035:PF15710,0,3,0,0,3,1015,0.0,1.0,0,0,0,0,0,0,1018,0,1.0,0,0
PF00889,PF09412:PF01299:PF10338,8,30,5,3,25,985,0.17,0.97,0.62,0.31,4,1,7,3,1007,0.25,0.99,0.12,0.17
PF07719,PF00515:PF13181:PF13174,38,122,30,8,92,888,0.25,0.9,0.79,0.41,43,23,15,20,960,0.53,0.97,0.61,0.55
PF13474,PF02577:PF02151:PF09346,3,18,2,1,16,999,0.11,0.98,0.67,0.27,2,1,2,1,1014,0.5,1.0,0.33,0.41
PF05643,PF13006:PF06286:PF07201,0,3,0,0,3,1015,0.0,1.0,0,0,0,0,0,0,1018,0,1.0,0,0
PF08209,PF02234:PF02116:PF15247,10,15,0,10,15,993,0.0,0.98,0.0,-0.01,2,0,10,2,1006,0.0,0.99,0.0,-0.0
PF08401,PF01913:PF01752:PF01514,0,3,0,0,3,1015,0.0,1.0,0,0,0,0,0,0,1018,0,1.0,0,0
PF07798,PF04729:PF10276:PF09805,8,16,3,5,13,997,0.19,0.98,0.38,0.26,1,1,7,0,1010,1.0,0.99,0.12,0.35
PF04969,PF04968:PF14050:PF05002,48,29,25,23,4,966,0.86,0.97,0.52,0.66,5,5,43,0,970,1.0,0.96,0.1,0.32
PF02699,PF02355:PF13721:PF02572,4,6,3,1,3,1011,0.5,1.0,0.75,0.61,3,3,1,0,1014,1.0,1.0,0.75,0.87
PF06250,PF12161:PF06122:PF16325,2,3,2,0,1,1015,0.67,1.0,1.0,0.82,0,0,2,0,1016,0,1.0,0.0,0
PF09704,PF00721:PF07265:PF10807,0,1,0,0,1,1017,0.0,1.0,0,0,0,0,0,0,1018,0,1.0,0,0
PF00772,PF13662:PF06350:PF01807,6,13,4,2,9,1003,0.31,0.99,0.67,0.45,6,3,3,3,1009,0.5,0.99,0.5,0.5
PF10144,PF04955:PF09391:PF06676,0,0,0,0,0,1018,0,1.0,0,0,0,0,0,0,1018,0,1.0,0,0
PF02317,PF07479:PF07683:PF02132,7,34,4,3,30,981,0.12,0.97,0.57,0.25,4,2,5,2,1009,0.5,0.99,0.29,0.37
PF03175,PF02945:PF16061:PF13402,11,12,5,6,7,1000,0.42,0.99,0.45,0.43,0,0,11,0,1007,0,0.99,0.0,0
PF09461,PF11124:PF08453:PF15776,0,4,0,0,4,1014,0.0,1.0,0,0,0,0,0,0,1018,0,1.0,0,0
PF02507,PF02531:PF08576:PF09252,0,4,0,0,4,1014,0.0,1.0,0,0,1,0,0,1,1017,0.0,1.0,0,0
PF08906,PF00713:PF02583:PF08846,0,5,0,0,5,1013,0.0,1.0,0,0,0,0,0,0,1018,0,1.0,0,0
PF00771,PF04717:PF08298:PF05034,0,0,0,0,0,1018,0,1.0,0,0,0,0,0,0,1018,0,1.0,0,0
PF05285,PF08158:PF09511:PF08302,15,17,7,8,10,993,0.41,0.98,0.47,0.43,4,1,14,3,1000,0.25,0.98,0.07,0.12
PF05350,PF06382:PF02157:PF02101,2,14,0,2,14,1002,0.0,0.98,0.0,-0.01,1,0,2,1,1015,0.0,1.0,0.0,-0.0
PF07047,PF10280:PF01730:PF14997,10,11,1,9,10,998,0.09,0.98,0.1,0.09,1,0,10,1,1007,0.0,0.99,0.0,-0.0
PF00037,PF04068:PF14510:PF02256,16,34,13,3,21,981,0.38,0.98,0.81,0.55,6,4,12,2,1000,0.67,0.99,0.25,0.4
PF13408,PF07508:PF00239:PF02501,2,5,2,0,3,1013,0.4,1.0,1.0,0.63,2,2,0,0,1016,1.0,1.0,1.0,1.0
PF15510,PF04965:PF09108:PF08744,1,0,0,1,0,1017,0,1.0,0.0,0,0,0,1,0,1017,0,1.0,0.0,0
PF17168,PF16335:PF08760:PF16334,4,5,4,0,1,1013,0.8,1.0,1.0,0.89,4,4,0,0,1014,1.0,1.0,1.0,1.0
PF06406,PF13876:PF17006:PF01913,0,2,0,0,2,1016,0.0,1.0,0,0,0,0,0,0,1018,0,1.0,0,0
PF10080,PF10634:PF07157:PF13421,0,0,0,0,0,1018,0,1.0,0,0,0,0,0,0,1018,0,1.0,0,0
PF01391,PF01410:PF07452:PF03523,74,16,11,63,5,939,0.69,0.93,0.15,0.3,1,1,73,0,944,1.0,0.93,0.01,0.11
PF16652,PF12763:PF08165:PF16165,8,41,6,2,35,975,0.15,0.96,0.75,0.32,3,1,7,2,1008,0.33,0.99,0.12,0.2
PF08324,PF06957:PF09070:PF15512,11,15,6,5,9,998,0.4,0.99,0.55,0.46,5,3,8,2,1005,0.6,0.99,0.27,0.4
PF02367,PF06832:PF03401:PF15041,2,3,0,2,3,1013,0.0,1.0,0.0,-0.0,0,0,2,0,1016,0,1.0,0.0,0
PF08265,PF12319:PF11669:PF07939,11,6,1,10,5,1002,0.17,0.99,0.09,0.12,0,0,11,0,1007,0,0.99,0.0,0
PF04472,PF03065:PF09614:PF08795,0,1,0,0,1,1017,0.0,1.0,0,0,0,0,0,0,1018,0,1.0,0,0
PF04851,PF11648:PF16739:PF03368,45,22,18,27,4,969,0.82,0.97,0.4,0.56,7,7,38,0,973,1.0,0.96,0.16,0.39
PF02208,PF08687:PF12516:PF12052,4,8,2,2,6,1008,0.25,0.99,0.5,0.35,2,1,3,1,1013,0.5,1.0,0.25,0.35
PF00611,PF09128:PF13543:PF00620,19,82,14,5,68,931,0.17,0.93,0.74,0.33,7,2,17,5,994,0.29,0.98,0.11,0.16
PF12857,PF01032:PF16326:PF09383,2,8,2,0,6,1010,0.25,0.99,1.0,0.5,2,2,0,0,1016,1.0,1.0,1.0,1.0
PF08312,PF06046:PF01805:PF12230,15,40,7,8,33,970,0.17,0.96,0.47,0.27,14,4,11,10,993,0.29,0.98,0.27,0.27
PF15063,PF15831:PF06541:PF02044,0,0,0,0,0,1018,0,1.0,0,0,0,0,0,0,1018,0,1.0,0,0
PF14703,PF02714:PF13967:PF12621,22,23,21,1,2,994,0.91,1.0,0.95,0.93,21,21,1,0,996,1.0,1.0,0.95,0.98
PF14871,PF03428:PF10459:PF09951,1,2,0,1,2,1015,0.0,1.0,0.0,-0.0,0,0,1,0,1017,0,1.0,0.0,0
PF15579,PF09726:PF01221:PF02659,0,20,0,0,20,998,0.0,0.98,0,0,2,0,0,2,1016,0.0,1.0,0,0
PF16335,PF17168:PF08760:PF16334,4,5,4,0,1,1013,0.8,1.0,1.0,0.89,4,4,0,0,1014,1.0,1.0,1.0,1.0
PF15471,PF04965:PF08867:PF05939,0,0,0,0,0,1018,0,1.0,0,0,0,0,0,0,1018,0,1.0,0,0
PF10520,PF07933:PF09288:PF07200,4,17,1,3,16,998,0.06,0.98,0.25,0.11,7,0,4,7,1007,0.0,0.99,0.0,-0.01
PF15342,PF10571:PF00473:PF03193,4,9,1,3,8,1006,0.11,0.99,0.25,0.16,1,0,4,1,1013,0.0,1.0,0.0,-0.0
PF07989,PF03801:PF16830:PF04423,13,12,2,11,10,995,0.17,0.98,0.15,0.15,1,1,12,0,1005,1.0,0.99,0.08,0.28
PF03480,PF06808:PF00950:PF00771,8,9,7,1,2,1008,0.78,1.0,0.88,0.82,3,3,5,0,1010,1.0,1.0,0.38,0.61
PF08328,PF14698:PF10415:PF10397,2,33,0,2,33,983,0.0,0.97,0.0,-0.01,7,0,2,7,1009,0.0,0.99,0.0,-0.0
PF05938,PF04520:PF00197:PF06749,9,8,3,6,5,1004,0.38,0.99,0.33,0.35,0,0,9,0,1009,0,0.99,0.0,0
PF02735,PF03731:PF03730:PF08785,24,24,23,1,1,993,0.96,1.0,0.96,0.96,20,20,4,0,994,1.0,1.0,0.83,0.91
PF01549,PF08768:PF05507:PF04942,43,12,7,36,5,970,0.58,0.96,0.16,0.29,0,0,43,0,975,0,0.96,0.0,0
PF03266,PF15741:PF15252:PF01959,3,4,1,2,3,1012,0.25,1.0,0.33,0.29,0,0,3,0,1015,0,1.0,0.0,0
PF00238,PF02284:PF01997:PF05995,14,21,3,11,18,986,0.14,0.97,0.21,0.16,3,0,14,3,1001,0.0,0.98,0.0,-0.01
PF05345,PF12509:PF15912:PF15273,3,7,0,3,7,1008,0.0,0.99,0.0,-0.0,0,0,3,0,1015,0,1.0,0.0,0
PF03544,PF05874:PF03601:PF12628,4,1,0,4,1,1013,0.0,1.0,0.0,-0.0,0,0,4,0,1014,0,1.0,0.0,0
PF16454,PF12162:PF08947:PF01991,7,10,2,5,8,1003,0.2,0.99,0.29,0.23,1,0,7,1,1010,0.0,0.99,0.0,-0.0
PF00236,PF05039:PF00714:PF00537,1,2,0,1,2,1015,0.0,1.0,0.0,-0.0,0,0,1,0,1017,0,1.0,0.0,0
PF00089,PF12032:PF08610:PF16030,126,22,17,109,5,887,0.77,0.89,0.13,0.29,3,3,123,0,892,1.0,0.88,0.02,0.14
PF15936,PF14138:PF06456:PF12315,7,28,4,3,24,987,0.14,0.97,0.57,0.28,3,2,5,1,1010,0.67,0.99,0.29,0.43
PF08447,PF11413:PF08778:PF16279,25,11,6,19,5,988,0.55,0.98,0.24,0.35,2,2,23,0,993,1.0,0.98,0.08,0.28
PF16077,PF10188:PF01868:PF13002,11,14,3,8,11,996,0.21,0.98,0.27,0.23,0,0,11,0,1007,0,0.99,0.0,0
PF15778,PF12516:PF15249:PF12478,3,13,0,3,13,1002,0.0,0.98,0.0,-0.01,1,0,3,1,1014,0.0,1.0,0.0,-0.0
PF09183,PF11720:PF09648:PF04466,1,1,1,0,0,1017,1.0,1.0,1.0,1.0,0,0,1,0,1017,0,1.0,0.0,0
PF08559,PF04367:PF04839:PF07939,2,4,0,2,4,1012,0.0,0.99,0.0,-0.0,1,0,2,1,1015,0.0,1.0,0.0,-0.0
PF03986,PF10381:PF03987:PF01113,10,21,9,1,12,996,0.43,0.99,0.9,0.62,11,9,1,2,1006,0.82,1.0,0.9,0.86
PF15163,PF06798:PF03739:PF01706,3,5,0,3,5,1010,0.0,0.99,0.0,-0.0,1,0,3,1,1014,0.0,1.0,0.0,-0.0
PF09939,PF00425:PF00117:PF00958,0,72,0,0,72,946,0.0,0.93,0,0,27,0,0,27,991,0.0,0.97,0,0
PF15195,PF15828:PF01514:PF17049,1,3,0,1,3,1014,0.0,1.0,0.0,-0.0,0,0,1,0,1017,0,1.0,0.0,0
PF13187,PF13237:PF00507:PF00430,12,15,8,4,7,999,0.53,0.99,0.67,0.59,3,2,10,1,1005,0.67,0.99,0.17,0.33
PF07051,PF12855:PF06989:PF11460,1,2,0,1,2,1015,0.0,1.0,0.0,-0.0,0,0,1,0,1017,0,1.0,0.0,0
PF02118,PF10323:PF10317:PF10319,4,19,3,1,16,998,0.16,0.98,0.75,0.34,0,0,4,0,1014,0,1.0,0.0,0
PF15704,PF06232:PF06521:PF07333,3,6,0,3,6,1009,0.0,0.99,0.0,-0.0,0,0,3,0,1015,0,1.0,0.0,0
PF05677,PF12898:PF14216:PF11223,0,2,0,0,2,1016,0.0,1.0,0,0,0,0,0,0,1018,0,1.0,0,0
PF02065,PF16874:PF16875:PF16711,5,2,1,4,1,1012,0.5,1.0,0.2,0.31,1,1,4,0,1013,1.0,1.0,0.2,0.45
PF09420,PF16954:PF08925:PF03858,4,8,1,3,7,1007,0.12,0.99,0.25,0.17,0,0,4,0,1014,0,1.0,0.0,0
PF08588,PF10332:PF04090:PF10104,3,9,0,3,9,1006,0.0,0.99,0.0,-0.01,1,0,3,1,1014,0.0,1.0,0.0,-0.0
PF13870,PF06211:PF15934:PF12240,3,2,0,3,2,1013,0.0,1.0,0.0,-0.0,0,0,3,0,1015,0,1.0,0.0,0
PF04796,PF15097:PF07804:PF14552,0,3,0,0,3,1015,0.0,1.0,0,0,0,0,0,0,1018,0,1.0,0,0
PF08975,PF12158:PF03050:PF03243,1,3,0,1,3,1014,0.0,1.0,0.0,-0.0,0,0,1,0,1017,0,1.0,0.0,0
PF01885,PF01126:PF06487:PF04119,13,17,3,10,14,991,0.18,0.98,0.23,0.19,0,0,13,0,1005,0,0.99,0.0,0
PF12911,PF02951:PF12299:PF15319,4,4,1,3,3,1011,0.25,0.99,0.25,0.25,0,0,4,0,1014,0,1.0,0.0,0
PF08781,PF16421:PF02319:PF03479,11,29,10,1,19,988,0.34,0.98,0.91,0.55,9,3,8,6,1001,0.33,0.99,0.27,0.29
PF13887,PF13888:PF13884:PF05224,6,18,6,0,12,1000,0.33,0.99,1.0,0.57,6,6,0,0,1012,1.0,1.0,1.0,1.0
PF03249,PF06140:PF10318:PF00510,0,26,0,0,26,992,0.0,0.97,0,0,3,0,0,3,1015,0.0,1.0,0,0
PF04127,PF14365:PF03080:PF04862,8,16,3,5,13,997,0.19,0.98,0.38,0.26,3,0,8,3,1007,0.0,0.99,0.0,-0.0
PF00590,PF14823:PF13241:PF04790,18,14,7,11,7,993,0.5,0.98,0.39,0.43,8,4,14,4,996,0.5,0.98,0.22,0.33
PF04305,PF08802:PF00848:PF01180,9,32,6,3,26,983,0.19,0.97,0.67,0.34,5,4,5,1,1008,0.8,0.99,0.44,0.59
PF08164,PF16174:PF16550:PF15285,14,5,1,13,4,1000,0.2,0.98,0.07,0.11,0,0,14,0,1004,0,0.99,0.0,0
PF04152,PF16891:PF10360:PF05011,14,25,6,8,19,985,0.24,0.97,0.43,0.31,6,3,11,3,1001,0.5,0.99,0.21,0.32
PF09260,PF16028:PF16657:PF09154,5,3,2,3,1,1012,0.67,1.0,0.4,0.51,1,1,4,0,1013,1.0,1.0,0.2,0.45
PF14026,PF03116:PF04034:PF09776,0,14,0,0,14,1004,0.0,0.99,0,0,0,0,0,0,1018,0,1.0,0,0
PF13391,PF01868:PF11735:PF10332,14,18,2,12,16,988,0.11,0.97,0.14,0.11,1,1,13,0,1004,1.0,0.99,0.07,0.27
PF00251,PF08244:PF11837:PF16352,16,13,13,3,0,1002,1.0,1.0,0.81,0.9,2,2,14,0,1002,1.0,0.99,0.12,0.35
PF00605,PF10401:PF16983:PF02219,11,19,10,1,9,998,0.53,0.99,0.91,0.69,2,2,9,0,1007,1.0,0.99,0.18,0.42
PF09793,PF00159:PF14774:PF01279,7,8,3,4,5,1006,0.38,0.99,0.43,0.4,1,0,7,1,1010,0.0,0.99,0.0,-0.0
PF15578,PF15085:PF15107:PF15141,1,2,0,1,2,1015,0.0,1.0,0.0,-0.0,0,0,1,0,1017,0,1.0,0.0,0
PF06210,PF05065:PF15482:PF08453,0,3,0,0,3,1015,0.0,1.0,0,0,0,0,0,0,1018,0,1.0,0,0
PF00800,PF13508:PF02153:PF01817,15,29,7,8,22,981,0.24,0.97,0.47,0.32,2,1,14,1,1002,0.5,0.99,0.07,0.18
PF01668,PF17010:PF01316:PF08404,2,2,0,2,2,1014,0.0,1.0,0.0,-0.0,0,0,2,0,1016,0,1.0,0.0,0
PF05636,PF07499:PF05045:PF08411,0,3,0,0,3,1015,0.0,1.0,0,0,0,0,0,0,1018,0,1.0,0,0
PF13928,PF15230:PF07977:PF07400,5,15,0,5,15,998,0.0,0.98,0.0,-0.01,0,0,5,0,1013,0,1.0,0.0,0
PF06974,PF03007:PF02789:PF13336,8,35,8,0,27,983,0.23,0.97,1.0,0.47,3,2,6,1,1009,0.67,0.99,0.25,0.41
PF10246,PF15013:PF14935:PF06388,9,4,1,8,3,1006,0.25,0.99,0.11,0.16,0,0,9,0,1009,0,0.99,0.0,0
PF15160,PF05418:PF09428:PF02025,0,4,0,0,4,1014,0.0,1.0,0,0,0,0,0,0,1018,0,1.0,0,0
PF00883,PF02789:PF03385:PF04515,26,32,21,5,11,981,0.66,0.98,0.81,0.72,2,2,24,0,992,1.0,0.98,0.08,0.27
PF13733,PF02709:PF06309:PF07258,19,37,19,0,18,981,0.51,0.98,1.0,0.71,7,5,14,2,997,0.71,0.98,0.26,0.43
PF02779,PF00456:PF02780:PF13292,41,35,31,10,4,973,0.89,0.99,0.76,0.81,11,11,30,0,977,1.0,0.97,0.27,0.51
PF00043,PF14497:PF04399:PF13417,49,69,35,14,34,935,0.51,0.95,0.71,0.58,22,18,31,4,965,0.82,0.97,0.37,0.53
PF09637,PF00220:PF06449:PF00126,7,12,1,6,11,1000,0.08,0.98,0.14,0.1,0,0,7,0,1011,0,0.99,0.0,0
PF16100,PF05754:PF14985:PF06876,3,2,0,3,2,1013,0.0,1.0,0.0,-0.0,0,0,3,0,1015,0,1.0,0.0,0
PF13118,PF11995:PF07199:PF15337,3,7,3,0,4,1011,0.43,1.0,1.0,0.65,0,0,3,0,1015,0,1.0,0.0,0
PF11822,PF12516:PF15326:PF02200,7,2,0,7,2,1009,0.0,0.99,0.0,-0.0,0,0,7,0,1011,0,0.99,0.0,0
PF00720,PF12686:PF15748:PF07960,1,2,0,1,2,1015,0.0,1.0,0.0,-0.0,0,0,1,0,1017,0,1.0,0.0,0
PF15984,PF14224:PF05962:PF03713,0,1,0,0,1,1017,0.0,1.0,0,0,0,0,0,0,1018,0,1.0,0,0
PF02401,PF07298:PF14279:PF09991,5,2,0,5,2,1011,0.0,0.99,0.0,-0.0,0,0,5,0,1013,0,1.0,0.0,0
PF02074,PF10856:PF15823:PF07157,1,0,0,1,0,1017,0,1.0,0.0,0,0,0,1,0,1017,0,1.0,0.0,0
PF12381,PF08762:PF00548:PF15395,4,12,4,0,8,1006,0.33,0.99,1.0,0.58,4,4,0,0,1014,1.0,1.0,1.0,1.0
PF14109,PF14398:PF05398:PF03613,0,0,0,0,0,1018,0,1.0,0,0,0,0,0,0,1018,0,1.0,0,0
PF10200,PF03073:PF10775:PF01922,5,10,2,3,8,1005,0.2,0.99,0.4,0.28,0,0,5,0,1013,0,1.0,0.0,0
PF13016,PF04788:PF00473:PF01245,2,15,1,1,14,1002,0.07,0.99,0.5,0.18,5,1,1,4,1012,0.2,1.0,0.5,0.31
PF08613,PF13908:PF02701:PF14719,23,15,3,20,12,983,0.2,0.97,0.13,0.15,1,1,22,0,995,1.0,0.98,0.04,0.21
PF16850,PF10554:PF17010:PF13722,1,0,0,1,0,1017,0,1.0,0.0,0,0,0,1,0,1017,0,1.0,0.0,0
PF07728,PF08385:PF12780:PF08393,38,45,28,10,17,963,0.62,0.97,0.74,0.66,33,26,12,7,973,0.79,0.98,0.68,0.72
PF13382,PF03841:PF00449:PF01475,3,10,1,2,9,1006,0.1,0.99,0.33,0.18,1,1,2,0,1015,1.0,1.0,0.33,0.58
PF04967,PF09669:PF00796:PF01312,0,1,0,0,1,1017,0.0,1.0,0,0,0,0,0,0,1018,0,1.0,0,0
PF15340,PF15772:PF01312:PF17049,2,1,0,2,1,1015,0.0,1.0,0.0,-0.0,0,0,2,0,1016,0,1.0,0.0,0
PF05450,PF06880:PF16061:PF04833,11,7,2,9,5,1002,0.29,0.99,0.18,0.22,0,0,11,0,1007,0,0.99,0.0,0
PF00928,PF09786:PF01217:PF10574,38,49,28,10,21,959,0.57,0.97,0.74,0.63,3,2,36,1,979,0.67,0.96,0.05,0.18
PF14056,PF00519:PF04911:PF05083,0,6,0,0,6,1012,0.0,0.99,0,0,1,0,0,1,1017,0.0,1.0,0,0
PF10564,PF11476:PF11244:PF11235,1,2,0,1,2,1015,0.0,1.0,0.0,-0.0,0,0,1,0,1017,0,1.0,0.0,0
PF08610,PF02983:PF09272:PF06417,9,12,2,7,10,999,0.17,0.98,0.22,0.18,1,1,8,0,1009,1.0,0.99,0.11,0.33
PF04061,PF14770:PF03652:PF05910,6,14,3,3,11,1001,0.21,0.99,0.5,0.32,3,2,4,1,1011,0.67,1.0,0.33,0.47
PF07876,PF01988:PF01817:PF07950,26,27,7,19,20,972,0.26,0.96,0.27,0.24,2,2,24,0,992,1.0,0.98,0.08,0.27
PF07312,PF09614:PF15204:PF05418,0,1,0,0,1,1017,0.0,1.0,0,0,0,0,0,0,1018,0,1.0,0,0
PF04886,PF09272:PF02983:PF16030,12,13,4,8,9,997,0.31,0.98,0.33,0.31,1,1,11,0,1006,1.0,0.99,0.08,0.29
PF12112,PF11289:PF05973:PF02660,0,1,0,0,1,1017,0.0,1.0,0,0,0,0,0,0,1018,0,1.0,0,0
PF14396,PF12399:PF08352:PF08402,3,13,2,1,11,1004,0.15,0.99,0.67,0.32,5,2,1,3,1012,0.4,1.0,0.67,0.51
PF02422,PF00074:PF13841:PF06404,2,3,0,2,3,1013,0.0,1.0,0.0,-0.0,0,0,2,0,1016,0,1.0,0.0,0
PF02060,PF15370:PF05039:PF15071,2,3,0,2,3,1013,0.0,1.0,0.0,-0.0,0,0,2,0,1016,0,1.0,0.0,0
PF09367,PF17085:PF05658:PF10376,0,1,0,0,1,1017,0.0,1.0,0,0,0,0,0,0,1018,0,1.0,0,0
PF11542,PF06586:PF05309:PF07178,1,1,0,1,1,1016,0.0,1.0,0.0,-0.0,1,0,1,1,1016,0.0,1.0,0.0,-0.0
PF00808,PF08517:PF08347:PF15245,47,7,1,46,6,965,0.14,0.95,0.02,0.04,0,0,47,0,971,0,0.95,0.0,0
PF11502,PF15735:PF15888:PF15082,1,8,0,1,8,1009,0.0,0.99,0.0,-0.0,0,0,1,0,1017,0,1.0,0.0,0
PF05565,PF06819:PF03175:PF00270,0,181,0,0,181,837,0.0,0.82,0,0,9,0,0,9,1009,0.0,0.99,0,0
PF11746,PF08518:PF12205:PF08321,0,16,0,0,16,1002,0.0,0.98,0,0,3,0,0,3,1015,0.0,1.0,0,0
PF04780,PF04781:PF09743:PF08167,5,11,3,2,8,1005,0.27,0.99,0.6,0.4,0,0,5,0,1013,0,1.0,0.0,0
PF03477,PF00317:PF02867:PF08343,6,14,6,0,8,1004,0.43,0.99,1.0,0.65,11,6,0,5,1007,0.55,1.0,1.0,0.74
PF01557,PF09298:PF12146:PF04083,44,76,32,12,44,930,0.42,0.94,0.73,0.53,25,18,26,7,967,0.72,0.97,0.41,0.53
PF10159,PF04090:PF08528:PF10104,11,13,4,7,9,998,0.31,0.98,0.36,0.33,2,1,10,1,1006,0.5,0.99,0.09,0.21
PF02027,PF07207:PF11739:PF15160,1,3,1,0,2,1015,0.33,1.0,1.0,0.58,1,1,0,0,1017,1.0,1.0,1.0,1.0
PF14338,PF11332:PF12920:PF01034,0,4,0,0,4,1014,0.0,1.0,0,0,0,0,0,0,1018,0,1.0,0,0
PF05114,PF17010:PF06681:PF11124,0,0,0,0,0,1018,0,1.0,0,0,0,0,0,0,1018,0,1.0,0,0
PF14365,PF03080:PF05634:PF03951,2,26,2,0,24,992,0.08,0.98,1.0,0.27,2,0,2,2,1014,0.0,1.0,0.0,-0.0
PF02496,PF06351:PF02361:PF01716,1,8,1,0,7,1010,0.12,0.99,1.0,0.35,0,0,1,0,1017,0,1.0,0.0,0
PF04637,PF17164:PF17206:PF06074,0,1,0,0,1,1017,0.0,1.0,0,0,0,0,0,0,1018,0,1.0,0,0
PF05707,PF00669:PF17164:PF05299,0,1,0,0,1,1017,0.0,1.0,0,0,0,0,0,0,1018,0,1.0,0,0
PF11946,PF00114:PF10566:PF01337,0,0,0,0,0,1018,0,1.0,0,0,0,0,0,0,1018,0,1.0,0,0
PF09969,PF15107:PF03379:PF01316,1,3,0,1,3,1014,0.0,1.0,0.0,-0.0,0,0,1,0,1017,0,1.0,0.0,0
PF03966,PF05365:PF08231:PF06098,7,18,3,4,15,996,0.17,0.98,0.43,0.26,2,1,6,1,1010,0.5,0.99,0.14,0.26
PF10937,PF14495:PF11017:PF10994,2,2,0,2,2,1014,0.0,1.0,0.0,-0.0,0,0,2,0,1016,0,1.0,0.0,0
PF05535,PF06729:PF04691:PF10454,0,1,0,0,1,1017,0.0,1.0,0,0,0,0,0,0,1018,0,1.0,0,0
PF11883,PF12398:PF01453:PF08917,5,41,5,0,36,977,0.12,0.96,1.0,0.34,4,4,1,0,1013,1.0,1.0,0.8,0.89
PF01007,PF08466:PF14798:PF05308,14,5,2,12,3,1001,0.4,0.99,0.14,0.23,1,1,13,0,1004,1.0,0.99,0.07,0.27
PF07390,PF06681:PF16861:PF10974,0,3,0,0,3,1015,0.0,1.0,0,0,0,0,0,0,1018,0,1.0,0,0
PF16747,PF15137:PF01580:PF04451,0,6,0,0,6,1012,0.0,0.99,0,0,1,0,0,1,1017,0.0,1.0,0,0
PF02777,PF00081:PF01731:PF00993,22,26,22,0,4,992,0.85,1.0,1.0,0.92,0,0,22,0,996,0,0.98,0.0,0
PF08257,PF02951:PF00997:PF00972,0,9,0,0,9,1009,0.0,0.99,0,0,1,0,0,1,1017,0.0,1.0,0,0
PF06566,PF06567:PF10630:PF15622,1,1,1,0,0,1017,1.0,1.0,1.0,1.0,0,0,1,0,1017,0,1.0,0.0,0
PF15296,PF14764:PF08640:PF08216,6,17,2,4,15,997,0.12,0.98,0.33,0.19,2,2,4,0,1012,1.0,1.0,0.33,0.58
PF15346,PF14279:PF11016:PF15503,2,1,0,2,1,1015,0.0,1.0,0.0,-0.0,0,0,2,0,1016,0,1.0,0.0,0
PF00175,PF00970:PF00667:PF00258,62,63,53,9,10,946,0.84,0.98,0.85,0.84,32,31,31,1,955,0.97,0.97,0.5,0.68
PF08562,PF00188:PF05884:PF03229,0,54,0,0,54,964,0.0,0.95,0,0,1,0,0,1,1017,0.0,1.0,0,0
PF15122,PF06210:PF01051:PF05065,0,2,0,0,2,1016,0.0,1.0,0,0,0,0,0,0,1018,0,1.0,0,0
PF01868,PF10332:PF10188:PF07545,10,1,1,9,0,1008,1.0,0.99,0.1,0.31,0,0,10,0,1008,0,0.99,0.0,0
PF08451,PF00962:PF12213:PF11894,5,30,5,0,25,988,0.17,0.98,1.0,0.4,7,2,3,5,1008,0.29,0.99,0.4,0.33
PF00341,PF14554:PF15800:PF03128,7,3,2,5,1,1010,0.67,0.99,0.29,0.43,1,1,6,0,1011,1.0,0.99,0.14,0.38
PF14774,PF15359:PF00159:PF08641,5,7,1,4,6,1007,0.14,0.99,0.2,0.16,1,0,5,1,1012,0.0,0.99,0.0,-0.0
PF11790,PF09362:PF09451:PF01670,8,21,3,5,18,992,0.14,0.98,0.38,0.22,4,3,5,1,1009,0.75,0.99,0.38,0.53
PF05316,PF09950:PF04453:PF06832,1,1,0,1,1,1016,0.0,1.0,0.0,-0.0,0,0,1,0,1017,0,1.0,0.0,0
PF11464,PF16696:PF12210:PF04366,11,14,1,10,13,994,0.07,0.98,0.09,0.07,3,1,10,2,1005,0.33,0.99,0.09,0.17
PF05110,PF14763:PF14761:PF14762,5,2,0,5,2,1011,0.0,0.99,0.0,-0.0,0,0,5,0,1013,0,1.0,0.0,0
PF12171,PF08648:PF01715:PF07776,42,64,23,19,41,935,0.36,0.94,0.55,0.41,8,6,36,2,974,0.75,0.96,0.14,0.32
PF07738,PF09387:PF06701:PF15808,28,18,9,19,9,981,0.5,0.97,0.32,0.39,1,0,28,1,989,0.0,0.97,0.0,-0.01
PF06327,PF16214:PF07700:PF08376,6,22,6,0,16,996,0.27,0.98,1.0,0.52,4,3,3,1,1011,0.75,1.0,0.5,0.61
PF09774,PF02569:PF09781:PF02101,8,17,1,7,16,994,0.06,0.98,0.12,0.08,2,0,8,2,1008,0.0,0.99,0.0,-0.0
PF07839,PF15235:PF12178:PF15997,3,3,0,3,3,1012,0.0,0.99,0.0,-0.0,0,0,3,0,1015,0,1.0,0.0,0
PF15793,PF15491:PF15735:PF16748,0,5,0,0,5,1013,0.0,1.0,0,0,0,0,0,0,1018,0,1.0,0,0
PF14443,PF14444:PF16294:PF15273,4,8,2,2,6,1008,0.25,0.99,0.5,0.35,1,1,3,0,1014,1.0,1.0,0.25,0.5
PF02599,PF15826:PF16824:PF09493,1,0,0,1,0,1017,0,1.0,0.0,0,0,0,1,0,1017,0,1.0,0.0,0
PF14113,PF06890:PF13722:PF08411,0,1,0,0,1,1017,0.0,1.0,0,0,0,0,0,0,1018,0,1.0,0,0
PF02463,PF06470:PF01641:PF10211,48,28,16,32,12,958,0.57,0.96,0.33,0.42,3,2,46,1,969,0.67,0.95,0.04,0.16
PF05483,PF05548:PF07260:PF15090,4,4,0,4,4,1010,0.0,0.99,0.0,-0.0,0,0,4,0,1014,0,1.0,0.0,0
PF03708,PF14421:PF09003:PF13101,2,2,0,2,2,1014,0.0,1.0,0.0,-0.0,0,0,2,0,1016,0,1.0,0.0,0
PF11988,PF08744:PF04001:PF04965,0,0,0,0,0,1018,0,1.0,0,0,0,0,0,0,1018,0,1.0,0,0
PF00018,PF14604:PF07653:PF08824,98,90,56,42,34,886,0.62,0.93,0.57,0.56,34,31,67,3,917,0.91,0.93,0.32,0.51
PF04260,PF07399:PF10694:PF07706,3,5,0,3,5,1010,0.0,0.99,0.0,-0.0,1,0,3,1,1014,0.0,1.0,0.0,-0.0
PF02165,PF04549:PF00865:PF15893,0,0,0,0,0,1018,0,1.0,0,0,0,0,0,0,1018,0,1.0,0,0
PF04444,PF10437:PF04572:PF17132,17,10,3,14,7,994,0.3,0.98,0.18,0.22,0,0,17,0,1001,0,0.98,0.0,0
PF00886,PF00499:PF00507:PF00430,8,10,3,5,7,1003,0.3,0.99,0.38,0.33,2,1,7,1,1009,0.5,0.99,0.12,0.25
PF15085,PF14866:PF09252:PF03379,2,1,0,2,1,1015,0.0,1.0,0.0,-0.0,0,0,2,0,1016,0,1.0,0.0,0
PF01876,PF08347:PF09011:PF08517,14,21,6,8,15,989,0.29,0.98,0.43,0.34,2,1,13,1,1003,0.5,0.99,0.07,0.19
PF11385,PF11081:PF01673:PF10109,0,0,0,0,0,1018,0,1.0,0,0,0,0,0,0,1018,0,1.0,0,0
PF05118,PF05279:PF13174:PF13181,8,108,4,4,104,906,0.04,0.89,0.5,0.11,14,2,6,12,998,0.14,0.98,0.25,0.18
PF03610,PF13876:PF07391:PF01913,3,2,0,3,2,1013,0.0,1.0,0.0,-0.0,0,0,3,0,1015,0,1.0,0.0,0
PF13960,PF13963:PF13952:PF02992,5,16,4,1,12,1001,0.25,0.99,0.8,0.44,8,3,2,5,1008,0.38,0.99,0.6,0.47
PF14932,PF04869:PF11496:PF03800,4,21,2,2,19,995,0.1,0.98,0.5,0.21,5,1,3,4,1010,0.2,0.99,0.25,0.22
PF17101,PF11380:PF17102:PF17103,5,9,5,0,4,1009,0.56,1.0,1.0,0.74,7,4,1,3,1010,0.57,1.0,0.8,0.67
PF05100,PF06805:PF08411:PF11751,0,1,0,0,1,1017,0.0,1.0,0,0,0,0,0,0,1018,0,1.0,0,0
PF02996,PF01956:PF13664:PF03657,28,23,8,20,15,975,0.35,0.97,0.29,0.3,5,3,25,2,988,0.6,0.97,0.11,0.25
PF09733,PF01594:PF10505:PF15189,5,15,2,3,13,1000,0.13,0.98,0.4,0.22,2,1,4,1,1012,0.5,1.0,0.2,0.31
PF10749,PF04917:PF11751:PF07409,0,1,0,0,1,1017,0.0,1.0,0,0,0,0,0,0,1018,0,1.0,0,0
PF11075,PF07305:PF11546:PF16338,0,1,0,0,1,1017,0.0,1.0,0,0,0,0,0,0,1018,0,1.0,0,0
PF01846,PF16512:PF09445:PF12237,20,16,9,11,7,991,0.56,0.98,0.45,0.49,2,2,18,0,998,1.0,0.98,0.1,0.31
PF04858,PF00463:PF01274:PF16062,3,18,2,1,16,999,0.11,0.98,0.67,0.27,4,0,3,4,1011,0.0,0.99,0.0,-0.0
PF17104,PF17062:PF03883:PF03275,0,3,0,0,3,1015,0.0,1.0,0,0,0,0,0,0,1018,0,1.0,0,0
PF15503,PF15062:PF06695:PF13270,1,3,0,1,3,1014,0.0,1.0,0.0,-0.0,0,0,1,0,1017,0,1.0,0.0,0
PF06058,PF15996:PF07217:PF08634,6,15,1,5,14,998,0.07,0.98,0.17,0.1,1,0,6,1,1011,0.0,0.99,0.0,-0.0
PF05831,PF12764:PF08699:PF07963,2,43,2,0,41,975,0.05,0.96,1.0,0.21,6,2,0,4,1012,0.33,1.0,1.0,0.58
PF07541,PF09371:PF08206:PF00575,6,35,6,0,29,983,0.17,0.97,1.0,0.41,2,1,5,1,1011,0.5,0.99,0.17,0.29
PF13349,PF06581:PF06541:PF06875,1,0,0,1,0,1017,0,1.0,0.0,0,0,0,1,0,1017,0,1.0,0.0,0
PF10590,PF10615:PF01243:PF03853,8,29,8,0,21,989,0.28,0.98,1.0,0.52,7,5,3,2,1008,0.71,1.0,0.62,0.67
PF00504,PF00810:PF00197:PF01625,18,30,7,11,23,977,0.23,0.97,0.39,0.29,4,1,17,3,997,0.25,0.98,0.06,0.11
PF06758,PF05911:PF00836:PF03470,3,12,0,3,12,1003,0.0,0.99,0.0,-0.01,1,0,3,1,1014,0.0,1.0,0.0,-0.0
PF06330,PF06581:PF12328:PF05824,2,6,0,2,6,1010,0.0,0.99,0.0,-0.0,0,0,2,0,1016,0,1.0,0.0,0
PF07030,PF09481:PF09343:PF02097,0,2,0,0,2,1016,0.0,1.0,0,0,0,0,0,0,1018,0,1.0,0,0
PF16899,PF02984:PF13825:PF08781,10,48,4,6,44,964,0.08,0.95,0.4,0.17,6,1,9,5,1003,0.17,0.99,0.1,0.12
PF04367,PF07939:PF00301:PF02576,2,4,1,1,3,1013,0.25,1.0,0.5,0.35,0,0,2,0,1016,0,1.0,0.0,0
PF15373,PF15748:PF16647:PF08026,0,1,0,0,1,1017,0.0,1.0,0,0,0,0,0,0,1018,0,1.0,0,0
PF01985,PF07766:PF04388:PF16471,9,22,5,4,17,992,0.23,0.98,0.56,0.35,3,3,6,0,1009,1.0,0.99,0.33,0.58
PF00722,PF15886:PF06955:PF14543,43,33,15,28,18,957,0.45,0.95,0.35,0.38,7,6,37,1,974,0.86,0.96,0.14,0.34
PF14531,PF15067:PF11669:PF05149,1,9,0,1,9,1008,0.0,0.99,0.0,-0.0,0,0,1,0,1017,0,1.0,0.0,0
PF00978,PF01443:PF08706:PF01660,5,11,5,0,6,1007,0.45,0.99,1.0,0.67,6,5,0,1,1012,0.83,1.0,1.0,0.91
PF00606,PF13721:PF04559:PF03793,4,6,2,2,4,1010,0.33,0.99,0.5,0.41,0,0,4,0,1014,0,1.0,0.0,0
PF05786,PF02055:PF01288:PF02152,3,29,2,1,27,988,0.07,0.97,0.67,0.21,8,1,2,7,1008,0.12,0.99,0.33,0.2
PF07661,PF04717:PF15529:PF05797,2,0,0,2,0,1016,0,1.0,0.0,0,0,0,2,0,1016,0,1.0,0.0,0
PF08150,PF16165:PF08165:PF08151,6,10,6,0,4,1008,0.6,1.0,1.0,0.77,5,4,2,1,1011,0.8,1.0,0.67,0.73
PF01248,PF07896:PF06093:PF04505,35,19,7,28,12,971,0.37,0.96,0.2,0.25,2,2,33,0,983,1.0,0.97,0.06,0.24
PF03420,PF14685:PF14526:PF04225,1,11,0,1,11,1006,0.0,0.99,0.0,-0.0,0,0,1,0,1017,0,1.0,0.0,0
PF08294,PF01126:PF10276:PF07939,10,13,4,6,9,999,0.31,0.99,0.4,0.34,0,0,10,0,1008,0,0.99,0.0,0
PF00446,PF00159:PF01279:PF02488,3,3,1,2,2,1013,0.33,1.0,0.33,0.33,1,1,2,0,1015,1.0,1.0,0.33,0.58
PF00330,PF00694:PF06434:PF11791,36,32,29,7,3,979,0.91,0.99,0.81,0.85,2,2,34,0,982,1.0,0.97,0.06,0.23
PF15014,PF08761:PF09057:PF15104,1,1,0,1,1,1016,0.0,1.0,0.0,-0.0,0,0,1,0,1017,0,1.0,0.0,0
PF15228,PF06592:PF09470:PF07149,2,1,0,2,1,1015,0.0,1.0,0.0,-0.0,0,0,2,0,1016,0,1.0,0.0,0
PF10523,PF03131:PF09494:PF02731,10,30,4,6,26,982,0.13,0.97,0.4,0.22,4,3,7,1,1007,0.75,0.99,0.3,0.47
PF13092,PF13225:PF15346:PF00468,7,9,2,5,7,1004,0.22,0.99,0.29,0.25,1,0,7,1,1010,0.0,0.99,0.0,-0.0
PF15701,PF10737:PF00720:PF02072,0,1,0,0,1,1017,0.0,1.0,0,0,0,0,0,0,1018,0,1.0,0,0
PF14033,PF07000:PF07065:PF07350,18,19,3,15,16,984,0.16,0.97,0.17,0.15,2,1,17,1,999,0.5,0.98,0.06,0.16
PF14050,PF04968:PF05002:PF16273,1,28,0,1,28,989,0.0,0.97,0.0,-0.01,5,0,1,5,1012,0.0,0.99,0.0,-0.0
PF02983,PF09272:PF15494:PF09396,2,13,1,1,12,1004,0.08,0.99,0.5,0.19,2,1,1,1,1015,0.5,1.0,0.5,0.5
PF03119,PF01653:PF03120:PF16893,3,10,3,0,7,1008,0.3,0.99,1.0,0.55,6,3,0,3,1012,0.5,1.0,1.0,0.71
PF07023,PF12416:PF02845:PF16286,0,34,0,0,34,984,0.0,0.97,0,0,1,0,0,1,1017,0.0,1.0,0,0
PF11708,PF09282:PF10234:PF02470,12,9,1,11,8,998,0.11,0.98,0.08,0.09,0,0,12,0,1006,0,0.99,0.0,0
PF00433,PF12179:PF03822:PF14593,34,6,4,30,2,982,0.67,0.97,0.12,0.27,2,2,32,0,984,1.0,0.97,0.06,0.24
PF00449,PF00699:PF00547:PF13382,7,9,7,0,2,1009,0.78,1.0,1.0,0.88,6,6,1,0,1011,1.0,1.0,0.86,0.93
PF01509,PF01472:PF16198:PF08068,19,20,11,8,9,990,0.55,0.98,0.58,0.56,6,6,13,0,999,1.0,0.99,0.32,0.56
PF00186,PF00303:PF12940:PF09261,9,29,4,5,25,984,0.14,0.97,0.44,0.24,2,1,8,1,1008,0.5,0.99,0.11,0.23
PF00367,PF10410:PF06773:PF14564,8,5,1,7,4,1006,0.2,0.99,0.12,0.15,0,0,8,0,1010,0,0.99,0.0,0
PF09951,PF08453:PF03241:PF07805,0,3,0,0,3,1015,0.0,1.0,0,0,0,0,0,0,1018,0,1.0,0,0
PF03165,PF00859:PF10524:PF03166,10,18,9,1,9,999,0.5,0.99,0.9,0.67,2,2,8,0,1008,1.0,0.99,0.2,0.45
PF08694,PF16843:PF13446:PF05162,3,9,1,2,8,1007,0.11,0.99,0.33,0.19,1,0,3,1,1014,0.0,1.0,0.0,-0.0
PF05640,PF16944:PF12887:PF10033,3,4,1,2,3,1012,0.25,1.0,0.33,0.29,0,0,3,0,1015,0,1.0,0.0,0
PF00272,PF01716:PF00321:PF04901,0,3,0,0,3,1015,0.0,1.0,0,0,0,0,0,0,1018,0,1.0,0,0
PF16912,PF13823:PF12242:PF02302,0,4,0,0,4,1014,0.0,1.0,0,0,0,0,0,0,1018,0,1.0,0,0
PF02084,PF02420:PF00323:PF11054,0,1,0,0,1,1017,0.0,1.0,0,0,0,0,0,0,1018,0,1.0,0,0
PF09326,PF00384:PF04879:PF01568,15,23,14,1,9,994,0.61,0.99,0.93,0.75,7,1,14,6,997,0.14,0.98,0.07,0.09
PF13293,PF04617:PF12413:PF10525,1,4,1,0,3,1014,0.25,1.0,1.0,0.5,1,1,0,0,1017,1.0,1.0,1.0,1.0
PF08067,PF16274:PF16544:PF16275,4,11,2,2,9,1005,0.18,0.99,0.5,0.3,3,1,3,2,1012,0.33,1.0,0.25,0.29
PF11895,PF00141:PF06721:PF03442,2,41,2,0,39,977,0.05,0.96,1.0,0.22,4,2,0,2,1014,0.5,1.0,1.0,0.71
PF12062,PF00685:PF16332:PF10559,8,45,7,1,38,972,0.16,0.96,0.88,0.36,5,2,6,3,1007,0.4,0.99,0.25,0.31
PF01131,PF01751:PF01396:PF13368,20,31,16,4,15,983,0.52,0.98,0.8,0.63,9,9,11,0,998,1.0,0.99,0.45,0.67
PF00970,PF00175:PF00174:PF03404,37,67,36,1,31,950,0.54,0.97,0.97,0.71,20,13,24,7,974,0.65,0.97,0.35,0.46
PF10346,PF14232:PF08657:PF10685,1,3,0,1,3,1014,0.0,1.0,0.0,-0.0,0,0,1,0,1017,0,1.0,0.0,0
PF03269,PF03710:PF06592:PF09510,0,4,0,0,4,1014,0.0,1.0,0,0,0,0,0,0,1018,0,1.0,0,0
PF08073,PF06465:PF06461:PF08074,12,12,11,1,1,1005,0.92,1.0,0.92,0.92,12,11,1,1,1005,0.92,1.0,0.92,0.92
PF04453,PF07499:PF04865:PF03944,0,4,0,0,4,1014,0.0,1.0,0,0,0,0,0,0,1018,0,1.0,0,0
PF01079,PF01085:PF04424:PF04870,13,27,10,3,17,988,0.37,0.98,0.77,0.53,10,5,8,5,1000,0.5,0.99,0.38,0.43
PF01661,PF13716:PF12174:PF00125,30,64,20,10,44,944,0.31,0.95,0.67,0.43,17,11,19,6,982,0.65,0.98,0.37,0.48
PF06617,PF09122:PF11127:PF12368,2,8,0,2,8,1008,0.0,0.99,0.0,-0.0,0,0,2,0,1016,0,1.0,0.0,0
PF17039,PF00852:PF05277:PF08100,16,38,15,1,23,979,0.39,0.98,0.94,0.6,8,8,8,0,1002,1.0,0.99,0.5,0.7
PF09471,PF03601:PF15460:PF09715,2,1,0,2,1,1015,0.0,1.0,0.0,-0.0,0,0,2,0,1016,0,1.0,0.0,0
PF13018,PF05658:PF05662:PF02951,0,5,0,0,5,1013,0.0,1.0,0,0,2,0,0,2,1016,0.0,1.0,0,0
PF06877,PF13813:PF09855:PF00293,0,82,0,0,82,936,0.0,0.92,0,0,11,0,0,11,1007,0.0,0.99,0,0
PF01923,PF16053:PF06516:PF12597,7,21,1,6,20,991,0.05,0.97,0.14,0.07,2,1,6,1,1010,0.5,0.99,0.14,0.26
PF04937,PF14372:PF02892:PF10683,20,39,13,7,26,972,0.33,0.97,0.65,0.45,13,8,12,5,993,0.62,0.98,0.4,0.49
PF09776,PF09837:PF04138:PF10044,1,1,0,1,1,1016,0.0,1.0,0.0,-0.0,0,0,1,0,1017,0,1.0,0.0,0
PF01867,PF12544:PF07799:PF02511,3,2,0,3,2,1013,0.0,1.0,0.0,-0.0,0,0,3,0,1015,0,1.0,0.0,0
PF12232,PF01586:PF15372:PF02344,3,7,3,0,4,1011,0.43,1.0,1.0,0.65,1,1,2,0,1015,1.0,1.0,0.33,0.58
PF09349,PF02394:PF00449:PF00699,8,9,2,6,7,1003,0.22,0.99,0.25,0.23,7,2,6,5,1005,0.29,0.99,0.25,0.26
PF01424,PF11952:PF13902:PF12752,37,20,13,24,7,974,0.65,0.97,0.35,0.46,4,4,33,0,981,1.0,0.97,0.11,0.32
PF12155,PF03237:PF01059:PF12139,0,1,0,0,1,1017,0.0,1.0,0,0,0,0,0,0,1018,0,1.0,0,0
PF08263,PF00560:PF12819:PF11721,52,65,39,13,26,940,0.6,0.96,0.75,0.65,13,12,40,1,965,0.92,0.96,0.23,0.45
PF06869,PF01666:PF15235:PF12443,0,1,0,0,1,1017,0.0,1.0,0,0,0,0,0,0,1018,0,1.0,0,0
PF07699,PF01404:PF02494:PF14575,20,23,12,8,11,987,0.52,0.98,0.6,0.55,5,4,16,1,997,0.8,0.98,0.2,0.4
PF06963,PF07063:PF07911:PF06090,13,18,5,8,13,992,0.28,0.98,0.38,0.32,2,1,12,1,1004,0.5,0.99,0.08,0.19
PF02076,PF08618:PF04934:PF07798,4,20,0,4,20,994,0.0,0.98,0.0,-0.01,2,0,4,2,1012,0.0,0.99,0.0,-0.0
PF00105,PF00104:PF11825:PF12743,46,45,40,6,5,967,0.89,0.99,0.87,0.87,7,7,39,0,972,1.0,0.96,0.15,0.38
PF04803,PF02576:PF06420:PF10330,3,3,0,3,3,1012,0.0,0.99,0.0,-0.0,0,0,3,0,1015,0,1.0,0.0,0
PF04340,PF15130:PF01254:PF15685,1,2,0,1,2,1015,0.0,1.0,0.0,-0.0,0,0,1,0,1017,0,1.0,0.0,0
PF15200,PF17076:PF02557:PF15192,0,2,0,0,2,1016,0.0,1.0,0,0,0,0,0,0,1018,0,1.0,0,0
PF10188,PF09816:PF10332:PF15929,0,6,0,0,6,1012,0.0,0.99,0,0,0,0,0,0,1018,0,1.0,0,0
PF12315,PF15936:PF06297:PF04814,8,15,3,5,12,998,0.2,0.98,0.38,0.27,2,2,6,0,1010,1.0,0.99,0.25,0.5
PF16286,PF11764:PF10691:PF07023,0,8,0,0,8,1010,0.0,0.99,0,0,0,0,0,0,1018,0,1.0,0,0
PF02915,PF13225:PF00468:PF04839,2,7,0,2,7,1009,0.0,0.99,0.0,-0.0,2,0,2,2,1014,0.0,1.0,0.0,-0.0
PF13320,PF16748:PF14613:PF15491,0,0,0,0,0,1018,0,1.0,0,0,0,0,0,0,1018,0,1.0,0,0
PF00128,PF02922:PF11852:PF02806,39,23,20,19,3,976,0.87,0.98,0.51,0.66,14,13,26,1,978,0.93,0.97,0.33,0.55
PF08080,PF15519:PF11627:PF12220,1,14,1,0,13,1004,0.07,0.99,1.0,0.27,2,1,0,1,1016,0.5,1.0,1.0,0.71
PF08772,PF15017:PF17146:PF01713,8,15,7,1,8,1002,0.47,0.99,0.88,0.64,4,4,4,0,1010,1.0,1.0,0.5,0.71
PF01154,PF08540:PF02797:PF04064,19,34,17,2,17,982,0.5,0.98,0.89,0.66,5,5,14,0,999,1.0,0.99,0.26,0.51
PF05418,PF15662:PF08497:PF12724,1,0,0,1,0,1017,0,1.0,0.0,0,0,0,1,0,1017,0,1.0,0.0,0
PF05298,PF15677:PF15707:PF09252,0,0,0,0,0,1018,0,1.0,0,0,0,0,0,0,1018,0,1.0,0,0
PF10411,PF12477:PF05109:PF04671,0,1,0,0,1,1017,0.0,1.0,0,0,0,0,0,0,1018,0,1.0,0,0
PF04233,PF06074:PF02554:PF01312,0,0,0,0,0,1018,0,1.0,0,0,0,0,0,0,1018,0,1.0,0,0
PF15050,PF05853:PF14877:PF15333,2,5,0,2,5,1011,0.0,0.99,0.0,-0.0,0,0,2,0,1016,0,1.0,0.0,0
PF03095,PF04729:PF07798:PF15251,11,15,3,8,12,995,0.2,0.98,0.27,0.22,2,1,10,1,1006,0.5,0.99,0.09,0.21
PF08654,PF15770:PF15380:PF15771,2,0,0,2,0,1016,0,1.0,0.0,0,0,0,2,0,1016,0,1.0,0.0,0
PF12194,PF08291:PF08744:PF15207,1,1,0,1,1,1016,0.0,1.0,0.0,-0.0,0,0,1,0,1017,0,1.0,0.0,0
PF15773,PF15744:PF05532:PF15849,1,1,0,1,1,1016,0.0,1.0,0.0,-0.0,0,0,1,0,1017,0,1.0,0.0,0
PF03920,PF08232:PF12931:PF07304,1,21,1,0,20,997,0.05,0.98,1.0,0.22,3,1,0,2,1015,0.33,1.0,1.0,0.58
PF00402,PF03271:PF15147:PF12510,15,14,7,8,7,996,0.5,0.99,0.47,0.48,1,1,14,0,1003,1.0,0.99,0.07,0.26
PF02174,PF08174:PF16018:PF08916,16,9,3,13,6,996,0.33,0.98,0.19,0.24,1,1,15,0,1002,1.0,0.99,0.06,0.25
PF08320,PF06293:PF02114:PF03134,14,36,8,6,28,976,0.22,0.97,0.57,0.34,7,5,9,2,1002,0.71,0.99,0.36,0.5
PF09309,PF16892:PF16893:PF12258,0,2,0,0,2,1016,0.0,1.0,0,0,2,0,0,2,1016,0.0,1.0,0,0
PF06819,PF05565:PF01967:PF01938,0,22,0,0,22,996,0.0,0.98,0,0,5,0,0,5,1013,0.0,1.0,0,0
PF05511,PF15158:PF07961:PF15715,7,0,0,7,0,1011,0,0.99,0.0,0,0,0,7,0,1011,0,0.99,0.0,0
PF02880,PF02879:PF00408:PF02878,37,41,37,0,4,977,0.9,1.0,1.0,0.95,37,36,1,1,980,0.97,1.0,0.97,0.97
PF06859,PF01207:PF15925:PF05439,4,39,2,2,37,977,0.05,0.96,0.5,0.15,2,2,2,0,1014,1.0,1.0,0.5,0.71
PF05965,PF05964:PF03353:PF11764,19,24,17,2,7,992,0.71,0.99,0.89,0.79,4,4,15,0,999,1.0,0.99,0.21,0.46
PF00286,PF11638:PF00895:PF08131,1,3,0,1,3,1014,0.0,1.0,0.0,-0.0,0,0,1,0,1017,0,1.0,0.0,0
PF06228,PF06956:PF08404:PF01292,0,8,0,0,8,1010,0.0,0.99,0,0,0,0,0,0,1018,0,1.0,0,0
PF05623,PF06404:PF00280:PF02590,5,15,2,3,13,1000,0.13,0.98,0.4,0.22,0,0,5,0,1013,0,1.0,0.0,0
PF11095,PF05014:PF04402:PF08674,6,9,1,5,8,1004,0.11,0.99,0.17,0.13,0,0,6,0,1012,0,0.99,0.0,0
PF04050,PF12152:PF02854:PF10573,6,35,6,0,29,983,0.17,0.97,1.0,0.41,3,2,4,1,1011,0.67,1.0,0.33,0.47
PF00525,PF10660:PF00011:PF14803,3,36,3,0,33,982,0.08,0.97,1.0,0.28,3,0,3,3,1012,0.0,0.99,0.0,-0.0
PF06212,PF03853:PF08229:PF01256,1,32,0,1,32,985,0.0,0.97,0.0,-0.01,8,0,1,8,1009,0.0,0.99,0.0,-0.0
PF01039,PF00289:PF02785:PF00364,34,49,20,14,29,955,0.41,0.96,0.59,0.47,33,18,16,15,969,0.55,0.97,0.53,0.52
PF02186,PF12049:PF06420:PF07223,14,2,0,14,2,1002,0.0,0.98,0.0,-0.01,0,0,14,0,1004,0,0.99,0.0,0
PF12374,PF08828:PF15791:PF03474,1,3,1,0,2,1015,0.33,1.0,1.0,0.58,1,1,0,0,1017,1.0,1.0,1.0,1.0
PF02456,PF03845:PF03930:PF05857,0,8,0,0,8,1010,0.0,0.99,0,0,0,0,0,0,1018,0,1.0,0,0
PF12254,PF08996:PF03104:PF00136,11,38,11,0,27,980,0.29,0.97,1.0,0.53,35,11,0,24,983,0.31,0.98,1.0,0.55
PF05778,PF05754:PF14885:PF01316,1,3,0,1,3,1014,0.0,1.0,0.0,-0.0,0,0,1,0,1017,0,1.0,0.0,0
PF01875,PF03842:PF14931:PF05296,8,3,1,7,2,1008,0.33,0.99,0.12,0.2,0,0,8,0,1010,0,0.99,0.0,0
PF16422,PF16423:PF09271:PF09270,4,14,3,1,11,1003,0.21,0.99,0.75,0.4,13,2,2,11,1003,0.15,0.99,0.5,0.27
PF01851,PF12859:PF06662:PF11882,13,11,2,11,9,996,0.18,0.98,0.15,0.16,1,1,12,0,1005,1.0,0.99,0.08,0.28
PF05029,PF12166:PF04821:PF04824,7,18,5,2,13,998,0.28,0.99,0.71,0.44,4,0,7,4,1007,0.0,0.99,0.0,-0.01
PF10421,PF01909:PF13427:PF13373,5,24,4,1,20,993,0.17,0.98,0.8,0.36,4,2,3,2,1011,0.5,1.0,0.4,0.44
PF03271,PF15147:PF12510:PF00402,14,15,7,7,8,996,0.47,0.99,0.5,0.48,1,1,13,0,1004,1.0,0.99,0.07,0.27
PF17002,PF17206:PF11697:PF08093,0,2,0,0,2,1016,0.0,1.0,0,0,0,0,0,0,1018,0,1.0,0,0
PF10198,PF10307:PF09463:PF10336,4,2,0,4,2,1012,0.0,0.99,0.0,-0.0,0,0,4,0,1014,0,1.0,0.0,0
PF06220,PF12237:PF09445:PF10453,33,17,8,25,9,976,0.47,0.97,0.24,0.32,4,2,31,2,983,0.5,0.97,0.06,0.17
PF01926,PF01018:PF09994:PF13167,71,24,16,55,8,939,0.67,0.94,0.23,0.36,6,6,65,0,947,1.0,0.94,0.08,0.28
PF13864,PF04004:PF07223:PF15342,6,16,3,3,13,999,0.19,0.98,0.5,0.3,0,0,6,0,1012,0,0.99,0.0,0
PF12419,PF10532:PF03108:PF04434,2,27,2,0,25,991,0.07,0.98,1.0,0.27,14,2,0,12,1004,0.14,0.99,1.0,0.38
PF15783,PF17053:PF10279:PF10873,1,0,0,1,0,1017,0,1.0,0.0,0,0,0,1,0,1017,0,1.0,0.0,0
PF02961,PF09307:PF10511:PF08831,3,4,1,2,3,1012,0.25,1.0,0.33,0.29,3,0,3,3,1012,0.0,0.99,0.0,-0.0
PF10422,PF15356:PF03739:PF14539,1,5,0,1,5,1012,0.0,0.99,0.0,-0.0,0,0,1,0,1017,0,1.0,0.0,0
PF13457,PF08461:PF06890:PF02305,1,1,0,1,1,1016,0.0,1.0,0.0,-0.0,0,0,1,0,1017,0,1.0,0.0,0
PF11987,PF08364:PF16658:PF14492,28,36,11,17,25,965,0.31,0.96,0.39,0.33,4,4,24,0,990,1.0,0.98,0.14,0.37
PF15097,PF15085:PF14866:PF15680,1,2,0,1,2,1015,0.0,1.0,0.0,-0.0,0,0,1,0,1017,0,1.0,0.0,0
PF04981,PF05334:PF10496:PF12309,5,22,3,2,19,994,0.14,0.98,0.6,0.28,1,1,4,0,1013,1.0,1.0,0.2,0.45
PF00659,PF08332:PF03822:PF16579,9,18,4,5,14,995,0.22,0.98,0.44,0.31,5,4,5,1,1008,0.8,0.99,0.44,0.59
PF12422,PF05041:PF14952:PF12231,2,12,0,2,12,1004,0.0,0.99,0.0,-0.0,1,0,2,1,1015,0.0,1.0,0.0,-0.0
PF14711,PF16325:PF13247:PF11751,0,1,0,0,1,1017,0.0,1.0,0,0,0,0,0,0,1018,0,1.0,0,0
PF09038,PF15997:PF14465:PF06513,0,2,0,0,2,1016,0.0,1.0,0,0,0,0,0,0,1018,0,1.0,0,0
PF00481,PF07830:PF02784:PF00278,73,29,20,53,9,936,0.69,0.94,0.27,0.41,16,10,63,6,939,0.62,0.93,0.14,0.27
PF12257,PF16646:PF09743:PF16474,10,14,4,6,10,998,0.29,0.98,0.4,0.33,1,0,10,1,1007,0.0,0.99,0.0,-0.0
PF02320,PF05915:PF03980:PF07114,13,6,1,12,5,1000,0.17,0.98,0.08,0.11,3,1,12,2,1003,0.33,0.99,0.08,0.16
PF09496,PF05837:PF02083:PF06211,4,5,0,4,5,1009,0.0,0.99,0.0,-0.0,0,0,4,0,1014,0,1.0,0.0,0
PF15914,PF05715:PF09322:PF15082,3,6,1,2,5,1010,0.17,0.99,0.33,0.23,0,0,3,0,1015,0,1.0,0.0,0
PF02024,PF00727:PF00489:PF16716,1,5,0,1,5,1012,0.0,0.99,0.0,-0.0,0,0,1,0,1017,0,1.0,0.0,0
PF16366,PF16368:PF16367:PF10267,12,18,11,1,7,999,0.61,0.99,0.92,0.74,5,5,7,0,1006,1.0,0.99,0.42,0.64
PF00114,PF01580:PF06070:PF10995,0,6,0,0,6,1012,0.0,0.99,0,0,0,0,0,0,1018,0,1.0,0,0
PF04000,PF08528:PF06886:PF04910,16,16,4,12,12,990,0.25,0.98,0.25,0.24,2,0,16,2,1000,0.0,0.98,0.0,-0.01
PF12446,PF15224:PF12658:PF08093,0,2,0,0,2,1016,0.0,1.0,0,0,0,0,0,0,1018,0,1.0,0,0
PF05086,PF05109:PF08887:PF02601,0,2,0,0,2,1016,0.0,1.0,0,0,0,0,0,0,1018,0,1.0,0,0
PF03705,PF08411:PF03241:PF11751,0,1,0,0,1,1017,0.0,1.0,0,0,0,0,0,0,1018,0,1.0,0,0
PF06046,PF08312:PF01980:PF03577,13,19,3,10,16,989,0.16,0.97,0.23,0.18,1,0,13,1,1004,0.0,0.99,0.0,-0.0
PF12737,PF12731:PF05722:PF07526,1,4,1,0,3,1014,0.25,1.0,1.0,0.5,1,1,0,0,1017,1.0,1.0,1.0,1.0
PF12851,PF15778:PF08729:PF12516,5,7,1,4,6,1007,0.14,0.99,0.2,0.16,0,0,5,0,1013,0,1.0,0.0,0
PF01051,PF06403:PF00669:PF15775,1,1,0,1,1,1016,0.0,1.0,0.0,-0.0,1,0,1,1,1016,0.0,1.0,0.0,-0.0
PF12283,PF05901:PF02217:PF11697,0,3,0,0,3,1015,0.0,1.0,0,0,0,0,0,0,1018,0,1.0,0,0
PF13627,PF09257:PF10079:PF01110,0,2,0,0,2,1016,0.0,1.0,0,0,0,0,0,0,1018,0,1.0,0,0
PF12081,PF08479:PF03241:PF05509,0,1,0,0,1,1017,0.0,1.0,0,0,0,0,0,0,1018,0,1.0,0,0
PF12721,PF09034:PF08917:PF06760,7,6,3,4,3,1008,0.5,0.99,0.43,0.46,2,2,5,0,1011,1.0,1.0,0.29,0.53
PF00485,PF01928:PF04859:PF03081,25,27,9,16,18,975,0.33,0.97,0.36,0.33,3,3,22,0,993,1.0,0.98,0.12,0.34
PF03447,PF00742:PF01958:PF10000,16,19,16,0,3,999,0.84,1.0,1.0,0.92,3,3,13,0,1002,1.0,0.99,0.19,0.43
PF12612,PF10350:PF14959:PF17034,13,15,4,9,11,994,0.27,0.98,0.31,0.28,3,2,11,1,1004,0.67,0.99,0.15,0.32
PF09313,PF13503:PF13334:PF10971,0,4,0,0,4,1014,0.0,1.0,0,0,0,0,0,0,1018,0,1.0,0,0
PF11336,PF09648:PF08681:PF03610,0,4,0,0,4,1014,0.0,1.0,0,0,0,0,0,0,1018,0,1.0,0,0
PF06697,PF00321:PF06206:PF07333,2,2,0,2,2,1014,0.0,1.0,0.0,-0.0,0,0,2,0,1016,0,1.0,0.0,0
PF01064,PF08515:PF12179:PF14593,18,10,8,10,2,998,0.8,0.99,0.44,0.59,2,2,16,0,1000,1.0,0.98,0.11,0.33
PF08950,PF17049:PF08026:PF01316,0,3,0,0,3,1015,0.0,1.0,0,0,0,0,0,0,1018,0,1.0,0,0
PF00895,PF15212:PF01292:PF05797,1,6,0,1,6,1011,0.0,0.99,0.0,-0.0,0,0,1,0,1017,0,1.0,0.0,0
PF03070,PF08543:PF02581:PF02152,13,27,10,3,17,988,0.37,0.98,0.77,0.53,7,4,9,3,1002,0.57,0.99,0.31,0.41
PF09967,PF11672:PF06586:PF09444,2,3,2,0,1,1015,0.67,1.0,1.0,0.82,1,1,1,0,1016,1.0,1.0,0.5,0.71
PF14310,PF01915:PF00933:PF08530,31,42,29,2,13,974,0.69,0.99,0.94,0.8,32,28,3,4,983,0.88,0.99,0.9,0.89
PF11204,PF02028:PF04749:PF02180,9,26,3,6,23,986,0.12,0.97,0.33,0.18,2,0,9,2,1007,0.0,0.99,0.0,-0.0
PF01956,PF02996:PF01912:PF00213,11,43,5,6,38,969,0.12,0.96,0.45,0.21,8,1,10,7,1000,0.12,0.98,0.09,0.1
PF09404,PF12904:PF05111:PF15467,10,1,0,10,1,1007,0.0,0.99,0.0,-0.0,0,0,10,0,1008,0,0.99,0.0,0
PF03695,PF12019:PF13588:PF03831,2,3,0,2,3,1013,0.0,1.0,0.0,-0.0,0,0,2,0,1016,0,1.0,0.0,0
PF15137,PF06890:PF13995:PF08411,1,1,0,1,1,1016,0.0,1.0,0.0,-0.0,0,0,1,0,1017,0,1.0,0.0,0
PF03590,PF15216:PF14985:PF02087,4,5,0,4,5,1009,0.0,0.99,0.0,-0.0,0,0,4,0,1014,0,1.0,0.0,0
PF07524,PF04139:PF11945:PF04189,19,24,7,12,17,982,0.29,0.97,0.37,0.31,4,2,17,2,997,0.5,0.98,0.11,0.22
PF10516,PF06428:PF15266:PF05132,3,21,2,1,19,996,0.1,0.98,0.67,0.25,2,1,2,1,1014,0.5,1.0,0.33,0.41
PF10269,PF14901:PF11968:PF06842,3,17,0,3,17,998,0.0,0.98,0.0,-0.01,1,0,3,1,1014,0.0,1.0,0.0,-0.0
PF02887,PF00224:PF02727:PF01179,26,55,26,0,29,963,0.47,0.97,1.0,0.68,20,10,16,10,982,0.5,0.97,0.38,0.43
PF05459,PF12240:PF15934:PF10490,0,5,0,0,5,1013,0.0,1.0,0,0,0,0,0,0,1018,0,1.0,0,0
PF02950,PF03379:PF11771:PF15333,1,1,0,1,1,1016,0.0,1.0,0.0,-0.0,0,0,1,0,1017,0,1.0,0.0,0
PF07260,PF07223:PF00473:PF12049,1,6,0,1,6,1011,0.0,0.99,0.0,-0.0,0,0,1,0,1017,0,1.0,0.0,0
PF00794,PF00792:PF00613:PF00454,23,64,21,2,43,952,0.33,0.96,0.91,0.53,32,21,2,11,984,0.66,0.99,0.91,0.77
PF12052,PF02208:PF08733:PF15737,6,7,2,4,5,1007,0.29,0.99,0.33,0.3,1,1,5,0,1012,1.0,1.0,0.17,0.41
PF04004,PF04090:PF07223:PF15045,11,3,1,10,2,1005,0.33,0.99,0.09,0.17,0,0,11,0,1007,0,0.99,0.0,0
PF16199,PF12345:PF06969:PF13186,8,13,3,5,10,1000,0.23,0.99,0.38,0.29,2,2,6,0,1010,1.0,0.99,0.25,0.5
PF02002,PF11521:PF08271:PF07741,11,20,7,4,13,994,0.35,0.98,0.64,0.46,3,2,9,1,1006,0.67,0.99,0.18,0.34
PF12015,PF15082:PF15407:PF09441,1,4,0,1,4,1013,0.0,1.0,0.0,-0.0,0,0,1,0,1017,0,1.0,0.0,0
PF08333,PF12009:PF14529:PF08284,9,63,4,5,59,950,0.06,0.94,0.44,0.15,10,4,5,6,1003,0.4,0.99,0.44,0.42
PF01419,PF12044:PF03018:PF14299,15,23,6,9,17,986,0.26,0.97,0.4,0.31,3,3,12,0,1003,1.0,0.99,0.2,0.44
PF03367,PF03074:PF06830:PF12735,8,6,1,7,5,1005,0.17,0.99,0.12,0.14,0,0,8,0,1010,0,0.99,0.0,0
PF16096,PF16097:PF12235:PF16098,2,7,2,0,5,1011,0.29,1.0,1.0,0.53,4,1,1,3,1013,0.25,1.0,0.5,0.35
PF00276,PF02733:PF13718:PF13725,25,23,5,20,18,975,0.22,0.96,0.2,0.19,12,3,22,9,984,0.25,0.97,0.12,0.16
PF02141,PF03456:PF12335:PF03455,36,33,31,5,2,980,0.94,0.99,0.86,0.9,14,14,22,0,982,1.0,0.98,0.39,0.62
PF01778,PF04874:PF02777:PF00081,16,29,7,9,22,980,0.24,0.97,0.44,0.31,22,2,14,20,982,0.09,0.97,0.12,0.09
PF00587,PF02686:PF03129:PF02403,48,59,42,6,17,953,0.71,0.98,0.88,0.78,13,12,36,1,969,0.92,0.96,0.25,0.47
PF11568,PF15085:PF15372:PF09232,2,3,1,1,2,1014,0.33,1.0,0.5,0.41,0,0,2,0,1016,0,1.0,0.0,0
PF00699,PF00449:PF00547:PF13382,7,9,7,0,2,1009,0.78,1.0,1.0,0.88,6,6,1,0,1011,1.0,1.0,0.86,0.93
PF11236,PF09684:PF13753:PF04671,0,2,0,0,2,1016,0.0,1.0,0,0,0,0,0,0,1018,0,1.0,0,0
PF04055,PF06463:PF01967:PF00919,61,23,23,38,0,957,1.0,0.96,0.38,0.6,10,10,51,0,957,1.0,0.95,0.16,0.39
PF12078,PF07735:PF00068:PF07114,6,22,3,3,19,993,0.14,0.98,0.5,0.25,2,0,6,2,1010,0.0,0.99,0.0,-0.0
PF00811,PF00965:PF12020:PF00143,9,7,0,9,7,1002,0.0,0.98,0.0,-0.01,0,0,9,0,1009,0,0.99,0.0,0
PF00353,PF08657:PF13204:PF00220,1,4,0,1,4,1013,0.0,1.0,0.0,-0.0,0,0,1,0,1017,0,1.0,0.0,0
PF10440,PF03353:PF05964:PF05965,4,23,2,2,21,993,0.09,0.98,0.5,0.2,17,2,2,15,999,0.12,0.98,0.5,0.24
PF03037,PF12840:PF11312:PF17192,0,1,0,0,1,1017,0.0,1.0,0,0,0,0,0,0,1018,0,1.0,0,0
PF07810,PF13890:PF14959:PF15627,11,7,3,8,4,1003,0.43,0.99,0.27,0.34,0,0,11,0,1007,0,0.99,0.0,0
PF06794,PF14048:PF01429:PF12232,0,31,0,0,31,987,0.0,0.97,0,0,2,0,0,2,1016,0.0,1.0,0,0
PF06469,PF14844:PF15787:PF02138,3,37,3,0,34,981,0.08,0.97,1.0,0.28,23,3,0,20,995,0.13,0.98,1.0,0.36
PF16074,PF13689:PF12098:PF16731,0,0,0,0,0,1018,0,1.0,0,0,0,0,0,0,1018,0,1.0,0,0
PF05212,PF02590:PF06090:PF14476,12,15,5,7,10,996,0.33,0.98,0.42,0.36,1,1,11,0,1006,1.0,0.99,0.08,0.29
PF08189,PF00451:PF09252:PF12201,0,1,0,0,1,1017,0.0,1.0,0,0,0,0,0,0,1018,0,1.0,0,0
PF12790,PF05836:PF10906:PF15340,0,4,0,0,4,1014,0.0,1.0,0,0,0,0,0,0,1018,0,1.0,0,0
PF12179,PF14593:PF11629:PF12063,3,10,2,1,8,1007,0.2,0.99,0.67,0.36,4,2,1,2,1013,0.5,1.0,0.67,0.58
PF09806,PF15352:PF01387:PF05436,5,1,0,5,1,1012,0.0,0.99,0.0,-0.0,0,0,5,0,1013,0,1.0,0.0,0
PF03826,PF00157:PF16878:PF12045,8,18,4,4,14,996,0.22,0.98,0.5,0.33,4,3,5,1,1009,0.75,0.99,0.38,0.53
PF15175,PF08945:PF15207:PF15776,0,3,0,0,3,1015,0.0,1.0,0,0,0,0,0,0,1018,0,1.0,0,0
PF04202,PF16469:PF02637:PF07837,0,18,0,0,18,1000,0.0,0.98,0,0,0,0,0,0,1018,0,1.0,0,0
PF02359,PF02933:PF05695:PF05362,11,33,8,3,25,982,0.24,0.97,0.73,0.41,5,4,7,1,1006,0.8,0.99,0.36,0.54
PF14716,PF10391:PF14792:PF14791,19,20,14,5,6,993,0.7,0.99,0.74,0.71,18,13,6,5,994,0.72,0.99,0.68,0.7
PF13892,PF09110:PF09111:PF08658,16,20,12,4,8,994,0.6,0.99,0.75,0.67,14,11,5,3,999,0.79,0.99,0.69,0.73
PF01097,PF16541:PF05039:PF15359,3,3,0,3,3,1012,0.0,0.99,0.0,-0.0,1,0,3,1,1014,0.0,1.0,0.0,-0.0
PF05234,PF03974:PF17015:PF03816,1,3,0,1,3,1014,0.0,1.0,0.0,-0.0,0,0,1,0,1017,0,1.0,0.0,0
PF00172,PF12013:PF03902:PF11951,139,81,62,77,19,860,0.77,0.91,0.45,0.54,12,12,127,0,879,1.0,0.88,0.09,0.27
PF03152,PF15090:PF04699:PF11547,17,9,3,14,6,995,0.33,0.98,0.18,0.23,1,1,16,0,1001,1.0,0.98,0.06,0.24
PF11595,PF15092:PF08041:PF08566,3,7,3,0,4,1011,0.43,1.0,1.0,0.65,3,3,0,0,1015,1.0,1.0,1.0,1.0
PF05209,PF07499:PF06864:PF04610,4,4,1,3,3,1011,0.25,0.99,0.25,0.25,1,1,3,0,1014,1.0,1.0,0.25,0.5
PF01858,PF11934:PF01857:PF08934,2,2,1,1,1,1015,0.5,1.0,0.5,0.5,1,1,1,0,1016,1.0,1.0,0.5,0.71
PF13362,PF02108:PF00524:PF09834,0,4,0,0,4,1014,0.0,1.0,0,0,0,0,0,0,1018,0,1.0,0,0
PF15277,PF09763:PF11707:PF16201,9,11,7,2,4,1005,0.64,0.99,0.78,0.7,2,0,9,2,1007,0.0,0.99,0.0,-0.0
PF02972,PF05754:PF14985:PF08843,0,2,0,0,2,1016,0.0,1.0,0,0,0,0,0,0,1018,0,1.0,0,0
PF16011,PF08708:PF01668:PF02554,2,2,0,2,2,1014,0.0,1.0,0.0,-0.0,0,0,2,0,1016,0,1.0,0.0,0
PF05761,PF15388:PF03096:PF04230,10,6,1,9,5,1003,0.17,0.99,0.1,0.12,1,0,10,1,1007,0.0,0.99,0.0,-0.0
PF11567,PF03934:PF14849:PF05134,0,4,0,0,4,1014,0.0,1.0,0,0,1,0,0,1,1017,0.0,1.0,0,0
PF14075,PF14383:PF15778:PF08729,3,9,2,1,7,1008,0.22,0.99,0.67,0.38,1,0,3,1,1014,0.0,1.0,0.0,-0.0
PF08459,PF04313:PF11408:PF16202,12,8,4,8,4,1002,0.5,0.99,0.33,0.4,4,3,9,1,1005,0.75,0.99,0.25,0.43
PF00408,PF02878:PF02880:PF02879,28,40,27,1,13,977,0.68,0.99,0.96,0.8,37,26,2,11,979,0.7,0.99,0.93,0.8
PF02590,PF10693:PF02575:PF16974,3,6,1,2,5,1010,0.17,0.99,0.33,0.23,0,0,3,0,1015,0,1.0,0.0,0
PF00729,PF03729:PF01913:PF07310,1,2,0,1,2,1015,0.0,1.0,0.0,-0.0,0,0,1,0,1017,0,1.0,0.0,0
PF04724,PF07816:PF07896:PF01871,6,8,4,2,4,1008,0.5,0.99,0.67,0.57,1,0,6,1,1011,0.0,0.99,0.0,-0.0
PF13387,PF03726:PF08083:PF08084,0,20,0,0,20,998,0.0,0.98,0,0,13,0,0,13,1005,0.0,0.99,0,0
PF01680,PF11779:PF06376:PF02284,7,12,1,6,11,1000,0.08,0.98,0.14,0.1,1,0,7,1,1010,0.0,0.99,0.0,-0.0
PF02036,PF01575:PF15011:PF15975,20,39,11,9,28,970,0.28,0.96,0.55,0.38,4,2,18,2,996,0.5,0.98,0.1,0.22
PF16647,PF05355:PF15119:PF17050,1,4,0,1,4,1013,0.0,1.0,0.0,-0.0,1,0,1,1,1016,0.0,1.0,0.0,-0.0
PF01160,PF15346:PF13092:PF15344,1,8,0,1,8,1009,0.0,0.99,0.0,-0.0,2,0,1,2,1015,0.0,1.0,0.0,-0.0
PF02289,PF09551:PF06816:PF03496,1,6,0,1,6,1011,0.0,0.99,0.0,-0.0,2,0,1,2,1015,0.0,1.0,0.0,-0.0
PF12174,PF00644:PF02825:PF05406,7,60,5,2,55,956,0.08,0.94,0.71,0.23,26,4,3,22,989,0.15,0.98,0.57,0.29
PF01928,PF00485:PF04437:PF11571,3,37,3,0,34,981,0.08,0.97,1.0,0.28,8,0,3,8,1007,0.0,0.99,0.0,-0.0
PF11403,PF08546:PF01996:PF10409,2,40,1,1,39,977,0.03,0.96,0.5,0.11,6,0,2,6,1010,0.0,0.99,0.0,-0.0
PF15161,PF14996:PF15938:PF16112,2,1,1,1,0,1016,1.0,1.0,0.5,0.71,1,1,1,0,1016,1.0,1.0,0.5,0.71
PF14420,PF15898:PF17109:PF07693,14,14,6,8,8,996,0.43,0.98,0.43,0.42,1,1,13,0,1004,1.0,0.99,0.07,0.27
PF09051,PF09049:PF09050:PF07014,0,0,0,0,0,1018,0,1.0,0,0,0,0,0,0,1018,0,1.0,0,0
PF10631,PF04363:PF02561:PF15153,0,2,0,0,2,1016,0.0,1.0,0,0,0,0,0,0,1018,0,1.0,0,0
PF04816,PF16824:PF09677:PF00516,1,0,0,1,0,1017,0,1.0,0.0,0,0,0,1,0,1017,0,1.0,0.0,0
PF07273,PF08783:PF04062:PF13696,0,17,0,0,17,1001,0.0,0.98,0,0,8,0,0,8,1010,0.0,0.99,0,0
PF07419,PF02399:PF14588:PF13657,1,7,1,0,6,1011,0.14,0.99,1.0,0.38,1,1,0,0,1017,1.0,1.0,1.0,1.0
PF08551,PF14279:PF08598:PF15346,5,7,2,3,5,1008,0.29,0.99,0.4,0.33,1,1,4,0,1013,1.0,1.0,0.2,0.45
PF13329,PF16910:PF12624:PF16908,10,29,8,2,21,987,0.28,0.98,0.8,0.46,18,3,7,15,993,0.17,0.98,0.3,0.21
PF03311,PF05051:PF02114:PF00274,14,23,5,9,18,986,0.22,0.97,0.36,0.27,3,2,12,1,1003,0.67,0.99,0.14,0.3
PF00547,PF00699:PF00449:PF13382,6,9,6,0,3,1009,0.67,1.0,1.0,0.82,7,6,0,1,1011,0.86,1.0,1.0,0.93
PF02547,PF03401:PF13333:PF07520,8,1,0,8,1,1009,0.0,0.99,0.0,-0.0,0,0,8,0,1010,0,0.99,0.0,0
PF11410,PF08668:PF08310:PF17092,1,7,0,1,7,1010,0.0,0.99,0.0,-0.0,0,0,1,0,1017,0,1.0,0.0,0
PF08220,PF03829:PF00455:PF03608,5,3,3,2,0,1013,1.0,1.0,0.6,0.77,2,2,3,0,1013,1.0,1.0,0.4,0.63
PF06992,PF08890:PF16330:PF16122,0,15,0,0,15,1003,0.0,0.99,0,0,1,0,0,1,1017,0.0,1.0,0,0
PF16033,PF10204:PF06809:PF07248,4,9,3,1,6,1008,0.33,0.99,0.75,0.5,0,0,4,0,1014,0,1.0,0.0,0
PF03173,PF03174:PF02838:PF14220,2,10,2,0,8,1008,0.2,0.99,1.0,0.45,4,2,0,2,1014,0.5,1.0,1.0,0.71
PF07248,PF10340:PF06581:PF14645,0,2,0,0,2,1016,0.0,1.0,0,0,0,0,0,0,1018,0,1.0,0,0
PF16355,PF16353:PF02929:PF02837,7,16,4,3,12,999,0.25,0.99,0.57,0.37,5,1,6,4,1007,0.2,0.99,0.14,0.16
PF07439,PF08210:PF04557:PF00749,1,40,0,1,40,977,0.0,0.96,0.0,-0.01,14,0,1,14,1003,0.0,0.99,0.0,-0.0
PF06429,PF03963:PF02107:PF07559,2,2,2,0,0,1016,1.0,1.0,1.0,1.0,1,1,1,0,1016,1.0,1.0,0.5,0.71
PF05874,PF03601:PF15553:PF03544,1,4,0,1,4,1013,0.0,1.0,0.0,-0.0,0,0,1,0,1017,0,1.0,0.0,0
PF03184,PF03221:PF04218:PF05225,59,64,42,17,22,937,0.66,0.96,0.71,0.66,27,23,36,4,955,0.85,0.96,0.39,0.56
PF08278,PF13612:PF03065:PF04472,4,4,1,3,3,1011,0.25,0.99,0.25,0.25,0,0,4,0,1014,0,1.0,0.0,0
PF01812,PF04098:PF03467:PF16131,13,30,4,9,26,979,0.13,0.97,0.31,0.19,5,2,11,3,1002,0.4,0.99,0.15,0.24
PF03444,PF01580:PF10109:PF06798,1,5,1,0,4,1013,0.2,1.0,1.0,0.45,0,0,1,0,1017,0,1.0,0.0,0
PF11202,PF04671:PF10411:PF07411,0,1,0,0,1,1017,0.0,1.0,0,0,0,0,0,0,1018,0,1.0,0,0
PF09463,PF10446:PF10198:PF10336,0,6,0,0,6,1012,0.0,0.99,0,0,0,0,0,0,1018,0,1.0,0,0
PF09049,PF09051:PF09050:PF15690,0,0,0,0,0,1018,0,1.0,0,0,0,0,0,0,1018,0,1.0,0,0
PF10124,PF03264:PF09722:PF08093,0,1,0,0,1,1017,0.0,1.0,0,0,0,0,0,0,1018,0,1.0,0,0
PF07503,PF00267:PF12425:PF08093,1,2,0,1,2,1015,0.0,1.0,0.0,-0.0,0,0,1,0,1017,0,1.0,0.0,0
PF14918,PF14920:PF14919:PF14654,0,0,0,0,0,1018,0,1.0,0,0,0,0,0,0,1018,0,1.0,0,0
PF16700,PF15808:PF15898:PF09310,2,5,0,2,5,1011,0.0,0.99,0.0,-0.0,0,0,2,0,1016,0,1.0,0.0,0
PF10971,PF12147:PF14671:PF09192,1,6,1,0,5,1012,0.17,1.0,1.0,0.41,1,1,0,0,1017,1.0,1.0,1.0,1.0
PF17006,PF01913:PF01580:PF06070,0,7,0,0,7,1011,0.0,0.99,0,0,0,0,0,0,1018,0,1.0,0,0
PF00881,PF00902:PF13237:PF01470,14,24,4,10,20,984,0.17,0.97,0.29,0.2,4,3,11,1,1003,0.75,0.99,0.21,0.4
PF10712,PF06723:PF10268:PF00012,6,73,6,0,67,945,0.08,0.93,1.0,0.28,5,3,3,2,1010,0.6,1.0,0.5,0.55
PF08142,PF04950:PF04065:PF10189,14,28,14,0,14,990,0.5,0.99,1.0,0.7,5,4,10,1,1003,0.8,0.99,0.29,0.47
PF15115,PF14986:PF15332:PF15055,0,1,0,0,1,1017,0.0,1.0,0,0,0,0,0,0,1018,0,1.0,0,0
PF17077,PF03743:PF14690:PF16824,1,7,0,1,7,1010,0.0,0.99,0.0,-0.0,0,0,1,0,1017,0,1.0,0.0,0
PF11779,PF08561:PF04716:PF01680,6,22,3,3,19,993,0.14,0.98,0.5,0.25,2,1,5,1,1011,0.5,0.99,0.17,0.29
PF15694,PF15693:PF07500:PF06881,0,18,0,0,18,1000,0.0,0.98,0,0,2,0,0,2,1016,0.0,1.0,0,0
PF13356,PF09003:PF14659:PF14657,3,2,1,2,1,1014,0.5,1.0,0.33,0.41,2,1,2,1,1014,0.5,1.0,0.33,0.41
PF12425,PF08093:PF15482:PF05939,0,1,0,0,1,1017,0.0,1.0,0,0,0,0,0,0,1018,0,1.0,0,0
PF01924,PF02119:PF01303:PF00267,2,3,0,2,3,1013,0.0,1.0,0.0,-0.0,0,0,2,0,1016,0,1.0,0.0,0
PF07828,PF16829:PF16576:PF00799,1,3,0,1,3,1014,0.0,1.0,0.0,-0.0,0,0,1,0,1017,0,1.0,0.0,0
PF01909,PF03828:PF10421:PF13427,22,28,18,4,10,986,0.64,0.99,0.82,0.72,3,3,19,0,996,1.0,0.98,0.14,0.37
PF01507,PF00994:PF03453:PF03454,19,40,8,11,32,967,0.2,0.96,0.42,0.27,22,5,14,17,982,0.23,0.97,0.26,0.23
PF16676,PF16675:PF09354:PF08430,5,6,3,2,3,1010,0.5,1.0,0.6,0.55,4,2,3,2,1011,0.5,1.0,0.4,0.44
PF15106,PF15085:PF14866:PF15478,2,3,0,2,3,1013,0.0,1.0,0.0,-0.0,0,0,2,0,1016,0,1.0,0.0,0
PF07648,PF00050:PF01469:PF03146,25,22,12,13,10,983,0.55,0.98,0.48,0.5,2,2,23,0,993,1.0,0.98,0.08,0.28
PF10515,PF02177:PF03494:PF12925,8,10,8,0,2,1008,0.8,1.0,1.0,0.89,8,8,0,0,1010,1.0,1.0,1.0,1.0
PF00313,PF14437:PF12752:PF02337,38,22,10,28,12,968,0.45,0.96,0.26,0.33,1,1,37,0,980,1.0,0.96,0.03,0.16
PF04109,PF15279:PF14909:PF05624,10,5,1,9,4,1004,0.2,0.99,0.1,0.14,0,0,10,0,1008,0,0.99,0.0,0
PF16192,PF02366:PF02815:PF15012,14,26,14,0,12,992,0.54,0.99,1.0,0.73,13,13,1,0,1004,1.0,1.0,0.93,0.96
PF00460,PF06429:PF02107:PF03963,2,2,1,1,1,1015,0.5,1.0,0.5,0.5,2,1,1,1,1015,0.5,1.0,0.5,0.5
PF04576,PF15275:PF16043:PF08634,12,8,1,11,7,999,0.12,0.98,0.08,0.09,0,0,12,0,1006,0,0.99,0.0,0
PF00610,PF00618:PF04784:PF12257,38,54,20,18,34,946,0.37,0.95,0.53,0.42,11,7,31,4,976,0.64,0.97,0.18,0.33
PF16423,PF16422:PF09270:PF09271,3,15,3,0,12,1003,0.2,0.99,1.0,0.44,13,2,1,11,1004,0.15,0.99,0.67,0.32
PF04069,PF12911:PF15319:PF04285,7,4,2,5,2,1009,0.5,0.99,0.29,0.37,0,0,7,0,1011,0,0.99,0.0,0
PF03733,PF01699:PF16494:PF14312,4,42,3,1,39,975,0.07,0.96,0.75,0.22,2,0,4,2,1012,0.0,0.99,0.0,-0.0
PF00582,PF12202:PF13281:PF03822,31,17,10,21,7,980,0.59,0.97,0.32,0.42,3,3,28,0,987,1.0,0.97,0.1,0.31
PF00793,PF08584:PF02284:PF01774,12,16,1,11,15,991,0.06,0.97,0.08,0.06,1,0,12,1,1005,0.0,0.99,0.0,-0.0
PF07889,PF13225:PF11833:PF07816,12,7,3,9,4,1002,0.43,0.99,0.25,0.32,0,0,12,0,1006,0,0.99,0.0,0
PF10179,PF06414:PF05334:PF12576,3,14,0,3,14,1001,0.0,0.98,0.0,-0.01,0,0,3,0,1015,0,1.0,0.0,0
PF14510,PF06422:PF08370:PF00037,16,29,15,1,14,988,0.52,0.99,0.94,0.69,6,4,12,2,1000,0.67,0.99,0.25,0.4
PF07426,PF10173:PF13097:PF01730,7,11,1,6,10,1001,0.09,0.98,0.14,0.11,0,0,7,0,1011,0,0.99,0.0,0
PF13888,PF13887:PF13884:PF05224,6,18,6,0,12,1000,0.33,0.99,1.0,0.57,6,6,0,0,1012,1.0,1.0,1.0,1.0
PF09412,PF00889:PF01033:PF00045,12,40,10,2,30,976,0.25,0.97,0.83,0.45,10,6,6,4,1002,0.6,0.99,0.5,0.54
PF08105,PF14200:PF09458:PF03318,0,16,0,0,16,1002,0.0,0.98,0,0,2,0,0,2,1016,0.0,1.0,0,0
PF03285,PF14802:PF15301:PF09496,0,7,0,0,7,1011,0.0,0.99,0,0,1,0,0,1,1017,0.0,1.0,0,0
PF13895,PF00047:PF08205:PF03921,27,51,25,2,26,965,0.49,0.97,0.93,0.66,16,11,16,5,986,0.69,0.98,0.41,0.52
PF08633,PF14534:PF02972:PF15770,4,0,0,4,0,1014,0,1.0,0.0,0,0,0,4,0,1014,0,1.0,0.0,0
PF01159,PF03868:PF01733:PF01281,19,32,11,8,21,978,0.34,0.97,0.58,0.43,9,7,12,2,997,0.78,0.99,0.37,0.53
PF00751,PF08828:PF03474:PF15791,6,3,3,3,0,1012,1.0,1.0,0.5,0.71,1,1,5,0,1012,1.0,1.0,0.17,0.41
PF08771,PF11865:PF02260:PF02192,10,33,10,0,23,985,0.3,0.98,1.0,0.54,9,8,2,1,1007,0.89,1.0,0.8,0.84
PF09740,PF15292:PF13320:PF08579,1,1,0,1,1,1016,0.0,1.0,0.0,-0.0,0,0,1,0,1017,0,1.0,0.0,0
PF11357,PF02186:PF06420:PF10173,10,18,3,7,15,993,0.17,0.98,0.3,0.21,2,0,10,2,1006,0.0,0.99,0.0,-0.0
PF10183,PF09769:PF03980:PF01097,9,9,0,9,9,1000,0.0,0.98,0.0,-0.01,1,0,9,1,1008,0.0,0.99,0.0,-0.0
PF00727,PF02024:PF06351:PF15071,4,3,0,4,3,1011,0.0,0.99,0.0,-0.0,0,0,4,0,1014,0,1.0,0.0,0
PF08686,PF15913:PF16470:PF06583,11,15,4,7,11,996,0.27,0.98,0.36,0.3,7,4,7,3,1004,0.57,0.99,0.36,0.45
PF08629,PF08778:PF11413:PF13188,1,11,0,1,11,1006,0.0,0.99,0.0,-0.0,2,0,1,2,1015,0.0,1.0,0.0,-0.0
PF08461,PF08411:PF06890:PF04612,0,2,0,0,2,1016,0.0,1.0,0,0,0,0,0,0,1018,0,1.0,0,0
PF10229,PF15008:PF15260:PF15065,11,9,2,9,7,1000,0.22,0.98,0.18,0.19,1,1,10,0,1007,1.0,0.99,0.09,0.3
PF11713,PF14113:PF04196:PF03534,1,1,0,1,1,1016,0.0,1.0,0.0,-0.0,0,0,1,0,1017,0,1.0,0.0,0
PF12158,PF01316:PF15107:PF03379,0,3,0,0,3,1015,0.0,1.0,0,0,0,0,0,0,1018,0,1.0,0,0
PF03164,PF01068:PF04675:PF10345,18,19,8,10,11,989,0.42,0.98,0.44,0.42,19,8,10,11,989,0.42,0.98,0.44,0.42
PF06521,PF11264:PF15071:PF06351,1,3,0,1,3,1014,0.0,1.0,0.0,-0.0,0,0,1,0,1017,0,1.0,0.0,0
PF12084,PF10225:PF09747:PF13136,0,20,0,0,20,998,0.0,0.98,0,0,3,0,0,3,1015,0.0,1.0,0,0
PF02044,PF01279:PF15063:PF04852,0,7,0,0,7,1011,0.0,0.99,0,0,0,0,0,0,1018,0,1.0,0,0
PF04483,PF13225:PF04839:PF15503,1,5,0,1,5,1012,0.0,0.99,0.0,-0.0,0,0,1,0,1017,0,1.0,0.0,0
PF09288,PF10520:PF07933:PF05529,0,22,0,0,22,996,0.0,0.98,0,0,4,0,0,4,1014,0.0,1.0,0,0
PF08576,PF12046:PF02427:PF17032,3,0,0,3,0,1015,0,1.0,0.0,0,0,0,3,0,1015,0,1.0,0.0,0
PF03542,PF11864:PF02145:PF11881,5,14,5,0,9,1004,0.36,0.99,1.0,0.59,5,5,0,0,1013,1.0,1.0,1.0,1.0
PF04519,PF02554:PF06798:PF09867,2,0,0,2,0,1016,0,1.0,0.0,0,0,0,2,0,1016,0,1.0,0.0,0
PF00436,PF04667:PF07816:PF09597,22,6,0,22,6,990,0.0,0.97,0.0,-0.01,0,0,22,0,996,0,0.98,0.0,0
PF10197,PF16944:PF00649:PF05508,21,11,1,20,10,987,0.09,0.97,0.05,0.05,0,0,21,0,997,0,0.98,0.0,0
PF17184,PF04179:PF08369:PF09363,4,5,3,1,2,1012,0.6,1.0,0.75,0.67,1,1,3,0,1014,1.0,1.0,0.25,0.5
PF11585,PF08189:PF13737:PF09669,0,1,0,0,1,1017,0.0,1.0,0,0,0,0,0,0,1018,0,1.0,0,0
PF14603,PF15442:PF15257:PF15670,5,4,1,4,3,1010,0.25,0.99,0.2,0.22,1,1,4,0,1013,1.0,1.0,0.2,0.45
PF03870,PF03331:PF10166:PF02175,7,4,0,7,4,1007,0.0,0.99,0.0,-0.01,0,0,7,0,1011,0,0.99,0.0,0
PF14444,PF08729:PF14443:PF12509,3,11,1,2,10,1005,0.09,0.99,0.33,0.17,1,1,2,0,1015,1.0,1.0,0.33,0.58
PF15769,PF09108:PF03553:PF04625,0,2,0,0,2,1016,0.0,1.0,0,0,0,0,0,0,1018,0,1.0,0,0
PF15515,PF15400:PF01076:PF05065,0,2,0,0,2,1016,0.0,1.0,0,0,0,0,0,0,1018,0,1.0,0,0
PF14769,PF00212:PF09282:PF10217,3,4,0,3,4,1011,0.0,0.99,0.0,-0.0,0,0,3,0,1015,0,1.0,0.0,0
PF01936,PF14418:PF17182:PF11608,11,4,3,8,1,1006,0.75,0.99,0.27,0.45,0,0,11,0,1007,0,0.99,0.0,0
PF08029,PF01634:PF00799:PF05432,6,10,6,0,4,1008,0.6,1.0,1.0,0.77,0,0,6,0,1012,0,0.99,0.0,0
PF08468,PF11697:PF02465:PF02530,2,1,0,2,1,1015,0.0,1.0,0.0,-0.0,0,0,2,0,1016,0,1.0,0.0,0
PF01380,PF01418:PF00571:PF08603,14,62,7,7,55,949,0.11,0.94,0.5,0.22,9,4,10,5,999,0.44,0.99,0.29,0.35
PF03790,PF03791:PF12737:PF07526,1,6,1,0,5,1012,0.17,1.0,1.0,0.41,1,1,0,0,1017,1.0,1.0,1.0,1.0
PF12530,PF11229:PF10487:PF08158,2,14,2,0,12,1004,0.14,0.99,1.0,0.38,2,0,2,2,1014,0.0,1.0,0.0,-0.0
PF00093,PF07452:PF00007:PF12947,24,30,13,11,17,977,0.43,0.97,0.54,0.47,4,4,20,0,994,1.0,0.98,0.17,0.4
PF05633,PF16803:PF17187:PF01439,6,12,3,3,9,1003,0.25,0.99,0.5,0.35,1,1,5,0,1012,1.0,1.0,0.17,0.41
PF11594,PF10173:PF10248:PF12926,4,7,0,4,7,1007,0.0,0.99,0.0,-0.01,1,0,4,1,1013,0.0,1.0,0.0,-0.0
PF07464,PF09057:PF15825:PF00451,1,1,0,1,1,1016,0.0,1.0,0.0,-0.0,0,0,1,0,1017,0,1.0,0.0,0
PF03137,PF06342:PF14798:PF05197,12,6,2,10,4,1002,0.33,0.99,0.17,0.23,2,1,11,1,1005,0.5,0.99,0.08,0.2
PF02413,PF06798:PF07157:PF06890,0,0,0,0,0,1018,0,1.0,0,0,0,0,0,0,1018,0,1.0,0,0
PF08530,PF02129:PF02065:PF16874,17,22,17,0,5,996,0.77,1.0,1.0,0.88,4,3,14,1,1000,0.75,0.99,0.18,0.36
PF01103,PF07244:PF08318:PF02225,23,56,13,10,43,952,0.23,0.95,0.57,0.34,10,6,17,4,991,0.6,0.98,0.26,0.39
PF03146,PF00050:PF07648:PF01469,2,35,2,0,33,983,0.06,0.97,1.0,0.24,12,2,0,10,1006,0.17,0.99,1.0,0.41
PF11791,PF06434:PF00694:PF11870,2,32,2,0,30,986,0.06,0.97,1.0,0.25,1,1,1,0,1016,1.0,1.0,0.5,0.71
PF02913,PF09265:PF04030:PF02873,29,34,8,21,26,963,0.24,0.95,0.28,0.23,5,4,25,1,988,0.8,0.97,0.14,0.33
PF00884,PF12548:PF01663:PF16347,46,42,19,27,23,949,0.45,0.95,0.41,0.41,6,6,40,0,972,1.0,0.96,0.13,0.35
PF01602,PF06375:PF14797:PF09066,41,9,6,35,3,974,0.67,0.96,0.15,0.3,2,2,39,0,977,1.0,0.96,0.05,0.22
PF01161,PF15430:PF13664:PF15860,28,17,6,22,11,979,0.35,0.97,0.21,0.26,3,2,26,1,989,0.67,0.97,0.07,0.21
PF00017,PF00779:PF00130:PF00387,74,71,34,40,37,907,0.48,0.92,0.46,0.43,11,9,65,2,942,0.82,0.93,0.12,0.3
PF04161,PF06172:PF05995:PF00210,13,19,7,6,12,993,0.37,0.98,0.54,0.44,4,3,10,1,1004,0.75,0.99,0.23,0.41
PF09067,PF12772:PF06328:PF16066,2,4,1,1,3,1013,0.25,1.0,0.5,0.35,1,1,1,0,1016,1.0,1.0,0.5,0.71
PF03993,PF00073:PF02868:PF00548,2,13,0,2,13,1003,0.0,0.99,0.0,-0.01,12,0,2,12,1004,0.0,0.99,0.0,-0.0
PF15873,PF05135:PF15856:PF17022,1,1,0,1,1,1016,0.0,1.0,0.0,-0.0,0,0,1,0,1017,0,1.0,0.0,0
PF00840,PF02013:PF02156:PF03664,16,13,3,13,10,992,0.23,0.98,0.19,0.2,4,2,14,2,1000,0.5,0.98,0.12,0.24
PF00758,PF15129:PF06373:PF08194,3,1,1,2,0,1015,1.0,1.0,0.33,0.58,0,0,3,0,1015,0,1.0,0.0,0
PF15230,PF15888:PF04988:PF09596,0,6,0,0,6,1012,0.0,0.99,0,0,0,0,0,0,1018,0,1.0,0,0
PF01267,PF16720:PF03437:PF03784,9,3,2,7,1,1008,0.67,0.99,0.22,0.38,0,0,9,0,1009,0,0.99,0.0,0
PF14533,PF12436:PF13446:PF16674,7,12,7,0,5,1006,0.58,1.0,1.0,0.76,2,1,6,1,1010,0.5,0.99,0.14,0.26
PF01824,PF01329:PF04520:PF00499,3,18,0,3,18,997,0.0,0.98,0.0,-0.01,0,0,3,0,1015,0,1.0,0.0,0
PF02466,PF01192:PF01907:PF01157,29,23,10,19,13,976,0.43,0.97,0.34,0.37,4,3,26,1,988,0.75,0.97,0.1,0.27
PF14613,PF13320:PF15491:PF08579,0,1,0,0,1,1017,0.0,1.0,0,0,0,0,0,0,1018,0,1.0,0,0
PF04847,PF14935:PF06658:PF12020,7,5,1,6,4,1007,0.2,0.99,0.14,0.16,0,0,7,0,1011,0,0.99,0.0,0
PF12361,PF11556:PF12377:PF15445,1,1,1,0,0,1017,1.0,1.0,1.0,1.0,1,1,0,0,1017,1.0,1.0,1.0,1.0
PF15854,PF12571:PF06670:PF05025,1,6,0,1,6,1011,0.0,0.99,0.0,-0.0,0,0,1,0,1017,0,1.0,0.0,0
PF16063,PF15391:PF01666:PF04988,1,5,1,0,4,1013,0.2,1.0,1.0,0.45,1,1,0,0,1017,1.0,1.0,1.0,1.0
PF01970,PF14690:PF15662:PF08497,0,0,0,0,0,1018,0,1.0,0,0,0,0,0,0,1018,0,1.0,0,0
PF07534,PF12068:PF00566:PF15733,18,84,11,7,73,927,0.13,0.92,0.61,0.26,9,1,17,8,992,0.11,0.98,0.06,0.07
PF11975,PF02056:PF08886:PF15272,8,8,8,0,0,1010,1.0,1.0,1.0,1.0,0,0,8,0,1010,0,0.99,0.0,0
PF14967,PF15467:PF15069:PF15060,2,0,0,2,0,1016,0,1.0,0.0,0,0,0,2,0,1016,0,1.0,0.0,0
PF04819,PF01896:PF03556:PF03195,4,24,3,1,21,993,0.12,0.98,0.75,0.3,5,2,2,3,1011,0.4,1.0,0.5,0.44
PF07430,PF15722:PF10630:PF16829,0,0,0,0,0,1018,0,1.0,0,0,0,0,0,0,1018,0,1.0,0,0
PF12507,PF12158:PF15380:PF15832,1,0,0,1,0,1017,0,1.0,0.0,0,0,0,1,0,1017,0,1.0,0.0,0
PF03189,PF01285:PF10401:PF14687,7,19,3,4,16,995,0.16,0.98,0.43,0.25,2,0,7,2,1009,0.0,0.99,0.0,-0.0
PF02978,PF00448:PF02881:PF04086,28,39,27,1,12,978,0.69,0.99,0.96,0.81,33,25,3,8,982,0.76,0.99,0.89,0.82
PF09207,PF16011:PF13094:PF09818,0,4,0,0,4,1014,0.0,1.0,0,0,0,0,0,0,1018,0,1.0,0,0
PF04357,PF15912:PF15309:PF05397,0,15,0,0,15,1003,0.0,0.99,0,0,1,0,0,1,1017,0.0,1.0,0,0
PF03812,PF10523:PF03099:PF00452,1,32,0,1,32,985,0.0,0.97,0.0,-0.01,3,0,1,3,1014,0.0,1.0,0.0,-0.0
PF01273,PF02886:PF02550:PF01144,12,38,12,0,26,980,0.32,0.97,1.0,0.55,3,3,9,0,1006,1.0,0.99,0.25,0.5
PF15688,PF15690:PF15689:PF15687,0,0,0,0,0,1018,0,1.0,0,0,0,0,0,0,1018,0,1.0,0,0
PF13346,PF00297:PF09923:PF04506,0,25,0,0,25,993,0.0,0.98,0,0,3,0,0,3,1015,0.0,1.0,0,0
PF00396,PF09353:PF03301:PF08127,12,11,4,8,7,999,0.36,0.99,0.33,0.34,1,1,11,0,1006,1.0,0.99,0.08,0.29
PF06816,PF07684:PF00066:PF16553,5,13,5,0,8,1005,0.38,0.99,1.0,0.62,7,5,0,2,1011,0.71,1.0,1.0,0.84
PF03478,PF07734:PF08268:PF08387,29,35,13,16,22,967,0.37,0.96,0.45,0.39,12,6,23,6,983,0.5,0.97,0.21,0.31
PF15610,PF08744:PF05901:PF17164,1,0,0,1,0,1017,0,1.0,0.0,0,0,0,1,0,1017,0,1.0,0.0,0
PF16515,PF17045:PF11577:PF04388,5,11,1,4,10,1003,0.09,0.99,0.2,0.13,1,0,5,1,1012,0.0,0.99,0.0,-0.0
PF02522,PF05167:PF01514:PF06890,1,1,0,1,1,1016,0.0,1.0,0.0,-0.0,0,0,1,0,1017,0,1.0,0.0,0
PF10486,PF04747:PF15710:PF11244,1,0,0,1,0,1017,0,1.0,0.0,0,0,0,1,0,1017,0,1.0,0.0,0
PF07685,PF11642:PF16829:PF08535,3,1,0,3,1,1014,0.0,1.0,0.0,-0.0,0,0,3,0,1015,0,1.0,0.0,0
PF04376,PF04377:PF16978:PF08068,7,20,6,1,14,997,0.3,0.99,0.86,0.5,3,2,5,1,1010,0.67,0.99,0.29,0.43
PF08696,PF08427:PF10350:PF07539,9,27,4,5,23,986,0.15,0.97,0.44,0.25,3,2,7,1,1008,0.67,0.99,0.22,0.38
PF15377,PF01959:PF15053:PF11017,0,5,0,0,5,1013,0.0,1.0,0,0,0,0,0,0,1018,0,1.0,0,0
PF00308,PF08479:PF15518:PF14841,5,2,1,4,1,1012,0.5,1.0,0.2,0.31,0,0,5,0,1013,0,1.0,0.0,0
PF01150,PF06179:PF11976:PF16815,22,34,10,12,24,972,0.29,0.96,0.45,0.35,4,4,18,0,996,1.0,0.98,0.18,0.42
PF09163,PF13247:PF14842:PF03406,0,0,0,0,0,1018,0,1.0,0,0,0,0,0,0,1018,0,1.0,0,0
PF15132,PF08945:PF15754:PF15046,0,3,0,0,3,1015,0.0,1.0,0,0,0,0,0,0,1018,0,1.0,0,0
PF10629,PF05782:PF07085:PF16321,3,12,2,1,10,1005,0.17,0.99,0.67,0.33,0,0,3,0,1015,0,1.0,0.0,0
PF02582,PF01025:PF03637:PF04759,16,31,3,13,28,974,0.1,0.96,0.19,0.12,4,2,14,2,1000,0.5,0.98,0.12,0.24
PF15203,PF11435:PF11210:PF11111,1,2,0,1,2,1015,0.0,1.0,0.0,-0.0,0,0,1,0,1017,0,1.0,0.0,0
PF03734,PF08924:PF00358:PF15225,3,10,1,2,9,1006,0.1,0.99,0.33,0.18,1,0,3,1,1014,0.0,1.0,0.0,-0.0
PF13306,PF13855:PF00001:PF12369,38,203,33,5,170,810,0.16,0.83,0.87,0.33,79,25,13,54,926,0.32,0.93,0.66,0.43
PF05953,PF04120:PF08369:PF04179,1,3,0,1,3,1014,0.0,1.0,0.0,-0.0,1,0,1,1,1016,0.0,1.0,0.0,-0.0
PF05479,PF00321:PF06232:PF01716,1,5,0,1,5,1012,0.0,0.99,0.0,-0.0,0,0,1,0,1017,0,1.0,0.0,0
PF10062,PF11790:PF08562:PF09362,0,15,0,0,15,1003,0.0,0.99,0,0,3,0,0,3,1015,0.0,1.0,0,0
PF04631,PF03379:PF06868:PF15085,0,3,0,0,3,1015,0.0,1.0,0,0,0,0,0,0,1018,0,1.0,0,0
PF04131,PF04552:PF14196:PF13421,1,1,0,1,1,1016,0.0,1.0,0.0,-0.0,0,0,1,0,1017,0,1.0,0.0,0
PF05616,PF14634:PF13445:PF04072,0,72,0,0,72,946,0.0,0.93,0,0,15,0,0,15,1003,0.0,0.99,0,0
PF08282,PF00689:PF12409:PF12515,22,66,14,8,52,944,0.21,0.94,0.64,0.34,13,5,17,8,988,0.38,0.98,0.23,0.28
PF16905,PF08763:PF16885:PF11933,6,10,5,1,5,1007,0.5,0.99,0.83,0.64,2,2,4,0,1012,1.0,1.0,0.33,0.58
PF00567,PF13871:PF12872:PF00565,33,28,12,21,16,969,0.43,0.96,0.36,0.38,5,5,28,0,985,1.0,0.97,0.15,0.38
PF09850,PF01364:PF05491:PF11304,1,7,0,1,7,1010,0.0,0.99,0.0,-0.0,0,0,1,0,1017,0,1.0,0.0,0
PF13286,PF04225:PF04335:PF02583,6,14,4,2,10,1002,0.29,0.99,0.67,0.43,3,2,4,1,1011,0.67,1.0,0.33,0.47
PF12317,PF03760:PF04852:PF15810,2,6,0,2,6,1010,0.0,0.99,0.0,-0.0,1,0,2,1,1015,0.0,1.0,0.0,-0.0
PF03843,PF01673:PF12302:PF05157,0,3,0,0,3,1015,0.0,1.0,0,0,0,0,0,0,1018,0,1.0,0,0
PF02556,PF13972:PF06617:PF14340,5,5,2,3,3,1010,0.4,0.99,0.4,0.4,0,0,5,0,1013,0,1.0,0.0,0
PF04194,PF07929:PF13392:PF08788,10,18,3,7,15,993,0.17,0.98,0.3,0.21,1,0,10,1,1007,0.0,0.99,0.0,-0.0
PF01403,PF08337:PF01437:PF00047,22,51,17,5,34,962,0.33,0.96,0.77,0.49,12,10,12,2,994,0.83,0.99,0.45,0.61
PF16359,PF09239:PF07730:PF06580,1,17,1,0,16,1001,0.06,0.98,1.0,0.24,1,0,1,1,1016,0.0,1.0,0.0,-0.0
PF08280,PF08453:PF03241:PF00669,0,3,0,0,3,1015,0.0,1.0,0,0,0,0,0,0,1018,0,1.0,0,0
PF00533,PF12738:PF16770:PF16893,52,27,22,30,5,961,0.81,0.97,0.42,0.57,11,9,43,2,964,0.82,0.96,0.17,0.36
PF01795,PF02381:PF10512:PF00707,15,11,5,10,6,997,0.45,0.98,0.33,0.38,1,1,14,0,1003,1.0,0.99,0.07,0.26
PF04879,PF01568:PF09326:PF00384,4,24,4,0,20,994,0.17,0.98,1.0,0.4,18,2,2,16,998,0.11,0.98,0.5,0.23
PF02145,PF03542:PF11864:PF02188,14,14,9,5,5,999,0.64,0.99,0.64,0.64,5,5,9,0,1004,1.0,0.99,0.36,0.59
PF15550,PF06875:PF14866:PF08576,0,3,0,0,3,1015,0.0,1.0,0,0,0,0,0,0,1018,0,1.0,0,0
PF13753,PF06745:PF04671:PF12081,0,1,0,0,1,1017,0.0,1.0,0,0,0,0,0,0,1018,0,1.0,0,0
PF11069,PF16972:PF02401:PF17043,3,6,0,3,6,1009,0.0,0.99,0.0,-0.0,1,0,3,1,1014,0.0,1.0,0.0,-0.0
PF07502,PF16915:PF09342:PF01522,2,34,1,1,33,983,0.03,0.97,0.5,0.12,2,1,1,1,1015,0.5,1.0,0.5,0.5
PF13931,PF16540:PF14739:PF11995,8,9,3,5,6,1004,0.33,0.99,0.38,0.35,3,3,5,0,1010,1.0,1.0,0.38,0.61
PF11317,PF10716:PF08843:PF08092,0,2,0,0,2,1016,0.0,1.0,0,0,0,0,0,0,1018,0,1.0,0,0
PF04680,PF12121:PF16048:PF16047,1,0,0,1,0,1017,0,1.0,0.0,0,0,0,1,0,1017,0,1.0,0.0,0
PF10438,PF09087:PF11941:PF09154,1,3,1,0,2,1015,0.33,1.0,1.0,0.58,1,1,0,0,1017,1.0,1.0,1.0,1.0
PF09342,PF15494:PF16915:PF07502,3,11,2,1,9,1006,0.18,0.99,0.67,0.34,1,1,2,0,1015,1.0,1.0,0.33,0.58
PF10414,PF13404:PF14823:PF02604,2,13,2,0,11,1005,0.15,0.99,1.0,0.39,1,1,1,0,1016,1.0,1.0,0.5,0.71
PF04006,PF05693:PF14798:PF15390,10,10,2,8,8,1000,0.2,0.98,0.2,0.19,1,1,9,0,1008,1.0,0.99,0.1,0.31
PF07258,PF00243:PF01731:PF10420,15,9,2,13,7,996,0.22,0.98,0.13,0.16,1,1,14,0,1003,1.0,0.99,0.07,0.26
PF14041,PF05028:PF07295:PF02788,0,17,0,0,17,1001,0.0,0.98,0,0,0,0,0,0,1018,0,1.0,0,0
PF05986,PF01421:PF01562:PF15913,14,40,11,3,29,975,0.28,0.97,0.79,0.45,27,10,4,17,987,0.37,0.98,0.71,0.51
PF09861,PF03525:PF16055:PF01514,0,0,0,0,0,1018,0,1.0,0,0,0,0,0,0,1018,0,1.0,0,0
PF15673,PF08228:PF03907:PF05551,1,4,0,1,4,1013,0.0,1.0,0.0,-0.0,0,0,1,0,1017,0,1.0,0.0,0
PF10332,PF07545:PF13002:PF10104,0,12,0,0,12,1006,0.0,0.99,0,0,1,0,0,1,1017,0.0,1.0,0,0
PF05398,PF05611:PF06403:PF15716,0,1,0,0,1,1017,0.0,1.0,0,0,0,0,0,0,1018,0,1.0,0,0
PF15356,PF11057:PF15119:PF15212,0,1,0,0,1,1017,0.0,1.0,0,0,0,0,0,0,1018,0,1.0,0,0
PF14009,PF14368:PF03195:PF04720,8,24,1,7,23,987,0.04,0.97,0.12,0.06,5,1,7,4,1006,0.2,0.99,0.12,0.15
PF01058,PF00329:PF00124:PF00507,17,21,8,9,13,988,0.38,0.98,0.47,0.41,3,2,15,1,1000,0.67,0.98,0.12,0.28
PF01088,PF03577:PF05191:PF09814,27,24,7,20,17,974,0.29,0.96,0.26,0.26,4,2,25,2,989,0.5,0.97,0.07,0.19
PF14811,PF01160:PF03776:PF13092,4,12,1,3,11,1003,0.08,0.99,0.25,0.14,0,0,4,0,1014,0,1.0,0.0,0
PF00850,PF09757:PF08997:PF12203,48,13,10,38,3,967,0.77,0.96,0.21,0.39,1,1,47,0,970,1.0,0.95,0.02,0.14
PF11999,PF16716:PF07544:PF02024,2,7,0,2,7,1009,0.0,0.99,0.0,-0.0,0,0,2,0,1016,0,1.0,0.0,0
PF09490,PF15817:PF06506:PF11751,0,5,0,0,5,1013,0.0,1.0,0,0,0,0,0,0,1018,0,1.0,0,0
PF11460,PF06989:PF13270:PF11255,0,3,0,0,3,1015,0.0,1.0,0,0,0,0,0,0,1018,0,1.0,0,0
PF00578,PF10417:PF03931:PF12680,45,50,33,12,17,956,0.66,0.97,0.73,0.68,12,10,35,2,971,0.83,0.96,0.22,0.42
PF16704,PF10212:PF16766:PF15964,1,5,1,0,4,1013,0.2,1.0,1.0,0.45,0,0,1,0,1017,0,1.0,0.0,0
PF00339,PF02752:PF05404:PF02269,33,39,29,4,10,975,0.74,0.99,0.88,0.8,4,4,29,0,985,1.0,0.97,0.12,0.34
PF12371,PF09596:PF12478:PF15249,1,14,1,0,13,1004,0.07,0.99,1.0,0.27,1,1,0,0,1017,1.0,1.0,1.0,1.0
PF09697,PF15141:PF05151:PF15758,0,0,0,0,0,1018,0,1.0,0,0,0,0,0,0,1018,0,1.0,0,0
PF14964,PF15293:PF16218:PF15462,5,2,0,5,2,1011,0.0,0.99,0.0,-0.0,0,0,5,0,1013,0,1.0,0.0,0
PF13026,PF10370:PF02719:PF07937,0,4,0,0,4,1014,0.0,1.0,0,0,1,0,0,1,1017,0.0,1.0,0,0
PF00473,PF15342:PF03856:PF02576,5,12,1,4,11,1002,0.08,0.99,0.2,0.12,0,0,5,0,1013,0,1.0,0.0,0
PF16126,PF14307:PF08762:PF04196,1,4,0,1,4,1013,0.0,1.0,0.0,-0.0,1,0,1,1,1016,0.0,1.0,0.0,-0.0
PF05730,PF08613:PF03443:PF11768,16,46,7,9,39,963,0.15,0.95,0.44,0.24,9,4,12,5,997,0.44,0.98,0.25,0.33
PF00273,PF09164:PF17187:PF14306,0,11,0,0,11,1007,0.0,0.99,0,0,0,0,0,0,1018,0,1.0,0,0
PF07549,PF02355:PF14882:PF08299,4,6,3,1,3,1011,0.5,1.0,0.75,0.61,0,0,4,0,1014,0,1.0,0.0,0
PF12336,PF13775:PF12067:PF08517,3,8,1,2,7,1008,0.12,0.99,0.33,0.2,0,0,3,0,1015,0,1.0,0.0,0
PF12583,PF12580:PF12245:PF16470,1,18,1,0,17,1000,0.06,0.98,1.0,0.23,2,1,0,1,1016,0.5,1.0,1.0,0.71
PF03466,PF00184:PF00220:PF00126,9,8,6,3,2,1007,0.75,1.0,0.67,0.7,2,0,9,2,1007,0.0,0.99,0.0,-0.0
PF11945,PF04004:PF15369:PF09755,6,12,1,5,11,1001,0.08,0.98,0.17,0.11,4,1,5,3,1009,0.25,0.99,0.17,0.2
PF09422,PF09305:PF01447:PF09772,0,7,0,0,7,1011,0.0,0.99,0,0,0,0,0,0,1018,0,1.0,0,0
PF16483,PF04229:PF05870:PF10868,4,7,1,3,6,1008,0.14,0.99,0.25,0.18,0,0,4,0,1014,0,1.0,0.0,0
PF08499,PF08629:PF00233:PF00158,2,31,2,0,29,987,0.06,0.97,1.0,0.25,2,2,0,0,1016,1.0,1.0,1.0,1.0
PF13280,PF09012:PF16861:PF11975,2,13,0,2,13,1003,0.0,0.99,0.0,-0.01,1,0,2,1,1015,0.0,1.0,0.0,-0.0
PF04963,PF04552:PF08479:PF07805,1,2,1,0,1,1016,0.5,1.0,1.0,0.71,0,0,1,0,1017,0,1.0,0.0,0
PF09845,PF06136:PF02319:PF04098,0,34,0,0,34,984,0.0,0.97,0,0,3,0,0,3,1015,0.0,1.0,0,0
PF09278,PF00376:PF00813:PF00555,2,4,2,0,2,1014,0.5,1.0,1.0,0.71,0,0,2,0,1016,0,1.0,0.0,0
PF14735,PF02401:PF03383:PF07298,4,7,0,4,7,1007,0.0,0.99,0.0,-0.01,0,0,4,0,1014,0,1.0,0.0,0
PF03260,PF17206:PF03592:PF16011,0,3,0,0,3,1015,0.0,1.0,0,0,0,0,0,0,1018,0,1.0,0,0
PF03487,PF13530:PF02561:PF03865,0,2,0,0,2,1016,0.0,1.0,0,0,0,0,0,0,1018,0,1.0,0,0
PF01904,PF04370:PF07484:PF15391,7,1,0,7,1,1010,0.0,0.99,0.0,-0.0,0,0,7,0,1011,0,0.99,0.0,0
PF10367,PF10366:PF00637:PF17122,18,36,17,1,19,981,0.47,0.98,0.94,0.66,10,9,9,1,999,0.9,0.99,0.5,0.67
PF12376,PF15120:PF15046:PF15576,0,5,0,0,5,1013,0.0,1.0,0,0,0,0,0,0,1018,0,1.0,0,0
PF07544,PF12046:PF00737:PF06912,6,4,0,6,4,1008,0.0,0.99,0.0,-0.0,0,0,6,0,1012,0,0.99,0.0,0
PF09789,PF15929:PF10188:PF04139,4,11,2,2,9,1005,0.18,0.99,0.5,0.3,0,0,4,0,1014,0,1.0,0.0,0
PF00880,PF15149:PF16748:PF00305,10,19,1,9,18,990,0.05,0.97,0.1,0.06,1,1,9,0,1008,1.0,0.99,0.1,0.31
PF04261,PF02690:PF12323:PF08692,13,9,5,8,4,1001,0.56,0.99,0.38,0.46,0,0,13,0,1005,0,0.99,0.0,0
PF10099,PF06122:PF15460:PF05962,0,2,0,0,2,1016,0.0,1.0,0,0,0,0,0,0,1018,0,1.0,0,0
PF11531,PF05185:PF11591:PF01799,2,36,2,0,34,982,0.06,0.97,1.0,0.23,7,0,2,7,1009,0.0,0.99,0.0,-0.0
PF16503,PF06041:PF11734:PF10288,8,13,3,5,10,1000,0.23,0.99,0.38,0.29,2,2,6,0,1010,1.0,0.99,0.25,0.5
PF07204,PF11465:PF02158:PF03921,4,8,2,2,6,1008,0.25,0.99,0.5,0.35,2,2,2,0,1014,1.0,1.0,0.5,0.71
PF15724,PF06875:PF06954:PF12046,0,1,0,0,1,1017,0.0,1.0,0,0,0,0,0,0,1018,0,1.0,0,0
PF06592,PF02951:PF17061:PF02277,1,7,0,1,7,1010,0.0,0.99,0.0,-0.0,0,0,1,0,1017,0,1.0,0.0,0
PF14536,PF15770:PF01668:PF01316,0,4,0,0,4,1014,0.0,1.0,0,0,0,0,0,0,1018,0,1.0,0,0
PF15740,PF12886:PF15622:PF12885,1,3,0,1,3,1014,0.0,1.0,0.0,-0.0,3,0,1,3,1014,0.0,1.0,0.0,-0.0
PF06119,PF03782:PF07474:PF00094,15,42,13,2,29,974,0.31,0.97,0.87,0.51,11,9,6,2,1001,0.82,0.99,0.6,0.7
PF16075,PF08744:PF12628:PF09917,0,0,0,0,0,1018,0,1.0,0,0,0,0,0,0,1018,0,1.0,0,0
PF00984,PF03720:PF03721:PF00273,7,7,7,0,0,1011,1.0,1.0,1.0,1.0,6,6,1,0,1011,1.0,1.0,0.86,0.93
PF03550,PF10798:PF12143:PF12923,0,16,0,0,16,1002,0.0,0.98,0,0,0,0,0,0,1018,0,1.0,0,0
PF10791,PF03389:PF05488:PF07499,0,2,0,0,2,1016,0.0,1.0,0,0,0,0,0,0,1018,0,1.0,0,0
PF01194,PF02531:PF03805:PF11909,4,3,0,4,3,1011,0.0,0.99,0.0,-0.0,0,0,4,0,1014,0,1.0,0.0,0
PF02952,PF07881:PF07882:PF07411,1,1,1,0,0,1017,1.0,1.0,1.0,1.0,1,1,0,0,1017,1.0,1.0,1.0,1.0
PF02086,PF11019:PF05939:PF06070,2,1,0,2,1,1015,0.0,1.0,0.0,-0.0,0,0,2,0,1016,0,1.0,0.0,0
PF06902,PF03428:PF11245:PF01514,0,0,0,0,0,1018,0,1.0,0,0,0,0,0,0,1018,0,1.0,0,0
PF03502,PF03772:PF06339:PF02224,0,13,0,0,13,1005,0.0,0.99,0,0,1,0,0,1,1017,0.0,1.0,0,0
PF10496,PF05334:PF04087:PF12253,14,4,1,13,3,1001,0.25,0.98,0.07,0.13,0,0,14,0,1004,0,0.99,0.0,0
PF14636,PF14638:PF14637:PF14558,6,8,6,0,2,1010,0.75,1.0,1.0,0.87,6,6,0,0,1012,1.0,1.0,1.0,1.0
PF03127,PF00790:PF12210:PF04516,11,32,11,0,21,986,0.34,0.98,1.0,0.58,7,3,8,4,1003,0.43,0.99,0.27,0.34
PF13871,PF14418:PF14061:PF17182,6,7,3,3,4,1008,0.43,0.99,0.5,0.46,0,0,6,0,1012,0,0.99,0.0,0
PF07142,PF09462:PF04001:PF14886,4,5,2,2,3,1011,0.4,1.0,0.5,0.44,1,1,3,0,1014,1.0,1.0,0.25,0.5
PF15326,PF10482:PF15914:PF07001,1,8,0,1,8,1009,0.0,0.99,0.0,-0.0,1,0,1,1,1016,0.0,1.0,0.0,-0.0
PF12901,PF14437:PF08604:PF14304,7,21,2,5,19,992,0.1,0.98,0.29,0.16,3,0,7,3,1008,0.0,0.99,0.0,-0.0
PF03773,PF06756:PF03616:PF17193,0,1,0,0,1,1017,0.0,1.0,0,0,0,0,0,0,1018,0,1.0,0,0
PF09330,PF02873:PF09129:PF02754,4,11,2,2,9,1005,0.18,0.99,0.5,0.3,2,2,2,0,1014,1.0,1.0,0.5,0.71
PF05978,PF06813:PF10022:PF07757,16,22,3,13,19,983,0.14,0.97,0.19,0.14,3,1,15,2,1000,0.33,0.98,0.06,0.14
PF12634,PF13362:PF13422:PF12196,2,8,0,2,8,1008,0.0,0.99,0.0,-0.0,1,0,2,1,1015,0.0,1.0,0.0,-0.0
PF04830,PF09861:PF11092:PF01514,0,0,0,0,0,1018,0,1.0,0,0,0,0,0,0,1018,0,1.0,0,0
PF00586,PF02843:PF02844:PF01071,12,16,7,5,9,997,0.44,0.99,0.58,0.5,13,7,5,6,1000,0.54,0.99,0.58,0.55
PF11938,PF02221:PF05669:PF12513,15,33,7,8,26,977,0.21,0.97,0.47,0.3,5,4,11,1,1002,0.8,0.99,0.27,0.46
PF02527,PF02448:PF15364:PF06541,8,0,0,8,0,1010,0,0.99,0.0,0,0,0,8,0,1010,0,0.99,0.0,0
PF03957,PF12498:PF08601:PF02173,3,8,2,1,6,1009,0.25,0.99,0.67,0.41,2,2,1,0,1015,1.0,1.0,0.67,0.82
PF09320,PF09350:PF12572:PF00684,12,16,4,8,12,994,0.25,0.98,0.33,0.28,0,0,12,0,1006,0,0.99,0.0,0
PF15719,PF11029:PF04736:PF09056,3,7,1,2,6,1009,0.14,0.99,0.33,0.21,0,0,3,0,1015,0,1.0,0.0,0
PF14327,PF05383:PF08081:PF04098,12,26,3,9,23,983,0.12,0.97,0.25,0.16,3,2,10,1,1005,0.67,0.99,0.17,0.33
PF10609,PF01883:PF06155:PF02668,21,48,9,12,39,958,0.19,0.95,0.43,0.26,13,6,15,7,990,0.46,0.98,0.29,0.35
PF11833,PF10218:PF07816:PF01632,4,5,0,4,5,1009,0.0,0.99,0.0,-0.0,0,0,4,0,1014,0,1.0,0.0,0
PF00165,PF04422:PF02805:PF12350,6,9,6,0,3,1009,0.67,1.0,1.0,0.82,0,0,6,0,1012,0,0.99,0.0,0
PF01843,PF16521:PF00063:PF16735,28,75,20,8,55,935,0.27,0.94,0.71,0.41,3,3,25,0,990,1.0,0.98,0.11,0.32
PF07777,PF12498:PF02173:PF03957,2,7,2,0,5,1011,0.29,1.0,1.0,0.53,2,2,0,0,1016,1.0,1.0,1.0,1.0
PF01070,PF00173:PF03404:PF00487,45,105,36,9,69,904,0.34,0.92,0.8,0.49,33,14,31,19,954,0.42,0.95,0.31,0.34
PF12513,PF16783:PF10927:PF07652,8,10,2,6,8,1002,0.2,0.99,0.25,0.22,1,0,8,1,1009,0.0,0.99,0.0,-0.0
PF00775,PF13391:PF08588:PF02537,19,22,4,15,18,981,0.18,0.97,0.21,0.18,1,0,19,1,998,0.0,0.98,0.0,-0.0
PF00233,PF01590:PF07716:PF08499,21,57,13,8,44,953,0.23,0.95,0.62,0.36,15,3,18,12,985,0.2,0.97,0.14,0.15
PF01149,PF09292:PF06831:PF04422,9,16,9,0,7,1002,0.56,0.99,1.0,0.75,4,4,5,0,1009,1.0,1.0,0.44,0.67
PF00061,PF08212:PF03973:PF05434,20,14,6,14,8,990,0.43,0.98,0.3,0.35,0,0,20,0,998,0,0.98,0.0,0
PF03254,PF02309:PF04674:PF14476,6,16,1,5,15,997,0.06,0.98,0.17,0.09,1,0,6,1,1011,0.0,0.99,0.0,-0.0
PF01116,PF07005:PF17042:PF14833,19,25,8,11,17,982,0.32,0.97,0.42,0.35,6,5,14,1,998,0.83,0.99,0.26,0.46
PF09591,PF07192:PF04562:PF08208,0,5,0,0,5,1013,0.0,1.0,0,0,0,0,0,0,1018,0,1.0,0,0
PF05502,PF10443:PF05383:PF03467,3,30,2,1,28,987,0.07,0.97,0.67,0.2,6,2,1,4,1011,0.33,1.0,0.67,0.47
PF01653,PF03119:PF03120:PF08605,8,7,6,2,1,1009,0.86,1.0,0.75,0.8,3,3,5,0,1010,1.0,1.0,0.38,0.61
PF10302,PF13373:PF16843:PF01020,4,15,3,1,12,1002,0.2,0.99,0.75,0.38,2,1,3,1,1013,0.5,1.0,0.25,0.35
PF16419,PF15309:PF12842:PF12381,0,17,0,0,17,1001,0.0,0.98,0,0,1,0,0,1,1017,0.0,1.0,0,0
PF13924,PF16117:PF12828:PF16697,8,7,5,3,2,1008,0.71,1.0,0.62,0.67,1,1,7,0,1010,1.0,0.99,0.12,0.35
PF10482,PF07001:PF15557:PF15326,1,6,0,1,6,1011,0.0,0.99,0.0,-0.0,0,0,1,0,1017,0,1.0,0.0,0
PF10797,PF12897:PF03882:PF17192,1,2,1,0,1,1016,0.5,1.0,1.0,0.71,0,0,1,0,1017,0,1.0,0.0,0
PF11980,PF00629:PF09458:PF00754,0,71,0,0,71,947,0.0,0.93,0,0,23,0,0,23,995,0.0,0.98,0,0
PF00807,PF09051:PF09049:PF09050,0,0,0,0,0,1018,0,1.0,0,0,0,0,0,0,1018,0,1.0,0,0
PF16836,PF15483:PF07804:PF01913,0,3,0,0,3,1015,0.0,1.0,0,0,0,0,0,0,1018,0,1.0,0,0
PF00312,PF05180:PF05019:PF08069,21,20,10,11,10,987,0.5,0.98,0.48,0.48,4,4,17,0,997,1.0,0.98,0.19,0.43
PF08541,PF08392:PF09261:PF02793,9,42,8,1,34,975,0.19,0.97,0.89,0.4,6,4,5,2,1007,0.67,0.99,0.44,0.54
PF12490,PF08159:PF13925:PF11540,5,15,3,2,12,1001,0.2,0.99,0.6,0.34,3,2,3,1,1012,0.67,1.0,0.4,0.51
PF07851,PF07767:PF16969:PF09751,8,21,3,5,18,992,0.14,0.98,0.38,0.22,6,2,6,4,1006,0.33,0.99,0.25,0.28
PF10616,PF08936:PF06227:PF15828,0,2,0,0,2,1016,0.0,1.0,0,0,0,0,0,0,1018,0,1.0,0,0
PF04501,PF05489:PF07505:PF17164,1,0,0,1,0,1017,0,1.0,0.0,0,0,0,1,0,1017,0,1.0,0.0,0
PF00082,PF05922:PF16470:PF12583,63,33,30,33,3,952,0.91,0.96,0.48,0.64,6,6,57,0,955,1.0,0.94,0.1,0.3
PF02934,PF02637:PF16709:PF16712,11,12,9,2,3,1004,0.75,1.0,0.82,0.78,1,0,11,1,1006,0.0,0.99,0.0,-0.0
PF08529,PF13184:PF08206:PF09876,4,4,4,0,0,1014,1.0,1.0,1.0,1.0,1,1,3,0,1014,1.0,1.0,0.25,0.5
PF02426,PF03831:PF08274:PF02719,4,4,1,3,3,1011,0.25,0.99,0.25,0.25,0,0,4,0,1014,0,1.0,0.0,0
PF11138,PF03963:PF05100:PF03090,0,1,0,0,1,1017,0.0,1.0,0,0,0,0,0,0,1018,0,1.0,0,0
PF04611,PF03867:PF10525:PF12413,1,4,1,0,3,1014,0.25,1.0,1.0,0.5,1,1,0,0,1017,1.0,1.0,1.0,1.0
PF06377,PF08738:PF16716:PF12046,2,0,0,2,0,1016,0,1.0,0.0,0,0,0,2,0,1016,0,1.0,0.0,0
PF03357,PF07491:PF13023:PF04419,47,20,11,36,9,962,0.55,0.96,0.23,0.34,6,5,42,1,970,0.83,0.96,0.11,0.29
PF06245,PF02556:PF06617:PF02934,0,18,0,0,18,1000,0.0,0.98,0,0,0,0,0,0,1018,0,1.0,0,0
PF14882,PF12241:PF08299:PF03428,0,3,0,0,3,1015,0.0,1.0,0,0,0,0,0,0,1018,0,1.0,0,0
PF05493,PF00543:PF09056:PF15071,18,7,2,16,5,995,0.29,0.98,0.11,0.17,1,0,18,1,999,0.0,0.98,0.0,-0.0
PF02115,PF09778:PF00197:PF06376,13,5,2,11,3,1002,0.4,0.99,0.15,0.24,0,0,13,0,1005,0,0.99,0.0,0
PF08811,PF07394:PF15912:PF15326,4,7,4,0,3,1011,0.57,1.0,1.0,0.75,0,0,4,0,1014,0,1.0,0.0,0
PF02453,PF01073:PF14934:PF07722,14,21,4,10,17,987,0.19,0.97,0.29,0.22,5,3,11,2,1002,0.6,0.99,0.21,0.35
PF09446,PF17125:PF01029:PF11709,4,18,3,1,15,999,0.17,0.98,0.75,0.35,3,1,3,2,1012,0.33,1.0,0.25,0.29
PF06681,PF03238:PF03745:PF05962,0,1,0,0,1,1017,0.0,1.0,0,0,0,0,0,0,1018,0,1.0,0,0
PF13749,PF11614:PF09093:PF02501,5,7,1,4,6,1007,0.14,0.99,0.2,0.16,0,0,5,0,1013,0,1.0,0.0,0
PF16646,PF08833:PF07001:PF06972,0,9,0,0,9,1009,0.0,0.99,0,0,0,0,0,0,1018,0,1.0,0,0
PF01389,PF14334:PF08116:PF07152,0,0,0,0,0,1018,0,1.0,0,0,0,0,0,0,1018,0,1.0,0,0
PF15212,PF03050:PF03238:PF15119,0,1,0,0,1,1017,0.0,1.0,0,0,0,0,0,0,1018,0,1.0,0,0
PF11123,PF09699:PF16217:PF10994,0,0,0,0,0,1018,0,1.0,0,0,0,0,0,0,1018,0,1.0,0,0
PF14985,PF00770:PF05754:PF15216,2,2,0,2,2,1014,0.0,1.0,0.0,-0.0,0,0,2,0,1016,0,1.0,0.0,0
PF04422,PF15805:PF15803:PF04432,0,0,0,0,0,1018,0,1.0,0,0,0,0,0,0,1018,0,1.0,0,0
PF02116,PF10180:PF07904:PF10104,2,19,1,1,18,998,0.05,0.98,0.5,0.16,2,0,2,2,1014,0.0,1.0,0.0,-0.0
PF12739,PF08626:PF12612:PF15979,8,28,1,7,27,983,0.04,0.97,0.12,0.05,8,1,7,7,1003,0.12,0.99,0.12,0.12
PF15558,PF10506:PF15877:PF11831,1,13,0,1,13,1004,0.0,0.99,0.0,-0.0,3,0,1,3,1014,0.0,1.0,0.0,-0.0
PF10466,PF06309:PF03022:PF10420,1,10,0,1,10,1007,0.0,0.99,0.0,-0.0,1,0,1,1,1016,0.0,1.0,0.0,-0.0
PF00060,PF10613:PF00497:PF10565,46,51,32,14,19,953,0.63,0.97,0.7,0.64,11,11,35,0,972,1.0,0.97,0.24,0.48
PF10176,PF15503:PF02427:PF04359,5,2,0,5,2,1011,0.0,0.99,0.0,-0.0,0,0,5,0,1013,0,1.0,0.0,0
PF09311,PF03528:PF16696:PF11464,6,15,5,1,10,1002,0.33,0.99,0.83,0.52,2,2,4,0,1012,1.0,1.0,0.33,0.58
PF07282,PF12600:PF08297:PF15073,2,2,0,2,2,1014,0.0,1.0,0.0,-0.0,0,0,2,0,1016,0,1.0,0.0,0
PF04560,PF10385:PF04561:PF06883,18,9,8,10,1,999,0.89,0.99,0.44,0.62,2,2,16,0,1000,1.0,0.98,0.11,0.33
PF12325,PF16574:PF07558:PF10650,10,7,1,9,6,1002,0.14,0.99,0.1,0.11,1,0,10,1,1007,0.0,0.99,0.0,-0.0
PF00893,PF11363:PF07321:PF14615,1,7,0,1,7,1010,0.0,0.99,0.0,-0.0,0,0,1,0,1017,0,1.0,0.0,0
PF15624,PF09441:PF05397:PF13945,4,13,1,3,12,1002,0.08,0.99,0.25,0.13,0,0,4,0,1014,0,1.0,0.0,0
PF08180,PF04835:PF06745:PF12192,0,0,0,0,0,1018,0,1.0,0,0,0,0,0,0,1018,0,1.0,0,0
PF11899,PF12036:PF16862:PF06964,4,31,1,3,30,984,0.03,0.97,0.25,0.08,2,0,4,2,1012,0.0,0.99,0.0,-0.0
PF07035,PF08427:PF12036:PF12460,7,16,1,6,15,996,0.06,0.98,0.14,0.09,1,0,7,1,1010,0.0,0.99,0.0,-0.0
PF03259,PF06522:PF10075:PF03657,12,17,7,5,10,996,0.41,0.99,0.58,0.48,5,4,8,1,1005,0.8,0.99,0.33,0.51
PF12770,PF17109:PF11701:PF14420,13,23,8,5,15,990,0.35,0.98,0.62,0.45,6,3,10,3,1002,0.5,0.99,0.23,0.33
PF14473,PF06541:PF00214:PF10839,0,1,0,0,1,1017,0.0,1.0,0,0,0,0,0,0,1018,0,1.0,0,0
PF04782,PF08234:PF11708:PF02083,14,15,3,11,12,992,0.2,0.98,0.21,0.2,2,0,14,2,1002,0.0,0.98,0.0,-0.01
PF06237,PF07786:PF16401:PF04515,3,18,0,3,18,997,0.0,0.98,0.0,-0.01,3,0,3,3,1012,0.0,0.99,0.0,-0.0
PF17070,PF04296:PF06725:PF09493,0,1,0,0,1,1017,0.0,1.0,0,0,0,0,0,0,1018,0,1.0,0,0
PF00563,PF00990:PF00015:PF02203,9,17,5,4,12,997,0.29,0.98,0.56,0.4,10,3,6,7,1002,0.3,0.99,0.33,0.31
PF17216,PF17215:PF13638:PF07504,9,17,7,2,10,999,0.41,0.99,0.78,0.56,6,6,3,0,1009,1.0,1.0,0.67,0.82
PF01315,PF02738:PF03450:PF01799,23,24,23,0,1,994,0.96,1.0,1.0,0.98,21,21,2,0,995,1.0,1.0,0.91,0.95
PF05726,PF02678:PF02744:PF01729,10,32,10,0,22,986,0.31,0.98,1.0,0.55,4,2,8,2,1006,0.5,0.99,0.2,0.31
PF00421,PF00124:PF00507:PF12238,17,7,4,13,3,998,0.57,0.98,0.24,0.36,0,0,17,0,1001,0,0.98,0.0,0
PF13643,PF15861:PF12220:PF16842,1,7,1,0,6,1011,0.14,0.99,1.0,0.38,1,1,0,0,1017,1.0,1.0,1.0,1.0
PF08856,PF10951:PF06934:PF15355,0,0,0,0,0,1018,0,1.0,0,0,0,0,0,0,1018,0,1.0,0,0
PF06965,PF00524:PF05164:PF05065,3,5,1,2,4,1011,0.2,0.99,0.33,0.26,0,0,3,0,1015,0,1.0,0.0,0
PF01512,PF10531:PF10589:PF01227,10,18,9,1,9,999,0.5,0.99,0.9,0.67,6,6,4,0,1008,1.0,1.0,0.6,0.77
PF00766,PF01012:PF03900:PF02672,9,35,7,2,28,981,0.2,0.97,0.78,0.39,5,1,8,4,1005,0.2,0.99,0.11,0.14
PF10500,PF09216:PF14866:PF15621,2,0,0,2,0,1016,0,1.0,0.0,0,0,0,2,0,1016,0,1.0,0.0,0
PF08144,PF05715:PF08578:PF15862,4,8,3,1,5,1009,0.38,0.99,0.75,0.53,1,0,4,1,1013,0.0,1.0,0.0,-0.0
PF15441,PF15720:PF12015:PF16523,2,2,2,0,0,1016,1.0,1.0,1.0,1.0,1,1,1,0,1016,1.0,1.0,0.5,0.71
PF00469,PF11697:PF04868:PF14512,1,2,0,1,2,1015,0.0,1.0,0.0,-0.0,0,0,1,0,1017,0,1.0,0.0,0
PF02451,PF07326:PF00997:PF11759,0,0,0,0,0,1018,0,1.0,0,0,0,0,0,0,1018,0,1.0,0,0
PF00739,PF17014:PF06450:PF17007,1,1,0,1,1,1016,0.0,1.0,0.0,-0.0,0,0,1,0,1017,0,1.0,0.0,0
PF08107,PF15576:PF02202:PF09802,0,2,0,0,2,1016,0.0,1.0,0,0,1,0,0,1,1017,0.0,1.0,0,0
PF08788,PF04194:PF07929:PF01342,7,20,2,5,18,993,0.1,0.98,0.29,0.16,3,0,7,3,1008,0.0,0.99,0.0,-0.0
PF14508,PF08708:PF01752:PF03729,0,2,0,0,2,1016,0.0,1.0,0,0,0,0,0,0,1018,0,1.0,0,0
PF05359,PF06681:PF02413:PF12615,0,0,0,0,0,1018,0,1.0,0,0,0,0,0,0,1018,0,1.0,0,0
PF11953,PF12837:PF12800:PF00950,0,4,0,0,4,1014,0.0,1.0,0,0,2,0,0,2,1016,0.0,1.0,0,0
PF10576,PF14815:PF07934:PF00633,3,22,3,0,19,996,0.14,0.98,1.0,0.37,3,1,2,2,1013,0.33,1.0,0.33,0.33
PF07404,PF15482:PF02425:PF05874,1,1,0,1,1,1016,0.0,1.0,0.0,-0.0,0,0,1,0,1017,0,1.0,0.0,0
PF12946,PF07462:PF01723:PF12947,3,26,3,0,23,992,0.12,0.98,1.0,0.34,0,0,3,0,1015,0,1.0,0.0,0
PF14857,PF05308:PF14822:PF07406,4,7,0,4,7,1007,0.0,0.99,0.0,-0.01,0,0,4,0,1014,0,1.0,0.0,0
PF03002,PF00127:PF10542:PF04839,7,4,0,7,4,1007,0.0,0.99,0.0,-0.01,0,0,7,0,1011,0,0.99,0.0,0
PF01233,PF02799:PF12470:PF05076,14,17,14,0,3,1001,0.82,1.0,1.0,0.91,4,3,11,1,1003,0.75,0.99,0.21,0.4
PF02801,PF00109:PF00698:PF16197,58,63,58,0,5,955,0.92,1.0,1.0,0.96,43,42,16,1,959,0.98,0.98,0.72,0.83
PF03198,PF00332:PF00154:PF07983,18,36,5,13,31,969,0.14,0.96,0.28,0.18,15,4,14,11,989,0.27,0.98,0.22,0.23
PF16958,PF11931:PF12108:PF01745,0,9,0,0,9,1009,0.0,0.99,0,0,5,0,0,5,1013,0.0,1.0,0,0
PF04979,PF09696:PF01185:PF04667,21,17,6,15,11,986,0.35,0.97,0.29,0.3,1,1,20,0,997,1.0,0.98,0.05,0.22
PF05622,PF04388:PF03800:PF06470,14,26,6,8,20,984,0.23,0.97,0.43,0.3,2,2,12,0,1004,1.0,0.99,0.14,0.38
PF00874,PF03123:PF09648:PF00358,4,9,2,2,7,1007,0.22,0.99,0.5,0.33,2,2,2,0,1014,1.0,1.0,0.5,0.71
PF09409,PF16678:PF04721:PF11470,28,14,9,19,5,985,0.64,0.98,0.32,0.44,2,2,26,0,990,1.0,0.97,0.07,0.26
PF09664,PF09983:PF03533:PF16216,3,3,3,0,0,1015,1.0,1.0,1.0,1.0,3,3,0,0,1015,1.0,1.0,1.0,1.0
PF05615,PF10173:PF10217:PF10180,6,14,1,5,13,999,0.07,0.98,0.17,0.1,2,0,6,2,1010,0.0,0.99,0.0,-0.0
PF05024,PF06584:PF14441:PF01285,8,12,1,7,11,999,0.08,0.98,0.12,0.09,1,1,7,0,1010,1.0,0.99,0.12,0.35
PF00239,PF13408:PF07508:PF05974,3,2,2,1,0,1015,1.0,1.0,0.67,0.82,2,2,1,0,1015,1.0,1.0,0.67,0.82
PF04074,PF09785:PF04760:PF16686,0,17,0,0,17,1001,0.0,0.98,0,0,0,0,0,0,1018,0,1.0,0,0
PF07077,PF08494:PF08744:PF04740,3,3,3,0,0,1015,1.0,1.0,1.0,1.0,0,0,3,0,1015,0,1.0,0.0,0
PF04311,PF04533:PF15835:PF07270,0,0,0,0,0,1018,0,1.0,0,0,0,0,0,0,1018,0,1.0,0,0
PF12927,PF05841:PF08634:PF08630,3,5,0,3,5,1010,0.0,0.99,0.0,-0.0,0,0,3,0,1015,0,1.0,0.0,0
PF08082,PF10598:PF10597:PF10596,13,18,13,0,5,1000,0.72,1.0,1.0,0.85,15,13,0,2,1003,0.87,1.0,1.0,0.93
PF02475,PF02676:PF15679:PF10102,22,12,7,15,5,991,0.58,0.98,0.32,0.42,1,1,21,0,996,1.0,0.98,0.05,0.21
PF04916,PF08661:PF10266:PF04756,9,20,5,4,15,994,0.25,0.98,0.56,0.36,3,1,8,2,1007,0.33,0.99,0.11,0.19
PF05434,PF04756:PF00277:PF04527,6,11,3,3,8,1004,0.27,0.99,0.5,0.36,0,0,6,0,1012,0,0.99,0.0,0
PF02101,PF08228:PF09784:PF01878,7,12,1,6,11,1000,0.08,0.98,0.14,0.1,1,0,7,1,1010,0.0,0.99,0.0,-0.0
PF12897,PF04350:PF12241:PF03882,2,1,0,2,1,1015,0.0,1.0,0.0,-0.0,0,0,2,0,1016,0,1.0,0.0,0
PF08615,PF11779:PF02046:PF03657,7,14,2,5,12,999,0.14,0.98,0.29,0.19,2,1,6,1,1010,0.5,0.99,0.14,0.26
PF06351,PF01241:PF00537:PF11264,2,2,0,2,2,1014,0.0,1.0,0.0,-0.0,0,0,2,0,1016,0,1.0,0.0,0
PF16839,PF05912:PF15724:PF09117,0,3,0,0,3,1015,0.0,1.0,0,0,0,0,0,0,1018,0,1.0,0,0
PF09498,PF03406:PF17206:PF08497,0,1,0,0,1,1017,0.0,1.0,0,0,0,0,0,0,1018,0,1.0,0,0
PF04147,PF07975:PF04056:PF16712,13,10,2,11,8,997,0.2,0.98,0.15,0.17,4,1,12,3,1002,0.25,0.99,0.08,0.13
PF02646,PF05065:PF04984:PF02108,4,1,1,3,0,1014,1.0,1.0,0.25,0.5,0,0,4,0,1014,0,1.0,0.0,0
PF04250,PF12054:PF08873:PF10339,0,10,0,0,10,1008,0.0,0.99,0,0,0,0,0,0,1018,0,1.0,0,0
PF04862,PF14365:PF04127:PF02773,7,13,2,5,11,1000,0.15,0.98,0.29,0.2,1,0,7,1,1010,0.0,0.99,0.0,-0.0
PF03788,PF16967:PF07434:PF03534,2,0,0,2,0,1016,0,1.0,0.0,0,0,0,2,0,1016,0,1.0,0.0,0
PF00336,PF07569:PF03669:PF14370,1,22,0,1,22,995,0.0,0.98,0.0,-0.0,3,0,1,3,1014,0.0,1.0,0.0,-0.0
PF07936,PF14866:PF15085:PF15555,1,3,0,1,3,1014,0.0,1.0,0.0,-0.0,0,0,1,0,1017,0,1.0,0.0,0
PF13554,PF14508:PF03729:PF02501,0,2,0,0,2,1016,0.0,1.0,0,0,0,0,0,0,1018,0,1.0,0,0
PF06020,PF15343:PF15776:PF15207,0,3,0,0,3,1015,0.0,1.0,0,0,0,0,0,0,1018,0,1.0,0,0
PF01638,PF01312:PF03749:PF14290,1,2,0,1,2,1015,0.0,1.0,0.0,-0.0,0,0,1,0,1017,0,1.0,0.0,0
PF16744,PF13864:PF04004:PF07545,1,14,0,1,14,1003,0.0,0.99,0.0,-0.0,4,0,1,4,1013,0.0,1.0,0.0,-0.0
PF12765,PF10441:PF15917:PF12830,13,13,8,5,5,1000,0.62,0.99,0.62,0.61,2,2,11,0,1005,1.0,0.99,0.15,0.39
PF04201,PF10246:PF03034:PF16680,4,19,0,4,19,995,0.0,0.98,0.0,-0.01,1,0,4,1,1013,0.0,1.0,0.0,-0.0
PF07610,PF15082:PF04632:PF04001,1,3,0,1,3,1014,0.0,1.0,0.0,-0.0,0,0,1,0,1017,0,1.0,0.0,0
PF07542,PF03583:PF06159:PF01758,12,14,4,8,10,996,0.29,0.98,0.33,0.3,0,0,12,0,1006,0,0.99,0.0,0
PF11781,PF10441:PF14952:PF15027,6,7,2,4,5,1007,0.29,0.99,0.33,0.3,0,0,6,0,1012,0,0.99,0.0,0
PF12497,PF02166:PF02161:PF02155,3,8,3,0,5,1010,0.38,1.0,1.0,0.61,5,3,0,2,1013,0.6,1.0,1.0,0.77
PF08389,PF08506:PF03378:PF08767,39,24,15,24,9,970,0.62,0.97,0.38,0.47,12,7,32,5,974,0.58,0.96,0.18,0.31
PF16591,PF03605:PF03994:PF11697,0,2,0,0,2,1016,0.0,1.0,0,0,0,0,0,0,1018,0,1.0,0,0
PF00293,PF00828:PF01008:PF01725,79,51,22,57,29,910,0.43,0.92,0.28,0.3,12,10,69,2,937,0.83,0.93,0.13,0.31
PF06462,PF06398:PF00337:PF06816,8,36,3,5,33,977,0.08,0.96,0.38,0.16,8,3,5,5,1005,0.38,0.99,0.38,0.37
PF04392,PF01752:PF04355:PF14251,2,4,0,2,4,1012,0.0,0.99,0.0,-0.0,0,0,2,0,1016,0,1.0,0.0,0
PF17018,PF11210:PF04076:PF15340,0,2,0,0,2,1016,0.0,1.0,0,0,0,0,0,0,1018,0,1.0,0,0
PF00847,PF02362:PF14733:PF02701,26,37,12,14,25,967,0.32,0.96,0.46,0.37,5,3,23,2,990,0.6,0.98,0.12,0.26
PF06779,PF09444:PF15304:PF06586,0,3,0,0,3,1015,0.0,1.0,0,0,0,0,0,0,1018,0,1.0,0,0
PF14796,PF09066:PF14797:PF06375,6,9,3,3,6,1006,0.33,0.99,0.5,0.4,2,1,5,1,1011,0.5,0.99,0.17,0.29
PF07755,PF17083:PF02313:PF10612,0,0,0,0,0,1018,0,1.0,0,0,0,0,0,0,1018,0,1.0,0,0
PF06996,PF04214:PF11260:PF01733,0,16,0,0,16,1002,0.0,0.98,0,0,0,0,0,0,1018,0,1.0,0,0
PF17048,PF04734:PF02268:PF12590,8,21,8,0,13,997,0.38,0.99,1.0,0.61,1,1,7,0,1010,1.0,0.99,0.12,0.35
PF11650,PF14322:PF10109:PF10618,0,0,0,0,0,1018,0,1.0,0,0,0,0,0,0,1018,0,1.0,0,0
PF01514,PF01752:PF08479:PF10974,0,2,0,0,2,1016,0.0,1.0,0,0,0,0,0,0,1018,0,1.0,0,0
PF07505,PF03428:PF01913:PF17206,0,2,0,0,2,1016,0.0,1.0,0,0,0,0,0,0,1018,0,1.0,0,0
PF01043,PF07516:PF15994:PF15995,3,3,3,0,0,1015,1.0,1.0,1.0,1.0,0,0,3,0,1015,0,1.0,0.0,0
PF03615,PF15280:PF10177:PF15862,5,4,1,4,3,1010,0.25,0.99,0.2,0.22,1,1,4,0,1013,1.0,1.0,0.2,0.45
PF09312,PF13145:PF11924:PF04279,1,8,1,0,7,1010,0.12,0.99,1.0,0.35,1,1,0,0,1017,1.0,1.0,1.0,1.0
PF03049,PF05375:PF04204:PF16164,0,8,0,0,8,1010,0.0,0.99,0,0,1,0,0,1,1017,0.0,1.0,0,0
PF11707,PF16201:PF15277:PF09763,2,13,2,0,11,1005,0.15,0.99,1.0,0.39,7,0,2,7,1009,0.0,0.99,0.0,-0.0
PF08640,PF08216:PF10392:PF15296,10,14,3,7,11,997,0.21,0.98,0.3,0.24,2,2,8,0,1008,1.0,0.99,0.2,0.45
PF05731,PF05386:PF13271:PF06469,5,9,3,2,6,1007,0.33,0.99,0.6,0.44,2,2,3,0,1013,1.0,1.0,0.4,0.63
PF04170,PF05939:PF01706:PF03589,0,2,0,0,2,1016,0.0,1.0,0,0,0,0,0,0,1018,0,1.0,0,0
PF06473,PF05478:PF06189:PF11703,0,8,0,0,8,1010,0.0,0.99,0,0,0,0,0,0,1018,0,1.0,0,0
PF02335,PF00079:PF13532:PF06075,1,68,0,1,68,949,0.0,0.93,0.0,-0.01,9,0,1,9,1008,0.0,0.99,0.0,-0.0
PF04011,PF06744:PF04552:PF03922,0,1,0,0,1,1017,0.0,1.0,0,0,0,0,0,0,1018,0,1.0,0,0
PF12538,PF06724:PF08707:PF09108,0,1,0,0,1,1017,0.0,1.0,0,0,0,0,0,0,1018,0,1.0,0,0
PF05773,PF08572:PF12745:PF09186,32,10,7,25,3,983,0.7,0.97,0.22,0.38,1,1,31,0,986,1.0,0.97,0.03,0.17
PF16534,PF16557:PF02376:PF00157,3,13,3,0,10,1005,0.23,0.99,1.0,0.48,3,2,1,1,1014,0.67,1.0,0.67,0.67
PF01094,PF00211:PF01547:PF02608,65,70,33,32,37,916,0.47,0.93,0.51,0.45,12,8,57,4,949,0.67,0.94,0.12,0.27
PF04041,PF07400:PF13406:PF02367,2,3,0,2,3,1013,0.0,1.0,0.0,-0.0,0,0,2,0,1016,0,1.0,0.0,0
PF01344,PF10102:PF07646:PF02594,84,22,15,69,7,927,0.68,0.93,0.18,0.32,4,4,80,0,934,1.0,0.92,0.05,0.21
PF07888,PF04388:PF04108:PF17045,2,9,1,1,8,1008,0.11,0.99,0.5,0.23,0,0,2,0,1016,0,1.0,0.0,0
PF00695,PF10335:PF05973:PF06873,0,2,0,0,2,1016,0.0,1.0,0,0,0,0,0,0,1018,0,1.0,0,0
PF15490,PF14494:PF03573:PF16965,2,3,1,1,2,1014,0.33,1.0,0.5,0.41,0,0,2,0,1016,0,1.0,0.0,0
PF14383,PF12552:PF14309:PF08729,3,11,3,0,8,1007,0.27,0.99,1.0,0.52,7,2,1,5,1010,0.29,0.99,0.67,0.43
PF07443,PF13892:PF09111:PF09110,5,19,4,1,15,998,0.21,0.98,0.8,0.41,14,4,1,10,1003,0.29,0.99,0.8,0.47
PF12335,PF02141:PF03456:PF02893,7,57,6,1,51,960,0.11,0.95,0.86,0.29,27,5,2,22,989,0.19,0.98,0.71,0.36
PF02877,PF05406:PF08063:PF12174,19,30,19,0,11,988,0.63,0.99,1.0,0.79,6,6,13,0,999,1.0,0.99,0.32,0.56
PF07792,PF15912:PF09441:PF04357,2,3,0,2,3,1013,0.0,1.0,0.0,-0.0,0,0,2,0,1016,0,1.0,0.0,0
PF00003,PF00497:PF07562:PF01547,32,47,21,11,26,960,0.45,0.96,0.66,0.52,13,10,22,3,983,0.77,0.98,0.31,0.48
PF10467,PF11855:PF10084:PF05103,1,4,0,1,4,1013,0.0,1.0,0.0,-0.0,0,0,1,0,1017,0,1.0,0.0,0
PF15392,PF15082:PF10407:PF17096,0,3,0,0,3,1015,0.0,1.0,0,0,0,0,0,0,1018,0,1.0,0,0
PF02269,PF04646:PF08609:PF15067,11,15,3,8,12,995,0.2,0.98,0.27,0.22,1,1,10,0,1007,1.0,0.99,0.09,0.3
PF15699,PF02427:PF17032:PF10868,0,0,0,0,0,1018,0,1.0,0,0,0,0,0,0,1018,0,1.0,0,0
PF01197,PF15724:PF05825:PF06377,4,4,0,4,4,1010,0.0,0.99,0.0,-0.0,0,0,4,0,1014,0,1.0,0.0,0
PF02628,PF05630:PF03650:PF01774,12,23,4,8,19,987,0.17,0.97,0.33,0.23,3,2,10,1,1005,0.67,0.99,0.17,0.33
PF13331,PF11341:PF17049:PF05981,0,7,0,0,7,1011,0.0,0.99,0,0,0,0,0,0,1018,0,1.0,0,0
PF13750,PF02413:PF02554:PF01580,0,5,0,0,5,1013,0.0,1.0,0,0,0,0,0,0,1018,0,1.0,0,0
PF14631,PF10293:PF10351:PF15149,1,8,1,0,7,1010,0.12,0.99,1.0,0.35,5,1,0,4,1013,0.2,1.0,1.0,0.45
PF10606,PF10482:PF07001:PF06972,1,8,0,1,8,1009,0.0,0.99,0.0,-0.0,0,0,1,0,1017,0,1.0,0.0,0
PF03985,PF00074:PF02422:PF06373,10,4,0,10,4,1004,0.0,0.99,0.0,-0.01,0,0,10,0,1008,0,0.99,0.0,0
PF05064,PF13874:PF09787:PF03469,5,25,2,3,23,990,0.08,0.97,0.4,0.17,7,1,4,6,1007,0.14,0.99,0.2,0.16
PF14942,PF11027:PF06639:PF15179,2,3,0,2,3,1013,0.0,1.0,0.0,-0.0,0,0,2,0,1016,0,1.0,0.0,0
PF09992,PF02012:PF02333:PF09443,3,6,0,3,6,1009,0.0,0.99,0.0,-0.0,0,0,3,0,1015,0,1.0,0.0,0
PF05129,PF03760:PF15003:PF10203,10,7,1,9,6,1002,0.14,0.99,0.1,0.11,0,0,10,0,1008,0,0.99,0.0,0
PF05508,PF16944:PF10307:PF08655,1,8,0,1,8,1009,0.0,0.99,0.0,-0.0,0,0,1,0,1017,0,1.0,0.0,0
PF05206,PF11722:PF05253:PF02971,9,19,7,2,12,997,0.37,0.99,0.78,0.53,7,4,5,3,1006,0.57,0.99,0.44,0.5
PF00403,PF00080:PF00122:PF06090,31,117,25,6,92,895,0.21,0.9,0.81,0.38,15,8,23,7,980,0.53,0.97,0.26,0.36
PF03741,PF06420:PF12049:PF02576,7,1,0,7,1,1010,0.0,0.99,0.0,-0.0,0,0,7,0,1011,0,0.99,0.0,0
PF03233,PF03883:PF06639:PF16590,0,3,0,0,3,1015,0.0,1.0,0,0,0,0,0,0,1018,0,1.0,0,0
PF05669,PF11938:PF15028:PF05253,12,24,5,7,19,987,0.21,0.97,0.42,0.28,4,3,9,1,1005,0.75,0.99,0.25,0.43
PF04174,PF06082:PF10566:PF01752,0,2,0,0,2,1016,0.0,1.0,0,0,0,0,0,0,1018,0,1.0,0,0
PF02403,PF03129:PF04073:PF11573,26,45,12,14,33,959,0.27,0.95,0.46,0.33,9,6,20,3,989,0.67,0.98,0.23,0.38
PF15682,PF08843:PF15680:PF11057,1,0,0,1,0,1017,0,1.0,0.0,0,0,0,1,0,1017,0,1.0,0.0,0
PF09040,PF12515:PF12409:PF02130,5,22,4,1,18,995,0.18,0.98,0.8,0.38,5,3,2,2,1011,0.6,1.0,0.6,0.6
PF14360,PF09246:PF07786:PF04516,10,13,4,6,9,999,0.31,0.99,0.4,0.34,2,1,9,1,1007,0.5,0.99,0.1,0.22
PF04388,PF15905:PF07888:PF17045,8,2,0,8,2,1008,0.0,0.99,0.0,-0.0,1,0,8,1,1009,0.0,0.99,0.0,-0.0
PF11312,PF13013:PF08398:PF13094,1,3,0,1,3,1014,0.0,1.0,0.0,-0.0,0,0,1,0,1017,0,1.0,0.0,0
PF00625,PF02828:PF00595:PF11957,40,116,26,14,90,888,0.22,0.9,0.65,0.34,10,9,31,1,977,0.9,0.97,0.23,0.44
PF16682,PF16685:PF11262:PF11732,2,9,2,0,7,1009,0.22,0.99,1.0,0.47,6,0,2,6,1010,0.0,0.99,0.0,-0.0
PF00652,PF00535:PF00161:PF09837,48,68,37,11,31,939,0.54,0.96,0.77,0.63,9,5,43,4,966,0.56,0.95,0.1,0.23
PF07012,PF14362:PF14028:PF04848,0,3,0,0,3,1015,0.0,1.0,0,0,0,0,0,0,1018,0,1.0,0,0
PF11198,PF04001:PF11738:PF08183,0,0,0,0,0,1018,0,1.0,0,0,0,0,0,0,1018,0,1.0,0,0
PF07465,PF05797:PF02572:PF12805,0,2,0,0,2,1016,0.0,1.0,0,0,0,0,0,0,1018,0,1.0,0,0
PF07218,PF03729:PF05974:PF06798,0,0,0,0,0,1018,0,1.0,0,0,0,0,0,0,1018,0,1.0,0,0
PF14064,PF03922:PF01673:PF17014,0,0,0,0,0,1018,0,1.0,0,0,0,0,0,0,1018,0,1.0,0,0
PF14639,PF14635:PF14641:PF14632,13,14,13,0,1,1004,0.93,1.0,1.0,0.96,13,13,0,0,1005,1.0,1.0,1.0,1.0
PF01465,PF10377:PF07989:PF03801,15,23,5,10,18,985,0.22,0.97,0.33,0.26,3,2,13,1,1002,0.67,0.99,0.13,0.29
PF00684,PF05099:PF14901:PF05207,2,15,0,2,15,1001,0.0,0.98,0.0,-0.01,1,0,2,1,1015,0.0,1.0,0.0,-0.0
PF17024,PF08873:PF03457:PF00377,0,7,0,0,7,1011,0.0,0.99,0,0,1,0,0,1,1017,0.0,1.0,0,0
PF12534,PF11921:PF10428:PF01462,4,10,3,1,7,1007,0.3,0.99,0.75,0.47,2,1,3,1,1013,0.5,1.0,0.25,0.35
PF14304,PF08777:PF12220:PF08081,11,13,3,8,10,997,0.23,0.98,0.27,0.24,4,3,8,1,1006,0.75,0.99,0.27,0.45
PF07575,PF14778:PF05719:PF01756,10,25,8,2,17,991,0.32,0.98,0.8,0.5,3,1,9,2,1006,0.33,0.99,0.1,0.18
PF13361,PF00580:PF12014:PF16866,19,21,16,3,5,994,0.76,0.99,0.84,0.8,4,4,15,0,999,1.0,0.99,0.21,0.46
PF01048,PF17107:PF13374:PF06985,30,99,20,10,79,909,0.2,0.91,0.67,0.33,29,18,12,11,977,0.62,0.98,0.6,0.6
PF01794,PF08022:PF08030:PF03807,41,58,39,2,19,958,0.67,0.98,0.95,0.79,42,39,2,3,974,0.93,1.0,0.95,0.94
PF01339,PF12431:PF04397:PF12010,6,2,1,5,1,1011,0.5,0.99,0.17,0.29,0,0,6,0,1012,0,0.99,0.0,0
PF06495,PF12196:PF12220:PF08081,3,5,2,1,3,1012,0.4,1.0,0.67,0.51,1,1,2,0,1015,1.0,1.0,0.33,0.58
PF12269,PF16737:PF03172:PF12165,6,6,2,4,4,1008,0.33,0.99,0.33,0.33,1,1,5,0,1012,1.0,1.0,0.17,0.41
PF03116,PF14026:PF08025:PF06101,0,13,0,0,13,1005,0.0,0.99,0,0,0,0,0,0,1018,0,1.0,0,0
PF02457,PF15212:PF15117:PF16824,0,0,0,0,0,1018,0,1.0,0,0,0,0,0,0,1018,0,1.0,0,0
PF15925,PF12625:PF06983:PF17192,1,5,0,1,5,1012,0.0,0.99,0.0,-0.0,0,0,1,0,1017,0,1.0,0.0,0
PF12867,PF10017:PF03781:PF03102,6,16,5,1,11,1001,0.31,0.99,0.83,0.51,4,2,4,2,1010,0.5,0.99,0.33,0.41
PF15090,PF15292:PF07904:PF05548,1,5,0,1,5,1012,0.0,0.99,0.0,-0.0,0,0,1,0,1017,0,1.0,0.0,0
PF15992,PF04583:PF10683:PF07927,1,4,1,0,3,1014,0.25,1.0,1.0,0.5,1,1,0,0,1017,1.0,1.0,1.0,1.0
PF08934,PF01857:PF11934:PF01858,0,3,0,0,3,1015,0.0,1.0,0,0,1,0,0,1,1017,0.0,1.0,0,0
PF15125,PF15036:PF05558:PF17062,3,2,0,3,2,1013,0.0,1.0,0.0,-0.0,0,0,3,0,1015,0,1.0,0.0,0
PF15833,PF10412:PF08398:PF11593,1,3,0,1,3,1014,0.0,1.0,0.0,-0.0,0,0,1,0,1017,0,1.0,0.0,0
PF00669,PF01752:PF08453:PF13722,1,2,0,1,2,1015,0.0,1.0,0.0,-0.0,2,0,1,2,1015,0.0,1.0,0.0,-0.0
PF15463,PF17206:PF00669:PF11751,1,2,0,1,2,1015,0.0,1.0,0.0,-0.0,0,0,1,0,1017,0,1.0,0.0,0
PF13506,PF03088:PF01731:PF04109,8,22,1,7,21,989,0.05,0.97,0.12,0.06,6,1,7,5,1005,0.17,0.99,0.12,0.14
PF06687,PF13805:PF01111:PF10775,7,16,2,5,14,997,0.12,0.98,0.29,0.18,0,0,7,0,1011,0,0.99,0.0,0
PF02705,PF03407:PF04130:PF12899,15,51,10,5,41,962,0.2,0.95,0.67,0.35,6,2,13,4,999,0.33,0.98,0.13,0.2
PF14748,PF03807:PF11221:PF01619,6,30,5,1,25,987,0.17,0.97,0.83,0.37,7,4,2,3,1009,0.57,1.0,0.67,0.61
PF07945,PF09280:PF01206:PF05903,0,26,0,0,26,992,0.0,0.97,0,0,3,0,0,3,1015,0.0,1.0,0,0
PF15302,PF02106:PF12904:PF15398,0,1,0,0,1,1017,0.0,1.0,0,0,0,0,0,0,1018,0,1.0,0,0
PF01250,PF10276:PF09805:PF10018,16,24,5,11,19,983,0.21,0.97,0.31,0.24,2,2,14,0,1002,1.0,0.99,0.12,0.35
PF08952,PF16726:PF16776:PF12456,4,12,2,2,10,1004,0.17,0.99,0.5,0.28,0,0,4,0,1014,0,1.0,0.0,0
PF10906,PF12615:PF06681:PF15775,2,0,0,2,0,1016,0,1.0,0.0,0,0,0,2,0,1016,0,1.0,0.0,0
PF15472,PF15175:PF08945:PF09365,0,2,0,0,2,1016,0.0,1.0,0,0,0,0,0,0,1018,0,1.0,0,0
PF04230,PF03151:PF15078:PF14616,2,33,0,2,33,983,0.0,0.97,0.0,-0.01,3,0,2,3,1013,0.0,1.0,0.0,-0.0
PF04812,PF04814:PF04813:PF12360,3,6,3,0,3,1012,0.5,1.0,1.0,0.71,1,1,2,0,1015,1.0,1.0,0.33,0.58
PF14322,PF05513:PF11751:PF04355,0,1,0,0,1,1017,0.0,1.0,0,0,0,0,0,0,1018,0,1.0,0,0
PF14363,PF14629:PF08740:PF12037,9,20,3,6,17,992,0.15,0.98,0.33,0.21,2,1,8,1,1008,0.5,0.99,0.11,0.23
PF12241,PF02277:PF14882:PF07157,1,3,0,1,3,1014,0.0,1.0,0.0,-0.0,0,0,1,0,1017,0,1.0,0.0,0
PF07177,PF12610:PF00186:PF00723,10,24,5,5,19,989,0.21,0.98,0.5,0.31,0,0,10,0,1008,0,0.99,0.0,0
PF05498,PF02704:PF06206:PF06749,7,12,1,6,11,1000,0.08,0.98,0.14,0.1,2,1,6,1,1010,0.5,0.99,0.14,0.26
PF07638,PF15870:PF13423:PF02037,0,71,0,0,71,947,0.0,0.93,0,0,11,0,0,11,1007,0.0,0.99,0,0
PF14951,PF14950:PF14911:PF01447,1,2,0,1,2,1015,0.0,1.0,0.0,-0.0,0,0,1,0,1017,0,1.0,0.0,0
PF10510,PF05719:PF06783:PF08661,13,15,3,10,12,993,0.2,0.98,0.23,0.2,1,1,12,0,1005,1.0,0.99,0.08,0.28
PF13795,PF03548:PF03050:PF10974,1,3,0,1,3,1014,0.0,1.0,0.0,-0.0,0,0,1,0,1017,0,1.0,0.0,0
PF02792,PF03842:PF14967:PF14931,6,3,2,4,1,1011,0.67,1.0,0.33,0.47,0,0,6,0,1012,0,0.99,0.0,0
PF14051,PF14061:PF12998:PF16737,8,23,4,4,19,991,0.17,0.98,0.5,0.29,2,1,7,1,1009,0.5,0.99,0.12,0.25
PF07515,PF04941:PF14344:PF15108,0,4,0,0,4,1014,0.0,1.0,0,0,0,0,0,0,1018,0,1.0,0,0
PF01144,PF02886:PF10022:PF01273,19,19,5,14,14,985,0.26,0.97,0.26,0.25,12,3,16,9,990,0.25,0.98,0.16,0.19
PF12638,PF00537:PF06232:PF12643,5,8,2,3,6,1007,0.25,0.99,0.4,0.31,0,0,5,0,1013,0,1.0,0.0,0
PF10511,PF08831:PF09307:PF02961,1,6,1,0,5,1012,0.17,1.0,1.0,0.41,3,0,1,3,1014,0.0,1.0,0.0,-0.0
PF06516,PF06108:PF06912:PF06232,5,13,1,4,12,1001,0.08,0.98,0.2,0.12,0,0,5,0,1013,0,1.0,0.0,0
PF06594,PF10554:PF06506:PF13876,1,5,0,1,5,1012,0.0,0.99,0.0,-0.0,0,0,1,0,1017,0,1.0,0.0,0
PF01650,PF05191:PF07722:PF07542,18,23,4,14,19,981,0.17,0.97,0.22,0.18,4,3,15,1,999,0.75,0.98,0.17,0.35
PF09795,PF02453:PF00717:PF04137,0,46,0,0,46,972,0.0,0.95,0,0,6,0,0,6,1012,0.0,0.99,0,0
PF02206,PF11548:PF14948:PF09414,8,10,2,6,8,1002,0.2,0.99,0.25,0.22,3,1,7,2,1008,0.33,0.99,0.12,0.2
PF09997,PF11057:PF14645:PF14945,0,3,0,0,3,1015,0.0,1.0,0,0,0,0,0,0,1018,0,1.0,0,0
PF14288,PF02364:PF14498:PF06964,9,24,9,0,15,994,0.38,0.99,1.0,0.61,8,5,4,3,1006,0.62,0.99,0.56,0.59
PF02429,PF05111:PF10578:PF11386,0,1,0,0,1,1017,0.0,1.0,0,0,0,0,0,0,1018,0,1.0,0,0
PF03749,PF03601:PF17015:PF12628,2,0,0,2,0,1016,0,1.0,0.0,0,0,0,2,0,1016,0,1.0,0.0,0
PF05546,PF12049:PF15342:PF07223,8,5,0,8,5,1005,0.0,0.99,0.0,-0.01,0,0,8,0,1010,0,0.99,0.0,0
PF11691,PF01846:PF08786:PF01862,0,21,0,0,21,997,0.0,0.98,0,0,0,0,0,0,1018,0,1.0,0,0
PF03000,PF09494:PF00917:PF09237,16,34,9,7,25,977,0.26,0.97,0.56,0.37,5,3,13,2,1000,0.6,0.99,0.19,0.33
PF07352,PF01325:PF04984:PF15150,1,3,0,1,3,1014,0.0,1.0,0.0,-0.0,0,0,1,0,1017,0,1.0,0.0,0
PF14465,PF15082:PF15259:PF15997,2,4,1,1,3,1013,0.25,1.0,0.5,0.35,0,0,2,0,1016,0,1.0,0.0,0
PF15504,PF06890:PF11751:PF07157,1,0,0,1,0,1017,0,1.0,0.0,0,0,0,1,0,1017,0,1.0,0.0,0
PF08712,PF01106:PF01113:PF01386,15,26,15,0,11,992,0.58,0.99,1.0,0.76,2,2,13,0,1003,1.0,0.99,0.13,0.36
PF02709,PF13733:PF15048:PF00535,26,71,22,4,49,943,0.31,0.95,0.85,0.49,14,13,13,1,991,0.93,0.99,0.5,0.68
PF06146,PF04892:PF09699:PF00419,1,1,0,1,1,1016,0.0,1.0,0.0,-0.0,0,0,1,0,1017,0,1.0,0.0,0
PF05463,PF05111:PF10630:PF03842,1,1,0,1,1,1016,0.0,1.0,0.0,-0.0,0,0,1,0,1017,0,1.0,0.0,0
PF00405,PF09439:PF16470:PF00408,9,40,3,6,37,972,0.07,0.96,0.33,0.14,7,1,8,6,1003,0.14,0.99,0.11,0.12
PF10863,PF15776:PF15143:PF15135,0,3,0,0,3,1015,0.0,1.0,0,0,0,0,0,0,1018,0,1.0,0,0
PF12373,PF09991:PF09085:PF08848,0,0,0,0,0,1018,0,1.0,0,0,0,0,0,0,1018,0,1.0,0,0
PF02760,PF13553:PF02758:PF05132,1,22,1,0,21,996,0.05,0.98,1.0,0.21,5,1,0,4,1013,0.2,1.0,1.0,0.45
PF10965,PF07295:PF00713:PF04112,0,9,0,0,9,1009,0.0,0.99,0,0,0,0,0,0,1018,0,1.0,0,0
PF03554,PF01303:PF09252:PF15848,0,0,0,0,0,1018,0,1.0,0,0,0,0,0,0,1018,0,1.0,0,0
PF15206,PF02277:PF05974:PF06082,0,3,0,0,3,1015,0.0,1.0,0,0,0,0,0,0,1018,0,1.0,0,0
PF00856,PF10440:PF05964:PF09273,109,33,27,82,6,903,0.82,0.91,0.25,0.42,5,5,104,0,909,1.0,0.9,0.05,0.2
PF15802,PF12243:PF06283:PF02226,1,17,1,0,16,1001,0.06,0.98,1.0,0.24,0,0,1,0,1017,0,1.0,0.0,0
PF15539,PF09332:PF16944:PF11496,0,15,0,0,15,1003,0.0,0.99,0,0,0,0,0,0,1018,0,1.0,0,0
PF00057,PF16472:PF07593:PF07679,74,92,40,34,52,892,0.43,0.92,0.54,0.44,5,5,69,0,944,1.0,0.93,0.07,0.25
PF06534,PF06535:PF17187:PF05023,0,11,0,0,11,1007,0.0,0.99,0,0,0,0,0,0,1018,0,1.0,0,0
PF02910,PF00890:PF02424:PF12831,17,50,16,1,34,967,0.32,0.97,0.94,0.54,8,3,14,5,996,0.38,0.98,0.18,0.25
PF08722,PF12696:PF11022:PF06745,1,1,1,0,0,1017,1.0,1.0,1.0,1.0,0,0,1,0,1017,0,1.0,0.0,0
PF15273,PF15997:PF11261:PF15249,1,15,1,0,14,1003,0.07,0.99,1.0,0.26,0,0,1,0,1017,0,1.0,0.0,0
PF16888,PF04740:PF13780:PF15150,0,0,0,0,0,1018,0,1.0,0,0,0,0,0,0,1018,0,1.0,0,0
PF05238,PF02106:PF15302:PF15165,0,0,0,0,0,1018,0,1.0,0,0,0,0,0,0,1018,0,1.0,0,0
PF12261,PF00582:PF14076:PF02181,0,55,0,0,55,963,0.0,0.95,0,0,15,0,0,15,1003,0.0,0.99,0,0
PF08847,PF03379:PF07327:PF11317,0,2,0,0,2,1016,0.0,1.0,0,0,0,0,0,0,1018,0,1.0,0,0
PF04650,PF13876:PF08021:PF07505,1,1,0,1,1,1016,0.0,1.0,0.0,-0.0,0,0,1,0,1017,0,1.0,0.0,0
PF05141,PF06155:PF09084:PF02668,9,48,6,3,42,967,0.12,0.96,0.67,0.28,14,4,5,10,999,0.29,0.99,0.44,0.35
PF15018,PF15063:PF04852:PF12926,1,5,0,1,5,1012,0.0,0.99,0.0,-0.0,0,0,1,0,1017,0,1.0,0.0,0
PF03413,PF07504:PF02128:PF00548,4,15,2,2,13,1001,0.13,0.99,0.5,0.25,3,2,2,1,1013,0.67,1.0,0.5,0.58
PF02520,PF01277:PF04107:PF03103,3,12,0,3,12,1003,0.0,0.99,0.0,-0.01,1,0,3,1,1014,0.0,1.0,0.0,-0.0
PF02150,PF01096:PF15694:PF10660,15,19,9,6,10,993,0.47,0.98,0.6,0.53,2,1,14,1,1002,0.5,0.99,0.07,0.18
PF01627,PF06376:PF04520:PF04716,8,14,3,5,11,999,0.21,0.98,0.38,0.28,1,1,7,0,1010,1.0,0.99,0.12,0.35
PF16387,PF00686:PF04378:PF13340,1,40,1,0,39,978,0.03,0.96,1.0,0.16,1,1,0,0,1017,1.0,1.0,1.0,1.0
PF03722,PF03723:PF00372:PF16126,7,11,7,0,4,1007,0.64,1.0,1.0,0.8,5,5,2,0,1011,1.0,1.0,0.71,0.84
PF06529,PF12498:PF11785:PF08601,2,5,2,0,3,1013,0.4,1.0,1.0,0.63,2,2,0,0,1016,1.0,1.0,1.0,1.0
PF15485,PF17206:PF13094:PF08497,0,1,0,0,1,1017,0.0,1.0,0,0,1,0,0,1,1017,0.0,1.0,0,0
PF03715,PF04139:PF15369:PF04000,13,24,7,6,17,988,0.29,0.98,0.54,0.39,4,2,11,2,1003,0.5,0.99,0.15,0.27
PF00577,PF13953:PF00345:PF15130,5,6,5,0,1,1012,0.83,1.0,1.0,0.91,3,3,2,0,1013,1.0,1.0,0.6,0.77
PF13769,PF11617:PF03764:PF13475,0,27,0,0,27,991,0.0,0.97,0,0,8,0,0,8,1010,0.0,0.99,0,0
PF14577,PF14576:PF14767:PF04927,2,2,1,1,1,1015,0.5,1.0,0.5,0.5,0,0,2,0,1016,0,1.0,0.0,0
PF07228,PF00654:PF09335:PF11303,9,49,4,5,45,964,0.08,0.95,0.44,0.17,8,2,7,6,1003,0.25,0.99,0.22,0.23
PF08015,PF13266:PF09922:PF09923,2,3,0,2,3,1013,0.0,1.0,0.0,-0.0,0,0,2,0,1016,0,1.0,0.0,0
PF00270,PF16783:PF13959:PF10927,179,24,24,155,0,839,1.0,0.85,0.13,0.34,3,3,176,0,839,1.0,0.83,0.02,0.12
PF12726,PF10407:PF15407:PF09462,4,2,1,3,1,1013,0.5,1.0,0.25,0.35,0,0,4,0,1014,0,1.0,0.0,0
PF12432,PF10395:PF15793:PF15735,4,5,3,1,2,1012,0.6,1.0,0.75,0.67,1,1,3,0,1014,1.0,1.0,0.25,0.5
PF03954,PF08391:PF09006:PF06023,1,1,0,1,1,1016,0.0,1.0,0.0,-0.0,0,0,1,0,1017,0,1.0,0.0,0
PF08285,PF05336:PF08566:PF04119,2,10,1,1,9,1007,0.1,0.99,0.5,0.22,0,0,2,0,1016,0,1.0,0.0,0
PF00143,PF12020:PF00965:PF02284,1,11,0,1,11,1006,0.0,0.99,0.0,-0.0,1,0,1,1,1016,0.0,1.0,0.0,-0.0
PF08913,PF09141:PF01608:PF16511,4,30,4,0,26,988,0.13,0.97,1.0,0.36,11,4,0,7,1007,0.36,0.99,1.0,0.6
PF07731,PF07732:PF00394:PF04578,50,61,47,3,14,954,0.77,0.98,0.94,0.84,42,41,9,1,967,0.98,0.99,0.82,0.89
PF02747,PF00705:PF09284:PF08523,11,21,9,2,12,995,0.43,0.99,0.82,0.59,3,1,10,2,1005,0.33,0.99,0.09,0.17
PF15167,PF04363:PF03869:PF07321,2,3,2,0,1,1015,0.67,1.0,1.0,0.82,2,2,0,0,1016,1.0,1.0,1.0,1.0
PF13592,PF01668:PF17050:PF15106,0,4,0,0,4,1014,0.0,1.0,0,0,1,0,0,1,1017,0.0,1.0,0,0
PF02184,PF17004:PF10383:PF05843,4,32,1,3,31,983,0.03,0.97,0.25,0.08,4,1,3,3,1011,0.25,0.99,0.25,0.25
PF01729,PF02749:PF05173:PF02222,10,19,10,0,9,999,0.53,0.99,1.0,0.72,4,3,7,1,1007,0.75,0.99,0.3,0.47
PF03983,PF12026:PF08397:PF09431,7,17,1,6,16,995,0.06,0.98,0.14,0.08,2,1,6,1,1010,0.5,0.99,0.14,0.26
PF00812,PF03195:PF07172:PF13841,6,9,3,3,6,1006,0.33,0.99,0.5,0.4,0,0,6,0,1012,0,0.99,0.0,0
PF15974,PF08374:PF16492:PF07953,2,5,2,0,3,1013,0.4,1.0,1.0,0.63,1,1,1,0,1016,1.0,1.0,0.5,0.71
PF09545,PF08108:PF02066:PF06103,0,0,0,0,0,1018,0,1.0,0,0,0,0,0,0,1018,0,1.0,0,0
PF06009,PF06008:PF00055:PF00054,2,31,2,0,29,987,0.06,0.97,1.0,0.25,10,2,0,8,1008,0.2,0.99,1.0,0.45
PF09224,PF09361:PF06505:PF09611,0,0,0,0,0,1018,0,1.0,0,0,0,0,0,0,1018,0,1.0,0,0
PF08560,PF10212:PF15246:PF16704,4,4,2,2,2,1012,0.5,1.0,0.5,0.5,1,1,3,0,1014,1.0,1.0,0.25,0.5
PF04569,PF10295:PF03525:PF06724,0,3,0,0,3,1015,0.0,1.0,0,0,0,0,0,0,1018,0,1.0,0,0
PF13601,PF04014:PF01021:PF11124,0,2,0,0,2,1016,0.0,1.0,0,0,0,0,0,0,1018,0,1.0,0,0
PF01618,PF14224:PF07476:PF03050,3,0,0,3,0,1015,0,1.0,0.0,0,0,0,3,0,1015,0,1.0,0.0,0
PF06224,PF09614:PF08707:PF15182,0,1,0,0,1,1017,0.0,1.0,0,0,0,0,0,0,1018,0,1.0,0,0
PF13564,PF15003:PF03760:PF03823,9,5,2,7,3,1006,0.4,0.99,0.22,0.29,0,0,9,0,1009,0,0.99,0.0,0
PF05845,PF03471:PF05772:PF12413,0,6,0,0,6,1012,0.0,0.99,0,0,0,0,0,0,1018,0,1.0,0,0
PF14766,PF14768:PF14767:PF01386,3,2,0,3,2,1013,0.0,1.0,0.0,-0.0,0,0,3,0,1015,0,1.0,0.0,0
PF15747,PF15730:PF15080:PF12873,0,2,0,0,2,1016,0.0,1.0,0,0,0,0,0,0,1018,0,1.0,0,0
PF09972,PF09988:PF04461:PF10962,0,0,0,0,0,1018,0,1.0,0,0,0,0,0,0,1018,0,1.0,0,0
PF01652,PF08534:PF05047:PF04176,27,33,14,13,19,972,0.42,0.97,0.52,0.45,9,5,22,4,987,0.56,0.97,0.19,0.31
PF01682,PF09067:PF12772:PF16066,12,2,1,11,1,1005,0.5,0.99,0.08,0.2,1,1,11,0,1006,1.0,0.99,0.08,0.29
PF06276,PF04183:PF11693:PF14232,2,4,2,0,2,1014,0.5,1.0,1.0,0.71,0,0,2,0,1016,0,1.0,0.0,0
PF03150,PF00950:PF06808:PF01032,8,12,5,3,7,1003,0.42,0.99,0.62,0.51,3,2,6,1,1009,0.67,0.99,0.25,0.41
PF03154,PF08674:PF01448:PF00135,7,88,5,2,83,928,0.06,0.92,0.71,0.19,11,4,3,7,1004,0.36,0.99,0.57,0.45
PF04421,PF14996:PF15161:PF15938,6,2,2,4,0,1012,1.0,1.0,0.33,0.58,1,1,5,0,1012,1.0,1.0,0.17,0.41
PF16672,PF14645:PF10340:PF15360,6,4,1,5,3,1009,0.25,0.99,0.17,0.2,0,0,6,0,1012,0,0.99,0.0,0
PF16742,PF16556:PF15037:PF07923,0,9,0,0,9,1009,0.0,0.99,0,0,0,0,0,0,1018,0,1.0,0,0
PF03435,PF05222:PF04455:PF12769,23,20,8,15,12,983,0.4,0.97,0.35,0.36,7,2,21,5,990,0.29,0.97,0.09,0.15
PF00069,PF07714:PF00314:PF00139,346,188,152,194,36,636,0.81,0.77,0.44,0.47,24,24,322,0,672,1.0,0.68,0.07,0.22
PF04573,PF09297:PF09296:PF11788,11,21,4,7,17,990,0.19,0.98,0.36,0.25,7,4,7,3,1004,0.57,0.99,0.36,0.45
PF15048,PF10044:PF04138:PF09837,2,1,0,2,1,1015,0.0,1.0,0.0,-0.0,0,0,2,0,1016,0,1.0,0.0,0
PF15907,PF06342:PF15800:PF05719,0,6,0,0,6,1012,0.0,0.99,0,0,1,0,0,1,1017,0.0,1.0,0,0
PF00023,PF12796:PF13606:PF00710,108,249,104,4,145,765,0.42,0.85,0.96,0.58,55,43,65,12,898,0.78,0.92,0.4,0.52
PF13009,PF03590:PF01455:PF01706,0,4,0,0,4,1014,0.0,1.0,0,0,1,0,0,1,1017,0.0,1.0,0,0
PF15779,PF14914:PF10578:PF15362,4,3,1,3,2,1012,0.33,1.0,0.25,0.29,0,0,4,0,1014,0,1.0,0.0,0
PF12746,PF08186:PF05756:PF04485,0,1,0,0,1,1017,0.0,1.0,0,0,0,0,0,0,1018,0,1.0,0,0
PF04094,PF04195:PF07430:PF03578,4,8,2,2,6,1008,0.25,0.99,0.5,0.35,0,0,4,0,1014,0,1.0,0.0,0
PF03476,PF03473:PF00266:PF03475,13,56,13,0,43,962,0.23,0.96,1.0,0.47,10,7,6,3,1002,0.7,0.99,0.54,0.61
PF15279,PF14909:PF09816:PF04087,0,8,0,0,8,1010,0.0,0.99,0,0,2,0,0,2,1016,0.0,1.0,0,0
PF00742,PF03447:PF01958:PF10000,9,17,7,2,10,999,0.41,0.99,0.78,0.56,11,2,7,9,1000,0.18,0.98,0.22,0.19
PF12660,PF06469:PF14844:PF12657,4,25,3,1,22,992,0.12,0.98,0.75,0.29,6,1,3,5,1009,0.17,0.99,0.25,0.2
PF14214,PF05970:PF02689:PF13538,24,42,18,6,24,970,0.43,0.97,0.75,0.55,9,8,16,1,993,0.89,0.98,0.33,0.54
PF09154,PF16657:PF11941:PF16028,3,1,1,2,0,1015,1.0,1.0,0.33,0.58,1,1,2,0,1015,1.0,1.0,0.33,0.58
PF05609,PF15370:PF04736:PF10853,1,8,1,0,7,1010,0.12,0.99,1.0,0.35,0,0,1,0,1017,0,1.0,0.0,0
PF15653,PF15143:PF15367:PF13753,0,2,0,0,2,1016,0.0,1.0,0,0,0,0,0,0,1018,0,1.0,0,0
PF09748,PF05254:PF03386:PF04418,14,14,5,9,9,995,0.36,0.98,0.36,0.35,0,0,14,0,1004,0,0.99,0.0,0
PF00875,PF03441:PF12546:PF03009,18,41,11,7,30,970,0.27,0.96,0.61,0.39,3,3,15,0,1000,1.0,0.99,0.17,0.41
PF03275,PF05611:PF17062:PF14877,1,4,0,1,4,1013,0.0,1.0,0.0,-0.0,0,0,1,0,1017,0,1.0,0.0,0
PF08148,PF15790:PF16739:PF02559,9,11,4,5,7,1002,0.36,0.99,0.44,0.4,2,2,7,0,1009,1.0,0.99,0.22,0.47
PF04940,PF08376:PF07700:PF16214,4,22,1,3,21,993,0.05,0.98,0.25,0.1,4,1,3,3,1011,0.25,0.99,0.25,0.25
PF11259,PF08708:PF10109:PF04451,0,1,0,0,1,1017,0.0,1.0,0,0,0,0,0,0,1018,0,1.0,0,0
PF07603,PF05673:PF10216:PF15091,0,0,0,0,0,1018,0,1.0,0,0,0,0,0,0,1018,0,1.0,0,0
PF16209,PF16212:PF00690:PF12409,42,89,40,2,49,927,0.45,0.95,0.95,0.64,24,18,24,6,970,0.75,0.97,0.43,0.55
PF13576,PF08744:PF10933:PF11988,0,0,0,0,0,1018,0,1.0,0,0,0,0,0,0,1018,0,1.0,0,0
PF10161,PF15884:PF11029:PF04402,1,8,0,1,8,1009,0.0,0.99,0.0,-0.0,2,0,1,2,1015,0.0,1.0,0.0,-0.0
PF07367,PF15610:PF12200:PF17106,2,4,0,2,4,1012,0.0,0.99,0.0,-0.0,1,0,2,1,1015,0.0,1.0,0.0,-0.0
PF17060,PF08411:PF08479:PF00947,1,13,0,1,13,1004,0.0,0.99,0.0,-0.0,0,0,1,0,1017,0,1.0,0.0,0
PF16906,PF00159:PF07106:PF09809,13,14,5,8,9,996,0.36,0.98,0.38,0.36,2,2,11,0,1005,1.0,0.99,0.15,0.39
PF07527,PF12533:PF01586:PF09427,6,7,2,4,5,1007,0.29,0.99,0.33,0.3,1,1,5,0,1012,1.0,1.0,0.17,0.41
PF00861,PF05915:PF02704:PF00321,9,7,1,8,6,1003,0.14,0.99,0.11,0.12,1,0,9,1,1008,0.0,0.99,0.0,-0.0
PF13430,PF09232:PF17032:PF02950,3,1,0,3,1,1014,0.0,1.0,0.0,-0.0,0,0,3,0,1015,0,1.0,0.0,0
PF04133,PF03071:PF16282:PF02245,5,19,2,3,17,996,0.11,0.98,0.4,0.2,2,1,4,1,1012,0.5,1.0,0.2,0.31
PF08659,PF14765:PF08242:PF00109,41,72,40,1,32,945,0.56,0.97,0.98,0.72,37,31,10,6,971,0.84,0.98,0.76,0.79
PF12259,PF07530:PF16012:PF08284,5,31,4,1,27,986,0.13,0.97,0.8,0.31,5,2,3,3,1010,0.4,0.99,0.4,0.4
PF16275,PF08067:PF16274:PF16544,9,8,4,5,4,1005,0.5,0.99,0.44,0.47,1,1,8,0,1009,1.0,0.99,0.11,0.33
PF02363,PF02736:PF14432:PF06957,6,59,4,2,55,957,0.07,0.94,0.67,0.2,14,3,3,11,1001,0.21,0.99,0.5,0.32
PF00613,PF00792:PF00454:PF00794,33,65,32,1,33,952,0.49,0.97,0.97,0.68,24,24,9,0,985,1.0,0.99,0.73,0.85
PF08590,PF17146:PF07145:PF01713,14,25,12,2,13,991,0.48,0.99,0.86,0.64,7,6,8,1,1003,0.86,0.99,0.43,0.6
PF04461,PF05783:PF12549:PF11352,0,12,0,0,12,1006,0.0,0.99,0,0,0,0,0,0,1018,0,1.0,0,0
PF02304,PF09095:PF01361:PF11084,0,3,0,0,3,1015,0.0,1.0,0,0,0,0,0,0,1018,0,1.0,0,0
PF00899,PF16420:PF10585:PF08825,57,18,18,39,0,961,1.0,0.96,0.32,0.55,2,2,55,0,961,1.0,0.95,0.04,0.18
PF07657,PF01414:PF17102:PF11380,3,18,3,0,15,1000,0.17,0.99,1.0,0.41,7,1,2,6,1009,0.14,0.99,0.33,0.21
PF14895,PF00964:PF09419:PF02245,3,15,1,2,14,1001,0.07,0.98,0.33,0.14,0,0,3,0,1015,0,1.0,0.0,0
PF10767,PF17025:PF01120:PF07829,0,20,0,0,20,998,0.0,0.98,0,0,0,0,0,0,1018,0,1.0,0,0
PF13897,PF03765:PF04707:PF03371,8,39,8,0,31,979,0.21,0.97,1.0,0.45,9,3,5,6,1004,0.33,0.99,0.38,0.35
PF14602,PF12464:PF06426:PF13720,26,21,12,14,9,983,0.57,0.98,0.46,0.5,4,4,22,0,992,1.0,0.98,0.15,0.39
PF13305,PF15149:PF08150:PF14613,0,6,0,0,6,1012,0.0,0.99,0,0,1,0,0,1,1017,0.0,1.0,0,0
PF14099,PF12716:PF03576:PF09056,1,4,0,1,4,1013,0.0,1.0,0.0,-0.0,0,0,1,0,1017,0,1.0,0.0,0
PF08367,PF16187:PF04627:PF05193,7,63,7,0,56,955,0.11,0.94,1.0,0.32,24,2,5,22,989,0.08,0.97,0.29,0.14
PF15075,PF10127:PF07326:PF02951,1,5,0,1,5,1012,0.0,0.99,0.0,-0.0,0,0,1,0,1017,0,1.0,0.0,0
PF15354,PF05292:PF07676:PF09902,0,30,0,0,30,988,0.0,0.97,0,0,4,0,0,4,1014,0.0,1.0,0,0
PF02965,PF02607:PF02310:PF01642,5,7,5,0,2,1011,0.71,1.0,1.0,0.84,7,5,0,2,1011,0.71,1.0,1.0,0.84
PF13036,PF13946:PF05943:PF11794,0,1,0,0,1,1017,0.0,1.0,0,0,0,0,0,0,1018,0,1.0,0,0
PF04815,PF08033:PF04810:PF04811,26,27,24,2,3,989,0.89,1.0,0.92,0.9,26,23,3,3,989,0.88,0.99,0.88,0.88
PF02138,PF06469:PF14844:PF15787,34,26,23,11,3,981,0.88,0.99,0.68,0.77,8,8,26,0,984,1.0,0.97,0.24,0.48
PF08022,PF08030:PF01794:PF08414,42,54,42,0,12,964,0.78,0.99,1.0,0.88,39,39,3,0,976,1.0,1.0,0.93,0.96
PF08441,PF01839:PF00882:PF01788,17,19,17,0,2,999,0.89,1.0,1.0,0.94,0,0,17,0,1001,0,0.98,0.0,0
PF16759,PF01660:PF15392:PF09247,7,8,1,6,7,1004,0.12,0.99,0.14,0.13,0,0,7,0,1011,0,0.99,0.0,0
PF17204,PF02931:PF11861:PF11515,0,84,0,0,84,934,0.0,0.92,0,0,18,0,0,18,1000,0.0,0.98,0,0
PF15193,PF15107:PF15754:PF15114,0,0,0,0,0,1018,0,1.0,0,0,0,0,0,0,1018,0,1.0,0,0
PF03850,PF01015:PF01813:PF01199,10,22,5,5,17,991,0.23,0.98,0.5,0.33,6,2,8,4,1004,0.33,0.99,0.2,0.25
PF06865,PF09510:PF11214:PF02601,0,2,0,0,2,1016,0.0,1.0,0,0,0,0,0,0,1018,0,1.0,0,0
PF03468,PF03801:PF04108:PF15905,6,9,1,5,8,1004,0.11,0.99,0.17,0.13,1,0,6,1,1011,0.0,0.99,0.0,-0.0
PF11789,PF05191:PF12483:PF00830,6,17,3,3,14,998,0.18,0.98,0.5,0.29,1,1,5,0,1012,1.0,1.0,0.17,0.41
PF05827,PF16692:PF16401:PF10022,8,12,1,7,11,999,0.08,0.98,0.12,0.09,0,0,8,0,1010,0,0.99,0.0,0
PF10483,PF05129:PF07344:PF06382,3,11,1,2,10,1005,0.09,0.99,0.33,0.17,0,0,3,0,1015,0,1.0,0.0,0
PF03869,PF04363:PF15167:PF15842,3,2,2,1,0,1015,1.0,1.0,0.67,0.82,2,2,1,0,1015,1.0,1.0,0.67,0.82
PF02176,PF16673:PF02263:PF08941,15,26,8,7,18,985,0.31,0.98,0.53,0.39,4,4,11,0,1003,1.0,0.99,0.27,0.51
PF02009,PF08027:PF01387:PF06217,0,1,0,0,1,1017,0.0,1.0,0,0,0,0,0,0,1018,0,1.0,0,0
PF06582,PF09042:PF06583:PF06789,4,5,3,1,2,1012,0.6,1.0,0.75,0.67,1,1,3,0,1014,1.0,1.0,0.25,0.5
PF13434,PF00743:PF01544:PF07938,17,75,14,3,61,940,0.19,0.94,0.82,0.37,16,12,5,4,997,0.75,0.99,0.71,0.72
PF11450,PF06277:PF15521:PF02210,0,40,0,0,40,978,0.0,0.96,0,0,0,0,0,0,1018,0,1.0,0,0
PF09724,PF10282:PF09494:PF07350,13,22,7,6,15,990,0.32,0.98,0.54,0.4,4,4,9,0,1005,1.0,0.99,0.31,0.55
PF09922,PF11306:PF05835:PF05461,0,17,0,0,17,1001,0.0,0.98,0,0,3,0,0,3,1015,0.0,1.0,0,0
PF00805,PF13599:PF11601:PF16885,17,8,3,14,5,996,0.38,0.98,0.18,0.25,3,2,15,1,1000,0.67,0.98,0.12,0.28
PF04855,PF16421:PF08781:PF12336,13,20,7,6,13,992,0.35,0.98,0.54,0.43,2,2,11,0,1005,1.0,0.99,0.15,0.39
PF11593,PF01913:PF05939:PF03244,2,1,0,2,1,1015,0.0,1.0,0.0,-0.0,0,0,2,0,1016,0,1.0,0.0,0
PF05467,PF11037:PF13148:PF09109,0,0,0,0,0,1018,0,1.0,0,0,0,0,0,0,1018,0,1.0,0,0
PF02898,PF09791:PF09045:PF01613,10,22,4,6,18,990,0.18,0.98,0.4,0.26,1,1,9,0,1008,1.0,0.99,0.1,0.31
PF09069,PF09068:PF16577:PF12744,6,7,6,0,1,1011,0.86,1.0,1.0,0.93,2,2,4,0,1012,1.0,1.0,0.33,0.58
PF05177,PF15509:PF12886:PF15622,4,5,1,3,4,1010,0.2,0.99,0.25,0.22,0,0,4,0,1014,0,1.0,0.0,0
PF08548,PF13946:PF03241:PF03944,1,3,1,0,2,1015,0.33,1.0,1.0,0.58,0,0,1,0,1017,0,1.0,0.0,0
PF01596,PF15011:PF04930:PF04061,15,15,6,9,9,994,0.4,0.98,0.4,0.39,4,4,11,0,1003,1.0,0.99,0.27,0.51
PF08742,PF00094:PF12714:PF01826,29,48,28,1,20,969,0.58,0.98,0.97,0.74,28,26,3,2,987,0.93,1.0,0.9,0.91
PF10623,PF04076:PF04740:PF15337,0,3,0,0,3,1015,0.0,1.0,0,0,0,0,0,0,1018,0,1.0,0,0
PF03635,PF02990:PF00793:PF07096,12,40,7,5,33,973,0.17,0.96,0.58,0.31,5,3,9,2,1004,0.6,0.99,0.25,0.38
PF12541,PF09365:PF15050:PF03065,0,5,0,0,5,1013,0.0,1.0,0,0,0,0,0,0,1018,0,1.0,0,0
PF00757,PF01030:PF14843:PF12398,7,15,7,0,8,1003,0.47,0.99,1.0,0.68,5,5,2,0,1011,1.0,1.0,0.71,0.84
PF01747,PF14306:PF00273:PF09164,9,9,9,0,0,1009,1.0,1.0,1.0,1.0,0,0,9,0,1009,0,0.99,0.0,0
PF06405,PF09585:PF06876:PF02371,3,4,0,3,4,1011,0.0,0.99,0.0,-0.0,0,0,3,0,1015,0,1.0,0.0,0
PF03556,PF01160:PF04819:PF01245,16,14,6,10,8,994,0.43,0.98,0.38,0.39,2,2,14,0,1002,1.0,0.99,0.12,0.35
PF05349,PF01610:PF03743:PF06406,4,9,2,2,7,1007,0.22,0.99,0.5,0.33,0,0,4,0,1014,0,1.0,0.0,0
PF02917,PF09109:PF11124:PF11593,2,2,0,2,2,1014,0.0,1.0,0.0,-0.0,0,0,2,0,1016,0,1.0,0.0,0
PF11937,PF02560:PF01234:PF01774,4,16,2,2,14,1000,0.12,0.98,0.5,0.24,1,0,4,1,1013,0.0,1.0,0.0,-0.0
PF02911,PF00551:PF00171:PF00465,11,119,10,1,109,898,0.08,0.89,0.91,0.26,29,8,3,21,986,0.28,0.98,0.73,0.44
PF04818,PF01805:PF16566:PF09750,29,46,19,10,27,962,0.41,0.96,0.66,0.5,14,9,20,5,984,0.64,0.98,0.31,0.44
PF00859,PF10524:PF03166:PF03165,2,19,2,0,17,999,0.11,0.98,1.0,0.32,9,2,0,7,1009,0.22,0.99,1.0,0.47
PF05577,PF00232:PF00248:PF00314,28,101,19,9,82,908,0.19,0.91,0.68,0.33,24,11,17,13,977,0.46,0.97,0.39,0.41
PF05242,PF06008:PF16094:PF07953,0,12,0,0,12,1006,0.0,0.99,0,0,2,0,0,2,1016,0.0,1.0,0,0
PF07955,PF07327:PF17124:PF03379,2,2,0,2,2,1014,0.0,1.0,0.0,-0.0,0,0,2,0,1016,0,1.0,0.0,0
PF00131,PF14967:PF02106:PF10285,1,2,0,1,2,1015,0.0,1.0,0.0,-0.0,0,0,1,0,1017,0,1.0,0.0,0
PF14634,PF00025:PF13445:PF15840,17,101,12,5,89,912,0.12,0.91,0.71,0.26,24,10,7,14,987,0.42,0.98,0.59,0.49
PF08303,PF08302:PF09511:PF17167,3,12,3,0,9,1006,0.25,0.99,1.0,0.5,4,3,0,1,1014,0.75,1.0,1.0,0.87
PF06679,PF04736:PF00726:PF15724,0,2,0,0,2,1016,0.0,1.0,0,0,0,0,0,0,1018,0,1.0,0,0
PF05425,PF13753:PF17206:PF07209,0,2,0,0,2,1016,0.0,1.0,0,0,0,0,0,0,1018,0,1.0,0,0
PF06983,PF09459:PF03379:PF08847,2,2,0,2,2,1014,0.0,1.0,0.0,-0.0,0,0,2,0,1016,0,1.0,0.0,0
PF15184,PF15776:PF11210:PF04911,1,4,0,1,4,1013,0.0,1.0,0.0,-0.0,0,0,1,0,1017,0,1.0,0.0,0
PF12221,PF09611:PF15529:PF05401,0,1,0,0,1,1017,0.0,1.0,0,0,0,0,0,0,1018,0,1.0,0,0
PF17079,PF04966:PF16756:PF08691,0,1,0,0,1,1017,0.0,1.0,0,0,0,0,0,0,1018,0,1.0,0,0
PF06387,PF09784:PF06109:PF15744,3,0,0,3,0,1015,0,1.0,0.0,0,0,0,3,0,1015,0,1.0,0.0,0
PF00754,PF09458:PF14200:PF05592,49,32,18,31,14,955,0.56,0.96,0.37,0.43,4,3,46,1,968,0.75,0.95,0.06,0.21
PF06964,PF14498:PF16862:PF08427,14,27,5,9,22,982,0.19,0.97,0.36,0.24,9,3,11,6,998,0.33,0.98,0.21,0.26
PF13972,PF09122:PF06617:PF11127,1,4,0,1,4,1013,0.0,1.0,0.0,-0.0,0,0,1,0,1017,0,1.0,0.0,0
PF09033,PF09230:PF05422:PF14831,0,8,0,0,8,1010,0.0,0.99,0,0,0,0,0,0,1018,0,1.0,0,0
PF10540,PF06292:PF08150:PF08165,9,16,6,3,10,999,0.38,0.99,0.67,0.49,4,3,6,1,1008,0.75,0.99,0.33,0.5
PF03576,PF08738:PF09056:PF12351,0,7,0,0,7,1011,0.0,0.99,0,0,0,0,0,0,1018,0,1.0,0,0
PF00491,PF13023:PF16906:PF14027,19,25,9,10,16,983,0.36,0.97,0.47,0.4,10,8,11,2,997,0.8,0.99,0.42,0.58
PF07539,PF17034:PF10350:PF02368,11,16,3,8,13,994,0.19,0.98,0.27,0.22,4,2,9,2,1005,0.5,0.99,0.18,0.3
PF12180,PF13851:PF13870:PF12845,1,13,1,0,12,1005,0.08,0.99,1.0,0.28,0,0,1,0,1017,0,1.0,0.0,0
PF07359,PF10974:PF06890:PF01752,0,2,0,0,2,1016,0.0,1.0,0,0,0,0,0,0,1018,0,1.0,0,0
PF15718,PF15302:PF11035:PF16720,2,3,0,2,3,1013,0.0,1.0,0.0,-0.0,0,0,2,0,1016,0,1.0,0.0,0
PF07806,PF01114:PF00799:PF15722,0,3,0,0,3,1015,0.0,1.0,0,0,0,0,0,0,1018,0,1.0,0,0
PF15739,PF07989:PF15651:PF04423,5,16,1,4,15,998,0.06,0.98,0.2,0.1,1,0,5,1,1012,0.0,0.99,0.0,-0.0
PF02230,PF08975:PF00045:PF03980,24,28,10,14,18,976,0.36,0.97,0.42,0.37,3,2,22,1,993,0.67,0.98,0.08,0.23
PF16043,PF06637:PF15275:PF14722,1,12,0,1,12,1005,0.0,0.99,0.0,-0.0,0,0,1,0,1017,0,1.0,0.0,0
PF15222,PF12226:PF11678:PF02899,0,6,0,0,6,1012,0.0,0.99,0,0,0,0,0,0,1018,0,1.0,0,0
PF10321,PF02118:PF03409:PF10323,7,13,3,4,10,1001,0.23,0.99,0.43,0.31,1,1,6,0,1011,1.0,0.99,0.14,0.38
PF04789,PF15134:PF15068:PF16576,1,3,0,1,3,1014,0.0,1.0,0.0,-0.0,0,0,1,0,1017,0,1.0,0.0,0
PF08456,PF02572:PF13995:PF05100,3,2,1,2,1,1014,0.5,1.0,0.33,0.41,0,0,3,0,1015,0,1.0,0.0,0
PF09511,PF08302:PF08303:PF06165,10,6,4,6,2,1006,0.67,0.99,0.4,0.51,3,3,7,0,1008,1.0,0.99,0.3,0.55
PF11892,PF14793:PF06082:PF11775,0,0,0,0,0,1018,0,1.0,0,0,0,0,0,0,1018,0,1.0,0,0
PF11786,PF11787:PF11785:PF12498,4,4,4,0,0,1014,1.0,1.0,1.0,1.0,3,3,1,0,1014,1.0,1.0,0.75,0.87
PF11162,PF02217:PF15337:PF15485,0,6,0,0,6,1012,0.0,0.99,0,0,0,0,0,0,1018,0,1.0,0,0
PF16954,PF15008:PF01147:PF05300,2,4,0,2,4,1012,0.0,0.99,0.0,-0.0,0,0,2,0,1016,0,1.0,0.0,0
PF07382,PF14600:PF06483:PF13148,3,0,0,3,0,1015,0,1.0,0.0,0,0,0,3,0,1015,0,1.0,0.0,0
PF16123,PF14864:PF14863:PF00753,13,72,13,0,59,946,0.18,0.94,1.0,0.41,4,2,11,2,1003,0.5,0.99,0.15,0.27
PF02013,PF02156:PF16990:PF00734,5,41,5,0,36,977,0.12,0.96,1.0,0.34,7,3,2,4,1009,0.43,0.99,0.6,0.5
PF15314,PF15863:PF14877:PF08945,0,5,0,0,5,1013,0.0,1.0,0,0,0,0,0,0,1018,0,1.0,0,0
PF08730,PF15825:PF10974:PF16001,0,1,0,0,1,1017,0.0,1.0,0,0,0,0,0,0,1018,0,1.0,0,0
PF06070,PF01580:PF06505:PF16325,1,6,0,1,6,1011,0.0,0.99,0.0,-0.0,0,0,1,0,1017,0,1.0,0.0,0
PF03006,PF04178:PF13088:PF00810,21,26,6,15,20,977,0.23,0.97,0.29,0.24,5,3,18,2,995,0.6,0.98,0.14,0.29
PF10036,PF15374:PF14713:PF02106,7,2,0,7,2,1009,0.0,0.99,0.0,-0.0,0,0,7,0,1011,0,0.99,0.0,0
PF07596,PF07960:PF05453:PF04384,0,3,0,0,3,1015,0.0,1.0,0,0,0,0,0,0,1018,0,1.0,0,0
PF06218,PF06699:PF09422:PF10381,6,19,4,2,15,997,0.21,0.98,0.67,0.37,4,1,5,3,1009,0.25,0.99,0.17,0.2
PF10266,PF04922:PF05742:PF06728,3,20,1,2,19,996,0.05,0.98,0.33,0.12,4,1,2,3,1012,0.25,1.0,0.33,0.29
PF06420,PF10330:PF11489:PF11255,1,2,0,1,2,1015,0.0,1.0,0.0,-0.0,0,0,1,0,1017,0,1.0,0.0,0
PF08674,PF00135:PF11095:PF03154,0,87,0,0,87,931,0.0,0.91,0,0,7,0,0,7,1011,0.0,0.99,0,0
PF03045,PF07816:PF07896:PF10018,8,18,4,4,14,996,0.22,0.98,0.5,0.33,3,2,6,1,1009,0.67,0.99,0.25,0.41
PF00041,PF12453:PF12567:PF07965,91,5,4,87,1,926,0.8,0.91,0.04,0.17,2,2,89,0,927,1.0,0.91,0.02,0.14
PF15127,PF10616:PF08936:PF15088,1,0,0,1,0,1017,0,1.0,0.0,0,0,0,1,0,1017,0,1.0,0.0,0
PF11030,PF02632:PF14760:PF05416,0,8,0,0,8,1010,0.0,0.99,0,0,1,0,0,1,1017,0.0,1.0,0,0
PF15796,PF08912:PF15368:PF07765,4,13,4,0,9,1005,0.31,0.99,1.0,0.55,2,2,2,0,1014,1.0,1.0,0.5,0.71
PF01499,PF03354:PF05571:PF00672,0,24,0,0,24,994,0.0,0.98,0,0,2,0,0,2,1016,0.0,1.0,0,0
PF06082,PF03090:PF06251:PF03428,0,0,0,0,0,1018,0,1.0,0,0,0,0,0,0,1018,0,1.0,0,0
PF11710,PF04910:PF07967:PF08600,15,16,3,12,13,990,0.19,0.98,0.2,0.18,7,1,14,6,997,0.14,0.98,0.07,0.09
PF10775,PF10310:PF13741:PF08656,0,3,0,0,3,1015,0.0,1.0,0,0,2,0,0,2,1016,0.0,1.0,0,0
PF12798,PF12837:PF11953:PF07338,0,5,0,0,5,1013,0.0,1.0,0,0,0,0,0,0,1018,0,1.0,0,0
PF05078,PF05910:PF04720:PF04690,3,17,1,2,16,999,0.06,0.98,0.33,0.13,3,1,2,2,1013,0.33,1.0,0.33,0.33
PF13812,PF17177:PF12921:PF16953,57,43,28,29,15,946,0.65,0.96,0.49,0.54,6,5,52,1,960,0.83,0.95,0.09,0.26
PF12280,PF08561:PF12020:PF00965,5,10,1,4,9,1004,0.1,0.99,0.2,0.14,1,0,5,1,1012,0.0,0.99,0.0,-0.0
PF07831,PF02885:PF00591:PF08125,2,13,2,0,11,1005,0.15,0.99,1.0,0.39,5,2,0,3,1013,0.4,1.0,1.0,0.63
PF06907,PF15831:PF15063:PF13933,2,0,0,2,0,1016,0,1.0,0.0,0,0,0,2,0,1016,0,1.0,0.0,0
PF10558,PF16860:PF03073:PF02569,4,16,0,4,16,998,0.0,0.98,0.0,-0.01,1,0,4,1,1013,0.0,1.0,0.0,-0.0
PF01973,PF00002:PF06243:PF06299,0,56,0,0,56,962,0.0,0.94,0,0,0,0,0,0,1018,0,1.0,0,0
PF04080,PF07712:PF09778:PF06172,10,2,0,10,2,1006,0.0,0.99,0.0,-0.0,0,0,10,0,1008,0,0.99,0.0,0
PF14433,PF09932:PF16233:PF11769,0,0,0,0,0,1018,0,1.0,0,0,0,0,0,0,1018,0,1.0,0,0
PF01906,PF08738:PF09252:PF07955,3,2,0,3,2,1013,0.0,1.0,0.0,-0.0,0,0,3,0,1015,0,1.0,0.0,0
PF16259,PF17188:PF01752:PF12019,0,3,0,0,3,1015,0.0,1.0,0,0,0,0,0,0,1018,0,1.0,0,0
PF14740,PF04194:PF07929:PF01753,3,71,2,1,69,946,0.03,0.93,0.67,0.13,10,1,2,9,1006,0.1,0.99,0.33,0.18
PF01880,PF11245:PF15281:PF10412,2,3,0,2,3,1013,0.0,1.0,0.0,-0.0,0,0,2,0,1016,0,1.0,0.0,0
PF11496,PF09762:PF17045:PF12757,9,3,0,9,3,1006,0.0,0.99,0.0,-0.01,0,0,9,0,1009,0,0.99,0.0,0
PF01823,PF01522:PF07502:PF01735,22,46,5,17,41,955,0.11,0.94,0.23,0.13,4,1,21,3,993,0.25,0.98,0.05,0.1
PF03666,PF16019:PF10188:PF02731,6,8,1,5,7,1005,0.12,0.99,0.17,0.14,0,0,6,0,1012,0,0.99,0.0,0
PF04103,PF13908:PF10185:PF09783,8,20,4,4,16,994,0.2,0.98,0.5,0.31,1,1,7,0,1010,1.0,0.99,0.12,0.35
PF00307,PF02187:PF03271:PF14923,74,24,18,56,6,938,0.75,0.94,0.24,0.41,7,7,67,0,944,1.0,0.93,0.09,0.3
PF12075,PF12297:PF16830:PF16574,8,2,1,7,1,1009,0.5,0.99,0.12,0.25,0,0,8,0,1010,0,0.99,0.0,0
PF08211,PF01872:PF00383:PF01249,3,57,3,0,54,961,0.05,0.95,1.0,0.22,21,1,2,20,995,0.05,0.98,0.33,0.12
PF01405,PF02119:PF16824:PF08497,0,2,0,0,2,1016,0.0,1.0,0,0,0,0,0,0,1018,0,1.0,0,0
PF06155,PF05141:PF10609:PF02668,10,55,9,1,46,962,0.16,0.95,0.9,0.37,10,6,4,4,1004,0.6,0.99,0.6,0.6
PF13178,PF10580:PF06614:PF15157,6,2,1,5,1,1011,0.5,0.99,0.17,0.29,1,1,5,0,1012,1.0,1.0,0.17,0.41
PF06475,PF15207:PF15175:PF14690,0,1,0,0,1,1017,0.0,1.0,0,0,0,0,0,0,1018,0,1.0,0,0
PF09677,PF12477:PF11130:PF16325,0,1,0,0,1,1017,0.0,1.0,0,0,0,0,0,0,1018,0,1.0,0,0
PF07748,PF09261:PF01074:PF03669,21,27,21,0,6,991,0.78,0.99,1.0,0.88,20,19,2,1,996,0.95,1.0,0.9,0.93
PF03918,PF15104:PF14985:PF17124,1,2,0,1,2,1015,0.0,1.0,0.0,-0.0,0,0,1,0,1017,0,1.0,0.0,0
PF09995,PF07542:PF03583:PF07470,10,30,8,2,22,986,0.27,0.98,0.8,0.45,2,2,8,0,1008,1.0,0.99,0.2,0.45
PF02017,PF12278:PF12253:PF02163,13,12,3,10,9,996,0.25,0.98,0.23,0.23,1,1,12,0,1005,1.0,0.99,0.08,0.28
PF08318,PF04437:PF16061:PF11571,14,18,4,10,14,990,0.22,0.98,0.29,0.24,6,1,13,5,999,0.17,0.98,0.07,0.1
PF07540,PF12329:PF10377:PF03801,4,19,1,3,18,996,0.05,0.98,0.25,0.11,5,1,3,4,1010,0.2,0.99,0.25,0.22
PF06481,PF02790:PF02433:PF06146,3,12,2,1,10,1005,0.17,0.99,0.67,0.33,5,1,2,4,1011,0.2,0.99,0.33,0.26
PF13436,PF13441:PF15419:PF13705,2,6,2,0,4,1012,0.33,1.0,1.0,0.58,2,2,0,0,1016,1.0,1.0,1.0,1.0
PF02870,PF01267:PF01035:PF01548,4,21,4,0,17,997,0.19,0.98,1.0,0.43,4,0,4,4,1010,0.0,0.99,0.0,-0.0
PF04766,PF02809:PF04366:PF05928,0,31,0,0,31,987,0.0,0.97,0,0,5,0,0,5,1013,0.0,1.0,0,0
PF04852,PF03760:PF02044:PF16594,5,2,2,3,0,1013,1.0,1.0,0.4,0.63,0,0,5,0,1013,0,1.0,0.0,0
PF06483,PF07382:PF14600:PF08520,0,4,0,0,4,1014,0.0,1.0,0,0,0,0,0,0,1018,0,1.0,0,0
PF12936,PF05178:PF16041:PF15279,8,14,8,0,6,1004,0.57,0.99,1.0,0.75,1,1,7,0,1010,1.0,0.99,0.12,0.35
PF00045,PF01471:PF08924:PF15225,26,32,22,4,10,982,0.69,0.99,0.85,0.76,2,2,24,0,992,1.0,0.98,0.08,0.27
PF10334,PF10337:PF12449:PF17167,7,13,6,1,7,1004,0.46,0.99,0.86,0.63,1,0,7,1,1010,0.0,0.99,0.0,-0.0
PF11927,PF03162:PF00436:PF07896,13,26,3,10,23,982,0.12,0.97,0.23,0.15,4,2,11,2,1003,0.5,0.99,0.15,0.27
PF05022,PF08640:PF08161:PF12169,11,13,4,7,9,998,0.31,0.98,0.36,0.33,3,3,8,0,1007,1.0,0.99,0.27,0.52
PF17081,PF00770:PF12724:PF08843,0,1,0,0,1,1017,0.0,1.0,0,0,0,0,0,0,1018,0,1.0,0,0
PF03114,PF08824:PF08397:PF12026,28,9,2,26,7,983,0.22,0.97,0.07,0.11,2,2,26,0,990,1.0,0.97,0.07,0.26
PF04320,PF17164:PF04222:PF11130,1,0,0,1,0,1017,0,1.0,0.0,0,0,0,1,0,1017,0,1.0,0.0,0
PF06742,PF06863:PF07171:PF07364,3,3,0,3,3,1012,0.0,0.99,0.0,-0.0,3,0,3,3,1012,0.0,0.99,0.0,-0.0
PF15020,PF14961:PF15069:PF14674,6,0,0,6,0,1012,0,0.99,0.0,0,0,0,6,0,1012,0,0.99,0.0,0
PF08543,PF03070:PF02110:PF02152,18,25,13,5,12,988,0.52,0.98,0.72,0.6,5,5,13,0,1000,1.0,0.99,0.28,0.52
PF02731,PF10188:PF04189:PF09789,8,15,1,7,14,996,0.07,0.98,0.12,0.08,1,1,7,0,1010,1.0,0.99,0.12,0.35
PF08387,PF03478:PF08268:PF07734,23,40,12,11,28,967,0.3,0.96,0.52,0.38,13,6,17,7,988,0.46,0.98,0.26,0.34
PF02566,PF06912:PF08787:PF07544,5,13,1,4,12,1001,0.08,0.98,0.2,0.12,0,0,5,0,1013,0,1.0,0.0,0
PF03065,PF06355:PF09614:PF07192,1,2,0,1,2,1015,0.0,1.0,0.0,-0.0,0,0,1,0,1017,0,1.0,0.0,0
PF05892,PF13330:PF01033:PF01223,0,36,0,0,36,982,0.0,0.96,0,0,16,0,0,16,1002,0.0,0.98,0,0
PF05127,PF13718:PF13725:PF08351,15,13,12,3,1,1002,0.92,1.0,0.8,0.86,12,12,3,0,1003,1.0,1.0,0.8,0.89
PF14675,PF14676:PF14680:PF14679,1,1,1,0,0,1017,1.0,1.0,1.0,1.0,1,1,0,0,1017,1.0,1.0,1.0,1.0
PF07571,PF09830:PF08731:PF11928,6,11,1,5,10,1002,0.09,0.99,0.17,0.12,0,0,6,0,1012,0,0.99,0.0,0
PF03860,PF07177:PF02932:PF11086,0,74,0,0,74,944,0.0,0.93,0,0,5,0,0,5,1013,0.0,1.0,0,0
PF09118,PF07250:PF06588:PF10102,7,11,6,1,5,1006,0.55,0.99,0.86,0.68,1,1,6,0,1011,1.0,0.99,0.14,0.38
PF13699,PF04476:PF10412:PF07243,0,0,0,0,0,1018,0,1.0,0,0,0,0,0,0,1018,0,1.0,0,0
PF12116,PF06007:PF00555:PF12241,1,5,0,1,5,1012,0.0,0.99,0.0,-0.0,0,0,1,0,1017,0,1.0,0.0,0
PF08043,PF10530:PF08063:PF00978,2,12,1,1,11,1005,0.08,0.99,0.5,0.2,0,0,2,0,1016,0,1.0,0.0,0
PF15445,PF15447:PF12377:PF03011,1,1,1,0,0,1017,1.0,1.0,1.0,1.0,1,1,0,0,1017,1.0,1.0,1.0,1.0
PF11214,PF05939:PF00669:PF06890,0,1,0,0,1,1017,0.0,1.0,0,0,0,0,0,0,1018,0,1.0,0,0
PF13371,PF08755:PF08495:PF09346,1,14,1,0,13,1004,0.07,0.99,1.0,0.27,2,1,0,1,1016,0.5,1.0,1.0,0.71
PF11068,PF00014:PF14085:PF14046,0,48,0,0,48,970,0.0,0.95,0,0,0,0,0,0,1018,0,1.0,0,0
PF03130,PF10508:PF16689:PF11336,1,12,1,0,11,1006,0.08,0.99,1.0,0.29,1,1,0,0,1017,1.0,1.0,1.0,1.0
PF02397,PF02719:PF08186:PF15100,2,5,2,0,3,1013,0.4,1.0,1.0,0.63,0,0,2,0,1016,0,1.0,0.0,0
PF16641,PF01465:PF15908:PF12455,1,22,1,0,21,996,0.05,0.98,1.0,0.21,4,1,0,3,1014,0.25,1.0,1.0,0.5
PF12018,PF10156:PF14868:PF10253,8,7,3,5,4,1006,0.43,0.99,0.38,0.4,1,0,8,1,1009,0.0,0.99,0.0,-0.0
PF01057,PF16071:PF15235:PF08744,2,1,1,1,0,1016,1.0,1.0,0.5,0.71,0,0,2,0,1016,0,1.0,0.0,0
PF09749,PF06658:PF02284:PF06172,10,8,4,6,4,1004,0.5,0.99,0.4,0.44,1,1,9,0,1008,1.0,0.99,0.1,0.31
PF00261,PF12718:PF13851:PF03285,7,4,1,6,3,1008,0.25,0.99,0.14,0.18,0,0,7,0,1011,0,0.99,0.0,0
PF15285,PF04111:PF04422:PF04432,1,12,0,1,12,1005,0.0,0.99,0.0,-0.0,0,0,1,0,1017,0,1.0,0.0,0
PF05795,PF13206:PF15377:PF12301,2,1,0,2,1,1015,0.0,1.0,0.0,-0.0,0,0,2,0,1016,0,1.0,0.0,0
PF03332,PF01775:PF05724:PF05742,16,18,6,10,12,990,0.33,0.98,0.38,0.34,3,3,13,0,1002,1.0,0.99,0.19,0.43
PF00457,PF10503:PF01083:PF03664,5,25,5,0,20,993,0.2,0.98,1.0,0.44,5,3,2,2,1011,0.6,1.0,0.6,0.6
PF10517,PF03351:PF01082:PF03712,6,25,6,0,19,993,0.24,0.98,1.0,0.49,18,2,4,16,996,0.11,0.98,0.33,0.18
PF02504,PF14983:PF03406:PF08548,3,3,0,3,3,1012,0.0,0.99,0.0,-0.0,0,0,3,0,1015,0,1.0,0.0,0
PF00868,PF00927:PF01841:PF13910,7,27,7,0,20,991,0.26,0.98,1.0,0.5,10,7,0,3,1008,0.7,1.0,1.0,0.84
PF08982,PF13876:PF01913:PF16861,3,5,0,3,5,1010,0.0,0.99,0.0,-0.0,0,0,3,0,1015,0,1.0,0.0,0
PF05294,PF08093:PF17112:PF16804,0,1,0,0,1,1017,0.0,1.0,0,0,0,0,0,0,1018,0,1.0,0,0
PF03895,PF14396:PF01032:PF12399,4,12,3,1,9,1005,0.25,0.99,0.75,0.43,3,2,2,1,1013,0.67,1.0,0.5,0.58
PF00340,PF00711:PF03784:PF01387,2,0,0,2,0,1016,0,1.0,0.0,0,0,0,2,0,1016,0,1.0,0.0,0
PF06382,PF02101:PF07253:PF09784,1,7,0,1,7,1010,0.0,0.99,0.0,-0.0,0,0,1,0,1017,0,1.0,0.0,0
PF02358,PF00982:PF12036:PF12460,28,28,22,6,6,984,0.79,0.99,0.79,0.78,2,2,26,0,990,1.0,0.97,0.07,0.26
PF01745,PF16958:PF01715:PF14849,2,17,2,0,15,1001,0.12,0.99,1.0,0.34,0,0,2,0,1016,0,1.0,0.0,0
PF07558,PF14818:PF15624:PF15914,3,12,3,0,9,1006,0.25,0.99,1.0,0.5,2,1,2,1,1014,0.5,1.0,0.33,0.41
PF00152,PF01336:PF16900:PF09170,70,54,40,30,14,934,0.74,0.96,0.57,0.63,12,8,62,4,944,0.67,0.94,0.11,0.26
PF15767,PF13270:PF11460:PF06989,2,3,0,2,3,1013,0.0,1.0,0.0,-0.0,0,0,2,0,1016,0,1.0,0.0,0
PF04264,PF13722:PF08497:PF15843,0,0,0,0,0,1018,0,1.0,0,0,0,0,0,0,1018,0,1.0,0,0
PF00707,PF03479:PF03066:PF08636,9,14,2,7,12,997,0.14,0.98,0.22,0.17,0,0,9,0,1009,0,0.99,0.0,0
PF02355,PF07549:PF13721:PF08299,4,6,3,1,3,1011,0.5,1.0,0.75,0.61,3,3,1,0,1014,1.0,1.0,0.75,0.87
PF03516,PF12881:PF06671:PF02420,1,1,0,1,1,1016,0.0,1.0,0.0,-0.0,0,0,1,0,1017,0,1.0,0.0,0
PF07780,PF11861:PF14978:PF01728,14,43,14,0,29,975,0.33,0.97,1.0,0.56,12,11,3,1,1003,0.92,1.0,0.79,0.85
PF00673,PF00281:PF13259:PF11937,23,25,19,4,6,989,0.76,0.99,0.83,0.79,6,5,18,1,994,0.83,0.98,0.22,0.42
PF03088,PF13506:PF01758:PF03662,14,26,5,9,21,983,0.19,0.97,0.36,0.25,2,2,12,0,1004,1.0,0.99,0.14,0.38
PF16363,PF04321:PF11803:PF01370,38,77,27,11,50,930,0.35,0.94,0.71,0.47,11,10,28,1,979,0.91,0.97,0.26,0.48
PF02516,PF04516:PF04981:PF06830,17,11,3,14,8,993,0.27,0.98,0.18,0.21,2,1,16,1,1000,0.5,0.98,0.06,0.17
PF15148,PF15293:PF02305:PF08964,1,2,0,1,2,1015,0.0,1.0,0.0,-0.0,0,0,1,0,1017,0,1.0,0.0,0
PF04923,PF06417:PF03587:PF02038,4,16,2,2,14,1000,0.12,0.98,0.5,0.24,4,2,2,2,1012,0.5,1.0,0.5,0.5
PF06381,PF03592:PF11863:PF02465,0,0,0,0,0,1018,0,1.0,0,0,0,0,0,0,1018,0,1.0,0,0
PF11816,PF15512:PF13271:PF09453,16,17,5,11,12,990,0.29,0.98,0.31,0.29,4,2,14,2,1000,0.5,0.98,0.12,0.24
PF03649,PF03459:PF09383:PF00471,4,5,2,2,3,1011,0.4,1.0,0.5,0.44,2,2,2,0,1014,1.0,1.0,0.5,0.71
PF00100,PF00530:PF01055:PF14845,55,78,26,29,52,911,0.33,0.92,0.47,0.36,14,12,43,2,961,0.86,0.96,0.22,0.42
PF03546,PF07891:PF05337:PF10198,1,7,0,1,7,1010,0.0,0.99,0.0,-0.0,0,0,1,0,1017,0,1.0,0.0,0
PF10087,PF06009:PF00055:PF16033,0,27,0,0,27,991,0.0,0.97,0,0,3,0,0,3,1015,0.0,1.0,0,0
PF05261,PF12827:PF03065:PF08026,1,1,0,1,1,1016,0.0,1.0,0.0,-0.0,0,0,1,0,1017,0,1.0,0.0,0
PF08039,PF05488:PF01638:PF13753,1,1,0,1,1,1016,0.0,1.0,0.0,-0.0,0,0,1,0,1017,0,1.0,0.0,0
PF03343,PF03386:PF08746:PF04006,9,16,4,5,12,997,0.25,0.98,0.44,0.33,2,1,8,1,1008,0.5,0.99,0.11,0.23
PF08740,PF14629:PF08542:PF14363,14,28,5,9,23,981,0.18,0.97,0.36,0.24,6,4,10,2,1002,0.67,0.99,0.29,0.43
PF17049,PF15856:PF14885:PF15141,1,2,0,1,2,1015,0.0,1.0,0.0,-0.0,0,0,1,0,1017,0,1.0,0.0,0
PF14683,PF06045:PF14686:PF09284,17,15,15,2,0,1001,1.0,1.0,0.88,0.94,11,11,6,0,1001,1.0,0.99,0.65,0.8
PF01526,PF16732:PF13482:PF11862,1,2,0,1,2,1015,0.0,1.0,0.0,-0.0,0,0,1,0,1017,0,1.0,0.0,0
PF08011,PF01136:PF09829:PF08411,0,2,0,0,2,1016,0.0,1.0,0,0,0,0,0,0,1018,0,1.0,0,0
PF01287,PF11937:PF02560:PF00590,15,22,3,12,19,984,0.14,0.97,0.2,0.15,5,1,14,4,999,0.2,0.98,0.07,0.11
PF05719,PF14778:PF07096:PF14954,5,9,2,3,7,1006,0.22,0.99,0.4,0.29,1,0,5,1,1012,0.0,0.99,0.0,-0.0
PF14935,PF10244:PF01716:PF02372,2,10,1,1,9,1007,0.1,0.99,0.5,0.22,0,0,2,0,1016,0,1.0,0.0,0
PF05334,PF04087:PF10496:PF12253,1,16,0,1,16,1001,0.0,0.98,0.0,-0.0,1,0,1,1,1016,0.0,1.0,0.0,-0.0
PF10999,PF05874:PF15553:PF03588,0,2,0,0,2,1016,0.0,1.0,0,0,0,0,0,0,1018,0,1.0,0,0
PF06512,PF11933:PF11404:PF16905,5,7,4,1,3,1010,0.57,1.0,0.8,0.67,3,3,2,0,1013,1.0,1.0,0.6,0.77
PF10508,PF16689:PF05956:PF03130,10,3,1,9,2,1006,0.33,0.99,0.1,0.18,3,1,9,2,1006,0.33,0.99,0.1,0.18
PF11018,PF15955:PF15868:PF14935,1,9,0,1,9,1008,0.0,0.99,0.0,-0.0,0,0,1,0,1017,0,1.0,0.0,0
PF02133,PF13023:PF05241:PF13577,23,19,10,13,9,986,0.53,0.98,0.43,0.47,6,6,17,0,995,1.0,0.98,0.26,0.51
PF02758,PF14484:PF13553:PF02760,9,16,6,3,10,999,0.38,0.99,0.67,0.49,2,2,7,0,1009,1.0,0.99,0.22,0.47
PF01244,PF15868:PF05719:PF06870,14,19,5,9,14,990,0.26,0.98,0.36,0.3,1,0,14,1,1003,0.0,0.99,0.0,-0.0
PF02268,PF02751:PF15689:PF17048,13,21,12,1,9,996,0.57,0.99,0.92,0.72,1,1,12,0,1005,1.0,0.99,0.08,0.28
PF16002,PF12213:PF15072:PF08418,4,14,3,1,11,1003,0.21,0.99,0.75,0.4,3,2,2,1,1013,0.67,1.0,0.5,0.58
PF04841,PF04840:PF12215:PF04685,9,20,9,0,11,998,0.45,0.99,1.0,0.67,5,2,7,3,1006,0.4,0.99,0.22,0.29
PF15502,PF14021:PF05387:PF07259,0,1,0,0,1,1017,0.0,1.0,0,0,0,0,0,0,1018,0,1.0,0,0
PF07694,PF13556:PF05231:PF12431,7,3,2,5,1,1010,0.67,0.99,0.29,0.43,0,0,7,0,1011,0,0.99,0.0,0
PF13023,PF00831:PF08315:PF00159,9,25,5,4,20,989,0.2,0.98,0.56,0.32,2,2,7,0,1009,1.0,0.99,0.22,0.47
PF14821,PF00290:PF00585:PF00291,7,58,7,0,51,960,0.12,0.95,1.0,0.34,6,0,7,6,1005,0.0,0.99,0.0,-0.01
PF00900,PF08071:PF16121:PF01777,15,26,13,2,13,990,0.5,0.99,0.87,0.65,13,12,3,1,1002,0.92,1.0,0.8,0.86
PF14832,PF17124:PF13095:PF15152,5,3,0,5,3,1010,0.0,0.99,0.0,-0.0,0,0,5,0,1013,0,1.0,0.0,0
PF05836,PF15760:PF15085:PF14519,0,2,0,0,2,1016,0.0,1.0,0,0,0,0,0,0,1018,0,1.0,0,0
PF01947,PF00737:PF08738:PF17124,0,1,0,0,1,1017,0.0,1.0,0,0,0,0,0,0,1018,0,1.0,0,0
PF05586,PF16754:PF05587:PF02743,2,19,2,0,17,999,0.11,0.98,1.0,0.32,1,0,2,1,1015,0.0,1.0,0.0,-0.0
PF11332,PF11268:PF16168:PF06222,0,0,0,0,0,1018,0,1.0,0,0,0,0,0,0,1018,0,1.0,0,0
PF11196,PF08744:PF02217:PF06745,0,3,0,0,3,1015,0.0,1.0,0,0,0,0,0,0,1018,0,1.0,0,0
PF08843,PF11317:PF15088:PF07327,0,1,0,0,1,1017,0.0,1.0,0,0,0,0,0,0,1018,0,1.0,0,0
PF00178,PF11620:PF02198:PF04621,30,19,16,14,3,985,0.84,0.98,0.53,0.66,2,2,28,0,988,1.0,0.97,0.07,0.25
PF00615,PF00610:PF00433:PF08833,59,61,27,32,34,925,0.44,0.94,0.46,0.42,13,10,49,3,956,0.77,0.95,0.17,0.35
PF08394,PF05100:PF05947:PF03135,1,5,0,1,5,1012,0.0,0.99,0.0,-0.0,0,0,1,0,1017,0,1.0,0.0,0
PF15320,PF11029:PF15960:PF16716,3,2,0,3,2,1013,0.0,1.0,0.0,-0.0,0,0,3,0,1015,0,1.0,0.0,0
PF00185,PF02729:PF02142:PF00988,21,34,20,1,14,983,0.59,0.99,0.95,0.74,15,13,8,2,995,0.87,0.99,0.62,0.73
PF04433,PF08558:PF16496:PF07988,23,12,7,16,5,990,0.58,0.98,0.3,0.41,0,0,23,0,995,0,0.98,0.0,0
PF02492,PF07683:PF08546:PF11989,19,29,11,8,18,981,0.38,0.97,0.58,0.46,4,4,15,0,999,1.0,0.99,0.21,0.46
PF06732,PF08914:PF11626:PF09197,5,14,1,4,13,1000,0.07,0.98,0.2,0.11,7,0,5,7,1006,0.0,0.99,0.0,-0.01
PF16716,PF02024:PF06446:PF00727,0,5,0,0,5,1013,0.0,1.0,0,0,0,0,0,0,1018,0,1.0,0,0
PF05374,PF01392:PF02934:PF02309,1,43,0,1,43,974,0.0,0.96,0.0,-0.01,3,0,1,3,1014,0.0,1.0,0.0,-0.0
PF09527,PF16096:PF03724:PF09090,0,12,0,0,12,1006,0.0,0.99,0,0,1,0,0,1,1017,0.0,1.0,0,0
PF08174,PF08916:PF16018:PF02174,7,18,3,4,15,996,0.17,0.98,0.43,0.26,1,1,6,0,1011,1.0,0.99,0.14,0.38
PF05548,PF15045:PF05604:PF10104,2,8,1,1,7,1009,0.12,0.99,0.5,0.25,1,1,1,0,1016,1.0,1.0,0.5,0.71
PF16565,PF12002:PF05496:PF16193,1,19,0,1,19,998,0.0,0.98,0.0,-0.0,14,0,1,14,1003,0.0,0.99,0.0,-0.0
PF14668,PF14664:PF14663:PF14666,12,12,12,0,0,1006,1.0,1.0,1.0,1.0,10,10,2,0,1006,1.0,1.0,0.83,0.91
PF10187,PF00473:PF15242:PF15991,9,6,2,7,4,1005,0.33,0.99,0.22,0.27,0,0,9,0,1009,0,0.99,0.0,0
PF01734,PF05057:PF01529:PF06985,54,106,28,26,78,886,0.26,0.9,0.52,0.32,35,18,36,17,947,0.51,0.95,0.33,0.39
PF00042,PF00175:PF09791:PF00499,23,66,14,9,52,943,0.21,0.94,0.61,0.34,5,3,20,2,993,0.6,0.98,0.13,0.27
PF10213,PF10260:PF15247:PF08511,10,12,3,7,9,999,0.25,0.98,0.3,0.27,1,1,9,0,1008,1.0,0.99,0.1,0.31
PF16058,PF08674:PF14518:PF11095,4,9,1,3,8,1006,0.11,0.99,0.25,0.16,0,0,4,0,1014,0,1.0,0.0,0
PF14082,PF09826:PF16888:PF07523,0,2,0,0,2,1016,0.0,1.0,0,0,0,0,0,0,1018,0,1.0,0,0
PF05585,PF05380:PF07245:PF03564,23,50,21,2,29,966,0.42,0.97,0.91,0.61,16,13,10,3,992,0.81,0.99,0.57,0.67
PF03279,PF11138:PF15480:PF14885,2,2,0,2,2,1014,0.0,1.0,0.0,-0.0,0,0,2,0,1016,0,1.0,0.0,0
PF16543,PF01205:PF06544:PF10453,18,31,5,13,26,974,0.16,0.96,0.28,0.19,6,3,15,3,997,0.5,0.98,0.17,0.28
PF11044,PF15207:PF09365:PF15771,0,3,0,0,3,1015,0.0,1.0,0,0,0,0,0,0,1018,0,1.0,0,0
PF07543,PF14087:PF08189:PF09252,6,9,4,2,5,1007,0.44,0.99,0.67,0.54,0,0,6,0,1012,0,0.99,0.0,0
PF06753,PF10285:PF10284:PF07276,1,0,0,1,0,1017,0,1.0,0.0,0,0,0,1,0,1017,0,1.0,0.0,0
PF02563,PF10481:PF11767:PF07926,3,18,0,3,18,997,0.0,0.98,0.0,-0.01,2,0,3,2,1013,0.0,1.0,0.0,-0.0
PF16030,PF12032:PF09272:PF00553,9,14,4,5,10,999,0.29,0.99,0.44,0.35,1,1,8,0,1009,1.0,0.99,0.11,0.33
PF07294,PF11210:PF11638:PF02399,1,3,0,1,3,1014,0.0,1.0,0.0,-0.0,1,0,1,1,1016,0.0,1.0,0.0,-0.0
PF00725,PF02737:PF00378:PF14779,27,73,27,0,46,945,0.37,0.95,1.0,0.59,20,19,8,1,990,0.95,0.99,0.7,0.81
PF14497,PF00043:PF04399:PF13409,37,58,23,14,35,946,0.4,0.95,0.62,0.47,8,6,31,2,979,0.75,0.97,0.16,0.34
PF12884,PF12886:PF14438:PF16794,1,21,1,0,20,997,0.05,0.98,1.0,0.22,1,0,1,1,1016,0.0,1.0,0.0,-0.0
PF01120,PF16757:PF04041:PF14687,19,15,9,10,6,993,0.6,0.98,0.47,0.53,1,1,18,0,999,1.0,0.98,0.05,0.23
PF04281,PF05347:PF07491:PF11176,3,35,1,2,34,981,0.03,0.96,0.33,0.09,7,1,2,6,1009,0.14,0.99,0.33,0.21
PF15872,PF15703:PF15060:PF15231,0,0,0,0,0,1018,0,1.0,0,0,0,0,0,0,1018,0,1.0,0,0
PF05025,PF08334:PF15150:PF15319,6,1,0,6,1,1011,0.0,0.99,0.0,-0.0,0,0,6,0,1012,0,0.99,0.0,0
PF04932,PF03050:PF08497:PF08345,0,1,0,0,1,1017,0.0,1.0,0,0,0,0,0,0,1018,0,1.0,0,0
PF02585,PF10183:PF07722:PF01632,13,16,3,10,13,992,0.19,0.98,0.23,0.2,1,0,13,1,1004,0.0,0.99,0.0,-0.0
PF04293,PF01624:PF00361:PF00542,0,50,0,0,50,968,0.0,0.95,0,0,14,0,0,14,1004,0.0,0.99,0,0
PF05515,PF15856:PF10407:PF15577,0,4,0,0,4,1014,0.0,1.0,0,0,0,0,0,0,1018,0,1.0,0,0
PF04144,PF00992:PF14802:PF04440,14,5,3,11,2,1002,0.6,0.99,0.21,0.35,0,0,14,0,1004,0,0.99,0.0,0
PF06741,PF14438:PF07145:PF10033,12,24,10,2,14,992,0.42,0.98,0.83,0.58,6,6,6,0,1006,1.0,0.99,0.5,0.71
PF04538,PF14473:PF15370:PF15359,1,5,0,1,5,1012,0.0,0.99,0.0,-0.0,0,0,1,0,1017,0,1.0,0.0,0
PF04062,PF07219:PF05527:PF07059,10,13,2,8,11,997,0.15,0.98,0.2,0.17,1,1,9,0,1008,1.0,0.99,0.1,0.31
PF05071,PF03501:PF00831:PF00159,15,16,6,9,10,993,0.38,0.98,0.4,0.38,2,1,14,1,1002,0.5,0.99,0.07,0.18
PF01136,PF01706:PF14842:PF08886,1,1,0,1,1,1016,0.0,1.0,0.0,-0.0,0,0,1,0,1017,0,1.0,0.0,0
PF15870,PF13423:PF00929:PF16764,8,54,7,1,47,963,0.13,0.95,0.88,0.33,12,3,5,9,1001,0.25,0.99,0.38,0.3
PF15959,PF02305:PF14564:PF04917,1,3,0,1,3,1014,0.0,1.0,0.0,-0.0,0,0,1,0,1017,0,1.0,0.0,0
PF07859,PF06350:PF06979:PF01063,69,27,16,53,11,938,0.59,0.94,0.23,0.34,4,3,66,1,948,0.75,0.93,0.04,0.17
PF15338,PF00721:PF13471:PF04335,0,9,0,0,9,1009,0.0,0.99,0,0,3,0,0,3,1015,0.0,1.0,0,0
PF00163,PF00900:PF00849:PF16065,15,49,6,9,43,960,0.12,0.95,0.4,0.2,11,4,11,7,996,0.36,0.98,0.27,0.3
PF01446,PF10174:PF06160:PF00736,1,33,1,0,32,985,0.03,0.97,1.0,0.17,5,0,1,5,1012,0.0,0.99,0.0,-0.0
PF04337,PF08345:PF12241:PF13502,1,3,0,1,3,1014,0.0,1.0,0.0,-0.0,0,0,1,0,1017,0,1.0,0.0,0
PF02188,PF02145:PF06372:PF03542,11,16,6,5,10,997,0.38,0.99,0.55,0.45,5,2,9,3,1004,0.4,0.99,0.18,0.26
PF15670,PF12527:PF04988:PF15257,1,6,0,1,6,1011,0.0,0.99,0.0,-0.0,1,0,1,1,1016,0.0,1.0,0.0,-0.0
PF04955,PF06119:PF07519:PF07019,0,40,0,0,40,978,0.0,0.96,0,0,10,0,0,10,1008,0.0,0.99,0,0
PF09072,PF16499:PF10632:PF03762,7,22,4,3,18,993,0.18,0.98,0.57,0.31,1,1,6,0,1011,1.0,0.99,0.14,0.38
PF03479,PF04934:PF07052:PF02234,6,30,3,3,27,985,0.1,0.97,0.5,0.21,3,0,6,3,1009,0.0,0.99,0.0,-0.0
PF13442,PF04736:PF15884:PF05825,9,5,0,9,5,1004,0.0,0.99,0.0,-0.01,1,0,9,1,1008,0.0,0.99,0.0,-0.0
PF13427,PF01934:PF08485:PF00516,1,2,1,0,1,1016,0.5,1.0,1.0,0.71,0,0,1,0,1017,0,1.0,0.0,0
PF05351,PF08038:PF15171:PF14770,6,5,1,5,4,1008,0.2,0.99,0.17,0.18,0,0,6,0,1012,0,0.99,0.0,0
PF13976,PF07727:PF13961:PF14244,60,133,53,7,80,878,0.4,0.91,0.88,0.56,28,19,41,9,949,0.68,0.95,0.32,0.44
PF12753,PF08310:PF17084:PF04552,1,2,0,1,2,1015,0.0,1.0,0.0,-0.0,0,0,1,0,1017,0,1.0,0.0,0
PF10391,PF14792:PF14716:PF14791,15,25,15,0,10,993,0.6,0.99,1.0,0.77,15,11,4,4,999,0.73,0.99,0.73,0.73
PF15965,PF15966:PF15146:PF00910,6,18,4,2,14,998,0.22,0.98,0.67,0.38,0,0,6,0,1012,0,0.99,0.0,0
PF12129,PF07001:PF10482:PF05397,4,17,1,3,16,998,0.06,0.98,0.25,0.11,0,0,4,0,1014,0,1.0,0.0,0
PF04777,PF00085:PF15928:PF05903,26,108,21,5,87,905,0.19,0.91,0.81,0.37,10,4,22,6,986,0.4,0.97,0.15,0.24
PF14418,PF17182:PF01936:PF11608,1,12,1,0,11,1006,0.08,0.99,1.0,0.29,2,0,1,2,1015,0.0,1.0,0.0,-0.0
PF06966,PF09809:PF00159:PF04667,16,13,3,13,10,992,0.23,0.98,0.19,0.2,1,1,15,0,1002,1.0,0.99,0.06,0.25
PF10498,PF12414:PF13865:PF08081,3,12,3,0,9,1006,0.25,0.99,1.0,0.5,3,2,1,1,1014,0.67,1.0,0.67,0.67
PF08662,PF08159:PF12341:PF11540,15,20,5,10,15,988,0.25,0.98,0.33,0.28,4,2,13,2,1001,0.5,0.99,0.13,0.25
PF06507,PF02362:PF02309:PF07496,11,44,9,2,35,972,0.2,0.96,0.82,0.4,15,5,6,10,997,0.33,0.98,0.45,0.38
PF11928,PF06221:PF04087:PF09816,0,16,0,0,16,1002,0.0,0.98,0,0,2,0,0,2,1016,0.0,1.0,0,0
PF08458,PF05703:PF07831:PF12235,6,12,6,0,6,1006,0.5,0.99,1.0,0.71,3,3,3,0,1012,1.0,1.0,0.5,0.71
PF08668,PF13098:PF08274:PF14841,5,6,0,5,6,1007,0.0,0.99,0.0,-0.01,0,0,5,0,1013,0,1.0,0.0,0
PF11901,PF12248:PF09458:PF01229,15,25,7,8,18,985,0.28,0.97,0.47,0.35,3,3,12,0,1003,1.0,0.99,0.2,0.44
PF13726,PF14983:PF12241:PF03922,0,3,0,0,3,1015,0.0,1.0,0,0,0,0,0,0,1018,0,1.0,0,0
PF11409,PF11979:PF16696:PF11464,1,15,1,0,14,1003,0.07,0.99,1.0,0.26,2,1,0,1,1016,0.5,1.0,1.0,0.71
PF15895,PF15553:PF17078:PF15379,0,1,0,0,1,1017,0.0,1.0,0,0,0,0,0,0,1018,0,1.0,0,0
PF02437,PF15223:PF08782:PF14444,11,12,10,1,2,1005,0.83,1.0,0.91,0.87,1,1,10,0,1007,1.0,0.99,0.09,0.3
PF03848,PF11751:PF04671:PF03090,0,1,0,0,1,1017,0.0,1.0,0,0,0,0,0,0,1018,0,1.0,0,0
PF13836,PF15678:PF09649:PF11261,0,8,0,0,8,1010,0.0,0.99,0,0,0,0,0,0,1018,0,1.0,0,0
PF10108,PF08496:PF02951:PF15685,2,6,1,1,5,1011,0.17,0.99,0.5,0.29,1,0,2,1,1015,0.0,1.0,0.0,-0.0
PF03803,PF05602:PF04831:PF16317,12,16,4,8,12,994,0.25,0.98,0.33,0.28,3,2,10,1,1005,0.67,0.99,0.17,0.33
PF07721,PF07720:PF16669:PF15044,6,16,3,3,13,999,0.19,0.98,0.5,0.3,3,2,4,1,1011,0.67,1.0,0.33,0.47
PF07793,PF12385:PF07799:PF02425,0,0,0,0,0,1018,0,1.0,0,0,0,0,0,0,1018,0,1.0,0,0
PF14046,PF12743:PF12577:PF02161,0,7,0,0,7,1011,0.0,0.99,0,0,5,0,0,5,1013,0.0,1.0,0,0
PF13968,PF04578:PF07762:PF07422,19,24,17,2,7,992,0.71,0.99,0.89,0.79,10,10,9,0,999,1.0,0.99,0.53,0.72
PF16027,PF15806:PF00473:PF07809,0,6,0,0,6,1012,0.0,0.99,0,0,0,0,0,0,1018,0,1.0,0,0
PF00472,PF03462:PF04095:PF00984,38,34,22,16,12,968,0.65,0.97,0.58,0.6,4,4,34,0,980,1.0,0.97,0.11,0.32
PF01429,PF10440:PF05964:PF05965,23,22,12,11,10,985,0.55,0.98,0.52,0.52,17,11,12,6,989,0.65,0.98,0.48,0.55
PF05170,PF13502:PF02604:PF10116,1,1,0,1,1,1016,0.0,1.0,0.0,-0.0,0,0,1,0,1017,0,1.0,0.0,0
PF06805,PF05939:PF05100:PF01913,0,1,0,0,1,1017,0.0,1.0,0,0,0,0,0,0,1018,0,1.0,0,0
PF00529,PF04984:PF16473:PF01807,3,6,0,3,6,1009,0.0,0.99,0.0,-0.0,1,0,3,1,1014,0.0,1.0,0.0,-0.0
PF09253,PF07327:PF15085:PF14519,0,3,0,0,3,1015,0.0,1.0,0,0,0,0,0,0,1018,0,1.0,0,0
PF09280,PF09055:PF09668:PF16843,9,22,5,4,17,992,0.23,0.98,0.56,0.35,2,2,7,0,1009,1.0,0.99,0.22,0.47
PF12768,PF12026:PF06920:PF16172,1,15,1,0,14,1003,0.07,0.99,1.0,0.26,3,1,0,2,1015,0.33,1.0,1.0,0.58
PF08785,PF03731:PF03730:PF02735,10,24,9,1,15,993,0.38,0.98,0.9,0.58,21,7,3,14,994,0.33,0.98,0.7,0.48
PF11406,PF10106:PF03065:PF05418,0,3,0,0,3,1015,0.0,1.0,0,0,0,0,0,0,1018,0,1.0,0,0
PF08598,PF15346:PF14279:PF12319,6,3,1,5,2,1010,0.33,0.99,0.17,0.23,0,0,6,0,1012,0,0.99,0.0,0
PF03577,PF05191:PF01980:PF12483,4,16,1,3,15,999,0.06,0.98,0.25,0.12,0,0,4,0,1014,0,1.0,0.0,0
PF07373,PF07942:PF00621:PF14634,0,87,0,0,87,931,0.0,0.91,0,0,13,0,0,13,1005,0.0,0.99,0,0
PF09173,PF16658:PF09107:PF03143,5,27,3,2,24,989,0.11,0.97,0.6,0.25,1,1,4,0,1013,1.0,1.0,0.2,0.45
PF10325,PF10327:PF10319:PF10318,3,16,2,1,14,1001,0.12,0.99,0.67,0.28,4,1,2,3,1012,0.25,1.0,0.33,0.29
PF01044,PF00932:PF06454:PF00244,8,32,2,6,30,980,0.06,0.96,0.25,0.11,6,2,6,4,1006,0.33,0.99,0.25,0.28
PF06355,PF15662:PF01292:PF11402,2,6,0,2,6,1010,0.0,0.99,0.0,-0.0,0,0,2,0,1016,0,1.0,0.0,0
PF00640,PF06311:PF08916:PF08574,27,7,4,23,3,988,0.57,0.97,0.15,0.28,2,1,26,1,990,0.5,0.97,0.04,0.13
PF09745,PF01868:PF07545:PF04004,8,19,4,4,15,995,0.21,0.98,0.5,0.32,2,2,6,0,1010,1.0,0.99,0.25,0.5
PF04247,PF08274:PF09648:PF06445,0,5,0,0,5,1013,0.0,1.0,0,0,0,0,0,0,1018,0,1.0,0,0
PF12935,PF08579:PF11549:PF10395,0,2,0,0,2,1016,0.0,1.0,0,0,1,0,0,1,1017,0.0,1.0,0,0
PF05567,PF17164:PF13505:PF17006,0,0,0,0,0,1018,0,1.0,0,0,0,0,0,0,1018,0,1.0,0,0
PF16521,PF01843:PF07926:PF16735,5,34,3,2,31,982,0.09,0.97,0.6,0.22,5,3,2,2,1011,0.6,1.0,0.6,0.6
PF02755,PF04589:PF06333:PF09750,8,24,4,4,20,990,0.17,0.98,0.5,0.28,3,2,6,1,1009,0.67,0.99,0.25,0.41
PF15815,PF08941:PF06803:PF00642,1,76,1,0,75,942,0.01,0.93,1.0,0.11,9,1,0,8,1009,0.11,0.99,1.0,0.33
PF14060,PF09685:PF03969:PF06702,0,22,0,0,22,996,0.0,0.98,0,0,4,0,0,4,1014,0.0,1.0,0,0
PF04003,PF08149:PF12490:PF11816,13,21,3,10,18,987,0.14,0.97,0.23,0.17,6,2,11,4,1001,0.33,0.99,0.15,0.22
PF02741,PF03729:PF11751:PF15518,1,1,0,1,1,1016,0.0,1.0,0.0,-0.0,0,0,1,0,1017,0,1.0,0.0,0
PF05135,PF04860:PF02565:PF10974,0,1,0,0,1,1017,0.0,1.0,0,0,0,0,0,0,1018,0,1.0,0,0
PF05033,PF11764:PF10440:PF15811,25,14,7,18,7,986,0.5,0.98,0.28,0.36,2,2,23,0,993,1.0,0.98,0.08,0.28
PF00698,PF16197:PF16073:PF02801,46,58,42,4,16,956,0.72,0.98,0.91,0.8,41,39,7,2,970,0.95,0.99,0.85,0.89
PF04667,PF01987:PF09769:PF01470,5,17,1,4,16,997,0.06,0.98,0.2,0.1,3,0,5,3,1010,0.0,0.99,0.0,-0.0
PF00300,PF01591:PF01513:PF09741,67,30,21,46,9,942,0.7,0.95,0.31,0.45,8,8,59,0,951,1.0,0.94,0.12,0.34
PF15068,PF16590:PF08730:PF00997,1,1,0,1,1,1016,0.0,1.0,0.0,-0.0,0,0,1,0,1017,0,1.0,0.0,0
PF04432,PF04422:PF15805:PF15285,0,1,0,0,1,1017,0.0,1.0,0,0,0,0,0,0,1018,0,1.0,0,0
PF12157,PF17105:PF10537:PF10513,7,35,4,3,31,980,0.11,0.97,0.57,0.25,3,2,5,1,1010,0.67,0.99,0.29,0.43
PF00502,PF00427:PF01383:PF12853,0,6,0,0,6,1012,0.0,0.99,0,0,0,0,0,0,1018,0,1.0,0,0
PF12228,PF03241:PF16055:PF09677,0,0,0,0,0,1018,0,1.0,0,0,0,0,0,0,1018,0,1.0,0,0
PF15361,PF10357:PF11187:PF14722,3,19,1,2,18,997,0.05,0.98,0.33,0.13,2,0,3,2,1013,0.0,1.0,0.0,-0.0
PF01920,PF16053:PF03661:PF14943,17,29,7,10,22,979,0.24,0.97,0.41,0.3,5,4,13,1,1000,0.8,0.99,0.24,0.43
PF05821,PF00717:PF01060:PF01400,6,83,6,0,77,935,0.07,0.92,1.0,0.26,21,5,1,16,996,0.24,0.98,0.83,0.44
PF04112,PF12359:PF11935:PF12340,8,14,1,7,13,997,0.07,0.98,0.12,0.09,8,1,7,7,1003,0.12,0.99,0.12,0.12
PF06890,PF07157:PF11751:PF02277,0,3,0,0,3,1015,0.0,1.0,0,0,0,0,0,0,1018,0,1.0,0,0
PF09717,PF09285:PF01132:PF15671,1,6,0,1,6,1011,0.0,0.99,0.0,-0.0,6,0,1,6,1011,0.0,0.99,0.0,-0.0
PF05713,PF08808:PF16804:PF12477,0,0,0,0,0,1018,0,1.0,0,0,0,0,0,0,1018,0,1.0,0,0
PF03039,PF15556:PF02977:PF17050,2,1,0,2,1,1015,0.0,1.0,0.0,-0.0,0,0,2,0,1016,0,1.0,0.0,0
PF01274,PF00463:PF12150:PF08925,9,16,4,5,12,997,0.25,0.98,0.44,0.33,2,0,9,2,1007,0.0,0.99,0.0,-0.0
PF12717,PF15246:PF12922:PF10377,24,21,18,6,3,991,0.86,0.99,0.75,0.8,1,1,23,0,994,1.0,0.98,0.04,0.2
PF10408,PF04564:PF08606:PF13019,11,63,10,1,53,954,0.16,0.95,0.91,0.37,15,4,7,11,996,0.27,0.98,0.36,0.3
PF04113,PF04006:PF05091:PF05254,11,33,4,7,29,978,0.12,0.96,0.36,0.2,4,2,9,2,1005,0.5,0.99,0.18,0.3
PF01597,PF06244:PF04716:PF01470,23,30,10,13,20,975,0.33,0.97,0.43,0.36,4,4,19,0,995,1.0,0.98,0.17,0.41
PF08490,PF08996:PF12254:PF03104,13,36,13,0,23,982,0.36,0.98,1.0,0.59,13,7,6,6,999,0.54,0.99,0.54,0.53
PF00795,PF01177:PF02540:PF01230,46,46,18,28,28,944,0.39,0.94,0.39,0.36,8,8,38,0,972,1.0,0.96,0.17,0.41
PF10570,PF09291:PF02124:PF02439,1,2,0,1,2,1015,0.0,1.0,0.0,-0.0,0,0,1,0,1017,0,1.0,0.0,0
PF14079,PF02217:PF08291:PF01752,0,5,0,0,5,1013,0.0,1.0,0,0,0,0,0,0,1018,0,1.0,0,0
PF15201,PF10690:PF05675:PF02705,0,15,0,0,15,1003,0.0,0.99,0,0,0,0,0,0,1018,0,1.0,0,0
PF14870,PF15334:PF08730:PF00669,1,1,0,1,1,1016,0.0,1.0,0.0,-0.0,0,0,1,0,1017,0,1.0,0.0,0
PF09727,PF17045:PF09762:PF07926,5,11,2,3,9,1004,0.18,0.99,0.4,0.26,1,0,5,1,1012,0.0,0.99,0.0,-0.0
PF05383,PF14327:PF04098:PF16131,20,32,7,13,25,973,0.22,0.96,0.35,0.26,4,2,18,2,996,0.5,0.98,0.1,0.22
PF11544,PF06586:PF05309:PF09444,0,2,0,0,2,1016,0.0,1.0,0,0,1,0,0,1,1017,0.0,1.0,0,0
PF14994,PF15023:PF09673:PF15334,1,0,0,1,0,1017,0,1.0,0.0,0,0,0,1,0,1017,0,1.0,0.0,0
PF03525,PF08744:PF06724:PF02557,0,2,0,0,2,1016,0.0,1.0,0,0,0,0,0,0,1018,0,1.0,0,0
PF01463,PF01462:PF01049:PF03736,6,20,6,0,14,998,0.3,0.99,1.0,0.54,3,3,3,0,1012,1.0,1.0,0.5,0.71
PF04163,PF15877:PF15515:PF01076,3,1,0,3,1,1014,0.0,1.0,0.0,-0.0,0,0,3,0,1015,0,1.0,0.0,0
PF12540,PF07545:PF10332:PF15797,1,5,0,1,5,1012,0.0,0.99,0.0,-0.0,0,0,1,0,1017,0,1.0,0.0,0
PF05297,PF11981:PF07074:PF01880,0,10,0,0,10,1008,0.0,0.99,0,0,0,0,0,0,1018,0,1.0,0,0
PF00199,PF06628:PF01965:PF01315,20,57,19,1,38,960,0.33,0.96,0.95,0.55,17,10,10,7,991,0.59,0.98,0.5,0.53
PF06624,PF08229:PF07189:PF06884,5,15,1,4,14,999,0.07,0.98,0.2,0.11,2,1,4,1,1012,0.5,1.0,0.2,0.31
PF11522,PF14621:PF11640:PF15785,3,14,1,2,13,1002,0.07,0.99,0.33,0.15,3,1,2,2,1013,0.33,1.0,0.33,0.33
PF03842,PF01701:PF15467:PF15060,0,1,0,0,1,1017,0.0,1.0,0,0,0,0,0,0,1018,0,1.0,0,0
PF02298,PF06749:PF04535:PF02519,19,19,7,12,12,987,0.37,0.98,0.37,0.36,4,4,15,0,999,1.0,0.99,0.21,0.46
PF15345,PF02253:PF15169:PF15750,1,2,0,1,2,1015,0.0,1.0,0.0,-0.0,0,0,1,0,1017,0,1.0,0.0,0
PF14000,PF06977:PF11502:PF15423,0,1,0,0,1,1017,0.0,1.0,0,0,0,0,0,0,1018,0,1.0,0,0
PF17032,PF10868:PF12046:PF02427,0,0,0,0,0,1018,0,1.0,0,0,0,0,0,0,1018,0,1.0,0,0
PF03415,PF15888:PF15082:PF15094,1,3,0,1,3,1014,0.0,1.0,0.0,-0.0,0,0,1,0,1017,0,1.0,0.0,0
PF14839,PF03878:PF15298:PF02038,0,13,0,0,13,1005,0.0,0.99,0,0,4,0,0,4,1014,0.0,1.0,0,0
PF07884,PF07896:PF15370:PF10218,6,8,1,5,7,1005,0.12,0.99,0.17,0.14,0,0,6,0,1012,0,0.99,0.0,0
PF03942,PF10780:PF00159:PF01987,17,8,4,13,4,997,0.5,0.98,0.24,0.34,0,0,17,0,1001,0,0.98,0.0,0
PF02775,PF02776:PF00205:PF10371,25,28,23,2,5,988,0.82,0.99,0.92,0.87,26,22,3,4,989,0.85,0.99,0.88,0.86
PF11086,PF03860:PF13401:PF01130,0,30,0,0,30,988,0.0,0.97,0,0,7,0,0,7,1011,0.0,0.99,0,0
PF01028,PF14370:PF02919:PF05392,7,10,6,1,4,1007,0.6,1.0,0.86,0.71,6,6,1,0,1011,1.0,1.0,0.86,0.93
PF10296,PF10186:PF05640:PF05997,10,18,3,7,15,993,0.17,0.98,0.3,0.21,2,1,9,1,1007,0.5,0.99,0.1,0.22
PF02033,PF07939:PF04839:PF06271,6,4,0,6,4,1008,0.0,0.99,0.0,-0.0,1,0,6,1,1011,0.0,0.99,0.0,-0.0
PF03471,PF15450:PF06835:PF04739,5,8,0,5,8,1005,0.0,0.99,0.0,-0.01,0,0,5,0,1013,0,1.0,0.0,0
PF17065,PF08991:PF10384:PF13805,12,18,4,8,14,992,0.22,0.98,0.33,0.26,2,1,11,1,1005,0.5,0.99,0.08,0.2
PF14220,PF09327:PF13808:PF13876,2,3,2,0,1,1015,0.67,1.0,1.0,0.82,0,0,2,0,1016,0,1.0,0.0,0
PF09014,PF10511:PF02961:PF08433,1,15,1,0,14,1003,0.07,0.99,1.0,0.26,2,1,0,1,1016,0.5,1.0,1.0,0.71
PF07317,PF01750:PF02281:PF06299,0,2,0,0,2,1016,0.0,1.0,0,0,0,0,0,0,1018,0,1.0,0,0
PF08232,PF03920:PF13925:PF09453,8,17,2,6,15,995,0.12,0.98,0.25,0.16,2,1,7,1,1009,0.5,0.99,0.12,0.25
PF06294,PF16034:PF04423:PF12606,6,8,2,4,6,1006,0.25,0.99,0.33,0.28,0,0,6,0,1012,0,0.99,0.0,0
PF11625,PF10999:PF08642:PF15460,0,1,0,0,1,1017,0.0,1.0,0,0,0,0,0,0,1018,0,1.0,0,0
PF06437,PF08591:PF11677:PF15063,3,0,0,3,0,1015,0,1.0,0.0,0,0,0,3,0,1015,0,1.0,0.0,0
PF12070,PF01147:PF00272:PF15260,1,2,0,1,2,1015,0.0,1.0,0.0,-0.0,0,0,1,0,1017,0,1.0,0.0,0
PF11832,PF04245:PF03092:PF13277,0,9,0,0,9,1009,0.0,0.99,0,0,0,0,0,0,1018,0,1.0,0,0
PF02014,PF06468:PF04526:PF03188,14,34,9,5,25,979,0.26,0.97,0.64,0.4,2,2,12,0,1004,1.0,0.99,0.14,0.38
PF04557,PF04558:PF03950:PF00749,11,35,11,0,24,983,0.31,0.98,1.0,0.55,23,11,0,12,995,0.48,0.99,1.0,0.69
PF15858,PF02931:PF08662:PF01823,0,95,0,0,95,923,0.0,0.91,0,0,14,0,0,14,1004,0.0,0.99,0,0
PF11352,PF04461:PF01412:PF03099,0,58,0,0,58,960,0.0,0.94,0,0,6,0,0,6,1012,0.0,0.99,0,0
PF11136,PF11876:PF07495:PF03613,0,1,0,0,1,1017,0.0,1.0,0,0,0,0,0,0,1018,0,1.0,0,0
PF10146,PF14931:PF06473:PF02792,3,7,0,3,7,1008,0.0,0.99,0.0,-0.0,0,0,3,0,1015,0,1.0,0.0,0
PF04977,PF00387:PF02759:PF07534,0,55,0,0,55,963,0.0,0.95,0,0,9,0,0,9,1009,0.0,0.99,0,0
PF01353,PF15377:PF15252:PF01387,2,0,0,2,0,1016,0,1.0,0.0,0,0,0,2,0,1016,0,1.0,0.0,0
PF15198,PF13737:PF09669:PF15139,0,2,0,0,2,1016,0.0,1.0,0,0,0,0,0,0,1018,0,1.0,0,0
PF02947,PF15138:PF14224:PF15211,3,1,1,2,0,1015,1.0,1.0,0.33,0.58,0,0,3,0,1015,0,1.0,0.0,0
PF15121,PF15762:PF15312:PF02070,1,0,0,1,0,1017,0,1.0,0.0,0,0,0,1,0,1017,0,1.0,0.0,0
PF01663,PF04987:PF01223:PF07035,38,37,20,18,17,963,0.54,0.97,0.53,0.52,7,6,32,1,979,0.86,0.97,0.16,0.36
PF14986,PF15055:PF15333:PF07448,0,0,0,0,0,1018,0,1.0,0,0,0,0,0,0,1018,0,1.0,0,0
PF15828,PF03745:PF08040:PF06681,2,1,0,2,1,1015,0.0,1.0,0.0,-0.0,0,0,2,0,1016,0,1.0,0.0,0
PF11415,PF16716:PF08089:PF02024,0,1,0,0,1,1017,0.0,1.0,0,0,0,0,0,0,1018,0,1.0,0,0
PF10530,PF01234:PF01723:PF02175,0,7,0,0,7,1011,0.0,0.99,0,0,0,0,0,0,1018,0,1.0,0,0
PF16001,PF08730:PF17061:PF02951,1,4,0,1,4,1013,0.0,1.0,0.0,-0.0,0,0,1,0,1017,0,1.0,0.0,0
PF07727,PF13976:PF14244:PF13961,121,78,59,62,19,878,0.76,0.92,0.49,0.57,22,19,102,3,894,0.86,0.9,0.16,0.34
PF04088,PF08397:PF08824:PF12026,2,9,1,1,8,1008,0.11,0.99,0.5,0.23,2,1,1,1,1015,0.5,1.0,0.5,0.5
PF13687,PF04466:PF04586:PF07016,2,1,0,2,1,1015,0.0,1.0,0.0,-0.0,0,0,2,0,1016,0,1.0,0.0,0
PF08612,PF03386:PF04418:PF05129,8,14,1,7,13,997,0.07,0.98,0.12,0.09,2,0,8,2,1008,0.0,0.99,0.0,-0.0
PF04759,PF04367:PF07809:PF03350,4,3,0,4,3,1011,0.0,0.99,0.0,-0.0,0,0,4,0,1014,0,1.0,0.0,0
PF06345,PF06346:PF06367:PF10377,4,27,4,0,23,991,0.15,0.98,1.0,0.38,5,3,1,2,1012,0.6,1.0,0.75,0.67
PF02211,PF03090:PF03241:PF14690,3,0,0,3,0,1015,0,1.0,0.0,0,0,0,3,0,1015,0,1.0,0.0,0
PF12137,PF07652:PF14229:PF10927,4,7,2,2,5,1009,0.29,0.99,0.5,0.37,1,1,3,0,1014,1.0,1.0,0.25,0.5
PF04389,PF02225:PF04258:PF01532,46,74,30,16,44,928,0.41,0.94,0.65,0.49,29,17,29,12,960,0.59,0.96,0.37,0.45
PF03982,PF12146:PF00561:PF04083,19,102,13,6,89,910,0.13,0.91,0.68,0.27,46,12,7,34,965,0.26,0.96,0.63,0.39
PF02468,PF15172:PF15115:PF15036,0,2,0,0,2,1016,0.0,1.0,0,0,0,0,0,0,1018,0,1.0,0,0
PF06540,PF01296:PF00323:PF01091,1,3,1,0,2,1015,0.33,1.0,1.0,0.58,0,0,1,0,1017,0,1.0,0.0,0
PF02536,PF01066:PF06068:PF04577,38,50,15,23,35,945,0.3,0.94,0.39,0.31,12,9,29,3,977,0.75,0.97,0.24,0.41
PF15985,PF10447:PF12260:PF14382,12,20,7,5,13,993,0.35,0.98,0.58,0.44,8,3,9,5,1001,0.38,0.99,0.25,0.3
PF01462,PF01463:PF12534:PF11921,8,8,7,1,1,1009,0.88,1.0,0.88,0.87,2,2,6,0,1010,1.0,0.99,0.25,0.5
PF05283,PF06679:PF00726:PF06373,3,1,0,3,1,1014,0.0,1.0,0.0,-0.0,0,0,3,0,1015,0,1.0,0.0,0
PF04134,PF06232:PF06127:PF12734,9,10,3,6,7,1002,0.3,0.99,0.33,0.31,0,0,9,0,1009,0,0.99,0.0,0
PF12625,PF12897:PF12242:PF12852,3,5,3,0,2,1013,0.6,1.0,1.0,0.77,0,0,3,0,1015,0,1.0,0.0,0
PF14852,PF14853:PF16205:PF02560,4,21,4,0,17,997,0.19,0.98,1.0,0.43,1,1,3,0,1014,1.0,1.0,0.25,0.5
PF01060,PF00213:PF01775:PF10190,31,25,9,22,16,971,0.36,0.96,0.29,0.3,4,4,27,0,987,1.0,0.97,0.13,0.35
PF09683,PF05418:PF08093:PF12805,0,2,0,0,2,1016,0.0,1.0,0,0,0,0,0,0,1018,0,1.0,0,0
PF07966,PF00026:PF09478:PF07855,2,64,2,0,62,954,0.03,0.94,1.0,0.17,12,1,1,11,1005,0.08,0.99,0.5,0.2
PF14479,PF14420:PF12773:PF17046,12,19,5,7,14,992,0.26,0.98,0.42,0.32,2,2,10,0,1006,1.0,0.99,0.17,0.41
PF17106,PF12200:PF17046:PF17111,3,21,3,0,18,997,0.14,0.98,1.0,0.37,5,2,1,3,1012,0.4,1.0,0.67,0.51
PF06457,PF08557:PF01821:PF01687,1,22,0,1,22,995,0.0,0.98,0.0,-0.0,1,0,1,1,1016,0.0,1.0,0.0,-0.0
PF08352,PF08402:PF12399:PF13732,4,13,2,2,11,1003,0.15,0.99,0.5,0.27,5,2,2,3,1011,0.4,1.0,0.5,0.44
PF12706,PF13691:PF00753:PF03669,35,82,23,12,59,924,0.28,0.93,0.66,0.4,12,11,24,1,982,0.92,0.98,0.31,0.53
PF04993,PF15529:PF06798:PF06403,0,1,0,0,1,1017,0.0,1.0,0,0,0,0,0,0,1018,0,1.0,0,0
PF02868,PF16485:PF01447:PF09051,1,1,1,0,0,1017,1.0,1.0,1.0,1.0,1,1,0,0,1017,1.0,1.0,1.0,1.0
PF10472,PF10488:PF14047:PF14049,0,1,0,0,1,1017,0.0,1.0,0,0,0,0,0,0,1018,0,1.0,0,0
PF10387,PF12066:PF01713:PF03915,0,24,0,0,24,994,0.0,0.98,0,0,6,0,0,6,1012,0.0,0.99,0,0
PF14606,PF14607:PF07494:PF06744,2,1,0,2,1,1015,0.0,1.0,0.0,-0.0,0,0,2,0,1016,0,1.0,0.0,0
PF13630,PF16325:PF08497:PF14841,0,2,0,0,2,1016,0.0,1.0,0,0,0,0,0,0,1018,0,1.0,0,0
PF00719,PF00886:PF03942:PF00499,21,22,5,16,17,980,0.23,0.97,0.24,0.22,5,4,17,1,996,0.8,0.98,0.19,0.39
PF05161,PF13660:PF07477:PF03648,7,16,7,0,9,1002,0.44,0.99,1.0,0.66,3,0,7,3,1008,0.0,0.99,0.0,-0.0
PF03323,PF02554:PF04466:PF09611,8,0,0,8,0,1010,0,0.99,0.0,0,0,0,8,0,1010,0,0.99,0.0,0
PF09501,PF06122:PF08651:PF05138,0,1,0,0,1,1017,0.0,1.0,0,0,0,0,0,0,1018,0,1.0,0,0
PF09612,PF14866:PF03553:PF02941,0,2,0,0,2,1016,0.0,1.0,0,0,0,0,0,0,1018,0,1.0,0,0
PF14161,PF02805:PF06736:PF02078,2,10,0,2,10,1006,0.0,0.99,0.0,-0.0,1,0,2,1,1015,0.0,1.0,0.0,-0.0
PF06506,PF09327:PF08479:PF12256,4,0,0,4,0,1014,0,1.0,0.0,0,0,0,4,0,1014,0,1.0,0.0,0
PF15139,PF15555:PF06876:PF14534,1,1,0,1,1,1016,0.0,1.0,0.0,-0.0,0,0,1,0,1017,0,1.0,0.0,0
PF03425,PF03442:PF12600:PF00517,2,10,1,1,9,1007,0.1,0.99,0.5,0.22,1,0,2,1,1015,0.0,1.0,0.0,-0.0
PF15378,PF15333:PF17078:PF05399,0,1,0,0,1,1017,0.0,1.0,0,0,0,0,0,0,1018,0,1.0,0,0
PF14850,PF06433:PF00171:PF05708,4,107,4,0,103,911,0.04,0.9,1.0,0.18,3,1,3,2,1012,0.33,1.0,0.25,0.29
PF14977,PF10198:PF10307:PF15280,6,7,2,4,5,1007,0.29,0.99,0.33,0.3,0,0,6,0,1012,0,0.99,0.0,0
PF11865,PF02260:PF08064:PF08771,9,26,8,1,18,991,0.31,0.98,0.89,0.52,13,8,1,5,1004,0.62,0.99,0.89,0.74
PF06388,PF10244:PF00321:PF14935,1,9,0,1,9,1008,0.0,0.99,0.0,-0.0,1,0,1,1,1016,0.0,1.0,0.0,-0.0
PF06286,PF11642:PF15231:PF06670,0,0,0,0,0,1018,0,1.0,0,0,0,0,0,0,1018,0,1.0,0,0
PF13277,PF17176:PF02785:PF14577,1,34,0,1,34,983,0.0,0.97,0.0,-0.01,3,0,1,3,1014,0.0,1.0,0.0,-0.0
PF00395,PF15066:PF03008:PF03800,11,3,1,10,2,1005,0.33,0.99,0.09,0.17,1,1,10,0,1007,1.0,0.99,0.09,0.3
PF07499,PF06798:PF12080:PF03090,2,0,0,2,0,1016,0,1.0,0.0,0,0,0,2,0,1016,0,1.0,0.0,0
PF15554,PF08653:PF15669:PF07904,2,4,0,2,4,1012,0.0,0.99,0.0,-0.0,0,0,2,0,1016,0,1.0,0.0,0
PF04313,PF12008:PF01863:PF06114,4,7,4,0,3,1011,0.57,1.0,1.0,0.75,4,4,0,0,1014,1.0,1.0,1.0,1.0
PF05226,PF02991:PF01018:PF02939,3,31,1,2,30,985,0.03,0.97,0.33,0.1,6,1,2,5,1010,0.17,0.99,0.33,0.23
PF13407,PF04069:PF00739:PF03524,17,13,5,12,8,993,0.38,0.98,0.29,0.33,2,2,15,0,1001,1.0,0.99,0.12,0.34
PF15255,PF05041:PF11331:PF15923,0,12,0,0,12,1006,0.0,0.99,0,0,0,0,0,0,1018,0,1.0,0,0
PF01166,PF15910:PF06446:PF16541,6,2,0,6,2,1010,0.0,0.99,0.0,-0.0,0,0,6,0,1012,0,0.99,0.0,0
PF15913,PF01483:PF14843:PF16470,8,26,8,0,18,992,0.31,0.98,1.0,0.55,12,8,0,4,1006,0.67,1.0,1.0,0.81
PF12023,PF06351:PF06232:PF11264,4,7,3,1,4,1010,0.43,1.0,0.75,0.56,0,0,4,0,1014,0,1.0,0.0,0
PF01185,PF06127:PF11779:PF08561,4,14,2,2,12,1002,0.14,0.99,0.5,0.26,1,1,3,0,1014,1.0,1.0,0.25,0.5
PF15264,PF02116:PF10180:PF04090,2,12,1,1,11,1005,0.08,0.99,0.5,0.2,2,1,1,1,1015,0.5,1.0,0.5,0.5
PF10728,PF11874:PF01673:PF11081,0,0,0,0,0,1018,0,1.0,0,0,0,0,0,0,1018,0,1.0,0,0
PF05196,PF01091:PF01296:PF06540,1,3,1,0,2,1015,0.33,1.0,1.0,0.58,1,0,1,1,1016,0.0,1.0,0.0,-0.0
PF03709,PF09950:PF12381:PF12603,2,4,0,2,4,1012,0.0,0.99,0.0,-0.0,1,0,2,1,1015,0.0,1.0,0.0,-0.0
PF03442,PF03425:PF00734:PF02013,6,39,5,1,34,978,0.13,0.97,0.83,0.32,5,1,5,4,1008,0.2,0.99,0.17,0.18
PF11863,PF03592:PF03428:PF05939,0,0,0,0,0,1018,0,1.0,0,0,0,0,0,0,1018,0,1.0,0,0
PF08074,PF06461:PF08073:PF06465,12,13,12,0,1,1005,0.92,1.0,1.0,0.96,12,12,0,0,1006,1.0,1.0,1.0,1.0
PF07940,PF04428:PF04632:PF01057,6,4,0,6,4,1008,0.0,0.99,0.0,-0.0,1,0,6,1,1011,0.0,0.99,0.0,-0.0
PF09929,PF13211:PF08270:PF04384,0,0,0,0,0,1018,0,1.0,0,0,0,0,0,0,1018,0,1.0,0,0
PF03491,PF00209:PF05291:PF09648,2,43,2,0,41,975,0.05,0.96,1.0,0.21,5,1,1,4,1012,0.2,1.0,0.5,0.31
PF17198,PF09367:PF08432:PF11385,0,0,0,0,0,1018,0,1.0,0,0,0,0,0,0,1018,0,1.0,0,0
PF00985,PF12782:PF00229:PF02401,0,12,0,0,12,1006,0.0,0.99,0,0,1,0,0,1,1017,0.0,1.0,0,0
PF01363,PF11409:PF11464:PF11979,78,14,11,67,3,937,0.79,0.93,0.14,0.31,2,2,76,0,940,1.0,0.93,0.03,0.15
PF03238,PF06681:PF03745:PF15212,0,0,0,0,0,1018,0,1.0,0,0,0,0,0,0,1018,0,1.0,0,0
PF02137,PF14622:PF00035:PF16482,22,60,18,4,42,954,0.3,0.95,0.82,0.48,19,7,15,12,984,0.37,0.97,0.32,0.33
PF02296,PF09066:PF16381:PF14806,5,19,2,3,17,996,0.11,0.98,0.4,0.2,5,1,4,4,1009,0.2,0.99,0.2,0.2
PF00604,PF08744:PF10933:PF05947,2,0,0,2,0,1016,0,1.0,0.0,0,0,0,2,0,1016,0,1.0,0.0,0
PF01307,PF13186:PF05190:PF00370,0,47,0,0,47,971,0.0,0.95,0,0,13,0,0,13,1005,0.0,0.99,0,0
PF15742,PF12240:PF13870:PF14988,2,5,0,2,5,1011,0.0,0.99,0.0,-0.0,2,0,2,2,1014,0.0,1.0,0.0,-0.0
PF02545,PF16864:PF08100:PF04093,18,18,5,13,13,987,0.28,0.97,0.28,0.26,2,2,16,0,1000,1.0,0.98,0.11,0.33
PF00462,PF06936:PF05903:PF06201,49,40,13,36,27,942,0.33,0.94,0.27,0.26,2,1,48,1,968,0.5,0.95,0.02,0.09
PF03858,PF16954:PF01147:PF09807,0,6,0,0,6,1012,0.0,0.99,0,0,0,0,0,0,1018,0,1.0,0,0
PF11767,PF03864:PF04310:PF10481,7,7,0,7,7,1004,0.0,0.99,0.0,-0.01,0,0,7,0,1011,0,0.99,0.0,0
PF10256,PF04716:PF00159:PF09769,18,15,4,14,11,989,0.27,0.98,0.22,0.23,2,2,16,0,1000,1.0,0.98,0.11,0.33
PF01430,PF09967:PF12178:PF16051,1,4,0,1,4,1013,0.0,1.0,0.0,-0.0,0,0,1,0,1017,0,1.0,0.0,0
PF08384,PF08035:PF16102:PF00976,0,0,0,0,0,1018,0,1.0,0,0,0,0,0,0,1018,0,1.0,0,0
PF10597,PF10596:PF08082:PF10598,15,18,15,0,3,1000,0.83,1.0,1.0,0.91,13,13,2,0,1003,1.0,1.0,0.87,0.93
PF02559,PF07999:PF16204:PF03880,3,10,2,1,8,1007,0.2,0.99,0.67,0.36,2,2,1,0,1015,1.0,1.0,0.67,0.82
PF17068,PF15334:PF11402:PF14519,0,0,0,0,0,1018,0,1.0,0,0,0,0,0,0,1018,0,1.0,0,0
PF14240,PF15491:PF05990:PF15235,5,1,0,5,1,1012,0.0,0.99,0.0,-0.0,1,0,5,1,1012,0.0,0.99,0.0,-0.0
PF00882,PF00357:PF01788:PF08441,0,17,0,0,17,1001,0.0,0.98,0,0,2,0,0,2,1016,0.0,1.0,0,0
PF08287,PF05419:PF08656:PF15109,3,2,0,3,2,1013,0.0,1.0,0.0,-0.0,0,0,3,0,1015,0,1.0,0.0,0
PF07875,PF17019:PF05552:PF09611,0,0,0,0,0,1018,0,1.0,0,0,0,0,0,0,1018,0,1.0,0,0
PF01697,PF04646:PF02517:PF04577,29,30,7,22,23,966,0.23,0.96,0.24,0.21,11,3,26,8,981,0.27,0.97,0.1,0.15
PF02966,PF11221:PF05755:PF04643,14,8,2,12,6,998,0.25,0.98,0.14,0.18,0,0,14,0,1004,0,0.99,0.0,0
PF05634,PF14365:PF14577:PF14576,8,4,0,8,4,1006,0.0,0.99,0.0,-0.01,0,0,8,0,1010,0,0.99,0.0,0
PF11831,PF15934:PF15821:PF13870,12,3,1,11,2,1004,0.33,0.99,0.08,0.16,0,0,12,0,1006,0,0.99,0.0,0
PF14701,PF06202:PF14702:PF14699,2,4,2,0,2,1014,0.5,1.0,1.0,0.71,2,2,0,0,1016,1.0,1.0,1.0,1.0
PF16004,PF14492:PF03764:PF06421,10,49,9,1,40,968,0.18,0.96,0.9,0.4,23,7,3,16,992,0.3,0.98,0.7,0.45
PF05230,PF02277:PF11363:PF03241,0,3,0,0,3,1015,0.0,1.0,0,0,0,0,0,0,1018,0,1.0,0,0
PF05782,PF08444:PF08426:PF12904,2,2,0,2,2,1014,0.0,1.0,0.0,-0.0,0,0,2,0,1016,0,1.0,0.0,0
PF14992,PF08964:PF10856:PF15623,1,0,0,1,0,1017,0,1.0,0.0,0,0,0,1,0,1017,0,1.0,0.0,0
PF03731,PF02735:PF03730:PF08785,21,25,21,0,4,993,0.84,1.0,1.0,0.91,22,20,1,2,995,0.91,1.0,0.95,0.93
PF08505,PF10490:PF10375:PF05164,1,5,0,1,5,1012,0.0,0.99,0.0,-0.0,0,0,1,0,1017,0,1.0,0.0,0
PF09537,PF15776:PF09490:PF08548,0,3,0,0,3,1015,0.0,1.0,0,0,0,0,0,0,1018,0,1.0,0,0
PF00849,PF12656:PF00163:PF00579,40,57,18,22,39,939,0.32,0.94,0.45,0.35,9,6,34,3,975,0.67,0.96,0.15,0.3
PF04420,PF09749:PF04716:PF06799,9,22,4,5,18,991,0.18,0.98,0.44,0.27,3,2,7,1,1008,0.67,0.99,0.22,0.38
PF00033,PF00115:PF13631:PF00119,11,19,10,1,9,998,0.53,0.99,0.91,0.69,9,8,3,1,1006,0.89,1.0,0.73,0.8
PF00768,PF07943:PF15751:PF12161,7,9,6,1,3,1008,0.67,1.0,0.86,0.75,0,0,7,0,1011,0,0.99,0.0,0
PF03082,PF12767:PF17137:PF04474,0,8,0,0,8,1010,0.0,0.99,0,0,1,0,0,1,1017,0.0,1.0,0,0
PF14593,PF11629:PF12063:PF12202,3,17,3,0,14,1001,0.18,0.99,1.0,0.42,4,3,0,1,1014,0.75,1.0,1.0,0.87
PF00982,PF02358:PF14372:PF07821,22,45,22,0,23,973,0.49,0.98,1.0,0.69,9,8,14,1,995,0.89,0.99,0.36,0.56
PF03971,PF07805:PF08497:PF10139,1,1,0,1,1,1016,0.0,1.0,0.0,-0.0,0,0,1,0,1017,0,1.0,0.0,0
PF02878,PF00408:PF02880:PF02879,39,40,38,1,2,977,0.95,1.0,0.97,0.96,36,36,3,0,979,1.0,1.0,0.92,0.96
PF05160,PF10200:PF14753:PF03239,9,15,3,6,12,997,0.2,0.98,0.33,0.25,1,1,8,0,1009,1.0,0.99,0.11,0.33
PF09426,PF13774:PF14995:PF15277,0,30,0,0,30,988,0.0,0.97,0,0,4,0,0,4,1014,0.0,1.0,0,0
PF11051,PF04189:PF08155:PF01416,10,37,6,4,31,977,0.16,0.97,0.6,0.3,11,4,6,7,1001,0.36,0.99,0.4,0.37
PF12235,PF16098:PF16096:PF16097,7,5,5,2,0,1011,1.0,1.0,0.71,0.84,1,1,6,0,1011,1.0,0.99,0.14,0.38
PF14954,PF14935:PF02285:PF02372,2,7,0,2,7,1009,0.0,0.99,0.0,-0.0,0,0,2,0,1016,0,1.0,0.0,0
PF10409,PF14671:PF09192:PF13543,26,7,5,21,2,990,0.71,0.98,0.19,0.36,2,2,24,0,992,1.0,0.98,0.08,0.27
PF07970,PF06201:PF01359:PF11025,15,56,8,7,48,955,0.14,0.95,0.53,0.26,7,3,12,4,999,0.43,0.98,0.2,0.29
PF13891,PF05030:PF14611:PF06058,2,14,0,2,14,1002,0.0,0.98,0.0,-0.01,2,0,2,2,1014,0.0,1.0,0.0,-0.0
PF10396,PF12631:PF07975:PF02789,12,26,7,5,19,987,0.27,0.98,0.58,0.39,1,1,11,0,1006,1.0,0.99,0.08,0.29
PF00387,PF00388:PF09279:PF06631,18,23,17,1,6,994,0.74,0.99,0.94,0.83,9,9,9,0,1000,1.0,0.99,0.5,0.7
PF14403,PF06355:PF02554:PF06074,0,2,0,0,2,1016,0.0,1.0,0,0,0,0,0,0,1018,0,1.0,0,0
PF01327,PF06658:PF04520:PF04176,8,10,1,7,9,1001,0.1,0.98,0.12,0.1,2,0,8,2,1008,0.0,0.99,0.0,-0.0
PF00527,PF15602:PF09507:PF11503,2,8,0,2,8,1008,0.0,0.99,0.0,-0.0,0,0,2,0,1016,0,1.0,0.0,0
PF06244,PF06127:PF09769:PF04716,11,18,4,7,14,993,0.22,0.98,0.36,0.27,2,2,9,0,1007,1.0,0.99,0.18,0.42
PF08190,PF02163:PF03619:PF06258,26,34,9,17,25,967,0.26,0.96,0.35,0.28,7,3,23,4,988,0.43,0.97,0.12,0.21
PF06446,PF07740:PF00537:PF16716,0,1,0,0,1,1017,0.0,1.0,0,0,1,0,0,1,1017,0.0,1.0,0,0
PF01447,PF16485:PF02868:PF00073,1,13,1,0,12,1005,0.08,0.99,1.0,0.28,1,1,0,0,1017,1.0,1.0,1.0,1.0
PF07413,PF17031:PF08879:PF03127,0,13,0,0,13,1005,0.0,0.99,0,0,2,0,0,2,1016,0.0,1.0,0,0
PF15117,PF08404:PF08497:PF02465,0,0,0,0,0,1018,0,1.0,0,0,0,0,0,0,1018,0,1.0,0,0
PF00359,PF07565:PF00955:PF00874,2,22,1,1,21,995,0.05,0.98,0.5,0.15,8,0,2,8,1008,0.0,0.99,0.0,-0.0
PF13243,PF13249:PF01645:PF03028,17,51,17,0,34,967,0.33,0.97,1.0,0.57,8,7,10,1,1000,0.88,0.99,0.41,0.6
PF14625,PF01683:PF02822:PF11543,13,31,8,5,23,982,0.26,0.97,0.62,0.39,9,5,8,4,1001,0.56,0.99,0.38,0.46
PF04926,PF04928:PF16979:PF11620,16,26,14,2,12,990,0.54,0.99,0.88,0.68,7,4,12,3,999,0.57,0.99,0.25,0.37
PF12807,PF13236:PF15044:PF05303,9,12,6,3,6,1003,0.5,0.99,0.67,0.57,5,5,4,0,1009,1.0,1.0,0.56,0.74
PF15006,PF06907:PF08656:PF03488,4,3,0,4,3,1011,0.0,0.99,0.0,-0.0,2,0,4,2,1012,0.0,0.99,0.0,-0.0
PF00624,PF10528:PF00526:PF05436,0,4,0,0,4,1014,0.0,1.0,0,0,0,0,0,0,1018,0,1.0,0,0
PF07139,PF07223:PF00363:PF02186,4,16,1,3,15,999,0.06,0.98,0.25,0.12,0,0,4,0,1014,0,1.0,0.0,0
PF06541,PF15715:PF15063:PF14473,0,0,0,0,0,1018,0,1.0,0,0,0,0,0,0,1018,0,1.0,0,0
PF12603,PF15518:PF14842:PF04196,1,1,1,0,0,1017,1.0,1.0,1.0,1.0,1,1,0,0,1017,1.0,1.0,1.0,1.0
PF11371,PF07259:PF08945:PF10664,0,2,0,0,2,1016,0.0,1.0,0,0,0,0,0,0,1018,0,1.0,0,0
PF09715,PF15460:PF14494:PF03601,0,1,0,0,1,1017,0.0,1.0,0,0,0,0,0,0,1018,0,1.0,0,0
PF14690,PF02211:PF03831:PF13722,0,3,0,0,3,1015,0.0,1.0,0,0,0,0,0,0,1018,0,1.0,0,0
PF00002,PF01825:PF02793:PF16489,56,47,39,17,8,954,0.83,0.98,0.7,0.75,17,15,41,2,960,0.88,0.96,0.27,0.47
PF12341,PF08953:PF13925:PF09453,12,24,6,6,18,988,0.25,0.98,0.5,0.34,3,2,10,1,1005,0.67,0.99,0.17,0.33
PF04375,PF05513:PF05509:PF15518,2,2,0,2,2,1014,0.0,1.0,0.0,-0.0,1,0,2,1,1015,0.0,1.0,0.0,-0.0
PF00456,PF13292:PF02780:PF02779,11,42,8,3,34,973,0.19,0.96,0.73,0.36,31,8,3,23,984,0.26,0.97,0.73,0.42
PF05128,PF15086:PF06780:PF10662,1,4,1,0,3,1014,0.25,1.0,1.0,0.5,1,1,0,0,1017,1.0,1.0,1.0,1.0
PF10667,PF15207:PF07243:PF08093,1,2,0,1,2,1015,0.0,1.0,0.0,-0.0,0,0,1,0,1017,0,1.0,0.0,0
PF08327,PF09229:PF16174:PF16791,17,18,16,1,2,999,0.89,1.0,0.94,0.91,1,1,16,0,1001,1.0,0.98,0.06,0.24
PF01672,PF02259:PF03157:PF12947,0,49,0,0,49,969,0.0,0.95,0,0,6,0,0,6,1012,0.0,0.99,0,0
PF12624,PF16910:PF16908:PF06650,27,26,18,9,8,983,0.69,0.98,0.67,0.67,18,16,11,2,989,0.89,0.99,0.59,0.72
PF16589,PF11626:PF06732:PF08914,27,18,16,11,2,989,0.89,0.99,0.59,0.72,8,8,19,0,991,1.0,0.98,0.3,0.54
PF10620,PF01411:PF15470:PF05725,1,40,0,1,40,977,0.0,0.96,0.0,-0.01,8,0,1,8,1009,0.0,0.99,0.0,-0.0
PF16901,PF16350:PF01266:PF08491,9,68,6,3,62,947,0.09,0.94,0.67,0.23,14,1,8,13,996,0.07,0.98,0.11,0.08
PF15462,PF15109:PF15115:PF15715,1,0,0,1,0,1017,0,1.0,0.0,0,0,0,1,0,1017,0,1.0,0.0,0
PF16500,PF13825:PF12188:PF01617,1,13,0,1,13,1004,0.0,0.99,0.0,-0.0,0,0,1,0,1017,0,1.0,0.0,0
PF04049,PF16546:PF14280:PF07219,12,13,4,8,9,997,0.31,0.98,0.33,0.31,1,1,11,0,1006,1.0,0.99,0.08,0.29
PF05564,PF11317:PF15550:PF02427,1,0,0,1,0,1017,0,1.0,0.0,0,0,0,1,0,1017,0,1.0,0.0,0
PF06400,PF09303:PF06401:PF14762,2,5,2,0,3,1013,0.4,1.0,1.0,0.63,0,0,2,0,1016,0,1.0,0.0,0
PF01169,PF01980:PF04921:PF07292,4,12,1,3,11,1003,0.08,0.99,0.25,0.14,2,1,3,1,1013,0.5,1.0,0.25,0.35
PF06333,PF11597:PF15950:PF08167,8,10,5,3,5,1005,0.5,0.99,0.62,0.56,1,1,7,0,1010,1.0,0.99,0.12,0.35
PF13491,PF09397:PF06505:PF01580,5,5,5,0,0,1013,1.0,1.0,1.0,1.0,5,5,0,0,1013,1.0,1.0,1.0,1.0
PF07326,PF00419:PF04624:PF07409,0,2,0,0,2,1016,0.0,1.0,0,0,0,0,0,0,1018,0,1.0,0,0
PF16053,PF01097:PF00159:PF06446,9,5,1,8,4,1005,0.2,0.99,0.11,0.14,0,0,9,0,1009,0,0.99,0.0,0
PF05130,PF06621:PF17009:PF12114,1,8,1,0,7,1010,0.12,0.99,1.0,0.35,2,1,0,1,1016,0.5,1.0,1.0,0.71
PF01895,PF15272:PF02056:PF06761,2,8,0,2,8,1008,0.0,0.99,0.0,-0.0,0,0,2,0,1016,0,1.0,0.0,0
PF09034,PF11957:PF12721:PF01335,2,17,1,1,16,1000,0.06,0.98,0.5,0.17,5,1,1,4,1012,0.2,1.0,0.5,0.31
PF02450,PF09767:PF01546:PF13813,21,47,11,10,36,961,0.23,0.95,0.52,0.33,8,2,19,6,991,0.25,0.98,0.1,0.14
PF14200,PF03762:PF08531:PF05592,5,22,2,3,20,993,0.09,0.98,0.4,0.18,13,2,3,11,1002,0.15,0.99,0.4,0.24
PF15215,PF08398:PF10951:PF14344,0,1,0,0,1,1017,0.0,1.0,0,0,0,0,0,0,1018,0,1.0,0,0
PF08486,PF10279:PF11751:PF13995,0,0,0,0,0,1018,0,1.0,0,0,0,0,0,0,1018,0,1.0,0,0
PF04820,PF05390:PF08221:PF08631,9,14,1,8,13,996,0.07,0.98,0.11,0.08,3,1,8,2,1007,0.33,0.99,0.11,0.19
PF09172,PF06448:PF01347:PF09175,10,19,10,0,9,999,0.53,0.99,1.0,0.72,5,4,6,1,1007,0.8,0.99,0.4,0.56
PF14663,PF14664:PF14666:PF14668,11,12,11,0,1,1006,0.92,1.0,1.0,0.96,11,10,1,1,1006,0.91,1.0,0.91,0.91
PF12998,PF14051:PF16737:PF09302,19,11,5,14,6,993,0.45,0.98,0.26,0.34,2,1,18,1,998,0.5,0.98,0.05,0.16
PF09192,PF14671:PF07655:PF00649,3,12,1,2,11,1004,0.08,0.99,0.33,0.16,1,1,2,0,1015,1.0,1.0,0.33,0.58
PF00020,PF09034:PF01335:PF15734,23,15,7,16,8,987,0.47,0.98,0.3,0.37,2,1,22,1,994,0.5,0.98,0.04,0.14
PF15938,PF14996:PF15161:PF16112,1,2,1,0,1,1016,0.5,1.0,1.0,0.71,1,1,0,0,1017,1.0,1.0,1.0,1.0
PF17015,PF14877:PF17062:PF03749,0,6,0,0,6,1012,0.0,0.99,0,0,0,0,0,0,1018,0,1.0,0,0
PF00607,PF02093:PF02337:PF00077,11,14,7,4,7,1000,0.5,0.99,0.64,0.56,5,5,6,0,1007,1.0,0.99,0.45,0.67
PF07128,PF05761:PF01938:PF06628,0,41,0,0,41,977,0.0,0.96,0,0,4,0,0,4,1014,0.0,1.0,0,0
PF11429,PF05316:PF10035:PF07391,1,3,0,1,3,1014,0.0,1.0,0.0,-0.0,0,0,1,0,1017,0,1.0,0.0,0
PF12800,PF11953:PF12837:PF12617,2,0,0,2,0,1016,0,1.0,0.0,0,0,0,2,0,1016,0,1.0,0.0,0
PF08003,PF07210:PF01451:PF09351,0,19,0,0,19,999,0.0,0.98,0,0,3,0,0,3,1015,0.0,1.0,0,0
PF03166,PF00859:PF10524:PF03165,16,11,8,8,3,999,0.73,0.99,0.5,0.6,3,2,14,1,1001,0.67,0.99,0.12,0.28
PF10390,PF07303:PF08417:PF09463,13,17,9,4,8,997,0.53,0.99,0.69,0.6,2,2,11,0,1005,1.0,0.99,0.15,0.39
PF00912,PF13699:PF09867:PF06737,9,0,0,9,0,1009,0,0.99,0.0,0,0,0,9,0,1009,0,0.99,0.0,0
PF15363,PF15082:PF10407:PF12443,1,3,0,1,3,1014,0.0,1.0,0.0,-0.0,0,0,1,0,1017,0,1.0,0.0,0
PF02302,PF12242:PF13568:PF13580,1,2,0,1,2,1015,0.0,1.0,0.0,-0.0,1,0,1,1,1016,0.0,1.0,0.0,-0.0
PF01330,PF07157:PF13722:PF07409,2,0,0,2,0,1016,0,1.0,0.0,0,0,0,2,0,1016,0,1.0,0.0,0
PF09443,PF15346:PF14279:PF15298,2,2,1,1,1,1015,0.5,1.0,0.5,0.5,0,0,2,0,1016,0,1.0,0.0,0
PF10195,PF15011:PF14989:PF04930,1,14,0,1,14,1003,0.0,0.99,0.0,-0.0,1,0,1,1,1016,0.0,1.0,0.0,-0.0
PF04406,PF01066:PF07786:PF04833,17,38,7,10,31,970,0.18,0.96,0.41,0.26,4,2,15,2,999,0.5,0.98,0.12,0.24
PF12165,PF12269:PF16737:PF03172,3,8,1,2,7,1008,0.12,0.99,0.33,0.2,2,1,2,1,1014,0.5,1.0,0.33,0.41
PF05378,PF02538:PF01968:PF06032,28,28,28,0,0,990,1.0,1.0,1.0,1.0,28,28,0,0,990,1.0,1.0,1.0,1.0
PF10404,PF10403:PF10405:PF03835,7,12,7,0,5,1006,0.58,1.0,1.0,0.76,10,7,0,3,1008,0.7,1.0,1.0,0.84
PF15174,PF09677:PF16325:PF12388,0,1,0,0,1,1017,0.0,1.0,0,0,0,0,0,0,1018,0,1.0,0,0
PF12632,PF15871:PF15619:PF16944,3,7,1,2,6,1009,0.14,0.99,0.33,0.21,0,0,3,0,1015,0,1.0,0.0,0
PF17045,PF09762:PF11577:PF11496,0,15,0,0,15,1003,0.0,0.99,0,0,1,0,0,1,1017,0.0,1.0,0,0
PF01817,PF01958:PF00742:PF03447,7,18,1,6,17,994,0.06,0.98,0.14,0.08,16,1,6,15,996,0.06,0.98,0.14,0.09
PF02608,PF01547:PF07562:PF03247,4,33,3,1,30,984,0.09,0.97,0.75,0.25,6,2,2,4,1010,0.33,0.99,0.5,0.41
PF16657,PF09154:PF11941:PF16028,1,3,1,0,2,1015,0.33,1.0,1.0,0.58,1,1,0,0,1017,1.0,1.0,1.0,1.0
PF01348,PF01215:PF01329:PF12280,11,29,1,10,28,979,0.03,0.96,0.09,0.04,2,1,10,1,1006,0.5,0.99,0.09,0.21
PF01537,PF17007:PF04632:PF17164,0,0,0,0,0,1018,0,1.0,0,0,0,0,0,0,1018,0,1.0,0,0
PF00393,PF03446:PF14833:PF17042,12,40,11,1,29,977,0.28,0.97,0.92,0.49,22,8,4,14,992,0.36,0.98,0.67,0.48
PF08115,PF08676:PF12736:PF11864,0,32,0,0,32,986,0.0,0.97,0,0,4,0,0,4,1014,0.0,1.0,0,0
PF06733,PF13307:PF06777:PF13890,22,22,21,1,1,995,0.95,1.0,0.95,0.95,15,15,7,0,996,1.0,0.99,0.68,0.82
PF15254,PF03306:PF15703:PF08964,1,6,0,1,6,1011,0.0,0.99,0.0,-0.0,0,0,1,0,1017,0,1.0,0.0,0
PF13946,PF08548:PF05857:PF13588,1,3,1,0,2,1015,0.33,1.0,1.0,0.58,0,0,1,0,1017,0,1.0,0.0,0
PF08604,PF17219:PF16764:PF00641,7,48,7,0,41,970,0.15,0.96,1.0,0.37,2,2,5,0,1011,1.0,1.0,0.29,0.53
PF03451,PF09453:PF04192:PF11540,12,20,3,9,17,989,0.15,0.97,0.25,0.18,1,1,11,0,1006,1.0,0.99,0.08,0.29
PF14680,PF14676:PF14679:PF14675,1,1,1,0,0,1017,1.0,1.0,1.0,1.0,1,1,0,0,1017,1.0,1.0,1.0,1.0
PF01873,PF05508:PF08655:PF10307,13,7,1,12,6,999,0.14,0.98,0.08,0.1,0,0,13,0,1005,0,0.99,0.0,0
PF00531,PF01335:PF00791:PF09034,39,24,19,20,5,974,0.79,0.98,0.49,0.61,4,3,36,1,978,0.75,0.96,0.08,0.23
PF05336,PF06711:PF06718:PF03323,2,8,0,2,8,1008,0.0,0.99,0.0,-0.0,0,0,2,0,1016,0,1.0,0.0,0
PF10630,PF15234:PF06670:PF15398,0,1,0,0,1,1017,0.0,1.0,0,0,0,0,0,0,1018,0,1.0,0,0
PF05724,PF05995:PF06172:PF02284,8,13,3,5,10,1000,0.23,0.99,0.38,0.29,3,1,7,2,1008,0.33,0.99,0.12,0.2
PF06357,PF09904:PF04264:PF09826,1,2,0,1,2,1015,0.0,1.0,0.0,-0.0,0,0,1,0,1017,0,1.0,0.0,0
PF10117,PF17164:PF06355:PF09432,0,2,0,0,2,1016,0.0,1.0,0,0,0,0,0,0,1018,0,1.0,0,0
PF02088,PF00010:PF01508:PF01579,0,101,0,0,101,917,0.0,0.9,0,0,4,0,0,4,1014,0.0,1.0,0,0
PF08240,PF00107:PF01066:PF08652,100,108,80,20,28,890,0.74,0.95,0.8,0.74,24,23,77,1,917,0.96,0.92,0.23,0.45
PF13780,PF04740:PF16888:PF03090,0,0,0,0,0,1018,0,1.0,0,0,0,0,0,0,1018,0,1.0,0,0
PF09551,PF14976:PF09372:PF15487,0,4,0,0,4,1014,0.0,1.0,0,0,1,0,0,1,1017,0.0,1.0,0,0
PF04190,PF01294:PF13741:PF09777,10,7,1,9,6,1002,0.14,0.99,0.1,0.11,2,0,10,2,1006,0.0,0.99,0.0,-0.0
PF07545,PF10332:PF09816:PF04090,1,7,0,1,7,1010,0.0,0.99,0.0,-0.0,1,0,1,1,1016,0.0,1.0,0.0,-0.0
PF13725,PF13718:PF05127:PF08351,12,16,12,0,4,1002,0.75,1.0,1.0,0.86,12,12,0,0,1006,1.0,1.0,1.0,1.0
PF11411,PF10345:PF14743:PF04679,7,19,7,0,12,999,0.37,0.99,1.0,0.6,6,5,2,1,1010,0.83,1.0,0.71,0.77
PF13667,PF16838:PF15319:PF05352,1,0,0,1,0,1017,0,1.0,0.0,0,0,0,1,0,1017,0,1.0,0.0,0
PF16141,PF01033:PF08084:PF08083,0,28,0,0,28,990,0.0,0.97,0,0,13,0,0,13,1005,0.0,0.99,0,0
PF02946,PF01159:PF12509:PF12480,7,24,3,4,21,990,0.12,0.98,0.43,0.22,3,1,6,2,1009,0.33,0.99,0.14,0.21
PF14695,PF04412:PF03709:PF03413,2,6,0,2,6,1010,0.0,0.99,0.0,-0.0,1,0,2,1,1015,0.0,1.0,0.0,-0.0
PF06461,PF08074:PF06465:PF08073,12,13,12,0,1,1005,0.92,1.0,1.0,0.96,12,12,0,0,1006,1.0,1.0,1.0,1.0
PF15150,PF12241:PF16325:PF15518,0,3,0,0,3,1015,0.0,1.0,0,0,0,0,0,0,1018,0,1.0,0,0
PF11046,PF06923:PF01802:PF15034,0,1,0,0,1,1017,0.0,1.0,0,0,0,0,0,0,1018,0,1.0,0,0
PF14303,PF09756:PF02234:PF08265,32,23,5,27,18,968,0.22,0.96,0.16,0.16,2,1,31,1,985,0.5,0.97,0.03,0.12
PF00375,PF03096:PF14798:PF00049,12,11,2,10,9,997,0.18,0.98,0.17,0.16,1,1,11,0,1006,1.0,0.99,0.08,0.29
PF04843,PF14214:PF02689:PF05970,3,48,1,2,47,968,0.02,0.95,0.33,0.07,18,1,2,17,998,0.06,0.98,0.33,0.13
PF15459,PF16874:PF16875:PF06165,3,4,0,3,4,1011,0.0,0.99,0.0,-0.0,1,0,3,1,1014,0.0,1.0,0.0,-0.0
PF00255,PF01625:PF00810:PF01775,19,31,3,16,28,971,0.1,0.96,0.16,0.1,9,2,17,7,992,0.22,0.98,0.11,0.14
PF15331,PF15752:PF03553:PF12081,2,1,0,2,1,1015,0.0,1.0,0.0,-0.0,0,0,2,0,1016,0,1.0,0.0,0
PF01713,PF08590:PF08772:PF16568,12,18,12,0,6,1000,0.67,0.99,1.0,0.81,5,5,7,0,1006,1.0,0.99,0.42,0.64
PF15736,PF04865:PF08334:PF08411,1,2,0,1,2,1015,0.0,1.0,0.0,-0.0,0,0,1,0,1017,0,1.0,0.0,0
PF06122,PF05065:PF05962:PF15775,0,2,0,0,2,1016,0.0,1.0,0,0,0,0,0,0,1018,0,1.0,0,0
PF12448,PF04849:PF16978:PF05422,2,16,2,0,14,1002,0.12,0.99,1.0,0.35,2,1,1,1,1015,0.5,1.0,0.5,0.5
PF15470,PF00936:PF10620:PF04533,0,1,0,0,1,1017,0.0,1.0,0,0,0,0,0,0,1018,0,1.0,0,0
PF01303,PF08093:PF15333:PF15212,0,1,0,0,1,1017,0.0,1.0,0,0,0,0,0,0,1018,0,1.0,0,0
PF07010,PF17049:PF15207:PF10009,0,2,0,0,2,1016,0.0,1.0,0,0,0,0,0,0,1018,0,1.0,0,0
PF07495,PF11863:PF01943:PF06403,1,1,0,1,1,1016,0.0,1.0,0.0,-0.0,0,0,1,0,1017,0,1.0,0.0,0
PF11591,PF03475:PF06545:PF04221,2,11,2,0,9,1007,0.18,0.99,1.0,0.42,4,2,0,2,1014,0.5,1.0,1.0,0.71
PF01922,PF04852:PF10775:PF10248,8,8,3,5,5,1005,0.38,0.99,0.38,0.37,0,0,8,0,1010,0,0.99,0.0,0
PF00892,PF13127:PF00891:PF05652,35,39,12,23,27,956,0.31,0.95,0.34,0.3,6,3,32,3,980,0.5,0.97,0.09,0.2
PF08131,PF06876:PF15141:PF02087,0,2,0,0,2,1016,0.0,1.0,0,0,0,0,0,0,1018,0,1.0,0,0
PF07659,PF11272:PF05504:PF03592,0,8,0,0,8,1010,0.0,0.99,0,0,0,0,0,0,1018,0,1.0,0,0
PF02083,PF13096:PF05837:PF06211,3,2,0,3,2,1013,0.0,1.0,0.0,-0.0,0,0,3,0,1015,0,1.0,0.0,0
PF10070,PF01936:PF06892:PF00347,0,29,0,0,29,989,0.0,0.97,0,0,5,0,0,5,1013,0.0,1.0,0,0
PF10430,PF02019:PF08917:PF06760,4,6,3,1,3,1011,0.5,1.0,0.75,0.61,2,2,2,0,1014,1.0,1.0,0.5,0.71
PF04754,PF06952:PF01668:PF15023,1,2,0,1,2,1015,0.0,1.0,0.0,-0.0,0,0,1,0,1017,0,1.0,0.0,0
PF00967,PF00187:PF00182:PF03427,3,23,3,0,20,995,0.13,0.98,1.0,0.36,6,3,0,3,1012,0.5,1.0,1.0,0.71
PF04729,PF07798:PF15251:PF03095,7,18,2,5,16,995,0.11,0.98,0.29,0.17,3,1,6,2,1009,0.33,0.99,0.14,0.21
PF13194,PF04370:PF14539:PF06451,0,0,0,0,0,1018,0,1.0,0,0,0,0,0,0,1018,0,1.0,0,0
PF01802,PF07250:PF09676:PF00637,1,34,1,0,33,984,0.03,0.97,1.0,0.17,2,0,1,2,1015,0.0,1.0,0.0,-0.0
PF08510,PF05128:PF15086:PF09269,13,6,1,12,5,1000,0.17,0.98,0.08,0.11,1,1,12,0,1005,1.0,0.99,0.08,0.28
PF15791,PF08828:PF12374:PF03474,2,2,1,1,1,1015,0.5,1.0,0.5,0.5,1,1,1,0,1016,1.0,1.0,0.5,0.71
PF13793,PF14572:PF00215:PF02812,23,44,15,8,29,966,0.34,0.96,0.65,0.46,7,6,17,1,994,0.86,0.98,0.26,0.47
PF02290,PF07911:PF06645:PF15879,14,13,2,12,11,993,0.15,0.98,0.14,0.14,2,1,13,1,1003,0.5,0.99,0.07,0.19
PF02806,PF02922:PF16028:PF07821,20,21,13,7,8,990,0.62,0.99,0.65,0.63,4,4,16,0,998,1.0,0.98,0.2,0.44
PF08377,PF00418:PF17020:PF07715,1,10,1,0,9,1008,0.1,0.99,1.0,0.31,2,0,1,2,1015,0.0,1.0,0.0,-0.0
PF11931,PF12108:PF16837:PF16958,6,6,5,1,1,1011,0.83,1.0,0.83,0.83,6,5,1,1,1011,0.83,1.0,0.83,0.83
PF11750,PF12996:PF12938:PF03092,0,12,0,0,12,1006,0.0,0.99,0,0,0,0,0,0,1018,0,1.0,0,0
PF04155,PF15973:PF03103:PF10239,12,13,1,11,12,994,0.08,0.98,0.08,0.07,0,0,12,0,1006,0,0.99,0.0,0
PF07730,PF09239:PF06580:PF16359,7,11,1,6,10,1001,0.09,0.98,0.14,0.11,1,0,7,1,1010,0.0,0.99,0.0,-0.0
PF16166,PF05996:PF08507:PF01023,2,15,1,1,14,1002,0.07,0.99,0.5,0.18,3,1,1,2,1014,0.33,1.0,0.5,0.41
PF00835,PF13097:PF08286:PF14988,1,7,0,1,7,1010,0.0,0.99,0.0,-0.0,0,0,1,0,1017,0,1.0,0.0,0
PF07778,PF16061:PF03074:PF09848,6,16,2,4,14,998,0.12,0.98,0.33,0.2,2,1,5,1,1011,0.5,0.99,0.17,0.29
PF11341,PF13367:PF15312:PF17056,2,3,0,2,3,1013,0.0,1.0,0.0,-0.0,0,0,2,0,1016,0,1.0,0.0,0
PF04954,PF11751:PF14690:PF07157,0,0,0,0,0,1018,0,1.0,0,0,0,0,0,0,1018,0,1.0,0,0
PF04263,PF04265:PF01259:PF01014,19,21,13,6,8,991,0.62,0.99,0.68,0.64,6,4,15,2,997,0.67,0.98,0.21,0.37
PF06760,PF14786:PF08917:PF02019,2,6,2,0,4,1012,0.33,1.0,1.0,0.58,2,2,0,0,1016,1.0,1.0,1.0,1.0
PF12318,PF03090:PF15662:PF08497,0,0,0,0,0,1018,0,1.0,0,0,0,0,0,0,1018,0,1.0,0,0
PF14611,PF11331:PF00649:PF08624,4,14,0,4,14,1000,0.0,0.98,0.0,-0.01,1,0,4,1,1013,0.0,1.0,0.0,-0.0
PF09186,PF03843:PF08572:PF14348,0,5,0,0,5,1013,0.0,1.0,0,0,0,0,0,0,1018,0,1.0,0,0
PF02730,PF07411:PF14376:PF03090,4,3,2,2,1,1013,0.67,1.0,0.5,0.58,0,0,4,0,1014,0,1.0,0.0,0
PF04731,PF10525:PF04617:PF12407,2,4,1,1,3,1013,0.25,1.0,0.5,0.35,1,1,1,0,1016,1.0,1.0,0.5,0.71
PF05642,PF01810:PF02501:PF13205,2,12,0,2,12,1004,0.0,0.99,0.0,-0.0,1,0,2,1,1015,0.0,1.0,0.0,-0.0
PF14845,PF02838:PF00728:PF03174,20,36,20,0,16,982,0.56,0.98,1.0,0.74,9,4,16,5,993,0.44,0.98,0.2,0.29
PF05154,PF09350:PF00684:PF01556,15,44,9,6,35,968,0.2,0.96,0.6,0.33,3,1,14,2,1001,0.33,0.98,0.07,0.14
PF05041,PF14611:PF12422:PF11331,8,9,0,8,9,1001,0.0,0.98,0.0,-0.01,0,0,8,0,1010,0,0.99,0.0,0
PF14528,PF07453:PF04232:PF04277,1,8,1,0,7,1010,0.12,0.99,1.0,0.35,0,0,1,0,1017,0,1.0,0.0,0
PF10371,PF01558:PF17147:PF01855,5,14,5,0,9,1004,0.36,0.99,1.0,0.59,8,5,0,3,1010,0.62,1.0,1.0,0.79
PF14609,PF11130:PF07405:PF09374,1,0,0,1,0,1017,0,1.0,0.0,0,0,0,1,0,1017,0,1.0,0.0,0
PF06861,PF06821:PF15577:PF08183,1,5,0,1,5,1012,0.0,0.99,0.0,-0.0,0,0,1,0,1017,0,1.0,0.0,0
PF07287,PF14330:PF17132:PF02515,10,35,5,5,30,978,0.14,0.97,0.5,0.25,5,4,6,1,1007,0.8,0.99,0.4,0.56
PF00927,PF00868:PF01841:PF04721,9,26,9,0,17,992,0.35,0.98,1.0,0.58,9,7,2,2,1007,0.78,1.0,0.78,0.78
PF12246,PF12247:PF00867:PF00752,2,39,2,0,37,979,0.05,0.96,1.0,0.22,30,1,1,29,987,0.03,0.97,0.5,0.12
PF00335,PF15320:PF04893:PF05347,53,40,16,37,24,941,0.4,0.94,0.3,0.32,6,6,47,0,965,1.0,0.95,0.11,0.33
PF09402,PF08198:PF12949:PF04153,13,20,11,2,9,996,0.55,0.99,0.85,0.68,4,4,9,0,1005,1.0,0.99,0.31,0.55
PF11244,PF11235:PF11232:PF11265,0,7,0,0,7,1011,0.0,0.99,0,0,3,0,0,3,1015,0.0,1.0,0,0
PF09756,PF04367:PF07809:PF15991,6,2,1,5,1,1011,0.5,0.99,0.17,0.29,0,0,6,0,1012,0,0.99,0.0,0
PF05917,PF16752:PF11970:PF06374,0,9,0,0,9,1009,0.0,0.99,0,0,0,0,0,0,1018,0,1.0,0,0
PF08752,PF16381:PF09066:PF14806,5,19,5,0,14,999,0.26,0.99,1.0,0.51,5,2,3,3,1010,0.4,0.99,0.4,0.4
PF15483,PF08404:PF08497:PF10908,1,0,0,1,0,1017,0,1.0,0.0,0,0,0,1,0,1017,0,1.0,0.0,0
PF01249,PF09803:PF09966:PF06399,16,11,5,11,6,996,0.45,0.98,0.31,0.37,1,1,15,0,1002,1.0,0.99,0.06,0.25
PF10754,PF14886:PF01737:PF08398,0,5,0,0,5,1013,0.0,1.0,0,0,0,0,0,0,1018,0,1.0,0,0
PF05191,PF11789:PF12483:PF04089,12,13,5,7,8,998,0.38,0.99,0.42,0.39,3,2,10,1,1005,0.67,0.99,0.17,0.33
PF04601,PF11891:PF04139:PF05097,3,19,3,0,16,999,0.16,0.98,1.0,0.39,3,2,1,1,1014,0.67,1.0,0.67,0.67
PF02622,PF12428:PF07260:PF11945,8,10,2,6,8,1002,0.2,0.99,0.25,0.22,0,0,8,0,1010,0,0.99,0.0,0
PF17005,PF10647:PF17108:PF14077,1,6,1,0,5,1012,0.17,1.0,1.0,0.41,1,1,0,0,1017,1.0,1.0,1.0,1.0
PF03839,PF05046:PF07787:PF05361,9,14,3,6,11,998,0.21,0.98,0.33,0.26,2,2,7,0,1009,1.0,0.99,0.22,0.47
PF01491,PF01230:PF01198:PF01997,4,51,3,1,48,966,0.06,0.95,0.75,0.2,8,2,2,6,1008,0.25,0.99,0.5,0.35
PF04568,PF00833:PF06516:PF01923,5,25,4,1,21,992,0.16,0.98,0.8,0.35,5,2,3,3,1010,0.4,0.99,0.4,0.4
PF06075,PF13537:PF02550:PF00215,6,41,3,3,38,974,0.07,0.96,0.5,0.18,5,0,6,5,1007,0.0,0.99,0.0,-0.01
PF11745,PF16824:PF06725:PF05935,0,3,0,0,3,1015,0.0,1.0,0,0,0,0,0,0,1018,0,1.0,0,0
PF00667,PF00258:PF00175:PF00067,36,194,36,0,158,824,0.19,0.84,1.0,0.39,56,30,6,26,956,0.54,0.97,0.83,0.65
PF16070,PF15705:PF15706:PF16978,11,16,4,7,12,995,0.25,0.98,0.36,0.29,2,2,9,0,1007,1.0,0.99,0.18,0.42
PF12821,PF14231:PF14232:PF06738,0,5,0,0,5,1013,0.0,1.0,0,0,0,0,0,0,1018,0,1.0,0,0
PF05284,PF01750:PF08120:PF07905,0,4,0,0,4,1014,0.0,1.0,0,0,0,0,0,0,1018,0,1.0,0,0
PF02157,PF15502:PF13826:PF15462,7,1,0,7,1,1010,0.0,0.99,0.0,-0.0,0,0,7,0,1011,0,0.99,0.0,0
PF15238,PF15374:PF15302:PF16829,1,0,0,1,0,1017,0,1.0,0.0,0,0,0,1,0,1017,0,1.0,0.0,0
PF06769,PF02197:PF00621:PF04883,1,91,0,1,91,926,0.0,0.91,0.0,-0.01,8,0,1,8,1009,0.0,0.99,0.0,-0.0
PF06969,PF13597:PF12345:PF01967,2,10,2,0,8,1008,0.2,0.99,1.0,0.45,3,2,0,1,1015,0.67,1.0,1.0,0.82
PF16487,PF16488:PF02171:PF16486,23,52,23,0,29,966,0.44,0.97,1.0,0.66,33,23,0,10,985,0.7,0.99,1.0,0.83
PF05306,PF06581:PF09057:PF06729,0,0,0,0,0,1018,0,1.0,0,0,0,0,0,0,1018,0,1.0,0,0
PF07708,PF10279:PF06056:PF17017,1,1,0,1,1,1016,0.0,1.0,0.0,-0.0,0,0,1,0,1017,0,1.0,0.0,0
PF13251,PF08161:PF12074:PF08216,4,13,2,2,11,1003,0.15,0.99,0.5,0.27,2,2,2,0,1014,1.0,1.0,0.5,0.71
PF15488,PF00054:PF05193:PF00675,0,70,0,0,70,948,0.0,0.93,0,0,50,0,0,50,968,0.0,0.95,0,0
PF07304,PF09453:PF08232:PF12234,5,25,2,3,23,990,0.08,0.97,0.4,0.17,2,1,4,1,1012,0.5,1.0,0.2,0.31
PF09830,PF07931:PF04981:PF05334,10,9,1,9,8,1000,0.11,0.98,0.1,0.1,0,0,10,0,1008,0,0.99,0.0,0
PF01504,PF00118:PF10247:PF09794,40,57,21,19,36,942,0.37,0.95,0.53,0.41,6,5,35,1,977,0.83,0.96,0.12,0.31
PF10378,PF12178:PF02472:PF04234,5,4,0,5,4,1009,0.0,0.99,0.0,-0.0,0,0,5,0,1013,0,1.0,0.0,0
PF00989,PF08447:PF16279:PF12114,37,28,17,20,11,970,0.61,0.97,0.46,0.51,8,6,31,2,979,0.75,0.97,0.16,0.34
PF10698,PF06724:PF05939:PF12628,0,0,0,0,0,1018,0,1.0,0,0,0,0,0,0,1018,0,1.0,0,0
PF13298,PF04090:PF11001:PF02631,8,9,4,4,5,1005,0.44,0.99,0.5,0.47,2,1,7,1,1009,0.5,0.99,0.12,0.25
PF00685,PF12062:PF00141:PF02485,40,49,16,24,33,945,0.33,0.94,0.4,0.33,11,9,31,2,976,0.82,0.97,0.23,0.42
PF09825,PF02237:PF10437:PF10210,2,9,1,1,8,1008,0.11,0.99,0.5,0.23,2,1,1,1,1015,0.5,1.0,0.5,0.5
PF16007,PF05387:PF11282:PF08636,1,4,0,1,4,1013,0.0,1.0,0.0,-0.0,0,0,1,0,1017,0,1.0,0.0,0
PF05140,PF09425:PF00925:PF04111,3,24,2,1,22,993,0.08,0.98,0.67,0.23,3,0,3,3,1012,0.0,0.99,0.0,-0.0
PF02765,PF16686:PF07923:PF14637,9,15,5,4,10,999,0.33,0.99,0.56,0.42,1,1,8,0,1009,1.0,0.99,0.11,0.33
PF10285,PF10284:PF05295:PF06753,0,1,0,0,1,1017,0.0,1.0,0,0,0,0,0,0,1018,0,1.0,0,0
PF12577,PF02161:PF12743:PF02155,3,8,3,0,5,1010,0.38,1.0,1.0,0.61,5,3,0,2,1013,0.6,1.0,1.0,0.77
PF15710,PF16829:PF10630:PF15398,0,1,0,0,1,1017,0.0,1.0,0,0,0,0,0,0,1018,0,1.0,0,0
PF15261,PF06210:PF00524:PF05065,1,5,0,1,5,1012,0.0,0.99,0.0,-0.0,0,0,1,0,1017,0,1.0,0.0,0
PF00788,PF16517:PF09235:PF08947,49,8,7,42,1,968,0.88,0.96,0.14,0.34,1,1,48,0,969,1.0,0.95,0.02,0.14
PF16449,PF08411:PF15935:PF08724,0,1,0,0,1,1017,0.0,1.0,0,0,0,0,0,0,1018,0,1.0,0,0
PF10417,PF05421:PF14289:PF00578,32,45,31,1,14,972,0.69,0.99,0.97,0.81,2,2,30,0,986,1.0,0.97,0.06,0.25
PF15800,PF14554:PF04692:PF00341,1,7,1,0,6,1011,0.14,0.99,1.0,0.38,2,1,0,1,1016,0.5,1.0,1.0,0.71
PF01066,PF08652:PF13813:PF02517,35,27,12,23,15,968,0.44,0.96,0.34,0.37,4,4,31,0,983,1.0,0.97,0.11,0.33
PF02749,PF01729:PF12243:PF14693,10,15,10,0,5,1003,0.67,1.0,1.0,0.81,0,0,10,0,1008,0,0.99,0.0,0
PF04641,PF15906:PF13879:PF00160,13,78,8,5,70,935,0.1,0.93,0.62,0.23,11,5,8,6,999,0.45,0.99,0.38,0.41
PF01810,PF06756:PF07964:PF10951,8,1,0,8,1,1009,0.0,0.99,0.0,-0.0,0,0,8,0,1010,0,0.99,0.0,0
PF09302,PF04004:PF04090:PF09816,4,15,1,3,14,1000,0.07,0.98,0.25,0.12,3,0,4,3,1011,0.0,0.99,0.0,-0.0
PF05473,PF12453:PF06583:PF12355,4,2,1,3,1,1013,0.5,1.0,0.25,0.35,1,1,3,0,1014,1.0,1.0,0.25,0.5
PF02297,PF16953:PF09713:PF15375,18,26,7,11,19,981,0.27,0.97,0.39,0.31,4,3,15,1,999,0.75,0.98,0.17,0.35
PF00197,PF04520:PF05915:PF06749,1,8,0,1,8,1009,0.0,0.99,0.0,-0.0,1,0,1,1,1016,0.0,1.0,0.0,-0.0
PF08570,PF06890:PF09829:PF17049,2,1,0,2,1,1015,0.0,1.0,0.0,-0.0,0,0,2,0,1016,0,1.0,0.0,0
PF10444,PF10512:PF15805:PF10488,6,2,0,6,2,1010,0.0,0.99,0.0,-0.0,0,0,6,0,1012,0,0.99,0.0,0
PF10151,PF01959:PF06217:PF14713,6,5,1,5,4,1008,0.2,0.99,0.17,0.18,0,0,6,0,1012,0,0.99,0.0,0
PF16415,PF12842:PF16417:PF04054,13,14,12,1,2,1003,0.86,1.0,0.92,0.89,10,10,3,0,1005,1.0,1.0,0.77,0.88
PF10644,PF14881:PF08221:PF08631,10,22,8,2,14,994,0.36,0.98,0.8,0.53,3,1,9,2,1006,0.33,0.99,0.1,0.18
PF09459,PF12046:PF10716:PF07544,1,7,0,1,7,1010,0.0,0.99,0.0,-0.0,0,0,1,0,1017,0,1.0,0.0,0
PF04092,PF16321:PF10806:PF17172,0,10,0,0,10,1008,0.0,0.99,0,0,2,0,0,2,1016,0.0,1.0,0,0
PF07687,PF01546:PF03417:PF01988,11,47,8,3,39,968,0.17,0.96,0.73,0.34,11,4,7,7,1000,0.36,0.99,0.36,0.36
PF05193,PF00675:PF16187:PF08367,57,61,54,3,7,954,0.89,0.99,0.95,0.91,22,21,36,1,960,0.95,0.96,0.37,0.58
PF06868,PF03379:PF15085:PF07327,0,4,0,0,4,1014,0.0,1.0,0,0,0,0,0,0,1018,0,1.0,0,0
PF01636,PF13419:PF00561:PF00441,55,136,38,17,98,865,0.28,0.89,0.69,0.39,43,26,29,17,946,0.6,0.95,0.47,0.51
PF04184,PF16720:PF03784:PF15993,2,2,0,2,2,1014,0.0,1.0,0.0,-0.0,0,0,2,0,1016,0,1.0,0.0,0
PF16892,PF16893:PF09309:PF12258,2,2,2,0,0,1016,1.0,1.0,1.0,1.0,0,0,2,0,1016,0,1.0,0.0,0
PF07289,PF13299:PF07521:PF10996,3,37,1,2,36,979,0.03,0.96,0.33,0.09,27,1,2,26,989,0.04,0.97,0.33,0.1
PF13625,PF16203:PF09416:PF04313,11,22,11,0,11,996,0.5,0.99,1.0,0.7,5,5,6,0,1007,1.0,0.99,0.45,0.67
PF00799,PF08283:PF07085:PF00577,2,12,2,0,10,1006,0.17,0.99,1.0,0.41,0,0,2,0,1016,0,1.0,0.0,0
PF00317,PF02867:PF03477:PF03989,11,22,11,0,11,996,0.5,0.99,1.0,0.7,6,6,5,0,1007,1.0,1.0,0.55,0.74
PF05823,PF01674:PF15868:PF00965,2,20,1,1,19,997,0.05,0.98,0.5,0.15,0,0,2,0,1016,0,1.0,0.0,0
PF00645,PF08063:PF08645:PF16759,22,22,9,13,13,983,0.41,0.97,0.41,0.4,3,3,19,0,996,1.0,0.98,0.14,0.37
PF00621,PF08174:PF08916:PF00617,78,50,27,51,23,917,0.54,0.93,0.35,0.4,5,5,73,0,940,1.0,0.93,0.06,0.24
PF14784,PF06239:PF17187:PF02799,1,20,1,0,19,998,0.05,0.98,1.0,0.22,3,0,1,3,1014,0.0,1.0,0.0,-0.0
PF00964,PF00758:PF06446:PF00537,0,4,0,0,4,1014,0.0,1.0,0,0,0,0,0,0,1018,0,1.0,0,0
PF03653,PF00986:PF00204:PF12155,0,22,0,0,22,996,0.0,0.98,0,0,10,0,0,10,1008,0.0,0.99,0,0
PF07533,PF07744:PF07529:PF15790,18,27,12,6,15,985,0.44,0.98,0.67,0.53,6,5,13,1,999,0.83,0.99,0.28,0.48
PF01247,PF12232:PF01586:PF15372,18,3,2,16,1,999,0.67,0.98,0.11,0.27,3,2,16,1,999,0.67,0.98,0.11,0.27
PF06671,PF02343:PF15789:PF02084,0,2,0,0,2,1016,0.0,1.0,0,0,0,0,0,0,1018,0,1.0,0,0
PF05621,PF10563:PF08453:PF16510,0,3,0,0,3,1015,0.0,1.0,0,0,0,0,0,0,1018,0,1.0,0,0
PF12101,PF03428:PF03241:PF03831,0,0,0,0,0,1018,0,1.0,0,0,0,0,0,0,1018,0,1.0,0,0
PF10448,PF15716:PF15763:PF11402,0,0,0,0,0,1018,0,1.0,0,0,0,0,0,0,1018,0,1.0,0,0
PF12307,PF08808:PF17076:PF03244,2,0,0,2,0,1016,0,1.0,0.0,0,0,0,2,0,1016,0,1.0,0.0,0
PF13516,PF00560:PF14484:PF13855,89,154,64,25,90,839,0.42,0.89,0.72,0.49,50,30,59,20,909,0.6,0.92,0.34,0.41
PF04288,PF03882:PF17192:PF10797,0,1,0,0,1,1017,0.0,1.0,0,0,0,0,0,0,1018,0,1.0,0,0
PF13929,PF13722:PF05947:PF02572,0,2,0,0,2,1016,0.0,1.0,0,0,0,0,0,0,1018,0,1.0,0,0
PF02533,PF15171:PF04538:PF00489,2,3,0,2,3,1013,0.0,1.0,0.0,-0.0,0,0,2,0,1016,0,1.0,0.0,0
PF00278,PF02784:PF03936:PF01397,19,35,17,2,18,981,0.49,0.98,0.89,0.65,17,3,16,14,985,0.18,0.97,0.16,0.15
PF00115,PF00119:PF00124:PF00507,17,13,8,9,5,996,0.62,0.99,0.47,0.53,3,3,14,0,1001,1.0,0.99,0.18,0.42
PF03816,PF15175:PF15046:PF15776,2,5,2,0,3,1013,0.4,1.0,1.0,0.63,0,0,2,0,1016,0,1.0,0.0,0
PF04578,PF13968:PF07731:PF01757,16,80,16,0,64,938,0.2,0.94,1.0,0.43,16,8,8,8,994,0.5,0.98,0.5,0.49
PF09584,PF16669:PF02649:PF10524,0,15,0,0,15,1003,0.0,0.99,0,0,2,0,0,2,1016,0.0,1.0,0,0
PF03748,PF14882:PF03406:PF07411,0,0,0,0,0,1018,0,1.0,0,0,0,0,0,0,1018,0,1.0,0,0
PF07471,PF11744:PF03096:PF11955,0,13,0,0,13,1005,0.0,0.99,0,0,4,0,0,4,1014,0.0,1.0,0,0
PF00949,PF00972:PF05309:PF05513,6,7,6,0,1,1011,0.86,1.0,1.0,0.93,1,0,6,1,1011,0.0,0.99,0.0,-0.0
PF08587,PF13240:PF08332:PF12605,11,11,3,8,8,999,0.27,0.98,0.27,0.26,3,2,9,1,1006,0.67,0.99,0.18,0.34
PF00198,PF02817:PF00364:PF10937,21,46,19,2,27,970,0.41,0.97,0.9,0.6,15,15,6,0,997,1.0,0.99,0.71,0.84
PF15332,PF15115:PF15333:PF15036,1,1,0,1,1,1016,0.0,1.0,0.0,-0.0,0,0,1,0,1017,0,1.0,0.0,0
PF01698,PF03414:PF03242:PF02431,1,7,1,0,6,1011,0.14,0.99,1.0,0.38,0,0,1,0,1017,0,1.0,0.0,0
PF02392,PF03040:PF10322:PF10285,8,6,6,2,0,1010,1.0,1.0,0.75,0.87,0,0,8,0,1010,0,0.99,0.0,0
PF17128,PF16967:PF08479:PF08453,1,2,0,1,2,1015,0.0,1.0,0.0,-0.0,0,0,1,0,1017,0,1.0,0.0,0
PF14359,PF03831:PF11751:PF04717,0,0,0,0,0,1018,0,1.0,0,0,0,0,0,0,1018,0,1.0,0,0
PF09230,PF09033:PF05422:PF10287,3,6,0,3,6,1009,0.0,0.99,0.0,-0.0,0,0,3,0,1015,0,1.0,0.0,0
PF13890,PF09733:PF11977:PF07810,4,21,3,1,18,996,0.14,0.98,0.75,0.32,4,1,3,3,1011,0.25,0.99,0.25,0.25
PF15208,PF16590:PF15340:PF01668,1,5,0,1,5,1012,0.0,0.99,0.0,-0.0,0,0,1,0,1017,0,1.0,0.0,0
PF09814,PF09496:PF04921:PF08286,12,14,6,6,8,998,0.43,0.99,0.5,0.46,1,1,11,0,1006,1.0,0.99,0.08,0.29
PF12072,PF10470:PF08067:PF16551,1,4,1,0,3,1014,0.25,1.0,1.0,0.5,1,1,0,0,1017,1.0,1.0,1.0,1.0
PF02633,PF13322:PF03616:PF15272,2,1,0,2,1,1015,0.0,1.0,0.0,-0.0,0,0,2,0,1016,0,1.0,0.0,0
PF03205,PF02217:PF06744:PF03743,1,8,0,1,8,1009,0.0,0.99,0.0,-0.0,2,0,1,2,1015,0.0,1.0,0.0,-0.0
PF05148,PF09310:PF15898:PF15264,14,4,1,13,3,1001,0.25,0.98,0.07,0.13,0,0,14,0,1004,0,0.99,0.0,0
PF15669,PF06989:PF16171:PF07904,0,3,0,0,3,1015,0.0,1.0,0,0,0,0,0,0,1018,0,1.0,0,0
PF04185,PF03647:PF03358:PF07816,15,23,6,9,17,986,0.26,0.97,0.4,0.31,6,2,13,4,999,0.33,0.98,0.13,0.2
PF01796,PF12106:PF03814:PF02399,1,4,0,1,4,1013,0.0,1.0,0.0,-0.0,0,0,1,0,1017,0,1.0,0.0,0
PF00332,PF07983:PF03198:PF00154,26,38,15,11,23,969,0.39,0.97,0.58,0.46,7,6,20,1,991,0.86,0.98,0.23,0.44
PF03315,PF03313:PF07171:PF05683,4,11,4,0,7,1007,0.36,0.99,1.0,0.6,2,1,3,1,1013,0.5,1.0,0.25,0.35
PF10237,PF06839:PF07962:PF01131,14,43,11,3,32,972,0.26,0.97,0.79,0.44,8,6,8,2,1002,0.75,0.99,0.43,0.56
PF08601,PF12498:PF03957:PF11785,4,4,2,2,2,1012,0.5,1.0,0.5,0.5,2,2,2,0,1014,1.0,1.0,0.5,0.71
PF05612,PF04901:PF02372:PF03488,0,4,0,0,4,1014,0.0,1.0,0,0,0,0,0,0,1018,0,1.0,0,0
PF10288,PF10022:PF16503:PF05827,5,20,3,2,17,996,0.15,0.98,0.6,0.29,3,1,4,2,1011,0.33,0.99,0.2,0.26
PF09066,PF14796:PF14797:PF14806,7,15,3,4,12,999,0.2,0.98,0.43,0.29,3,1,6,2,1009,0.33,0.99,0.14,0.21
PF03634,PF09335:PF02915:PF05678,6,29,4,2,25,987,0.14,0.97,0.67,0.3,4,1,5,3,1009,0.25,0.99,0.17,0.2
PF16566,PF04818:PF09750:PF01805,12,54,10,2,44,962,0.19,0.95,0.83,0.38,17,3,9,14,992,0.18,0.98,0.25,0.2
PF11326,PF01987:PF11264:PF10780,4,6,1,3,5,1009,0.17,0.99,0.25,0.2,1,0,4,1,1013,0.0,1.0,0.0,-0.0
PF09771,PF04709:PF00688:PF00019,5,20,5,0,15,998,0.25,0.99,1.0,0.5,15,4,1,11,1002,0.27,0.99,0.8,0.46
PF04137,PF00197:PF10604:PF05910,6,25,1,5,24,988,0.04,0.97,0.17,0.07,3,1,5,2,1010,0.33,0.99,0.17,0.23
PF00014,PF10223:PF15761:PF00095,48,30,14,34,16,954,0.47,0.95,0.29,0.34,2,2,46,0,970,1.0,0.95,0.04,0.2
PF02560,PF09424:PF12900:PF02195,5,18,2,3,16,997,0.11,0.98,0.4,0.2,1,1,4,0,1013,1.0,1.0,0.2,0.45
PF14937,PF05234:PF15190:PF15107,4,2,0,4,2,1012,0.0,0.99,0.0,-0.0,0,0,4,0,1014,0,1.0,0.0,0
PF01411,PF07973:PF02272:PF03129,27,51,19,8,32,959,0.37,0.96,0.7,0.49,23,14,13,9,982,0.61,0.98,0.52,0.55
PF04438,PF14773:PF05030:PF08655,20,16,5,15,11,987,0.31,0.97,0.25,0.27,3,0,20,3,995,0.0,0.98,0.0,-0.01
PF14343,PF15771:PF07209:PF16804,0,1,0,0,1,1017,0.0,1.0,0,0,0,0,0,0,1018,0,1.0,0,0
PF08485,PF04552:PF14842:PF04963,1,1,0,1,1,1016,0.0,1.0,0.0,-0.0,1,0,1,1,1016,0.0,1.0,0.0,-0.0
PF16403,PF08305:PF08919:PF13402,8,14,3,5,11,999,0.21,0.98,0.38,0.28,3,2,6,1,1009,0.67,0.99,0.25,0.41
PF13363,PF10435:PF13364:PF01301,5,31,5,0,26,987,0.16,0.97,1.0,0.4,10,5,0,5,1008,0.5,1.0,1.0,0.71
PF03652,PF00537:PF06232:PF07011,5,5,1,4,4,1009,0.2,0.99,0.2,0.2,0,0,5,0,1013,0,1.0,0.0,0
PF00696,PF00171:PF04768:PF13840,39,109,28,11,81,898,0.26,0.91,0.72,0.39,18,10,29,8,971,0.56,0.96,0.26,0.36
PF00125,PF16211:PF01661:PF02926,46,50,25,21,25,947,0.5,0.95,0.54,0.5,13,11,35,2,970,0.85,0.96,0.24,0.44
PF08776,PF05210:PF00568:PF02205,10,43,10,0,33,975,0.23,0.97,1.0,0.47,12,7,3,5,1003,0.58,0.99,0.7,0.64
PF04104,PF01702:PF06991:PF06814,18,31,6,12,25,975,0.19,0.96,0.33,0.24,4,3,15,1,999,0.75,0.98,0.17,0.35
PF00618,PF00617:PF00610:PF00027,40,121,39,1,82,896,0.32,0.92,0.97,0.54,33,22,18,11,967,0.67,0.97,0.55,0.59
PF08880,PF08879:PF07529:PF14619,10,20,10,0,10,998,0.5,0.99,1.0,0.7,7,7,3,0,1008,1.0,1.0,0.7,0.84
PF08859,PF17017:PF15730:PF14216,0,2,0,0,2,1016,0.0,1.0,0,0,0,0,0,0,1018,0,1.0,0,0
PF02922,PF02806:PF07821:PF16028,16,25,13,3,12,990,0.52,0.99,0.81,0.64,4,4,12,0,1002,1.0,0.99,0.25,0.5
PF07159,PF05994:PF01175:PF04704,7,13,6,1,7,1004,0.46,0.99,0.86,0.63,2,1,6,1,1010,0.5,0.99,0.14,0.26
PF11267,PF06485:PF10571:PF12049,2,4,0,2,4,1012,0.0,0.99,0.0,-0.0,0,0,2,0,1016,0,1.0,0.0,0
PF04755,PF14547:PF02590:PF07887,15,14,5,10,9,994,0.36,0.98,0.33,0.34,1,1,14,0,1003,1.0,0.99,0.07,0.26
PF12792,PF00376:PF09278:PF13644,2,2,2,0,0,1016,1.0,1.0,1.0,1.0,2,2,0,0,1016,1.0,1.0,1.0,1.0
PF10206,PF02950:PF09232:PF17124,4,1,0,4,1,1013,0.0,1.0,0.0,-0.0,0,0,4,0,1014,0,1.0,0.0,0
PF10579,PF13441:PF06547:PF16669,9,10,3,6,7,1002,0.3,0.99,0.33,0.31,2,2,7,0,1009,1.0,0.99,0.22,0.47
PF06640,PF07988:PF08558:PF09316,1,9,0,1,9,1008,0.0,0.99,0.0,-0.0,1,0,1,1,1016,0.0,1.0,0.0,-0.0
PF12098,PF08885:PF10951:PF05962,0,2,0,0,2,1016,0.0,1.0,0,0,0,0,0,0,1018,0,1.0,0,0
PF15717,PF04988:PF16051:PF03344,0,5,0,0,5,1013,0.0,1.0,0,0,1,0,0,1,1017,0.0,1.0,0,0
PF15258,PF12519:PF15961:PF15509,2,8,0,2,8,1008,0.0,0.99,0.0,-0.0,0,0,2,0,1016,0,1.0,0.0,0
PF00183,PF09239:PF07730:PF10436,33,23,7,26,16,969,0.3,0.96,0.21,0.23,2,2,31,0,985,1.0,0.97,0.06,0.24
PF00187,PF00967:PF00182:PF03427,13,16,6,7,10,995,0.38,0.98,0.46,0.41,3,3,10,0,1005,1.0,0.99,0.23,0.48
PF08777,PF14304:PF12196:PF08081,12,11,3,9,8,998,0.27,0.98,0.25,0.25,1,1,11,0,1006,1.0,0.99,0.08,0.29
PF03973,PF12238:PF00143:PF06658,0,4,0,0,4,1014,0.0,1.0,0,0,0,0,0,0,1018,0,1.0,0,0
PF16414,PF02460:PF12349:PF00368,16,55,16,0,39,963,0.29,0.96,1.0,0.53,22,12,4,10,992,0.55,0.99,0.75,0.63
PF14249,PF00301:PF08137:PF07809,2,2,0,2,2,1014,0.0,1.0,0.0,-0.0,0,0,2,0,1016,0,1.0,0.0,0
PF12409,PF12515:PF12424:PF09040,14,17,6,8,11,993,0.35,0.98,0.43,0.38,3,3,11,0,1004,1.0,0.99,0.21,0.46
PF01316,PF01668:PF03379:PF10106,2,4,0,2,4,1012,0.0,0.99,0.0,-0.0,0,0,2,0,1016,0,1.0,0.0,0
PF00322,PF02394:PF05283:PF14946,1,7,0,1,7,1010,0.0,0.99,0.0,-0.0,0,0,1,0,1017,0,1.0,0.0,0
PF06737,PF02557:PF09669:PF06724,0,3,0,0,3,1015,0.0,1.0,0,0,0,0,0,0,1018,0,1.0,0,0
PF05379,PF16463:PF13753:PF07804,2,1,0,2,1,1015,0.0,1.0,0.0,-0.0,0,0,2,0,1016,0,1.0,0.0,0
PF00142,PF06446:PF01097:PF16541,2,5,0,2,5,1011,0.0,0.99,0.0,-0.0,0,0,2,0,1016,0,1.0,0.0,0
PF15047,PF08792:PF15211:PF15713,0,2,0,0,2,1016,0.0,1.0,0,0,0,0,0,0,1018,0,1.0,0,0
PF15492,PF08314:PF17167:PF06165,1,8,1,0,7,1010,0.12,0.99,1.0,0.35,3,0,1,3,1014,0.0,1.0,0.0,-0.0
PF11652,PF15379:PF06485:PF17078,1,5,0,1,5,1012,0.0,0.99,0.0,-0.0,0,0,1,0,1017,0,1.0,0.0,0
PF01852,PF07059:PF16719:PF12045,30,12,8,22,4,984,0.67,0.97,0.27,0.41,2,2,28,0,988,1.0,0.97,0.07,0.25
PF07054,PF11265:PF04747:PF11244,2,4,0,2,4,1012,0.0,0.99,0.0,-0.0,0,0,2,0,1016,0,1.0,0.0,0
PF09839,PF14573:PF14885:PF03548,0,4,0,0,4,1014,0.0,1.0,0,0,0,0,0,0,1018,0,1.0,0,0
PF04973,PF01717:PF00130:PF02123,1,67,0,1,67,950,0.0,0.93,0.0,-0.01,8,0,1,8,1009,0.0,0.99,0.0,-0.0
PF11218,PF02554:PF03831:PF17164,1,0,0,1,0,1017,0,1.0,0.0,0,0,0,1,0,1017,0,1.0,0.0,0
PF08564,PF03234:PF08565:PF07334,9,12,9,0,3,1006,0.75,1.0,1.0,0.86,7,6,3,1,1008,0.86,1.0,0.67,0.75
PF00520,PF03521:PF03520:PF11956,88,11,11,77,0,930,1.0,0.92,0.12,0.34,3,3,85,0,930,1.0,0.92,0.03,0.18
PF06291,PF02297:PF07719:PF13640,0,67,0,0,67,951,0.0,0.93,0,0,24,0,0,24,994,0.0,0.98,0,0
PF15750,PF05857:PF02951:PF14882,1,4,0,1,4,1013,0.0,1.0,0.0,-0.0,0,0,1,0,1017,0,1.0,0.0,0
PF09006,PF08391:PF03954:PF06023,0,2,0,0,2,1016,0.0,1.0,0,0,0,0,0,0,1018,0,1.0,0,0
PF01355,PF09826:PF17060:PF09798,2,3,1,1,2,1014,0.33,1.0,0.5,0.41,0,0,2,0,1016,0,1.0,0.0,0
PF07364,PF07171:PF06863:PF06742,3,6,3,0,3,1012,0.5,1.0,1.0,0.71,0,0,3,0,1015,0,1.0,0.0,0
PF15651,PF14858:PF10650:PF15739,0,7,0,0,7,1011,0.0,0.99,0,0,1,0,0,1,1017,0.0,1.0,0,0
PF07263,PF15427:PF12264:PF04428,0,8,0,0,8,1010,0.0,0.99,0,0,0,0,0,0,1018,0,1.0,0,0
PF02448,PF15559:PF02427:PF15109,0,0,0,0,0,1018,0,1.0,0,0,0,0,0,0,1018,0,1.0,0,0
PF11547,PF12516:PF10309:PF15778,4,12,3,1,9,1005,0.25,0.99,0.75,0.43,1,1,3,0,1014,1.0,1.0,0.25,0.5
PF08248,PF08110:PF07440:PF01372,0,1,0,0,1,1017,0.0,1.0,0,0,0,0,0,0,1018,0,1.0,0,0
PF00487,PF01070:PF03404:PF04116,38,67,12,26,55,925,0.18,0.92,0.32,0.2,21,8,30,13,967,0.38,0.96,0.21,0.26
PF02567,PF13380:PF15161:PF14996,17,9,6,11,3,998,0.67,0.99,0.35,0.48,1,1,16,0,1001,1.0,0.98,0.06,0.24
PF04117,PF03556:PF04819:PF07542,40,26,9,31,17,961,0.35,0.95,0.23,0.26,5,4,36,1,977,0.8,0.96,0.1,0.28
PF03841,PF13382:PF01475:PF12390,1,6,1,0,5,1012,0.17,1.0,1.0,0.41,1,1,0,0,1017,1.0,1.0,1.0,1.0
PF16092,PF01493:PF14691:PF00310,7,17,2,5,15,996,0.12,0.98,0.29,0.17,7,2,5,5,1006,0.29,0.99,0.29,0.28
PF05925,PF06711:PF08192:PF11339,2,0,0,2,0,1016,0,1.0,0.0,0,0,0,2,0,1016,0,1.0,0.0,0
PF05742,PF05719:PF06172:PF10165,5,13,2,3,11,1002,0.15,0.99,0.4,0.24,1,0,5,1,1012,0.0,0.99,0.0,-0.0
PF14765,PF16073:PF08659:PF08242,36,60,36,0,24,958,0.6,0.98,1.0,0.77,29,27,9,2,980,0.93,0.99,0.75,0.83
PF16000,PF10699:PF09797:PF16401,3,12,1,2,11,1004,0.08,0.99,0.33,0.16,0,0,3,0,1015,0,1.0,0.0,0
PF14815,PF10576:PF07934:PF00633,7,18,3,4,15,996,0.17,0.98,0.43,0.26,3,1,6,2,1009,0.33,0.99,0.14,0.21
PF08731,PF13810:PF05841:PF07931,1,4,0,1,4,1013,0.0,1.0,0.0,-0.0,0,0,1,0,1017,0,1.0,0.0,0
PF05704,PF10329:PF04229:PF03631,5,9,0,5,9,1004,0.0,0.99,0.0,-0.01,0,0,5,0,1013,0,1.0,0.0,0
PF10354,PF03147:PF01409:PF02912,14,24,7,7,17,987,0.29,0.98,0.5,0.37,17,4,10,13,991,0.24,0.98,0.29,0.25
PF01545,PF00474:PF16916:PF00849,41,70,20,21,50,927,0.29,0.93,0.49,0.34,15,13,28,2,975,0.87,0.97,0.32,0.51
PF10376,PF09367:PF11017:PF15551,1,0,0,1,0,1017,0,1.0,0.0,0,0,0,1,0,1017,0,1.0,0.0,0
PF12152,PF04050:PF15407:PF09462,3,7,2,1,5,1010,0.29,0.99,0.67,0.43,1,0,3,1,1014,0.0,1.0,0.0,-0.0
PF16297,PF07962:PF14893:PF07530,3,12,3,0,9,1006,0.25,0.99,1.0,0.5,4,3,0,1,1014,0.75,1.0,1.0,0.87
PF11398,PF01874:PF07661:PF11775,0,3,0,0,3,1015,0.0,1.0,0,0,1,0,0,1,1017,0.0,1.0,0,0
PF07734,PF08268:PF10442:PF03478,16,35,10,6,25,977,0.29,0.97,0.62,0.41,8,4,12,4,998,0.5,0.98,0.25,0.35
PF00362,PF17205:PF07965:PF08725,10,10,9,1,1,1007,0.9,1.0,0.9,0.9,4,4,6,0,1008,1.0,0.99,0.4,0.63
PF14936,PF08591:PF15462:PF03488,0,2,0,0,2,1016,0.0,1.0,0,0,0,0,0,0,1018,0,1.0,0,0
PF09768,PF05915:PF03587:PF14935,10,10,3,7,7,1001,0.3,0.99,0.3,0.29,1,1,9,0,1008,1.0,0.99,0.1,0.31
PF10373,PF09469:PF10374:PF00649,14,18,11,3,7,997,0.61,0.99,0.79,0.69,0,0,14,0,1004,0,0.99,0.0,0
PF01964,PF12049:PF03741:PF11460,5,7,1,4,6,1007,0.14,0.99,0.2,0.16,0,0,5,0,1013,0,1.0,0.0,0
PF16416,PF07963:PF10410:PF12299,0,6,0,0,6,1012,0.0,0.99,0,0,0,0,0,0,1018,0,1.0,0,0
PF13846,PF12449:PF10334:PF16801,1,11,0,1,11,1006,0.0,0.99,0.0,-0.0,0,0,1,0,1017,0,1.0,0.0,0
PF11500,PF15456:PF16501:PF03344,1,4,0,1,4,1013,0.0,1.0,0.0,-0.0,0,0,1,0,1017,0,1.0,0.0,0
PF07765,PF11577:PF16830:PF10377,8,8,3,5,5,1005,0.38,0.99,0.38,0.37,1,1,7,0,1010,1.0,0.99,0.12,0.35
PF04992,PF04990:PF04983:PF11523,4,34,3,1,31,983,0.09,0.97,0.75,0.25,5,2,2,3,1011,0.4,1.0,0.5,0.44
PF01756,PF14749:PF08028:PF09317,20,15,12,8,3,995,0.8,0.99,0.6,0.69,3,3,17,0,998,1.0,0.98,0.15,0.38
PF13827,PF12946:PF01000:PF05434,0,12,0,0,12,1006,0.0,0.99,0,0,3,0,0,3,1015,0.0,1.0,0,0
PF06148,PF08314:PF10475:PF15492,11,8,4,7,4,1003,0.5,0.99,0.36,0.42,2,2,9,0,1007,1.0,0.99,0.18,0.42
PF09532,PF12701:PF03853:PF02750,17,28,16,1,12,989,0.57,0.99,0.94,0.73,8,8,9,0,1001,1.0,0.99,0.47,0.68
PF03707,PF16415:PF11597:PF06011,7,20,1,6,19,992,0.05,0.98,0.14,0.07,3,1,6,2,1009,0.33,0.99,0.14,0.21
PF16977,PF07602:PF15494:PF09342,7,11,3,4,8,1003,0.27,0.99,0.43,0.34,2,1,6,1,1010,0.5,0.99,0.14,0.26
PF08494,PF07077:PF04740:PF06864,3,3,3,0,0,1015,1.0,1.0,1.0,1.0,1,1,2,0,1015,1.0,1.0,0.33,0.58
PF08024,PF09786:PF03351:PF06080,0,31,0,0,31,987,0.0,0.97,0,0,5,0,0,5,1013,0.0,1.0,0,0
PF03446,PF14833:PF00393:PF17042,37,29,25,12,4,977,0.86,0.98,0.68,0.76,12,12,25,0,981,1.0,0.98,0.32,0.56
PF16332,PF12062:PF12372:PF14906,2,14,1,1,13,1003,0.07,0.99,0.5,0.19,2,0,2,2,1014,0.0,1.0,0.0,-0.0
PF10279,PF11751:PF13995:PF07157,0,0,0,0,0,1018,0,1.0,0,0,0,0,0,0,1018,0,1.0,0,0
PF06432,PF05562:PF03331:PF15377,12,4,1,11,3,1003,0.25,0.99,0.08,0.14,0,0,12,0,1006,0,0.99,0.0,0
PF03984,PF07085:PF00905:PF08444,0,24,0,0,24,994,0.0,0.98,0,0,3,0,0,3,1015,0.0,1.0,0,0
PF04366,PF11464:PF16696:PF12210,11,16,3,8,13,994,0.19,0.98,0.27,0.22,1,1,10,0,1007,1.0,0.99,0.09,0.3
PF10272,PF10148:PF10444:PF15929,4,10,1,3,9,1005,0.1,0.99,0.25,0.15,0,0,4,0,1014,0,1.0,0.0,0
PF04666,PF05191:PF07542:PF00316,11,46,7,4,39,968,0.15,0.96,0.64,0.3,4,1,10,3,1004,0.25,0.99,0.09,0.15
PF09805,PF07939:PF09340:PF10248,9,9,1,8,8,1001,0.11,0.98,0.11,0.1,2,1,8,1,1008,0.5,0.99,0.11,0.23
PF03567,PF01896:PF00708:PF06083,16,14,4,12,10,992,0.29,0.98,0.25,0.26,3,2,14,1,1001,0.67,0.99,0.12,0.28
PF12948,PF14922:PF08634:PF05508,0,6,0,0,6,1012,0.0,0.99,0,0,1,0,0,1,1017,0.0,1.0,0,0
PF08037,PF07888:PF15501:PF14973,1,7,0,1,7,1010,0.0,0.99,0.0,-0.0,1,0,1,1,1016,0.0,1.0,0.0,-0.0
PF05050,PF13532:PF08592:PF08498,17,51,7,10,44,957,0.14,0.95,0.41,0.22,9,3,14,6,995,0.33,0.98,0.18,0.23
PF01141,PF01140:PF02093:PF13276,4,12,4,0,8,1006,0.33,0.99,1.0,0.58,5,4,0,1,1013,0.8,1.0,1.0,0.89
PF04579,PF15750:PF17085:PF15703,3,1,0,3,1,1014,0.0,1.0,0.0,-0.0,0,0,3,0,1015,0,1.0,0.0,0
PF02768,PF02767:PF00712:PF08918,7,10,7,0,3,1008,0.7,1.0,1.0,0.84,7,7,0,0,1011,1.0,1.0,1.0,1.0
PF16675,PF16676:PF09354:PF08430,3,8,3,0,5,1010,0.38,1.0,1.0,0.61,4,2,1,2,1013,0.5,1.0,0.67,0.58
PF11580,PF12101:PF06651:PF03090,0,0,0,0,0,1018,0,1.0,0,0,0,0,0,0,1018,0,1.0,0,0
PF00234,PF14159:PF01871:PF14249,6,6,1,5,5,1007,0.17,0.99,0.17,0.16,0,0,6,0,1012,0,0.99,0.0,0
PF15679,PF13422:PF13689:PF14659,0,10,0,0,10,1008,0.0,0.99,0,0,0,0,0,0,1018,0,1.0,0,0
PF16739,PF13625:PF11648:PF08148,10,22,8,2,14,994,0.36,0.98,0.8,0.53,6,6,4,0,1008,1.0,1.0,0.6,0.77
PF01930,PF11229:PF08696:PF00680,1,21,1,0,20,997,0.05,0.98,1.0,0.22,2,0,1,2,1015,0.0,1.0,0.0,-0.0
PF08625,PF14077:PF15512:PF09384,6,14,2,4,12,1000,0.14,0.98,0.33,0.21,2,1,5,1,1011,0.5,0.99,0.17,0.29
PF09068,PF09069:PF00639:PF16577,7,18,6,1,12,999,0.33,0.99,0.86,0.53,2,2,5,0,1011,1.0,1.0,0.29,0.53
PF14299,PF07723:PF08268:PF08495,10,21,4,6,17,991,0.19,0.98,0.4,0.27,4,3,7,1,1007,0.75,0.99,0.3,0.47
PF15113,PF02888:PF03530:PF03520,2,21,1,1,20,996,0.05,0.98,0.5,0.15,8,0,2,8,1008,0.0,0.99,0.0,-0.0
PF15002,PF06951:PF06679:PF05335,12,13,3,9,10,996,0.23,0.98,0.25,0.23,0,0,12,0,1006,0,0.99,0.0,0
PF04351,PF11741:PF04350:PF08808,0,0,0,0,0,1018,0,1.0,0,0,0,0,0,0,1018,0,1.0,0,0
PF17167,PF06165:PF08302:PF09511,3,12,3,0,9,1006,0.25,0.99,1.0,0.5,4,1,2,3,1012,0.25,1.0,0.33,0.29
PF10315,PF15097:PF15085:PF03819,0,4,0,0,4,1014,0.0,1.0,0,0,0,0,0,0,1018,0,1.0,0,0
PF11130,PF12477:PF09677:PF03241,0,0,0,0,0,1018,0,1.0,0,0,0,0,0,0,1018,0,1.0,0,0
PF08214,PF06001:PF02135:PF09030,22,25,19,3,6,990,0.76,0.99,0.86,0.81,12,11,11,1,995,0.92,0.99,0.5,0.67
PF08939,PF10161:PF12006:PF15054,7,12,3,4,9,1002,0.25,0.99,0.43,0.32,0,0,7,0,1011,0,0.99,0.0,0
PF12297,PF10481:PF16830:PF07926,0,13,0,0,13,1005,0.0,0.99,0,0,0,0,0,0,1018,0,1.0,0,0
PF16504,PF04958:PF10460:PF02929,0,8,0,0,8,1010,0.0,0.99,0,0,0,0,0,0,1018,0,1.0,0,0
PF13405,PF00036:PF13202:PF13833,35,95,28,7,67,916,0.29,0.93,0.8,0.46,41,20,15,21,962,0.49,0.96,0.57,0.51
PF12126,PF15451:PF09418:PF03915,5,8,3,2,5,1008,0.38,0.99,0.6,0.47,2,2,3,0,1013,1.0,1.0,0.4,0.63
PF00523,PF02611:PF14606:PF07068,0,3,0,0,3,1015,0.0,1.0,0,0,0,0,0,0,1018,0,1.0,0,0
PF05920,PF00907:PF03790:PF15499,25,24,9,16,15,978,0.38,0.97,0.36,0.35,1,1,24,0,993,1.0,0.98,0.04,0.2
PF11354,PF05613:PF09937:PF12883,0,2,0,0,2,1016,0.0,1.0,0,0,0,0,0,0,1018,0,1.0,0,0
PF10600,PF10608:PF09058:PF04629,2,8,1,1,7,1009,0.12,0.99,0.5,0.25,1,1,1,0,1016,1.0,1.0,0.5,0.71
PF06676,PF01750:PF10144:PF03496,0,5,0,0,5,1013,0.0,1.0,0,0,0,0,0,0,1018,0,1.0,0,0
PF13833,PF13499:PF00036:PF13202,53,147,44,9,103,862,0.3,0.89,0.83,0.46,59,34,19,25,940,0.58,0.96,0.64,0.59
PF08381,PF13713:PF11464:PF04366,8,26,7,1,19,991,0.27,0.98,0.88,0.48,2,2,6,0,1010,1.0,0.99,0.25,0.5
PF16210,PF15234:PF12571:PF15851,1,0,0,1,0,1017,0,1.0,0.0,0,0,0,1,0,1017,0,1.0,0.0,0
PF10149,PF08356:PF08355:PF02126,9,17,4,5,13,996,0.24,0.98,0.44,0.32,12,4,5,8,1001,0.33,0.99,0.44,0.38
PF03131,PF08209:PF11911:PF09756,16,17,3,13,14,988,0.18,0.97,0.19,0.17,2,1,15,1,1001,0.5,0.98,0.06,0.17
PF05670,PF14722:PF08573:PF07557,13,19,3,10,16,989,0.16,0.97,0.23,0.18,0,0,13,0,1005,0,0.99,0.0,0
PF08636,PF11623:PF05387:PF16007,2,1,0,2,1,1015,0.0,1.0,0.0,-0.0,0,0,2,0,1016,0,1.0,0.0,0
PF16854,PF04100:PF12932:PF06662,0,16,0,0,16,1002,0.0,0.98,0,0,3,0,0,3,1015,0.0,1.0,0,0
PF02177,PF10515:PF12925:PF03494,9,9,8,1,1,1008,0.89,1.0,0.89,0.89,8,8,1,0,1009,1.0,1.0,0.89,0.94
PF06547,PF13441:PF13705:PF15419,3,6,2,1,4,1011,0.33,1.0,0.67,0.47,2,2,1,0,1015,1.0,1.0,0.67,0.82
PF06554,PF13548:PF13677:PF09361,2,1,1,1,0,1016,1.0,1.0,0.5,0.71,0,0,2,0,1016,0,1.0,0.0,0
PF17176,PF13718:PF13725:PF05127,2,16,2,0,14,1002,0.12,0.99,1.0,0.35,12,1,1,11,1005,0.08,0.99,0.5,0.2
PF12449,PF12935:PF02916:PF11542,4,2,0,4,2,1012,0.0,0.99,0.0,-0.0,0,0,4,0,1014,0,1.0,0.0,0
PF16006,PF16171:PF05483:PF15669,1,4,0,1,4,1013,0.0,1.0,0.0,-0.0,0,0,1,0,1017,0,1.0,0.0,0
PF07957,PF02277:PF01051:PF05974,0,4,0,0,4,1014,0.0,1.0,0,0,0,0,0,0,1018,0,1.0,0,0
PF15475,PF04736:PF11029:PF06875,1,3,0,1,3,1014,0.0,1.0,0.0,-0.0,0,0,1,0,1017,0,1.0,0.0,0
PF01518,PF03422:PF16881:PF06463,2,29,0,2,29,987,0.0,0.97,0.0,-0.01,5,0,2,5,1011,0.0,0.99,0.0,-0.0
PF02645,PF09904:PF08805:PF15355,1,1,0,1,1,1016,0.0,1.0,0.0,-0.0,0,0,1,0,1017,0,1.0,0.0,0
PF03988,PF00865:PF15710:PF15467,0,0,0,0,0,1018,0,1.0,0,0,0,0,0,0,1018,0,1.0,0,0
PF11172,PF08026:PF15188:PF00796,0,0,0,0,0,1018,0,1.0,0,0,0,0,0,0,1018,0,1.0,0,0
PF04533,PF04311:PF08213:PF01142,0,20,0,0,20,998,0.0,0.98,0,0,0,0,0,0,1018,0,1.0,0,0
PF08632,PF16051:PF01430:PF05974,5,1,0,5,1,1012,0.0,0.99,0.0,-0.0,0,0,5,0,1013,0,1.0,0.0,0
PF06280,PF05922:PF12583:PF12580,2,28,1,1,27,989,0.04,0.97,0.5,0.13,1,1,1,0,1016,1.0,1.0,0.5,0.71
PF03759,PF04729:PF03479:PF06136,7,16,1,6,15,996,0.06,0.98,0.14,0.09,2,1,6,1,1010,0.5,0.99,0.14,0.26
PF08106,PF06684:PF04062:PF07059,0,16,0,0,16,1002,0.0,0.98,0,0,1,0,0,1,1017,0.0,1.0,0,0
PF03874,PF05676:PF01779:PF01279,11,17,4,7,13,994,0.24,0.98,0.36,0.28,1,1,10,0,1007,1.0,0.99,0.09,0.3
PF13372,PF00288:PF02826:PF13905,0,65,0,0,65,953,0.0,0.94,0,0,20,0,0,20,998,0.0,0.98,0,0
PF12878,PF12879:PF12887:PF05640,0,3,0,0,3,1015,0.0,1.0,0,0,0,0,0,0,1018,0,1.0,0,0
PF10403,PF10405:PF10404:PF03835,10,12,10,0,2,1006,0.83,1.0,1.0,0.91,10,10,0,0,1008,1.0,1.0,1.0,1.0
PF14884,PF14931:PF05856:PF06382,2,7,0,2,7,1009,0.0,0.99,0.0,-0.0,1,0,2,1,1015,0.0,1.0,0.0,-0.0
PF09817,PF05823:PF10266:PF00821,3,8,0,3,8,1007,0.0,0.99,0.0,-0.0,0,0,3,0,1015,0,1.0,0.0,0
PF08204,PF04549:PF01114:PF06736,0,2,0,0,2,1016,0.0,1.0,0,0,0,0,0,0,1018,0,1.0,0,0
PF03836,PF15780:PF12510:PF03271,5,22,3,2,19,994,0.14,0.98,0.6,0.28,2,2,3,0,1013,1.0,1.0,0.4,0.63
PF06888,PF01937:PF05742:PF01093,4,20,3,1,17,997,0.15,0.98,0.75,0.33,2,0,4,2,1012,0.0,0.99,0.0,-0.0
PF14215,PF09427:PF15951:PF08447,8,26,2,6,24,986,0.08,0.97,0.25,0.13,4,2,6,2,1008,0.5,0.99,0.25,0.35
PF00549,PF08442:PF02629:PF16114,30,26,24,6,2,986,0.92,0.99,0.8,0.86,6,6,24,0,988,1.0,0.98,0.2,0.44
PF00140,PF08281:PF04545:PF04539,7,24,5,2,19,992,0.21,0.98,0.71,0.38,15,5,2,10,1001,0.33,0.99,0.71,0.48
PF14554,PF04692:PF15800:PF03128,2,2,1,1,1,1015,0.5,1.0,0.5,0.5,1,1,1,0,1016,1.0,1.0,0.5,0.71
PF01068,PF04679:PF04675:PF10345,19,19,19,0,0,999,1.0,1.0,1.0,1.0,18,18,1,0,999,1.0,1.0,0.95,0.97
PF02300,PF00574:PF01425:PF04072,0,79,0,0,79,939,0.0,0.92,0,0,14,0,0,14,1004,0.0,0.99,0,0
PF03587,PF05915:PF09768:PF04716,8,21,4,4,17,993,0.19,0.98,0.5,0.3,3,1,7,2,1008,0.33,0.99,0.12,0.2
PF08345,PF03428:PF08274:PF14841,1,1,1,0,0,1017,1.0,1.0,1.0,1.0,0,0,1,0,1017,0,1.0,0.0,0
PF11997,PF14573:PF16967:PF06505,0,0,0,0,0,1018,0,1.0,0,0,0,0,0,0,1018,0,1.0,0,0
PF02883,PF09066:PF07718:PF14796,17,15,6,11,9,992,0.4,0.98,0.35,0.37,5,5,12,0,1001,1.0,0.99,0.29,0.54
PF02501,PF03934:PF11612:PF02107,2,4,2,0,2,1014,0.5,1.0,1.0,0.71,2,2,0,0,1016,1.0,1.0,1.0,1.0
PF00994,PF01507:PF03453:PF03454,36,40,25,11,15,967,0.62,0.97,0.69,0.65,16,16,20,0,982,1.0,0.98,0.44,0.66
PF00127,PF10542:PF04839:PF15305,3,3,0,3,3,1012,0.0,0.99,0.0,-0.0,0,0,3,0,1015,0,1.0,0.0,0
PF00919,PF01938:PF01967:PF06969,20,22,15,5,7,991,0.68,0.99,0.75,0.71,5,5,15,0,998,1.0,0.99,0.25,0.5
PF03639,PF02015:PF06910:PF05730,12,19,5,7,14,992,0.26,0.98,0.42,0.32,4,3,9,1,1005,0.75,0.99,0.25,0.43
PF12114,PF07469:PF08815:PF16279,6,6,1,5,5,1007,0.17,0.99,0.17,0.16,6,1,5,5,1007,0.17,0.99,0.17,0.16
PF07714,PF00069:PF12036:PF00696,180,351,146,34,205,633,0.42,0.77,0.81,0.45,35,26,154,9,829,0.74,0.84,0.14,0.28
PF11578,PF14612:PF04229:PF03595,12,26,2,10,24,982,0.08,0.97,0.17,0.1,1,0,12,1,1005,0.0,0.99,0.0,-0.0
PF01118,PF02774:PF04768:PF13840,13,30,11,2,19,986,0.37,0.98,0.85,0.55,5,5,8,0,1005,1.0,0.99,0.38,0.62
PF11910,PF15334:PF05151:PF08092,3,1,0,3,1,1014,0.0,1.0,0.0,-0.0,0,0,3,0,1015,0,1.0,0.0,0
PF00648,PF01067:PF09149:PF02666,47,45,32,15,13,958,0.71,0.97,0.68,0.68,9,8,39,1,970,0.89,0.96,0.17,0.38
PF05300,PF16954:PF12301:PF02267,4,7,1,3,6,1008,0.14,0.99,0.25,0.18,0,0,4,0,1014,0,1.0,0.0,0
PF08368,PF06743:PF08373:PF15074,7,21,7,0,14,997,0.33,0.99,1.0,0.57,6,6,1,0,1011,1.0,1.0,0.86,0.93
PF08539,PF05841:PF08634:PF12927,2,5,1,1,4,1012,0.2,1.0,0.5,0.31,0,0,2,0,1016,0,1.0,0.0,0
PF03928,PF06912:PF15071:PF12716,8,3,0,8,3,1007,0.0,0.99,0.0,-0.0,0,0,8,0,1010,0,0.99,0.0,0
PF12355,PF06583:PF05473:PF12453,1,5,1,0,4,1013,0.2,1.0,1.0,0.45,1,1,0,0,1017,1.0,1.0,1.0,1.0
PF14744,PF14745:PF14746:PF03894,8,9,7,1,2,1008,0.78,1.0,0.88,0.82,4,4,4,0,1010,1.0,1.0,0.5,0.71
PF02357,PF12656:PF11942:PF01777,2,33,1,1,32,984,0.03,0.97,0.5,0.12,3,0,2,3,1013,0.0,1.0,0.0,-0.0
PF01265,PF09468:PF06172:PF06388,17,10,3,14,7,994,0.3,0.98,0.18,0.22,0,0,17,0,1001,0,0.98,0.0,0
PF07724,PF10431:PF02577:PF02861,27,27,25,2,2,989,0.93,1.0,0.93,0.92,9,9,18,0,991,1.0,0.98,0.33,0.57
PF05675,PF01118:PF00995:PF05720,0,39,0,0,39,979,0.0,0.96,0,0,5,0,0,5,1013,0.0,1.0,0,0
PF10996,PF16661:PF07521:PF13299,32,40,32,0,8,978,0.8,0.99,1.0,0.89,22,22,10,0,986,1.0,0.99,0.69,0.82
PF04814,PF04812:PF03867:PF12045,4,3,3,1,0,1014,1.0,1.0,0.75,0.87,1,1,3,0,1014,1.0,1.0,0.25,0.5
PF10239,PF10507:PF03103:PF15973,6,12,2,4,10,1002,0.17,0.99,0.33,0.23,0,0,6,0,1012,0,0.99,0.0,0
PF02984,PF16899:PF00134:PF13825,43,69,39,4,30,945,0.57,0.97,0.91,0.7,10,3,40,7,968,0.3,0.95,0.07,0.13
PF12130,PF15949:PF10358:PF12510,9,23,3,6,20,989,0.13,0.97,0.33,0.2,1,1,8,0,1009,1.0,0.99,0.11,0.33
PF14761,PF14763:PF14762:PF00073,2,12,0,2,12,1004,0.0,0.99,0.0,-0.0,0,0,2,0,1016,0,1.0,0.0,0
PF01678,PF17187:PF09328:PF08622,5,4,0,5,4,1009,0.0,0.99,0.0,-0.0,2,0,5,2,1011,0.0,0.99,0.0,-0.0
PF00550,PF08659:PF14765:PF00109,68,64,46,22,18,932,0.72,0.96,0.68,0.68,44,40,28,4,946,0.91,0.97,0.59,0.72
PF13701,PF08813:PF01801:PF01798,0,26,0,0,26,992,0.0,0.97,0,0,0,0,0,0,1018,0,1.0,0,0
PF11951,PF04082:PF08493:PF16846,80,155,56,24,99,839,0.36,0.88,0.7,0.45,3,3,77,0,938,1.0,0.92,0.04,0.19
PF01268,PF00763:PF02882:PF06298,13,31,12,1,19,986,0.39,0.98,0.92,0.59,24,12,1,12,993,0.5,0.99,0.92,0.67
PF02686,PF10181:PF15370:PF09597,7,7,1,6,6,1005,0.14,0.99,0.14,0.14,0,0,7,0,1011,0,0.99,0.0,0
PF11721,PF12819:PF08917:PF12799,18,53,10,8,43,957,0.19,0.95,0.56,0.3,7,5,13,2,998,0.71,0.99,0.28,0.44
PF00767,PF06798:PF17188:PF01514,2,0,0,2,0,1016,0,1.0,0.0,0,0,0,2,0,1016,0,1.0,0.0,0
PF06839,PF01396:PF10237:PF01131,28,28,12,16,16,974,0.43,0.97,0.43,0.41,9,7,21,2,988,0.78,0.98,0.25,0.43
PF08493,PF16846:PF11951:PF10703,4,80,3,1,77,937,0.04,0.92,0.75,0.16,2,2,2,0,1014,1.0,1.0,0.5,0.71
PF05922,PF06280:PF09286:PF12583,25,15,6,19,9,984,0.4,0.97,0.24,0.3,2,1,24,1,992,0.5,0.98,0.04,0.14
PF05751,PF00855:PF07496:PF11467,0,47,0,0,47,971,0.0,0.95,0,0,13,0,0,13,1005,0.0,0.99,0,0
PF15347,PF15703:PF15068:PF15427,0,2,0,0,2,1016,0.0,1.0,0,0,0,0,0,0,1018,0,1.0,0,0
PF14990,PF04816:PF15766:PF16039,0,1,0,0,1,1017,0.0,1.0,0,0,0,0,0,0,1018,0,1.0,0,0
PF17092,PF08274:PF06751:PF08497,1,1,0,1,1,1016,0.0,1.0,0.0,-0.0,0,0,1,0,1017,0,1.0,0.0,0
PF15001,PF15312:PF10951:PF05448,1,2,0,1,2,1015,0.0,1.0,0.0,-0.0,0,0,1,0,1017,0,1.0,0.0,0
PF00524,PF05065:PF11291:PF06965,4,4,1,3,3,1011,0.25,0.99,0.25,0.25,0,0,4,0,1014,0,1.0,0.0,0
PF10492,PF10491:PF15999:PF12751,0,7,0,0,7,1011,0.0,0.99,0,0,0,0,0,0,1018,0,1.0,0,0
PF00962,PF08451:PF06237:PF01757,22,39,9,13,30,966,0.23,0.96,0.41,0.29,2,1,21,1,995,0.5,0.98,0.05,0.15
PF02508,PF03831:PF10554:PF03865,2,0,0,2,0,1016,0,1.0,0.0,0,0,0,2,0,1016,0,1.0,0.0,0
PF08210,PF08028:PF12806:PF09317,8,3,3,5,0,1010,1.0,1.0,0.38,0.61,3,3,5,0,1010,1.0,1.0,0.38,0.61
PF00141,PF11895:PF02949:PF00685,37,69,19,18,50,931,0.28,0.93,0.51,0.34,13,9,28,4,977,0.69,0.97,0.24,0.4
PF04797,PF00780:PF10367:PF07305,0,45,0,0,45,973,0.0,0.96,0,0,11,0,0,11,1007,0.0,0.99,0,0
PF14257,PF14985:PF01316:PF03238,0,4,0,0,4,1014,0.0,1.0,0,0,0,0,0,0,1018,0,1.0,0,0
PF05176,PF07063:PF03652:PF01680,3,17,0,3,17,998,0.0,0.98,0.0,-0.01,1,0,3,1,1014,0.0,1.0,0.0,-0.0
PF06532,PF13793:PF12465:PF10584,0,45,0,0,45,973,0.0,0.96,0,0,13,0,0,13,1005,0.0,0.99,0,0
PF02309,PF06507:PF02362:PF03254,12,36,6,6,30,976,0.17,0.96,0.5,0.27,10,2,10,8,998,0.2,0.98,0.17,0.17
PF00179,PF07933:PF10520:PF09288,98,15,10,88,5,915,0.67,0.91,0.1,0.24,0,0,98,0,920,0,0.9,0.0,0
PF00490,PF05051:PF04603:PF03266,16,11,4,12,7,995,0.36,0.98,0.25,0.29,2,2,14,0,1002,1.0,0.99,0.12,0.35
PF14604,PF00018:PF08824:PF12026,68,98,50,18,48,902,0.51,0.94,0.74,0.58,4,3,65,1,949,0.75,0.94,0.04,0.17
PF00839,PF04815:PF08033:PF04558,3,35,0,3,35,980,0.0,0.96,0.0,-0.01,23,0,3,23,992,0.0,0.97,0.0,-0.01
PF03326,PF13655:PF04473:PF08388,0,6,0,0,6,1012,0.0,0.99,0,0,6,0,0,6,1012,0.0,0.99,0,0
PF13796,PF08260:PF12016:PF01855,0,14,0,0,14,1004,0.0,0.99,0,0,0,0,0,0,1018,0,1.0,0,0
PF16968,PF03739:PF07157:PF01330,0,6,0,0,6,1012,0.0,0.99,0,0,1,0,0,1,1017,0.0,1.0,0,0
PF14925,PF13995:PF02277:PF10109,2,3,0,2,3,1013,0.0,1.0,0.0,-0.0,0,0,2,0,1016,0,1.0,0.0,0
PF04832,PF10184:PF01091:PF00864,10,21,3,7,18,990,0.14,0.98,0.3,0.2,2,2,8,0,1008,1.0,0.99,0.2,0.45
PF01096,PF02150:PF15694:PF15693,19,15,9,10,6,993,0.6,0.98,0.47,0.53,0,0,19,0,999,0,0.98,0.0,0
PF16782,PF11291:PF09834:PF10490,1,4,0,1,4,1013,0.0,1.0,0.0,-0.0,0,0,1,0,1017,0,1.0,0.0,0
PF12090,PF08729:PF15253:PF12887,2,6,0,2,6,1010,0.0,0.99,0.0,-0.0,1,0,2,1,1015,0.0,1.0,0.0,-0.0
PF07691,PF10162:PF13402:PF08239,15,16,4,11,12,991,0.25,0.98,0.27,0.25,6,3,12,3,1000,0.5,0.99,0.2,0.31
PF03048,PF12014:PF10209:PF09699,1,2,1,0,1,1016,0.5,1.0,1.0,0.71,1,1,0,0,1017,1.0,1.0,1.0,1.0
PF17144,PF14204:PF02482:PF03763,14,24,12,2,12,992,0.5,0.99,0.86,0.65,3,3,11,0,1004,1.0,0.99,0.21,0.46
PF05705,PF14388:PF05096:PF12680,15,21,4,11,17,986,0.19,0.97,0.27,0.21,1,1,14,0,1003,1.0,0.99,0.07,0.26
PF01396,PF01131:PF01751:PF13368,7,34,6,1,28,983,0.18,0.97,0.86,0.38,16,6,1,10,1001,0.38,0.99,0.86,0.56
PF10184,PF04832:PF12400:PF15998,11,18,3,8,15,992,0.17,0.98,0.27,0.2,3,2,9,1,1006,0.67,0.99,0.18,0.34
PF12561,PF11681:PF15214:PF09493,0,2,0,0,2,1016,0.0,1.0,0,0,0,0,0,0,1018,0,1.0,0,0
PF07052,PF11623:PF11282:PF10217,12,3,1,11,2,1004,0.33,0.99,0.08,0.16,0,0,12,0,1006,0,0.99,0.0,0
PF05932,PF05939:PF05547:PF06626,1,2,0,1,2,1015,0.0,1.0,0.0,-0.0,0,0,1,0,1017,0,1.0,0.0,0
PF03016,PF09258:PF03407:PF01501,34,59,21,13,38,946,0.36,0.95,0.62,0.45,10,9,25,1,983,0.9,0.97,0.26,0.48
PF15017,PF17146:PF08772:PF12348,1,20,1,0,19,998,0.05,0.98,1.0,0.22,7,1,0,6,1011,0.14,0.99,1.0,0.38
PF15051,PF06702:PF15067:PF03085,1,15,0,1,15,1002,0.0,0.98,0.0,-0.0,0,0,1,0,1017,0,1.0,0.0,0
PF01450,PF07991:PF08622:PF17187,11,10,8,3,2,1005,0.8,1.0,0.73,0.76,2,0,11,2,1005,0.0,0.99,0.0,-0.0
PF05743,PF09454:PF02866:PF03800,11,32,11,0,21,986,0.34,0.98,1.0,0.58,3,3,8,0,1007,1.0,0.99,0.27,0.52
PF13584,PF14479:PF01011:PF17109,0,22,0,0,22,996,0.0,0.98,0,0,4,0,0,4,1014,0.0,1.0,0,0
PF02458,PF01063:PF03140:PF05368,33,62,16,17,46,939,0.26,0.94,0.48,0.32,19,12,21,7,978,0.63,0.97,0.36,0.47
PF16776,PF16726:PF08952:PF09036,1,14,1,0,13,1004,0.07,0.99,1.0,0.27,0,0,1,0,1017,0,1.0,0.0,0
PF04068,PF00037:PF12704:PF06472,20,28,12,8,16,982,0.43,0.98,0.6,0.5,5,3,17,2,996,0.6,0.98,0.15,0.29
PF12656,PF02357:PF09816:PF00849,15,43,7,8,36,967,0.16,0.96,0.47,0.26,5,2,13,3,1000,0.4,0.98,0.13,0.22
PF04882,PF06384:PF02374:PF12718,10,16,2,8,14,994,0.12,0.98,0.2,0.15,0,0,10,0,1008,0,0.99,0.0,0
PF00703,PF02836:PF02837:PF02929,27,22,18,9,4,987,0.82,0.99,0.67,0.73,12,10,17,2,989,0.83,0.98,0.37,0.55
PF05818,PF13802:PF16863:PF17137,0,29,0,0,29,989,0.0,0.97,0,0,15,0,0,15,1003,0.0,0.99,0,0
PF15508,PF05432:PF17187:PF05076,4,6,1,3,5,1009,0.17,0.99,0.25,0.2,1,0,4,1,1013,0.0,1.0,0.0,-0.0
PF13557,PF08274:PF03934:PF04122,4,2,0,4,2,1012,0.0,0.99,0.0,-0.0,0,0,4,0,1014,0,1.0,0.0,0
PF03091,PF02284:PF10244:PF12020,13,12,4,9,8,997,0.33,0.98,0.31,0.31,2,2,11,0,1005,1.0,0.99,0.15,0.39
PF12477,PF11130:PF09677:PF03241,0,0,0,0,0,1018,0,1.0,0,0,0,0,0,0,1018,0,1.0,0,0
PF03663,PF03595:PF04570:PF11927,16,34,6,10,28,974,0.18,0.96,0.38,0.24,2,0,16,2,1000,0.0,0.98,0.0,-0.01
PF15169,PF03745:PF09461:PF14290,0,0,0,0,0,1018,0,1.0,0,0,0,0,0,0,1018,0,1.0,0,0
PF00344,PF10559:PF05004:PF02607,17,16,9,8,7,994,0.56,0.99,0.53,0.54,2,2,15,0,1001,1.0,0.99,0.12,0.34
PF04402,PF00727:PF02024:PF06541,6,5,1,5,4,1008,0.2,0.99,0.17,0.18,0,0,6,0,1012,0,0.99,0.0,0
PF08351,PF13725:PF13718:PF05127,12,16,12,0,4,1002,0.75,1.0,1.0,0.86,12,12,0,0,1006,1.0,1.0,1.0,1.0
PF09734,PF04664:PF09789:PF15929,7,5,1,6,4,1007,0.2,0.99,0.14,0.16,0,0,7,0,1011,0,0.99,0.0,0
PF01586,PF12533:PF12232:PF15372,3,5,3,0,2,1013,0.6,1.0,1.0,0.77,1,1,2,0,1015,1.0,1.0,0.33,0.58
PF09005,PF16568:PF10470:PF16544,10,4,2,8,2,1006,0.5,0.99,0.2,0.31,1,1,9,0,1008,1.0,0.99,0.1,0.31
PF06273,PF16485:PF14918:PF14920,5,1,0,5,1,1012,0.0,0.99,0.0,-0.0,0,0,5,0,1013,0,1.0,0.0,0
PF02265,PF06404:PF04690:PF06749,7,9,2,5,7,1004,0.22,0.99,0.29,0.25,1,0,7,1,1010,0.0,0.99,0.0,-0.0
PF00012,PF10712:PF06723:PF10268,69,12,8,61,4,945,0.67,0.94,0.12,0.26,3,3,66,0,949,1.0,0.94,0.04,0.2
PF00280,PF06404:PF14941:PF05216,11,9,1,10,8,999,0.11,0.98,0.09,0.09,0,0,11,0,1007,0,0.99,0.0,0
PF10734,PF03735:PF16135:PF08512,0,28,0,0,28,990,0.0,0.97,0,0,7,0,0,7,1011,0.0,0.99,0,0
PF00822,PF07803:PF02038:PF04831,9,9,2,7,7,1002,0.22,0.99,0.22,0.22,1,1,8,0,1009,1.0,0.99,0.11,0.33
PF05055,PF08536:PF03652:PF07333,3,9,0,3,9,1006,0.0,0.99,0.0,-0.01,1,0,3,1,1014,0.0,1.0,0.0,-0.0
PF11521,PF02002:PF08271:PF07741,2,24,2,0,22,994,0.08,0.98,1.0,0.29,6,0,2,6,1010,0.0,0.99,0.0,-0.0
PF04725,PF05479:PF02372:PF15884,2,5,0,2,5,1011,0.0,0.99,0.0,-0.0,0,0,2,0,1016,0,1.0,0.0,0
PF00076,PF08081:PF12353:PF08050,245,18,18,227,0,773,1.0,0.78,0.07,0.24,1,1,244,0,773,1.0,0.76,0.0,0.06
PF05866,PF15082:PF09322:PF15392,1,3,0,1,3,1014,0.0,1.0,0.0,-0.0,0,0,1,0,1017,0,1.0,0.0,0
PF05051,PF01115:PF06093:PF09749,7,12,4,3,8,1003,0.33,0.99,0.57,0.43,4,2,5,2,1009,0.5,0.99,0.29,0.37
PF02319,PF16421:PF08781:PF15244,24,19,16,8,3,991,0.84,0.99,0.67,0.74,1,1,23,0,994,1.0,0.98,0.04,0.2
PF10277,PF00252:PF16906:PF08790,27,33,11,16,22,969,0.33,0.96,0.41,0.35,10,5,22,5,986,0.5,0.97,0.19,0.29
PF10172,PF09692:PF03760:PF16294,5,6,0,5,6,1007,0.0,0.99,0.0,-0.01,1,0,5,1,1012,0.0,0.99,0.0,-0.0
PF00022,PF10357:PF16840:PF15361,60,14,10,50,4,954,0.71,0.95,0.17,0.33,1,1,59,0,958,1.0,0.94,0.02,0.13
PF00902,PF00159:PF01097:PF10018,8,20,2,6,18,992,0.1,0.98,0.25,0.15,1,0,8,1,1009,0.0,0.99,0.0,-0.0
PF15686,PF15289:PF15324:PF00363,3,4,0,3,4,1011,0.0,0.99,0.0,-0.0,0,0,3,0,1015,0,1.0,0.0,0
PF12933,PF12934:PF14920:PF14918,0,0,0,0,0,1018,0,1.0,0,0,0,0,0,0,1018,0,1.0,0,0
PF15630,PF15003:PF03760:PF08649,5,4,1,4,3,1010,0.25,0.99,0.2,0.22,0,0,5,0,1013,0,1.0,0.0,0
PF02016,PF08744:PF00669:PF15032,6,1,0,6,1,1011,0.0,0.99,0.0,-0.0,0,0,6,0,1012,0,0.99,0.0,0
PF02351,PF00393:PF16656:PF02244,3,41,2,1,39,976,0.05,0.96,0.67,0.17,12,2,1,10,1005,0.17,0.99,0.67,0.33
PF04114,PF01694:PF12595:PF02544,16,62,7,9,55,947,0.11,0.94,0.44,0.2,12,4,12,8,994,0.33,0.98,0.25,0.28
PF04266,PF06886:PF11970:PF04139,10,17,4,6,13,995,0.24,0.98,0.4,0.3,2,1,9,1,1007,0.5,0.99,0.1,0.22
PF02773,PF00438:PF02772:PF02075,4,5,4,0,1,1013,0.8,1.0,1.0,0.89,4,4,0,0,1014,1.0,1.0,1.0,1.0
PF13378,PF16582:PF10329:PF02775,26,28,8,18,20,972,0.29,0.96,0.31,0.28,3,3,23,0,992,1.0,0.98,0.12,0.34
PF01753,PF09273:PF14740:PF07034,66,22,10,56,12,940,0.45,0.93,0.15,0.24,3,3,63,0,952,1.0,0.94,0.05,0.21
PF10369,PF00351:PF01842:PF10637,10,41,4,6,37,971,0.1,0.96,0.4,0.18,9,2,8,7,1001,0.22,0.99,0.2,0.2
PF01385,PF17030:PF02741:PF11975,0,9,0,0,9,1009,0.0,0.99,0,0,0,0,0,0,1018,0,1.0,0,0
PF05913,PF03831:PF07411:PF16888,1,0,0,1,0,1017,0,1.0,0.0,0,0,0,1,0,1017,0,1.0,0.0,0
PF05894,PF08291:PF10618:PF05100,0,0,0,0,0,1018,0,1.0,0,0,0,0,0,0,1018,0,1.0,0,0
PF03108,PF04434:PF10551:PF10532,16,59,15,1,44,958,0.25,0.96,0.94,0.48,21,12,4,9,993,0.57,0.99,0.75,0.65
PF00521,PF16898:PF08070:PF00204,19,20,15,4,5,994,0.75,0.99,0.79,0.76,8,8,11,0,999,1.0,0.99,0.42,0.65
PF04813,PF04812:PF12360:PF04618,1,5,1,0,4,1013,0.2,1.0,1.0,0.45,3,1,0,2,1015,0.33,1.0,1.0,0.58
PF06342,PF14799:PF14935:PF15260,1,9,0,1,9,1008,0.0,0.99,0.0,-0.0,1,0,1,1,1016,0.0,1.0,0.0,-0.0
PF03009,PF03105:PF00686:PF00723,33,61,22,11,39,946,0.36,0.95,0.67,0.47,16,14,19,2,983,0.88,0.98,0.42,0.6
PF10392,PF08640:PF08216:PF17034,7,16,3,4,13,998,0.19,0.98,0.43,0.28,3,3,4,0,1011,1.0,1.0,0.43,0.65
PF08277,PF00024:PF08391:PF14295,9,66,8,1,58,951,0.12,0.94,0.89,0.32,25,4,5,21,988,0.16,0.97,0.44,0.26
PF15271,PF14841:PF15529:PF03241,0,1,0,0,1,1017,0.0,1.0,0,0,0,0,0,0,1018,0,1.0,0,0
PF07720,PF07721:PF07219:PF04049,7,18,5,2,13,998,0.28,0.99,0.71,0.44,1,1,6,0,1011,1.0,0.99,0.14,0.38
PF09794,PF02732:PF07810:PF12877,9,29,4,5,25,984,0.14,0.97,0.44,0.24,11,4,5,7,1002,0.36,0.99,0.44,0.4
PF02892,PF04937:PF14372:PF05699,31,73,22,9,51,936,0.3,0.94,0.71,0.44,27,16,15,11,976,0.59,0.97,0.52,0.54
PF06464,PF12047:PF13570:PF01011,11,20,9,2,11,996,0.45,0.99,0.82,0.6,4,2,9,2,1005,0.5,0.99,0.18,0.3
PF15464,PF17049:PF17188:PF00381,0,1,0,0,1,1017,0.0,1.0,0,0,0,0,0,0,1018,0,1.0,0,0
PF01975,PF03133:PF02939:PF11927,12,45,5,7,40,966,0.11,0.95,0.42,0.2,12,2,10,10,996,0.17,0.98,0.17,0.16
PF13662,PF00772:PF03796:PF02132,7,15,6,1,9,1002,0.4,0.99,0.86,0.58,4,3,4,1,1010,0.75,1.0,0.43,0.56
PF13392,PF07929:PF04194:PF09698,7,15,2,5,13,998,0.13,0.98,0.29,0.19,0,0,7,0,1011,0,0.99,0.0,0
PF05826,PF10192:PF15019:PF01758,11,19,3,8,16,991,0.16,0.98,0.27,0.2,1,0,11,1,1006,0.0,0.99,0.0,-0.0
PF08337,PF01833:PF01403:PF16422,11,45,10,1,35,972,0.22,0.96,0.91,0.44,15,8,3,7,1000,0.53,0.99,0.73,0.62
PF12067,PF13775:PF12336:PF09667,1,4,0,1,4,1013,0.0,1.0,0.0,-0.0,0,0,1,0,1017,0,1.0,0.0,0
PF01750,PF07317:PF06676:PF05284,2,0,0,2,0,1016,0,1.0,0.0,0,0,0,2,0,1016,0,1.0,0.0,0
PF15355,PF07505:PF08093:PF01913,0,2,0,0,2,1016,0.0,1.0,0,0,0,0,0,0,1018,0,1.0,0,0
PF01062,PF03619:PF05653:PF02423,26,43,11,15,32,960,0.26,0.95,0.42,0.31,8,5,21,3,989,0.62,0.98,0.19,0.34
PF00676,PF02779:PF02780:PF16078,35,42,21,14,21,962,0.5,0.97,0.6,0.53,34,16,19,18,965,0.47,0.96,0.46,0.45
PF06527,PF10266:PF03311:PF06923,0,16,0,0,16,1002,0.0,0.98,0,0,1,0,0,1,1017,0.0,1.0,0,0
PF06440,PF06209:PF05007:PF11717,2,30,1,1,29,987,0.03,0.97,0.5,0.12,6,1,1,5,1011,0.17,0.99,0.5,0.29
PF01510,PF15955:PF09412:PF04241,7,24,2,5,22,989,0.08,0.97,0.29,0.14,1,0,7,1,1010,0.0,0.99,0.0,-0.0
PF01840,PF08964:PF00997:PF10856,0,0,0,0,0,1018,0,1.0,0,0,0,0,0,0,1018,0,1.0,0,0
PF04255,PF05736:PF04657:PF04350,0,4,0,0,4,1014,0.0,1.0,0,0,0,0,0,0,1018,0,1.0,0,0
PF16990,PF02156:PF02013:PF00734,7,41,7,0,34,977,0.17,0.97,1.0,0.41,7,5,2,2,1009,0.71,1.0,0.71,0.71
PF03239,PF13741:PF03386:PF07767,7,13,2,5,11,1000,0.15,0.98,0.29,0.2,1,0,7,1,1010,0.0,0.99,0.0,-0.0
PF02537,PF08622:PF17187:PF02421,7,5,0,7,5,1006,0.0,0.99,0.0,-0.01,2,0,7,2,1009,0.0,0.99,0.0,-0.0
PF14435,PF07954:PF15334:PF14251,0,3,0,0,3,1015,0.0,1.0,0,0,0,0,0,0,1018,0,1.0,0,0
PF00439,PF12157:PF17105:PF17035,78,18,15,63,3,937,0.83,0.94,0.19,0.38,4,4,74,0,940,1.0,0.93,0.05,0.22
PF12733,PF06662:PF02408:PF15995,1,5,1,0,4,1013,0.2,1.0,1.0,0.45,0,0,1,0,1017,0,1.0,0.0,0
PF02809,PF03127:PF15300:PF00790,25,29,10,15,19,974,0.34,0.97,0.4,0.35,12,7,18,5,988,0.58,0.98,0.28,0.39
PF01253,PF02201:PF03669:PF03126,26,38,15,11,23,969,0.39,0.97,0.58,0.46,12,8,18,4,988,0.67,0.98,0.31,0.44
PF08724,PF14841:PF01913:PF16449,0,2,0,0,2,1016,0.0,1.0,0,0,0,0,0,0,1018,0,1.0,0,0
PF02620,PF03703:PF12646:PF09991,8,1,0,8,1,1009,0.0,0.99,0.0,-0.0,0,0,8,0,1010,0,0.99,0.0,0
PF07733,PF14579:PF13477:PF10111,13,13,13,0,0,1005,1.0,1.0,1.0,1.0,0,0,13,0,1005,0,0.99,0.0,0
PF14823,PF13241:PF14824:PF00590,8,23,8,0,15,995,0.35,0.99,1.0,0.59,10,8,0,2,1008,0.8,1.0,1.0,0.89
PF03074,PF07971:PF04833:PF06237,6,20,2,4,18,994,0.1,0.98,0.33,0.17,1,0,6,1,1011,0.0,0.99,0.0,-0.0
PF11386,PF05111:PF02429:PF10578,0,1,0,0,1,1017,0.0,1.0,0,0,0,0,0,0,1018,0,1.0,0,0
PF05037,PF14934:PF01488:PF08501,0,26,0,0,26,992,0.0,0.97,0,0,10,0,0,10,1008,0.0,0.99,0,0
PF12440,PF01454:PF17187:PF10806,1,15,1,0,14,1003,0.07,0.99,1.0,0.26,2,0,1,2,1015,0.0,1.0,0.0,-0.0
PF15007,PF05841:PF15241:PF13810,0,1,0,0,1,1017,0.0,1.0,0,0,0,0,0,0,1018,0,1.0,0,0
PF02970,PF01987:PF06232:PF10780,6,9,0,6,9,1003,0.0,0.99,0.0,-0.01,1,0,6,1,1011,0.0,0.99,0.0,-0.0
PF01055,PF13802:PF16863:PF00088,38,35,27,11,8,972,0.77,0.98,0.71,0.73,13,13,25,0,980,1.0,0.98,0.34,0.58
PF08661,PF05912:PF10504:PF15014,9,5,2,7,3,1006,0.4,0.99,0.22,0.29,0,0,9,0,1009,0,0.99,0.0,0
PF07348,PF16033:PF07105:PF07992,0,89,0,0,89,929,0.0,0.91,0,0,4,0,0,4,1014,0.0,1.0,0,0
PF13288,PF08436:PF02670:PF00674,5,12,5,0,7,1006,0.42,0.99,1.0,0.64,11,4,1,7,1006,0.36,0.99,0.8,0.54
PF12057,PF16843:PF09055:PF05162,2,9,1,1,8,1008,0.11,0.99,0.5,0.23,1,1,1,0,1016,1.0,1.0,0.5,0.71
PF09203,PF01301:PF15636:PF05593,1,35,0,1,35,982,0.0,0.96,0.0,-0.01,1,0,1,1,1016,0.0,1.0,0.0,-0.0
PF02388,PF13464:PF14280:PF12835,2,2,1,1,1,1015,0.5,1.0,0.5,0.5,1,1,1,0,1016,1.0,1.0,0.5,0.71
PF15318,PF16840:PF14251:PF01330,0,4,0,0,4,1014,0.0,1.0,0,0,0,0,0,0,1018,0,1.0,0,0
PF13599,PF00805:PF11601:PF05336,6,20,2,4,18,994,0.1,0.98,0.33,0.17,2,1,5,1,1011,0.5,0.99,0.17,0.29
PF12527,PF10361:PF08528:PF11669,0,8,0,0,8,1010,0.0,0.99,0,0,0,0,0,0,1018,0,1.0,0,0
PF05843,PF08492:PF16669:PF02184,24,17,4,20,13,981,0.24,0.97,0.17,0.18,2,2,22,0,994,1.0,0.98,0.08,0.29
PF06068,PF04979:PF02536:PF02990,11,64,8,3,56,951,0.12,0.94,0.73,0.29,18,8,3,10,997,0.44,0.99,0.73,0.56
PF07975,PF04056:PF14687:PF03648,4,19,4,0,15,999,0.21,0.99,1.0,0.46,1,0,4,1,1013,0.0,1.0,0.0,-0.0
PF04683,PF03299:PF04801:PF15929,4,22,1,3,21,993,0.05,0.98,0.25,0.1,2,0,4,2,1012,0.0,0.99,0.0,-0.0
PF06465,PF08073:PF06461:PF08074,11,13,11,0,2,1005,0.85,1.0,1.0,0.92,12,11,0,1,1006,0.92,1.0,1.0,0.96
PF02772,PF02773:PF00438:PF01731,4,9,4,0,5,1009,0.44,1.0,1.0,0.67,4,4,0,0,1014,1.0,1.0,1.0,1.0
PF09157,PF09183:PF14232:PF08068,3,5,1,2,4,1011,0.2,0.99,0.33,0.26,1,1,2,0,1015,1.0,1.0,0.33,0.58
PF10377,PF15246:PF16501:PF07765,5,8,3,2,5,1008,0.38,0.99,0.6,0.47,0,0,5,0,1013,0,1.0,0.0,0
PF09649,PF13836:PF02200:PF10384,2,6,0,2,6,1010,0.0,0.99,0.0,-0.0,1,0,2,1,1015,0.0,1.0,0.0,-0.0
PF01847,PF06127:PF05039:PF12597,11,13,4,7,9,998,0.31,0.98,0.36,0.33,0,0,11,0,1007,0,0.99,0.0,0
PF15812,PF00714:PF04856:PF15109,1,1,0,1,1,1016,0.0,1.0,0.0,-0.0,0,0,1,0,1017,0,1.0,0.0,0
PF15871,PF17045:PF12632:PF14197,1,9,0,1,9,1008,0.0,0.99,0.0,-0.0,0,0,1,0,1017,0,1.0,0.0,0
PF06375,PF14796:PF14807:PF14797,4,6,3,1,3,1011,0.5,1.0,0.75,0.61,0,0,4,0,1014,0,1.0,0.0,0
PF05857,PF13247:PF11751:PF08483,0,1,0,0,1,1017,0.0,1.0,0,0,0,0,0,0,1018,0,1.0,0,0
PF04864,PF04863:PF03979:PF04546,4,8,2,2,6,1008,0.25,0.99,0.5,0.35,4,0,4,4,1010,0.0,0.99,0.0,-0.0
PF01382,PF06679:PF15745:PF04041,3,5,1,2,4,1011,0.2,0.99,0.33,0.26,0,0,3,0,1015,0,1.0,0.0,0
PF00094,PF08742:PF09175:PF12714,36,29,28,8,1,981,0.97,0.99,0.78,0.86,14,14,22,0,982,1.0,0.98,0.39,0.62
PF02502,PF05899:PF06249:PF07883,7,33,4,3,29,982,0.12,0.97,0.57,0.25,4,1,6,3,1008,0.25,0.99,0.14,0.18
PF15993,PF03784:PF03769:PF16720,1,2,0,1,2,1015,0.0,1.0,0.0,-0.0,0,0,1,0,1017,0,1.0,0.0,0
PF03193,PF05991:PF12049:PF15342,5,7,1,4,6,1007,0.14,0.99,0.2,0.16,0,0,5,0,1013,0,1.0,0.0,0
PF10865,PF02591:PF15191:PF07023,0,0,0,0,0,1018,0,1.0,0,0,0,0,0,0,1018,0,1.0,0,0
PF09027,PF06760:PF08917:PF03623,2,6,1,1,5,1011,0.17,0.99,0.5,0.29,2,1,1,1,1015,0.5,1.0,0.5,0.5
PF04301,PF05518:PF05989:PF04073,0,13,0,0,13,1005,0.0,0.99,0,0,0,0,0,0,1018,0,1.0,0,0
PF04279,PF13145:PF13568:PF07195,1,7,1,0,6,1011,0.14,0.99,1.0,0.38,0,0,1,0,1017,0,1.0,0.0,0
PF07368,PF15055:PF02448:PF07961,0,0,0,0,0,1018,0,1.0,0,0,0,0,0,0,1018,0,1.0,0,0
PF10719,PF09269:PF06780:PF15086,3,6,1,2,5,1010,0.17,0.99,0.33,0.23,1,1,2,0,1015,1.0,1.0,0.33,0.58
PF06749,PF04720:PF04520:PF06376,7,9,2,5,7,1004,0.22,0.99,0.29,0.25,1,1,6,0,1011,1.0,0.99,0.14,0.38
PF04188,PF14656:PF05742:PF14724,12,12,4,8,8,998,0.33,0.98,0.33,0.33,2,2,10,0,1006,1.0,0.99,0.17,0.41
PF10512,PF10444:PF15805:PF15803,1,6,0,1,6,1011,0.0,0.99,0.0,-0.0,0,0,1,0,1017,0,1.0,0.0,0
PF01281,PF07542:PF00327:PF01159,14,39,7,7,32,972,0.18,0.96,0.5,0.28,6,3,11,3,1001,0.5,0.99,0.21,0.32
PF14892,PF15559:PF00489:PF15339,4,1,0,4,1,1013,0.0,1.0,0.0,-0.0,0,0,4,0,1014,0,1.0,0.0,0
PF05324,PF04644:PF04643:PF00323,0,2,0,0,2,1016,0.0,1.0,0,0,1,0,0,1,1017,0.0,1.0,0,0
PF00151,PF01477:PF00305:PF08016,33,52,17,16,35,950,0.33,0.95,0.52,0.39,23,9,24,14,971,0.39,0.96,0.27,0.31
PF14512,PF06403:PF04451:PF16325,0,2,0,0,2,1016,0.0,1.0,0,0,1,0,0,1,1017,0.0,1.0,0,0
PF03974,PF09461:PF01668:PF10999,1,2,0,1,2,1015,0.0,1.0,0.0,-0.0,0,0,1,0,1017,0,1.0,0.0,0
PF01807,PF08275:PF09327:PF08411,6,5,4,2,1,1011,0.8,1.0,0.67,0.73,0,0,6,0,1012,0,0.99,0.0,0
PF09042,PF06582:PF06583:PF07204,3,6,3,0,3,1012,0.5,1.0,1.0,0.71,2,2,1,0,1015,1.0,1.0,0.67,0.82
PF07178,PF05509:PF06586:PF05309,1,1,1,0,0,1017,1.0,1.0,1.0,1.0,1,1,0,0,1017,1.0,1.0,1.0,1.0
PF16047,PF08023:PF16048:PF08018,0,0,0,0,0,1018,0,1.0,0,0,0,0,0,0,1018,0,1.0,0,0
PF06005,PF11658:PF02137:PF13305,0,22,0,0,22,996,0.0,0.98,0,0,0,0,0,0,1018,0,1.0,0,0
PF09816,PF07545:PF10332:PF13002,6,5,1,5,4,1008,0.2,0.99,0.17,0.18,0,0,6,0,1012,0,0.99,0.0,0
PF14025,PF02217:PF16325:PF04740,0,4,0,0,4,1014,0.0,1.0,0,0,0,0,0,0,1018,0,1.0,0,0
PF15664,PF15119:PF15809:PF05399,0,1,0,0,1,1017,0.0,1.0,0,0,0,0,0,0,1018,0,1.0,0,0
PF00560,PF13855:PF08263:PF12799,50,158,50,0,108,860,0.32,0.89,1.0,0.53,66,40,10,26,942,0.61,0.96,0.8,0.68
PF10460,PF11651:PF08803:PF02354,0,2,0,0,2,1016,0.0,1.0,0,0,0,0,0,0,1018,0,1.0,0,0
PF13765,PF00622:PF00643:PF10607,19,98,18,1,80,919,0.18,0.92,0.95,0.4,37,14,5,23,976,0.38,0.97,0.74,0.52
PF02041,PF12435:PF11338:PF15677,2,9,0,2,9,1007,0.0,0.99,0.0,-0.0,0,0,2,0,1016,0,1.0,0.0,0
PF16816,PF03092:PF16840:PF01031,0,52,0,0,52,966,0.0,0.95,0,0,3,0,0,3,1015,0.0,1.0,0,0
PF16117,PF15823:PF01289:PF04391,1,1,0,1,1,1016,0.0,1.0,0.0,-0.0,0,0,1,0,1017,0,1.0,0.0,0
PF07075,PF10106:PF14985:PF15832,2,3,0,2,3,1013,0.0,1.0,0.0,-0.0,0,0,2,0,1016,0,1.0,0.0,0
PF07751,PF14866:PF04532:PF00770,0,2,0,0,2,1016,0.0,1.0,0,0,0,0,0,0,1018,0,1.0,0,0
PF09818,PF15482:PF03601:PF06626,1,1,0,1,1,1016,0.0,1.0,0.0,-0.0,0,0,1,0,1017,0,1.0,0.0,0
PF16783,PF10927:PF07652:PF03461,5,8,2,3,6,1007,0.25,0.99,0.4,0.31,1,1,4,0,1013,1.0,1.0,0.2,0.45
PF14779,PF07034:PF10022:PF14764,2,16,0,2,16,1000,0.0,0.98,0.0,-0.01,1,0,2,1,1015,0.0,1.0,0.0,-0.0
PF15628,PF15629:PF00073:PF08811,3,16,0,3,16,999,0.0,0.98,0.0,-0.01,0,0,3,0,1015,0,1.0,0.0,0
PF05706,PF11032:PF00727:PF15812,4,8,0,4,8,1006,0.0,0.99,0.0,-0.01,0,0,4,0,1014,0,1.0,0.0,0
PF00122,PF12409:PF00690:PF00689,106,70,66,40,4,908,0.94,0.96,0.62,0.75,60,60,46,0,912,1.0,0.95,0.57,0.73
PF09690,PF02977:PF15119:PF00770,0,2,0,0,2,1016,0.0,1.0,0,0,0,0,0,0,1018,0,1.0,0,0
PF16696,PF11464:PF11409:PF13713,2,17,2,0,15,1001,0.12,0.99,1.0,0.34,1,1,1,0,1016,1.0,1.0,0.5,0.71
PF05422,PF16979:PF16978:PF12448,3,16,3,0,13,1002,0.19,0.99,1.0,0.43,11,2,1,9,1006,0.18,0.99,0.67,0.34
PF01916,PF03345:PF05995:PF06172,5,20,2,3,18,995,0.1,0.98,0.4,0.19,3,2,3,1,1012,0.67,1.0,0.4,0.51
PF15882,PF15013:PF10853:PF06342,12,6,3,9,3,1003,0.5,0.99,0.25,0.35,0,0,12,0,1006,0,0.99,0.0,0
PF00148,PF08369:PF11937:PF09364,1,6,1,0,5,1012,0.17,1.0,1.0,0.41,1,1,0,0,1017,1.0,1.0,1.0,1.0
PF00953,PF07542:PF09995:PF01758,15,26,4,11,22,981,0.15,0.97,0.27,0.19,5,2,13,3,1000,0.4,0.98,0.13,0.22
PF09798,PF07499:PF05939:PF03241,0,2,0,0,2,1016,0.0,1.0,0,0,0,0,0,0,1018,0,1.0,0,0
PF10091,PF06745:PF17164:PF13505,0,0,0,0,0,1018,0,1.0,0,0,0,0,0,0,1018,0,1.0,0,0
PF01341,PF02015:PF03664:PF10503,8,19,5,3,14,996,0.26,0.98,0.62,0.4,2,2,6,0,1010,1.0,0.99,0.25,0.5
PF08065,PF15690:PF09049:PF15689,1,0,0,1,0,1017,0,1.0,0.0,0,0,0,1,0,1017,0,1.0,0.0,0
PF01056,PF02344:PF11851:PF15372,11,5,4,7,1,1006,0.8,0.99,0.36,0.54,1,1,10,0,1007,1.0,0.99,0.09,0.3
PF15460,PF09715:PF17078:PF08642,1,1,0,1,1,1016,0.0,1.0,0.0,-0.0,0,0,1,0,1017,0,1.0,0.0,0
PF08946,PF02452:PF03180:PF13876,1,6,1,0,5,1012,0.17,1.0,1.0,0.41,0,0,1,0,1017,0,1.0,0.0,0
PF05936,PF12080:PF06798:PF00516,2,0,0,2,0,1016,0,1.0,0.0,0,0,0,2,0,1016,0,1.0,0.0,0
PF14524,PF11803:PF04321:PF00908,1,18,0,1,18,999,0.0,0.98,0.0,-0.0,5,0,1,5,1012,0.0,0.99,0.0,-0.0
PF09004,PF08284:PF12384:PF00077,14,32,4,10,28,976,0.12,0.96,0.29,0.17,4,2,12,2,1002,0.5,0.99,0.14,0.26
PF11666,PF02931:PF17209:PF02696,0,83,0,0,83,935,0.0,0.92,0,0,7,0,0,7,1011,0.0,0.99,0,0
PF05970,PF14214:PF02689:PF13538,41,25,18,23,7,970,0.72,0.97,0.44,0.55,9,8,33,1,976,0.89,0.97,0.2,0.41
PF00091,PF03953:PF08609:PF05652,58,56,46,12,10,950,0.82,0.98,0.79,0.8,8,8,50,0,960,1.0,0.95,0.14,0.36
PF02254,PF08619:PF16644:PF00999,13,55,11,2,44,961,0.2,0.95,0.85,0.4,3,1,12,2,1003,0.33,0.99,0.08,0.16
PF09950,PF04917:PF02399:PF07523,0,2,0,0,2,1016,0.0,1.0,0,0,1,0,0,1,1017,0.0,1.0,0,0
PF10976,PF03562:PF15089:PF10988,0,1,0,0,1,1017,0.0,1.0,0,0,0,0,0,0,1018,0,1.0,0,0
PF16417,PF16418:PF04054:PF12842,11,13,10,1,3,1004,0.77,1.0,0.91,0.83,10,10,1,0,1007,1.0,1.0,0.91,0.95
PF08747,PF02759:PF11830:PF05336,0,37,0,0,37,981,0.0,0.96,0,0,1,0,0,1,1017,0.0,1.0,0,0
PF05944,PF16980:PF10092:PF01424,2,37,1,1,36,980,0.03,0.96,0.5,0.11,0,0,2,0,1016,0,1.0,0.0,0
PF16550,PF14831:PF04683:PF08164,3,18,3,0,15,1000,0.17,0.99,1.0,0.41,2,1,2,1,1014,0.5,1.0,0.33,0.41
PF15683,PF06729:PF15760:PF05355,0,3,0,0,3,1015,0.0,1.0,0,0,0,0,0,0,1018,0,1.0,0,0
PF07267,PF15547:PF09361:PF08093,0,1,0,0,1,1017,0.0,1.0,0,0,0,0,0,0,1018,0,1.0,0,0
PF12207,PF07226:PF05357:PF07866,0,0,0,0,0,1018,0,1.0,0,0,0,0,0,0,1018,0,1.0,0,0
PF15153,PF13421:PF07411:PF03241,0,0,0,0,0,1018,0,1.0,0,0,0,0,0,0,1018,0,1.0,0,0
PF16352,PF16346:PF11837:PF03788,0,4,0,0,4,1014,0.0,1.0,0,0,0,0,0,0,1018,0,1.0,0,0
PF11461,PF16516:PF16471:PF09730,11,12,2,9,10,997,0.17,0.98,0.18,0.16,0,0,11,0,1007,0,0.99,0.0,0
PF08171,PF14465:PF15624:PF09462,2,8,1,1,7,1009,0.12,0.99,0.5,0.25,0,0,2,0,1016,0,1.0,0.0,0
PF14449,PF04740:PF16888:PF08453,0,2,0,0,2,1016,0.0,1.0,0,0,0,0,0,0,1018,0,1.0,0,0
PF12904,PF13204:PF01114:PF15302,0,1,0,0,1,1017,0.0,1.0,0,0,0,0,0,0,1018,0,1.0,0,0
PF01967,PF06969:PF00919:PF13597,9,21,6,3,15,994,0.29,0.98,0.67,0.43,3,3,6,0,1009,1.0,0.99,0.33,0.58
PF00992,PF04144:PF10173:PF15237,5,17,3,2,14,999,0.18,0.98,0.6,0.32,4,2,3,2,1011,0.5,1.0,0.4,0.44
PF00723,PF00686:PF01757:PF03009,15,75,11,4,64,939,0.15,0.93,0.73,0.31,24,11,4,13,990,0.46,0.98,0.73,0.57
PF07850,PF05450:PF12735:PF17132,12,15,2,10,13,993,0.13,0.98,0.17,0.14,2,0,12,2,1004,0.0,0.99,0.0,-0.0
PF15709,PF06890:PF17061:PF10856,0,0,0,0,0,1018,0,1.0,0,0,0,0,0,0,1018,0,1.0,0,0
PF16801,PF03546:PF15774:PF07199,0,1,0,0,1,1017,0.0,1.0,0,0,0,0,0,0,1018,0,1.0,0,0
PF01032,PF09383:PF16326:PF09821,5,5,2,3,3,1010,0.4,0.99,0.4,0.4,2,2,3,0,1013,1.0,1.0,0.4,0.63
PF09730,PF16516:PF09728:PF15921,5,14,0,5,14,999,0.0,0.98,0.0,-0.01,1,0,5,1,1012,0.0,0.99,0.0,-0.0
PF00044,PF02672:PF02800:PF00121,28,35,21,7,14,976,0.6,0.98,0.75,0.66,8,7,21,1,989,0.88,0.98,0.25,0.46
PF03496,PF09372:PF09310:PF15487,3,3,1,2,2,1013,0.33,1.0,0.33,0.33,1,1,2,0,1015,1.0,1.0,0.33,0.58
PF12894,PF04192:PF12341:PF03451,54,27,19,35,8,956,0.7,0.96,0.35,0.48,4,4,50,0,964,1.0,0.95,0.07,0.27
PF02728,PF02727:PF01179:PF09248,18,28,18,0,10,990,0.64,0.99,1.0,0.8,17,13,5,4,996,0.76,0.99,0.72,0.74
PF04474,PF16010:PF03082:PF06923,0,17,0,0,17,1001,0.0,0.98,0,0,0,0,0,0,1018,0,1.0,0,0
PF12755,PF13001:PF11916:PF12074,12,20,8,4,12,994,0.4,0.98,0.67,0.51,5,2,10,3,1003,0.4,0.99,0.17,0.25
PF01790,PF11751:PF04222:PF02277,2,3,0,2,3,1013,0.0,1.0,0.0,-0.0,0,0,2,0,1016,0,1.0,0.0,0
PF14996,PF15161:PF15938:PF16112,1,2,1,0,1,1016,0.5,1.0,1.0,0.71,1,1,0,0,1017,1.0,1.0,1.0,1.0
PF07715,PF06937:PF03929:PF15769,7,3,2,5,1,1010,0.67,0.99,0.29,0.43,0,0,7,0,1011,0,0.99,0.0,0
PF12840,PF08093:PF06681:PF10106,0,2,0,0,2,1016,0.0,1.0,0,0,0,0,0,0,1018,0,1.0,0,0
PF11857,PF08924:PF03734:PF16210,3,4,0,3,4,1011,0.0,0.99,0.0,-0.0,0,0,3,0,1015,0,1.0,0.0,0
PF00957,PF13774:PF01357:PF03330,36,35,20,16,15,967,0.57,0.97,0.56,0.55,14,8,28,6,976,0.57,0.97,0.22,0.34
PF07896,PF07816:PF04716:PF01097,5,16,1,4,15,998,0.06,0.98,0.2,0.1,0,0,5,0,1013,0,1.0,0.0,0
PF13421,PF06744:PF14842:PF03241,0,0,0,0,0,1018,0,1.0,0,0,0,0,0,0,1018,0,1.0,0,0
PF15756,PF15049:PF06805:PF10109,1,0,0,1,0,1017,0,1.0,0.0,0,0,0,1,0,1017,0,1.0,0.0,0
PF03313,PF03315:PF05683:PF07171,4,11,4,0,7,1007,0.36,0.99,1.0,0.6,2,1,3,1,1013,0.5,1.0,0.25,0.35
PF13296,PF01580:PF03428:PF06798,1,5,0,1,5,1012,0.0,0.99,0.0,-0.0,0,0,1,0,1017,0,1.0,0.0,0
PF15841,PF15340:PF17014:PF08808,0,2,0,0,2,1016,0.0,1.0,0,0,0,0,0,0,1018,0,1.0,0,0
PF10360,PF04152:PF05334:PF08634,4,16,2,2,14,1000,0.12,0.98,0.5,0.24,1,0,4,1,1013,0.0,1.0,0.0,-0.0
PF03071,PF04133:PF05221:PF06312,11,17,4,7,13,994,0.24,0.98,0.36,0.28,1,1,10,0,1007,1.0,0.99,0.09,0.3
PF16881,PF06463:PF06969:PF06968,11,14,4,7,10,997,0.29,0.98,0.36,0.31,3,2,9,1,1006,0.67,0.99,0.18,0.34
PF04990,PF04992:PF11523:PF04983,3,35,3,0,32,983,0.09,0.97,1.0,0.29,6,3,0,3,1012,0.5,1.0,1.0,0.71
PF00327,PF01281:PF04819:PF01159,16,30,7,9,23,979,0.23,0.97,0.44,0.3,6,3,13,3,999,0.5,0.98,0.19,0.3
PF15681,PF15119:PF14866:PF15809,3,1,0,3,1,1014,0.0,1.0,0.0,-0.0,0,0,3,0,1015,0,1.0,0.0,0
PF17103,PF11380:PF17101:PF17102,5,9,5,0,4,1009,0.56,1.0,1.0,0.74,7,4,1,3,1010,0.57,1.0,0.8,0.67
PF07995,PF02012:PF03118:PF03024,14,14,6,8,8,996,0.43,0.98,0.43,0.42,1,0,14,1,1003,0.0,0.99,0.0,-0.0
PF00289,PF02785:PF08326:PF00364,34,48,33,1,15,969,0.69,0.98,0.97,0.81,29,29,5,0,984,1.0,1.0,0.85,0.92
PF10692,PF00560:PF13855:PF12799,0,154,0,0,154,864,0.0,0.85,0,0,65,0,0,65,953,0.0,0.94,0,0
PF12720,PF10454:PF00737:PF00770,3,2,0,3,2,1013,0.0,1.0,0.0,-0.0,0,0,3,0,1015,0,1.0,0.0,0
PF10521,PF12627:PF06414:PF13735,10,20,5,5,15,993,0.25,0.98,0.5,0.34,2,2,8,0,1008,1.0,0.99,0.2,0.45
PF11105,PF15814:PF03488:PF09057,1,1,0,1,1,1016,0.0,1.0,0.0,-0.0,0,0,1,0,1017,0,1.0,0.0,0
PF00380,PF04981:PF08609:PF05334,16,9,3,13,6,996,0.33,0.98,0.19,0.24,2,1,15,1,1001,0.5,0.98,0.06,0.17
PF11351,PF15040:PF07295:PF10941,0,0,0,0,0,1018,0,1.0,0,0,0,0,0,0,1018,0,1.0,0,0
PF05352,PF16838:PF12256:PF12603,0,1,0,0,1,1017,0.0,1.0,0,0,0,0,0,0,1018,0,1.0,0,0
PF15904,PF10428:PF11921:PF12799,2,45,1,1,44,972,0.02,0.96,0.5,0.1,1,1,1,0,1016,1.0,1.0,0.5,0.71
PF00252,PF00329:PF16906:PF05047,25,29,10,15,19,974,0.34,0.97,0.4,0.35,8,6,19,2,991,0.75,0.98,0.24,0.42
PF07073,PF02500:PF01888:PF05552,0,1,0,0,1,1017,0.0,1.0,0,0,0,0,0,0,1018,0,1.0,0,0
PF02924,PF05309:PF07178:PF06586,0,1,0,0,1,1017,0.0,1.0,0,0,1,0,0,1,1017,0.0,1.0,0,0
PF08064,PF08163:PF11865:PF02259,8,33,8,0,25,985,0.24,0.98,1.0,0.49,13,3,5,10,1000,0.23,0.99,0.38,0.29
PF01227,PF01512:PF05023:PF10589,5,19,2,3,17,996,0.11,0.98,0.4,0.2,7,2,3,5,1008,0.29,0.99,0.4,0.33
PF02190,PF12037:PF06480:PF03226,27,31,12,15,19,972,0.39,0.97,0.44,0.4,5,3,24,2,989,0.6,0.97,0.11,0.25
PF01712,PF04176:PF10160:PF15013,7,10,3,4,7,1004,0.3,0.99,0.43,0.35,0,0,7,0,1011,0,0.99,0.0,0
PF02727,PF02728:PF01179:PF09248,17,28,17,0,11,990,0.61,0.99,1.0,0.77,18,13,4,5,996,0.72,0.99,0.76,0.74
PF04939,PF08316:PF11489:PF15991,9,7,0,9,7,1002,0.0,0.98,0.0,-0.01,0,0,9,0,1009,0,0.99,0.0,0
PF07797,PF15245:PF11623:PF07904,4,3,0,4,3,1011,0.0,0.99,0.0,-0.0,0,0,4,0,1014,0,1.0,0.0,0
PF10758,PF07617:PF11792:PF00931,0,82,0,0,82,936,0.0,0.92,0,0,0,0,0,0,1018,0,1.0,0,0
PF02649,PF07143:PF17186:PF00496,5,15,1,4,14,999,0.07,0.98,0.2,0.11,0,0,5,0,1013,0,1.0,0.0,0
PF06537,PF00857:PF13902:PF04707,0,46,0,0,46,972,0.0,0.95,0,0,9,0,0,9,1009,0.0,0.99,0,0
PF00940,PF14700:PF11934:PF01857,9,12,8,1,4,1005,0.67,1.0,0.89,0.77,1,0,9,1,1008,0.0,0.99,0.0,-0.0
PF12906,PF06454:PF08313:PF16563,32,24,5,27,19,967,0.21,0.95,0.16,0.16,3,2,30,1,985,0.67,0.97,0.06,0.2
PF14225,PF14222:PF14228:PF16206,6,15,6,0,9,1003,0.4,0.99,1.0,0.63,7,6,0,1,1011,0.86,1.0,1.0,0.93
PF01844,PF08388:PF13655:PF08284,12,26,9,3,17,989,0.35,0.98,0.75,0.5,6,6,6,0,1006,1.0,0.99,0.5,0.71
PF06293,PF09812:PF01784:PF01215,13,13,3,10,10,995,0.23,0.98,0.23,0.22,1,1,12,0,1005,1.0,0.99,0.08,0.28
PF16898,PF00986:PF08070:PF00204,9,22,8,1,14,995,0.36,0.99,0.89,0.56,11,4,5,7,1002,0.36,0.99,0.44,0.4
PF15795,PF00214:PF15910:PF09366,0,7,0,0,7,1011,0.0,0.99,0,0,0,0,0,0,1018,0,1.0,0,0
PF13101,PF17164:PF04610:PF03994,0,4,0,0,4,1014,0.0,1.0,0,0,0,0,0,0,1018,0,1.0,0,0
PF10459,PF14871:PF16967:PF15976,2,1,0,2,1,1015,0.0,1.0,0.0,-0.0,0,0,2,0,1016,0,1.0,0.0,0
PF06159,PF07542:PF10218:PF00830,2,15,2,0,13,1003,0.13,0.99,1.0,0.36,0,0,2,0,1016,0,1.0,0.0,0
PF04345,PF15674:PF09259:PF04586,2,5,1,1,4,1012,0.2,1.0,0.5,0.31,1,1,1,0,1016,1.0,1.0,0.5,0.71
PF00963,PF15705:PF15706:PF16070,6,11,6,0,5,1007,0.55,1.0,1.0,0.74,3,0,6,3,1009,0.0,0.99,0.0,-0.0
PF16201,PF11707:PF08696:PF15277,3,18,2,1,16,999,0.11,0.98,0.67,0.27,2,0,3,2,1013,0.0,1.0,0.0,-0.0
PF12943,PF10780:PF00321:PF11779,4,6,0,4,6,1008,0.0,0.99,0.0,-0.0,0,0,4,0,1014,0,1.0,0.0,0
PF01568,PF04879:PF09326:PF00384,5,24,5,0,19,994,0.21,0.98,1.0,0.45,17,2,3,15,998,0.12,0.98,0.4,0.21
PF14833,PF03446:PF17042:PF00393,25,38,22,3,16,977,0.58,0.98,0.88,0.71,15,12,13,3,990,0.8,0.98,0.48,0.61
PF12287,PF00386:PF03523:PF12308,1,25,0,1,25,992,0.0,0.97,0.0,-0.0,2,0,1,2,1015,0.0,1.0,0.0,-0.0
PF12316,PF02377:PF00778:PF04629,6,12,4,2,8,1004,0.33,0.99,0.67,0.47,3,3,3,0,1012,1.0,1.0,0.5,0.71
PF09646,PF09861:PF08453:PF08707,0,3,0,0,3,1015,0.0,1.0,0,0,0,0,0,0,1018,0,1.0,0,0
PF01042,PF01902:PF01497:PF02353,23,23,7,16,16,979,0.3,0.97,0.3,0.29,6,5,18,1,994,0.83,0.98,0.22,0.42
PF07276,PF06753:PF10285:PF03991,0,1,0,0,1,1017,0.0,1.0,0,0,0,0,0,0,1018,0,1.0,0,0
PF13943,PF10063:PF14021:PF02575,4,7,0,4,7,1007,0.0,0.99,0.0,-0.01,2,0,4,2,1012,0.0,0.99,0.0,-0.0
PF08343,PF10554:PF12467:PF04196,2,6,1,1,5,1011,0.17,0.99,0.5,0.29,0,0,2,0,1016,0,1.0,0.0,0
PF03776,PF02427:PF15063:PF06581,4,0,0,4,0,1014,0,1.0,0.0,0,0,0,4,0,1014,0,1.0,0.0,0
PF01628,PF08411:PF14882:PF01325,2,4,1,1,3,1013,0.25,1.0,0.5,0.35,0,0,2,0,1016,0,1.0,0.0,0
PF00173,PF01070:PF11960:PF08557,87,50,35,52,15,916,0.7,0.93,0.4,0.5,3,3,84,0,931,1.0,0.92,0.03,0.18
PF08187,PF05572:PF08225:PF13778,1,10,0,1,10,1007,0.0,0.99,0.0,-0.0,1,0,1,1,1016,0.0,1.0,0.0,-0.0
PF00067,PF00667:PF00258:PF13813,177,51,42,135,9,832,0.82,0.86,0.24,0.39,30,26,151,4,837,0.87,0.85,0.15,0.32
PF12787,PF10917:PF07411:PF06761,2,1,0,2,1,1015,0.0,1.0,0.0,-0.0,0,0,2,0,1016,0,1.0,0.0,0
PF02404,PF06387:PF14047:PF10488,1,4,0,1,4,1013,0.0,1.0,0.0,-0.0,0,0,1,0,1017,0,1.0,0.0,0
PF01105,PF15011:PF03006:PF04930,37,29,10,27,19,962,0.34,0.95,0.27,0.28,5,4,33,1,980,0.8,0.97,0.11,0.29
PF01759,PF07703:PF01821:PF07677,16,16,9,7,7,995,0.56,0.99,0.56,0.56,11,8,8,3,999,0.73,0.99,0.5,0.6
PF05651,PF05280:PF02554:PF12241,0,5,0,0,5,1013,0.0,1.0,0,0,0,0,0,0,1018,0,1.0,0,0
PF11875,PF14308:PF11926:PF14237,5,16,1,4,15,998,0.06,0.98,0.2,0.1,3,1,4,2,1011,0.33,0.99,0.2,0.26
PF12643,PF12638:PF00537:PF06232,3,9,1,2,8,1007,0.11,0.99,0.33,0.19,1,0,3,1,1014,0.0,1.0,0.0,-0.0
PF13359,PF13613:PF14949:PF12017,45,30,18,27,12,961,0.6,0.96,0.4,0.47,8,8,37,0,973,1.0,0.96,0.18,0.41
PF02128,PF07504:PF03413:PF14837,3,7,3,0,4,1011,0.43,1.0,1.0,0.65,2,2,1,0,1015,1.0,1.0,0.67,0.82
PF00860,PF04724:PF02705:PF01866,31,28,8,23,20,967,0.29,0.96,0.26,0.25,6,4,27,2,985,0.67,0.97,0.13,0.29
PF15455,PF10912:PF17006:PF12840,1,1,1,0,0,1017,1.0,1.0,1.0,1.0,0,0,1,0,1017,0,1.0,0.0,0
PF06411,PF04989:PF07142:PF09796,0,11,0,0,11,1007,0.0,0.99,0,0,1,0,0,1,1017,0.0,1.0,0,0
PF02201,PF02229:PF03126:PF08766,28,45,23,5,22,968,0.51,0.97,0.82,0.64,12,9,19,3,987,0.75,0.98,0.32,0.48
PF15859,PF12313:PF05247:PF04219,0,4,0,0,4,1014,0.0,1.0,0,0,0,0,0,0,1018,0,1.0,0,0
PF00429,PF03708:PF10155:PF04704,5,10,2,3,8,1005,0.2,0.99,0.4,0.28,0,0,5,0,1013,0,1.0,0.0,0
PF03792,PF00157:PF13293:PF12413,4,8,4,0,4,1010,0.5,1.0,1.0,0.71,1,1,3,0,1014,1.0,1.0,0.25,0.5
PF00360,PF01590:PF08446:PF10436,13,47,12,1,35,970,0.26,0.96,0.92,0.48,14,11,2,3,1002,0.79,1.0,0.85,0.81
PF00924,PF15996:PF03615:PF14611,14,14,4,10,10,994,0.29,0.98,0.29,0.28,3,2,12,1,1003,0.67,0.99,0.14,0.3
PF10578,PF02420:PF15362:PF12782,0,1,0,0,1,1017,0.0,1.0,0,0,0,0,0,0,1018,0,1.0,0,0
PF10816,PF00932:PF06748:PF14372,0,23,0,0,23,995,0.0,0.98,0,0,4,0,0,4,1014,0.0,1.0,0,0
PF14319,PF09795:PF09986:PF16330,0,2,0,0,2,1016,0.0,1.0,0,0,0,0,0,0,1018,0,1.0,0,0
PF08555,PF10780:PF10244:PF01470,4,16,1,3,15,999,0.06,0.98,0.25,0.12,4,1,3,3,1011,0.25,0.99,0.25,0.25
PF09267,PF12610:PF15895:PF12162,0,2,0,0,2,1016,0.0,1.0,0,0,0,0,0,0,1018,0,1.0,0,0
PF01214,PF14798:PF13593:PF00956,19,26,7,12,19,980,0.27,0.97,0.37,0.3,3,3,16,0,999,1.0,0.98,0.16,0.39
PF14792,PF10391:PF14791:PF14716,19,25,19,0,6,993,0.76,0.99,1.0,0.87,13,13,6,0,999,1.0,0.99,0.68,0.82
PF12309,PF04981:PF16061:PF10496,8,20,2,6,18,992,0.1,0.98,0.25,0.15,2,1,7,1,1009,0.5,0.99,0.12,0.25
PF03914,PF00924:PF06584:PF13934,18,24,6,12,18,982,0.25,0.97,0.33,0.27,2,2,16,0,1000,1.0,0.98,0.11,0.33
PF01536,PF08132:PF00272:PF08660,9,11,4,5,7,1002,0.36,0.99,0.44,0.4,0,0,9,0,1009,0,0.99,0.0,0
PF12731,PF12737:PF05722:PF07526,1,4,1,0,3,1014,0.25,1.0,1.0,0.5,1,1,0,0,1017,1.0,1.0,1.0,1.0
PF08728,PF00649:PF12516:PF15678,5,8,1,4,7,1006,0.12,0.99,0.2,0.15,0,0,5,0,1013,0,1.0,0.0,0
PF01165,PF07816:PF11833:PF09754,4,9,2,2,7,1007,0.22,0.99,0.5,0.33,1,1,3,0,1014,1.0,1.0,0.25,0.5
PF12210,PF11464:PF16696:PF00790,5,35,4,1,31,982,0.11,0.97,0.8,0.3,5,1,4,4,1009,0.2,0.99,0.2,0.2
PF08370,PF06422:PF14510:PF08352,7,19,5,2,14,997,0.26,0.98,0.71,0.43,14,4,3,10,1001,0.29,0.99,0.57,0.4
PF16711,PF16709:PF16712:PF02065,1,8,1,0,7,1010,0.12,0.99,1.0,0.35,1,1,0,0,1017,1.0,1.0,1.0,1.0
PF08094,PF10456:PF05571:PF12825,1,21,0,1,21,996,0.0,0.98,0.0,-0.0,4,0,1,4,1013,0.0,1.0,0.0,-0.0
PF05568,PF05881:PF04160:PF01273,0,15,0,0,15,1003,0.0,0.99,0,0,1,0,0,1,1017,0.0,1.0,0,0
PF04558,PF04557:PF03950:PF00749,12,35,12,0,23,983,0.34,0.98,1.0,0.58,23,12,0,11,995,0.52,0.99,1.0,0.72
PF08412,PF13545:PF10137:PF16526,6,10,1,5,9,1003,0.1,0.99,0.17,0.12,0,0,6,0,1012,0,0.99,0.0,0
PF14877,PF15050:PF17078:PF17015,4,3,0,4,3,1011,0.0,0.99,0.0,-0.0,0,0,4,0,1014,0,1.0,0.0,0
PF00634,PF09169:PF09121:PF09104,4,5,2,2,3,1011,0.4,1.0,0.5,0.44,1,1,3,0,1014,1.0,1.0,0.25,0.5
PF02493,PF08154:PF00415:PF02204,45,83,23,22,60,913,0.28,0.92,0.51,0.34,24,13,32,11,962,0.54,0.96,0.29,0.38
PF12520,PF04576:PF12830:PF15275,4,24,2,2,22,992,0.08,0.98,0.5,0.2,2,1,3,1,1013,0.5,1.0,0.25,0.35
PF04791,PF04859:PF00029:PF00262,17,26,6,11,20,981,0.23,0.97,0.35,0.27,5,2,15,3,998,0.4,0.98,0.12,0.21
PF12928,PF10307:PF13859:PF10198,9,5,0,9,5,1004,0.0,0.99,0.0,-0.01,0,0,9,0,1009,0,0.99,0.0,0
PF07801,PF02672:PF13965:PF03483,5,23,2,3,21,992,0.09,0.98,0.4,0.18,2,1,4,1,1012,0.5,1.0,0.2,0.31
PF12436,PF14533:PF13446:PF06337,10,23,10,0,13,995,0.43,0.99,1.0,0.66,4,4,6,0,1008,1.0,0.99,0.4,0.63
PF04696,PF12511:PF10234:PF04880,12,14,5,7,9,997,0.36,0.98,0.42,0.38,0,0,12,0,1006,0,0.99,0.0,0
PF09397,PF01580:PF08886:PF06070,5,6,5,0,1,1012,0.83,1.0,1.0,0.91,0,0,5,0,1013,0,1.0,0.0,0
PF03815,PF08305:PF14200:PF02010,11,19,4,7,15,992,0.21,0.98,0.36,0.27,3,2,9,1,1006,0.67,0.99,0.18,0.34
PF16699,PF04158:PF12265:PF08154,4,21,3,1,18,996,0.14,0.98,0.75,0.32,4,2,2,2,1012,0.5,1.0,0.5,0.5
PF03662,PF07542:PF03088:PF01758,9,29,2,7,27,982,0.07,0.97,0.22,0.11,7,1,8,6,1003,0.14,0.99,0.11,0.12
PF08786,PF11691:PF01280:PF05625,0,21,0,0,21,997,0.0,0.98,0,0,4,0,0,4,1014,0.0,1.0,0,0
PF08482,PF08148:PF16204:PF16739,3,19,2,1,17,998,0.11,0.98,0.67,0.26,5,2,1,3,1012,0.4,1.0,0.67,0.51
PF12369,PF09193:PF10413:PF03827,2,4,2,0,2,1014,0.5,1.0,1.0,0.71,1,1,1,0,1016,1.0,1.0,0.5,0.71
PF14551,PF00493:PF17207:PF12619,46,50,44,2,6,966,0.88,0.99,0.96,0.91,47,44,2,3,969,0.94,1.0,0.96,0.94
PF02570,PF13557:PF16210:PF10077,4,8,4,0,4,1010,0.5,1.0,1.0,0.71,1,1,3,0,1014,1.0,1.0,0.25,0.5
PF10923,PF02489:PF05664:PF13401,2,25,2,0,23,993,0.08,0.98,1.0,0.28,4,1,1,3,1013,0.25,1.0,0.5,0.35
PF07327,PF17124:PF03379:PF15085,1,3,0,1,3,1014,0.0,1.0,0.0,-0.0,0,0,1,0,1017,0,1.0,0.0,0
PF03453,PF03454:PF06844:PF00994,23,37,20,3,17,978,0.54,0.98,0.87,0.68,15,13,10,2,993,0.87,0.99,0.57,0.69
PF06514,PF14866:PF15041:PF02531,0,3,0,0,3,1015,0.0,1.0,0,0,0,0,0,0,1018,0,1.0,0,0
PF08317,PF05513:PF12080:PF01913,5,2,1,4,1,1012,0.5,1.0,0.2,0.31,0,0,5,0,1013,0,1.0,0.0,0
PF00679,PF03764:PF06421:PF14492,50,49,41,9,8,960,0.84,0.98,0.82,0.82,23,23,27,0,968,1.0,0.97,0.46,0.67
PF04457,PF10470:PF16274:PF16568,9,2,0,9,2,1007,0.0,0.99,0.0,-0.0,1,0,9,1,1008,0.0,0.99,0.0,-0.0
PF06584,PF13824:PF07222:PF01285,5,8,1,4,7,1006,0.12,0.99,0.2,0.15,2,1,4,1,1012,0.5,1.0,0.2,0.31
PF00871,PF01515:PF07279:PF14232,5,9,4,1,5,1008,0.44,0.99,0.8,0.59,0,0,5,0,1013,0,1.0,0.0,0
PF03109,PF00144:PF01636:PF09797,42,97,30,12,67,909,0.31,0.92,0.71,0.44,31,19,23,12,964,0.61,0.97,0.45,0.51
PF05794,PF09138:PF07406:PF08228,10,11,2,8,9,999,0.18,0.98,0.2,0.18,2,0,10,2,1006,0.0,0.99,0.0,-0.0
PF05966,PF13116:PF04811:PF03326,0,34,0,0,34,984,0.0,0.97,0,0,1,0,0,1,1017,0.0,1.0,0,0
PF14699,PF06202:PF14701:PF14702,1,3,0,1,3,1014,0.0,1.0,0.0,-0.0,2,0,1,2,1015,0.0,1.0,0.0,-0.0
PF09667,PF16090:PF13775:PF12444,0,5,0,0,5,1013,0.0,1.0,0,0,0,0,0,0,1018,0,1.0,0,0
PF02470,PF07039:PF11708:PF07800,4,22,2,2,20,994,0.09,0.98,0.5,0.21,3,1,3,2,1012,0.33,1.0,0.25,0.29
PF12589,PF08498:PF05093:PF07109,6,26,3,3,23,989,0.12,0.97,0.5,0.23,2,2,4,0,1012,1.0,1.0,0.33,0.58
PF01372,PF08110:PF08023:PF16048,1,0,0,1,0,1017,0,1.0,0.0,0,0,0,1,0,1017,0,1.0,0.0,0
PF07361,PF02614:PF06864:PF11614,6,7,4,2,3,1009,0.57,1.0,0.67,0.61,0,0,6,0,1012,0,0.99,0.0,0
PF07466,PF04107:PF05096:PF14159,3,8,0,3,8,1007,0.0,0.99,0.0,-0.0,0,0,3,0,1015,0,1.0,0.0,0
PF15678,PF13836:PF00649:PF10482,0,9,0,0,9,1009,0.0,0.99,0,0,0,0,0,0,1018,0,1.0,0,0
PF08295,PF02671:PF16879:PF02762,17,32,16,1,16,985,0.5,0.98,0.94,0.68,15,15,2,0,1001,1.0,1.0,0.88,0.94
PF08999,PF11636:PF02180:PF13335,2,2,0,2,2,1014,0.0,1.0,0.0,-0.0,0,0,2,0,1016,0,1.0,0.0,0
PF03730,PF02735:PF03731:PF08785,17,25,17,0,8,993,0.68,0.99,1.0,0.82,23,17,0,6,995,0.74,0.99,1.0,0.86
PF12017,PF05485:PF12596:PF14291,24,71,19,5,52,942,0.27,0.94,0.79,0.44,15,11,13,4,990,0.73,0.98,0.46,0.57
PF06850,PF07209:PF04830:PF17164,0,1,0,0,1,1017,0.0,1.0,0,0,0,0,0,0,1018,0,1.0,0,0
PF06365,PF15045:PF08528:PF15369,6,6,0,6,6,1006,0.0,0.99,0.0,-0.01,1,0,6,1,1011,0.0,0.99,0.0,-0.0
PF06825,PF03386:PF05512:PF13741,4,4,0,4,4,1010,0.0,0.99,0.0,-0.0,1,0,4,1,1013,0.0,1.0,0.0,-0.0
PF07166,PF05453:PF15170:PF13677,0,2,0,0,2,1016,0.0,1.0,0,0,0,0,0,0,1018,0,1.0,0,0
PF16712,PF16711:PF16709:PF16874,1,4,1,0,3,1014,0.25,1.0,1.0,0.5,1,1,0,0,1017,1.0,1.0,1.0,1.0
PF04925,PF04795:PF10156:PF03081,7,26,3,4,23,988,0.12,0.97,0.43,0.21,3,1,6,2,1009,0.33,0.99,0.14,0.21
PF02203,PF00015:PF00563:PF08918,4,19,4,0,15,999,0.21,0.99,1.0,0.46,5,2,2,3,1011,0.4,1.0,0.5,0.44
PF15725,PF10994:PF15216:PF15339,0,1,0,0,1,1017,0.0,1.0,0,0,0,0,0,0,1018,0,1.0,0,0
PF00310,PF04898:PF01645:PF14691,12,12,7,5,5,1001,0.58,0.99,0.58,0.58,6,6,6,0,1006,1.0,0.99,0.5,0.71
PF08366,PF09453:PF12931:PF07304,12,22,4,8,18,988,0.18,0.97,0.33,0.23,6,2,10,4,1002,0.33,0.99,0.17,0.23
PF06259,PF13036:PF15117:PF11794,0,0,0,0,0,1018,0,1.0,0,0,0,0,0,0,1018,0,1.0,0,0
PF13614,PF10407:PF15241:PF04417,14,2,0,14,2,1002,0.0,0.98,0.0,-0.01,0,0,14,0,1004,0,0.99,0.0,0
PF15480,PF06890:PF02565:PF17193,1,0,0,1,0,1017,0,1.0,0.0,0,0,0,1,0,1017,0,1.0,0.0,0
PF06936,PF14340:PF10961:PF07912,5,11,2,3,9,1004,0.18,0.99,0.4,0.26,0,0,5,0,1013,0,1.0,0.0,0
PF14290,PF03745:PF17076:PF03238,0,0,0,0,0,1018,0,1.0,0,0,0,0,0,0,1018,0,1.0,0,0
PF06678,PF17193:PF03739:PF06403,0,6,0,0,6,1012,0.0,0.99,0,0,0,0,0,0,1018,0,1.0,0,0
PF06331,PF12806:PF09317:PF12418,11,3,3,8,0,1007,1.0,0.99,0.27,0.52,3,3,8,0,1007,1.0,0.99,0.27,0.52
PF13532,PF05050:PF08498:PF12589,44,29,12,32,17,957,0.41,0.95,0.27,0.31,3,3,41,0,974,1.0,0.96,0.07,0.26
PF08914,PF11626:PF06732:PF09197,14,12,8,6,4,1000,0.67,0.99,0.57,0.61,1,1,13,0,1004,1.0,0.99,0.07,0.27
PF05092,PF05787:PF09798:PF04349,0,0,0,0,0,1018,0,1.0,0,0,0,0,0,0,1018,0,1.0,0,0
PF16489,PF02793:PF01825:PF00002,17,64,17,0,47,954,0.27,0.95,1.0,0.5,40,16,1,24,977,0.4,0.98,0.94,0.6
PF15100,PF12686:PF04222:PF03831,0,0,0,0,0,1018,0,1.0,0,0,0,0,0,0,1018,0,1.0,0,0
PF08790,PF08265:PF15477:PF06365,8,20,6,2,14,996,0.3,0.98,0.75,0.47,3,3,5,0,1010,1.0,1.0,0.38,0.61
PF06549,PF02605:PF11152:PF09057,1,2,1,0,1,1016,0.5,1.0,1.0,0.71,0,0,1,0,1017,0,1.0,0.0,0
PF03944,PF04349:PF07434:PF11019,2,0,0,2,0,1016,0,1.0,0.0,0,0,0,2,0,1016,0,1.0,0.0,0
PF03813,PF04935:PF11538:PF16875,9,13,1,8,12,997,0.08,0.98,0.11,0.08,0,0,9,0,1009,0,0.99,0.0,0
PF09331,PF03384:PF02902:PF16944,4,71,3,1,68,946,0.04,0.93,0.75,0.17,2,0,4,2,1012,0.0,0.99,0.0,-0.0
PF07814,PF10188:PF09808:PF09816,12,10,2,10,8,998,0.2,0.98,0.17,0.17,1,1,11,0,1006,1.0,0.99,0.08,0.29
PF05658,PF13018:PF05662:PF04624,0,4,0,0,4,1014,0.0,1.0,0,0,0,0,0,0,1018,0,1.0,0,0
PF15265,PF15302:PF01114:PF09051,0,1,0,0,1,1017,0.0,1.0,0,0,0,0,0,0,1018,0,1.0,0,0
PF07106,PF00159:PF10780:PF04667,7,7,0,7,7,1004,0.0,0.99,0.0,-0.01,0,0,7,0,1011,0,0.99,0.0,0
PF05301,PF15991:PF09756:PF15264,3,8,1,2,7,1008,0.12,0.99,0.33,0.2,0,0,3,0,1015,0,1.0,0.0,0
PF00291,PF00290:PF14821:PF00571,56,66,25,31,41,921,0.38,0.93,0.45,0.37,4,4,52,0,962,1.0,0.95,0.07,0.26
PF06574,PF07298:PF02401:PF15346,4,8,1,3,7,1007,0.12,0.99,0.25,0.17,1,0,4,1,1013,0.0,1.0,0.0,-0.0
PF00257,PF10222:PF00684:PF14308,6,18,0,6,18,994,0.0,0.98,0.0,-0.01,3,0,6,3,1009,0.0,0.99,0.0,-0.0
PF16135,PF07897:PF03735:PF12269,15,10,6,9,4,999,0.6,0.99,0.4,0.48,3,3,12,0,1003,1.0,0.99,0.2,0.44
PF00448,PF02978:PF02881:PF04086,37,38,35,2,3,978,0.92,1.0,0.95,0.93,27,27,10,0,981,1.0,0.99,0.73,0.85
PF06739,PF15817:PF04632:PF07484,3,1,1,2,0,1015,1.0,1.0,0.33,0.58,0,0,3,0,1015,0,1.0,0.0,0
PF00926,PF12471:PF07958:PF00925,9,14,6,3,8,1001,0.43,0.99,0.67,0.53,3,2,7,1,1008,0.67,0.99,0.22,0.38
PF13985,PF12431:PF01339:PF08667,1,6,0,1,6,1011,0.0,0.99,0.0,-0.0,0,0,1,0,1017,0,1.0,0.0,0
PF12461,PF11975:PF15272:PF01706,0,9,0,0,9,1009,0.0,0.99,0,0,0,0,0,0,1018,0,1.0,0,0
PF04794,PF00796:PF07486:PF03379,3,3,0,3,3,1012,0.0,0.99,0.0,-0.0,0,0,3,0,1015,0,1.0,0.0,0
PF03638,PF01754:PF03909:PF05920,10,42,5,5,37,971,0.12,0.96,0.5,0.23,8,4,6,4,1004,0.5,0.99,0.4,0.44
PF00161,PF00652:PF00535:PF16499,13,81,10,3,71,934,0.12,0.93,0.77,0.29,41,8,5,33,972,0.2,0.96,0.62,0.33
PF08155,PF06858:PF02421:PF10998,16,26,16,0,10,992,0.62,0.99,1.0,0.78,2,2,14,0,1002,1.0,0.99,0.12,0.35
PF00715,PF10422:PF16804:PF06222,2,1,0,2,1,1015,0.0,1.0,0.0,-0.0,0,0,2,0,1016,0,1.0,0.0,0
PF12605,PF08332:PF14593:PF11629,4,8,3,1,5,1009,0.38,0.99,0.75,0.53,3,2,2,1,1013,0.67,1.0,0.5,0.58
PF01229,PF04253:PF09112:PF03629,4,17,1,3,16,998,0.06,0.98,0.25,0.11,2,1,3,1,1013,0.5,1.0,0.25,0.35
PF09324,PF12783:PF16213:PF16206,12,30,12,0,18,988,0.4,0.98,1.0,0.63,17,11,1,6,1000,0.65,0.99,0.92,0.77
PF04262,PF12461:PF15271:PF03631,1,0,0,1,0,1017,0,1.0,0.0,0,0,0,1,0,1017,0,1.0,0.0,0
PF11546,PF08173:PF11075:PF00763,0,24,0,0,24,994,0.0,0.98,0,0,0,0,0,0,1018,0,1.0,0,0
PF04988,PF15696:PF15337:PF05841,5,3,1,4,2,1011,0.33,0.99,0.2,0.26,0,0,5,0,1013,0,1.0,0.0,0
PF03117,PF04347:PF15195:PF14347,0,1,0,0,1,1017,0.0,1.0,0,0,0,0,0,0,1018,0,1.0,0,0
PF00202,PF05577:PF10046:PF12739,44,39,18,26,21,953,0.46,0.95,0.41,0.41,8,7,37,1,973,0.88,0.96,0.16,0.36
PF15124,PF11863:PF16325:PF04228,0,1,0,0,1,1017,0.0,1.0,0,0,0,0,0,0,1018,0,1.0,0,0
PF10177,PF15862:PF15280:PF03615,1,8,1,0,7,1010,0.12,0.99,1.0,0.35,1,1,0,0,1017,1.0,1.0,1.0,1.0
PF14738,PF16501:PF14662:PF02213,4,17,1,3,16,998,0.06,0.98,0.25,0.11,1,1,3,0,1014,1.0,1.0,0.25,0.5
PF03784,PF16720:PF08027:PF00340,0,3,0,0,3,1015,0.0,1.0,0,0,1,0,0,1,1017,0.0,1.0,0,0
PF06933,PF07610:PF10407:PF15082,0,4,0,0,4,1014,0.0,1.0,0,0,0,0,0,0,1018,0,1.0,0,0
PF02291,PF00473:PF05172:PF02234,5,23,3,2,20,993,0.13,0.98,0.6,0.27,0,0,5,0,1013,0,1.0,0.0,0
PF08509,PF15904:PF08376:PF13458,6,11,4,2,7,1005,0.36,0.99,0.67,0.49,3,2,4,1,1011,0.67,1.0,0.33,0.47
PF09044,PF04232:PF15872:PF17085,2,3,0,2,3,1013,0.0,1.0,0.0,-0.0,0,0,2,0,1016,0,1.0,0.0,0
PF14995,PF15041:PF04691:PF05836,6,2,1,5,1,1011,0.5,0.99,0.17,0.29,0,0,6,0,1012,0,0.99,0.0,0
PF15224,PF06393:PF08857:PF08093,0,3,0,0,3,1015,0.0,1.0,0,0,0,0,0,0,1018,0,1.0,0,0
PF08568,PF12463:PF03385:PF02449,5,14,0,5,14,999,0.0,0.98,0.0,-0.01,0,0,5,0,1013,0,1.0,0.0,0
PF15005,PF14049:PF07111:PF10173,6,7,2,4,5,1007,0.29,0.99,0.33,0.3,1,0,6,1,1011,0.0,0.99,0.0,-0.0
PF00596,PF13419:PF01738:PF00475,33,67,19,14,48,937,0.28,0.94,0.58,0.38,13,9,24,4,981,0.69,0.97,0.27,0.42
PF14984,PF15129:PF15138:PF07400,0,2,0,0,2,1016,0.0,1.0,0,0,0,0,0,0,1018,0,1.0,0,0
PF11127,PF09122:PF06617:PF12368,2,8,0,2,8,1008,0.0,0.99,0.0,-0.0,0,0,2,0,1016,0,1.0,0.0,0
PF07295,PF09676:PF05746:PF14041,0,30,0,0,30,988,0.0,0.97,0,0,0,0,0,0,1018,0,1.0,0,0
PF09937,PF02141:PF15270:PF07714,0,194,0,0,194,824,0.0,0.81,0,0,23,0,0,23,995,0.0,0.98,0,0
PF13339,PF13864:PF11489:PF10330,15,8,5,10,3,1000,0.62,0.99,0.33,0.45,0,0,15,0,1003,0,0.99,0.0,0
PF13085,PF06159:PF07542:PF11735,20,20,3,17,17,981,0.15,0.97,0.15,0.13,3,0,20,3,995,0.0,0.98,0.0,-0.01
PF08038,PF15475:PF04736:PF11029,1,4,0,1,4,1013,0.0,1.0,0.0,-0.0,0,0,1,0,1017,0,1.0,0.0,0
PF15081,PF01110:PF15132:PF15754,2,1,0,2,1,1015,0.0,1.0,0.0,-0.0,0,0,2,0,1016,0,1.0,0.0,0
PF01292,PF11794:PF08497:PF06834,6,0,0,6,0,1012,0,0.99,0.0,0,0,0,6,0,1012,0,0.99,0.0,0
PF00174,PF03404:PF00970:PF01070,20,71,20,0,51,947,0.28,0.95,1.0,0.52,23,18,2,5,993,0.78,0.99,0.9,0.84
PF13933,PF15831:PF06907:PF16594,0,3,0,0,3,1015,0.0,1.0,0,0,0,0,0,0,1018,0,1.0,0,0
PF02673,PF08795:PF04349:PF02601,1,2,0,1,2,1015,0.0,1.0,0.0,-0.0,0,0,1,0,1017,0,1.0,0.0,0
PF07117,PF15976:PF07434:PF14113,0,0,0,0,0,1018,0,1.0,0,0,0,0,0,0,1018,0,1.0,0,0
PF00212,PF14769:PF15342:PF09282,1,9,0,1,9,1008,0.0,0.99,0.0,-0.0,0,0,1,0,1017,0,1.0,0.0,0
PF02045,PF02234:PF05678:PF07939,6,17,5,1,12,1000,0.29,0.99,0.83,0.49,2,2,4,0,1012,1.0,1.0,0.33,0.58
PF04471,PF00555:PF15281:PF02119,3,7,0,3,7,1008,0.0,0.99,0.0,-0.0,0,0,3,0,1015,0,1.0,0.0,0
PF08251,PF07560:PF10095:PF14642,0,1,0,0,1,1017,0.0,1.0,0,0,0,0,0,0,1018,0,1.0,0,0
PF00746,PF10856:PF02226:PF08361,0,13,0,0,13,1005,0.0,0.99,0,0,0,0,0,0,1018,0,1.0,0,0
PF12782,PF15362:PF10578:PF02343,0,3,0,0,3,1015,0.0,1.0,0,0,0,0,0,0,1018,0,1.0,0,0
PF11640,PF15785:PF08163:PF11522,5,22,3,2,19,994,0.14,0.98,0.6,0.28,2,2,3,0,1013,1.0,1.0,0.4,0.63
PF15116,PF11341:PF15828:PF03238,0,4,0,0,4,1014,0.0,1.0,0,0,0,0,0,0,1018,0,1.0,0,0
PF01157,PF01907:PF05197:PF00831,14,19,5,9,14,990,0.26,0.98,0.36,0.3,5,2,12,3,1001,0.4,0.99,0.14,0.23
PF03879,PF09696:PF05361:PF10244,6,15,2,4,13,999,0.13,0.98,0.33,0.2,5,2,4,3,1009,0.4,0.99,0.33,0.36
PF10793,PF15623:PF16590:PF13588,0,3,0,0,3,1015,0.0,1.0,0,0,0,0,0,0,1018,0,1.0,0,0
PF14652,PF10347:PF01503:PF14678,1,22,0,1,22,995,0.0,0.98,0.0,-0.0,2,0,1,2,1015,0.0,1.0,0.0,-0.0
PF08718,PF01791:PF04178:PF06093,15,22,4,11,18,985,0.18,0.97,0.27,0.21,5,2,13,3,1000,0.4,0.98,0.13,0.22
PF07745,PF15173:PF15071:PF06521,7,1,0,7,1,1010,0.0,0.99,0.0,-0.0,0,0,7,0,1011,0,0.99,0.0,0
PF04703,PF11751:PF05100:PF02413,0,0,0,0,0,1018,0,1.0,0,0,0,0,0,0,1018,0,1.0,0,0
PF03024,PF07995:PF15387:PF08626,9,24,7,2,17,992,0.29,0.98,0.78,0.47,4,4,5,0,1009,1.0,1.0,0.44,0.67
PF15926,PF07139:PF04139:PF10188,5,14,1,4,13,1000,0.07,0.98,0.2,0.11,1,1,4,0,1013,1.0,1.0,0.2,0.45
PF07937,PF09611:PF02119:PF01292,0,8,0,0,8,1010,0.0,0.99,0,0,0,0,0,0,1018,0,1.0,0,0
PF12861,PF15189:PF04536:PF08034,14,7,3,11,4,1000,0.43,0.99,0.21,0.3,2,2,12,0,1004,1.0,0.99,0.14,0.38
PF01575,PF08354:PF16073:PF02036,34,36,21,13,15,969,0.58,0.97,0.62,0.59,10,10,24,0,984,1.0,0.98,0.29,0.54
PF07226,PF12207:PF01750:PF03038,0,2,0,0,2,1016,0.0,1.0,0,0,0,0,0,0,1018,0,1.0,0,0
PF15661,PF08275:PF00308:PF04865,2,8,1,1,7,1009,0.12,0.99,0.5,0.25,1,0,2,1,1015,0.0,1.0,0.0,-0.0
PF06763,PF11924:PF03562:PF04687,0,3,0,0,3,1015,0.0,1.0,0,0,0,0,0,0,1018,0,1.0,0,0
PF00053,PF00028:PF16489:PF12661,38,74,28,10,46,934,0.38,0.94,0.74,0.5,25,20,18,5,975,0.8,0.98,0.53,0.64
PF10244,PF14935:PF15071:PF12020,8,2,1,7,1,1009,0.5,0.99,0.12,0.25,0,0,8,0,1010,0,0.99,0.0,0
PF06934,PF10566:PF08497:PF07805,0,1,0,0,1,1017,0.0,1.0,0,0,0,0,0,0,1018,0,1.0,0,0
PF12009,PF14529:PF06817:PF08333,6,52,2,4,50,962,0.04,0.95,0.33,0.1,7,1,5,6,1006,0.14,0.99,0.17,0.15
PF15912,PF11526:PF07001:PF15624,2,15,0,2,15,1001,0.0,0.98,0.0,-0.01,1,0,2,1,1015,0.0,1.0,0.0,-0.0
PF10645,PF16861:PF09677:PF03616,2,4,0,2,4,1012,0.0,0.99,0.0,-0.0,0,0,2,0,1016,0,1.0,0.0,0
PF06631,PF11618:PF00388:PF09457,4,29,4,0,25,989,0.14,0.98,1.0,0.37,6,2,2,4,1010,0.33,0.99,0.5,0.41
PF09687,PF10332:PF15247:PF11735,0,15,0,0,15,1003,0.0,0.99,0,0,1,0,0,1,1017,0.0,1.0,0,0
PF05060,PF04088:PF15383:PF08397,3,16,1,2,15,1000,0.06,0.98,0.33,0.14,1,1,2,0,1015,1.0,1.0,0.33,0.58
PF01402,PF05939:PF07157:PF06798,1,0,0,1,0,1017,0,1.0,0.0,0,0,0,1,0,1017,0,1.0,0.0,0
PF01107,PF03732:PF03159:PF02337,5,68,4,1,64,949,0.06,0.94,0.8,0.21,11,3,2,8,1005,0.27,0.99,0.6,0.4
PF16822,PF08497:PF10908:PF14882,0,0,0,0,0,1018,0,1.0,0,0,0,0,0,0,1018,0,1.0,0,0
PF12230,PF09750:PF01805:PF16566,13,46,13,0,33,972,0.28,0.97,1.0,0.52,14,5,8,9,996,0.36,0.98,0.38,0.36
PF04566,PF04565:PF06883:PF04561,13,20,13,0,7,998,0.65,0.99,1.0,0.8,6,3,10,3,1002,0.5,0.99,0.23,0.33
PF07454,PF04562:PF15775:PF04076,0,0,0,0,0,1018,0,1.0,0,0,0,0,0,0,1018,0,1.0,0,0
PF15138,PF07400:PF15211:PF14984,1,0,0,1,0,1017,0,1.0,0.0,0,0,0,1,0,1017,0,1.0,0.0,0
PF03353,PF10440:PF05965:PF05964,4,22,1,3,21,993,0.05,0.98,0.25,0.1,17,1,3,16,998,0.06,0.98,0.25,0.11
PF12796,PF00023:PF13606:PF00710,246,123,116,130,7,765,0.94,0.87,0.47,0.61,43,43,203,0,772,1.0,0.8,0.17,0.37
PF15351,PF12090:PF11365:PF12887,2,10,0,2,10,1006,0.0,0.99,0.0,-0.0,0,0,2,0,1016,0,1.0,0.0,0
PF16076,PF14829:PF08806:PF16094,22,16,8,14,8,988,0.5,0.98,0.36,0.42,3,2,20,1,995,0.67,0.98,0.09,0.24
PF03883,PF15849:PF02202:PF15125,2,3,1,1,2,1014,0.33,1.0,0.5,0.41,0,0,2,0,1016,0,1.0,0.0,0
PF06246,PF07019:PF02434:PF04230,12,39,7,5,32,974,0.18,0.96,0.58,0.31,7,3,9,4,1002,0.43,0.99,0.25,0.32
PF03530,PF02888:PF15113:PF07885,14,63,13,1,50,954,0.21,0.95,0.93,0.42,10,8,6,2,1002,0.8,0.99,0.57,0.67
PF11210,PF01752:PF15207:PF05167,0,4,0,0,4,1014,0.0,1.0,0,0,0,0,0,0,1018,0,1.0,0,0
PF16477,PF15181:PF15798:PF03527,0,3,0,0,3,1015,0.0,1.0,0,0,0,0,0,0,1018,0,1.0,0,0
PF15868,PF15955:PF14935:PF10853,6,6,0,6,6,1006,0.0,0.99,0.0,-0.01,1,0,6,1,1011,0.0,0.99,0.0,-0.0
PF05940,PF03992:PF00994:PF02668,0,74,0,0,74,944,0.0,0.93,0,0,20,0,0,20,998,0.0,0.98,0,0
PF01716,PF05039:PF06351:PF02285,1,6,0,1,6,1011,0.0,0.99,0.0,-0.0,0,0,1,0,1017,0,1.0,0.0,0
PF13577,PF00296:PF05176:PF11991,7,26,5,2,21,990,0.19,0.98,0.71,0.36,1,1,6,0,1011,1.0,0.99,0.14,0.38
PF05063,PF05346:PF04000:PF06886,22,29,7,15,22,974,0.24,0.96,0.32,0.26,5,4,18,1,995,0.8,0.98,0.18,0.38
PF11756,PF01476:PF09362:PF09514,0,47,0,0,47,971,0.0,0.95,0,0,4,0,0,4,1014,0.0,1.0,0,0
PF00374,PF17188:PF15340:PF05294,1,2,0,1,2,1015,0.0,1.0,0.0,-0.0,0,0,1,0,1017,0,1.0,0.0,0
PF08953,PF09453:PF13925:PF12341,9,23,2,7,21,988,0.09,0.97,0.22,0.13,7,2,7,5,1004,0.29,0.99,0.22,0.25
PF16921,PF09371:PF08529:PF14878,3,17,3,0,14,1001,0.18,0.99,1.0,0.42,2,2,1,0,1015,1.0,1.0,0.67,0.82
PF01239,PF07711:PF04566:PF00288,27,50,13,14,37,954,0.26,0.95,0.48,0.33,10,5,22,5,986,0.5,0.97,0.19,0.29
PF01394,PF09268:PF00993:PF16196,8,5,3,5,2,1008,0.6,0.99,0.38,0.47,0,0,8,0,1010,0,0.99,0.0,0
PF05115,PF08026:PF15105:PF15763,2,0,0,2,0,1016,0,1.0,0.0,0,0,0,2,0,1016,0,1.0,0.0,0
PF15837,PF06681:PF13094:PF15555,0,2,0,0,2,1016,0.0,1.0,0,0,0,0,0,0,1018,0,1.0,0,0
PF01562,PF00200:PF16698:PF01421,32,42,31,1,11,975,0.74,0.99,0.97,0.84,22,17,15,5,981,0.77,0.98,0.53,0.63
PF12402,PF08014:PF15257:PF05841,0,2,0,0,2,1016,0.0,1.0,0,0,1,0,0,1,1017,0.0,1.0,0,0
PF04824,PF05029:PF12166:PF04054,8,25,5,3,20,990,0.2,0.98,0.62,0.35,2,1,7,1,1009,0.5,0.99,0.12,0.25
PF08036,PF15041:PF15555:PF15809,0,2,0,0,2,1016,0.0,1.0,0,0,0,0,0,0,1018,0,1.0,0,0
PF06943,PF04086:PF06124:PF05140,2,15,1,1,14,1002,0.07,0.99,0.5,0.18,1,0,2,1,1015,0.0,1.0,0.0,-0.0
PF01117,PF07468:PF03318:PF02884,0,6,0,0,6,1012,0.0,0.99,0,0,0,0,0,0,1018,0,1.0,0,0
PF05201,PF00745:PF01488:PF08501,8,25,8,0,17,993,0.32,0.98,1.0,0.56,17,8,0,9,1001,0.47,0.99,1.0,0.68
PF06313,PF04856:PF00714:PF00489,0,2,0,0,2,1016,0.0,1.0,0,0,0,0,0,0,1018,0,1.0,0,0
PF02063,PF02399:PF15476:PF08432,3,2,0,3,2,1013,0.0,1.0,0.0,-0.0,0,0,3,0,1015,0,1.0,0.0,0
PF12146,PF03982:PF00561:PF00544,51,95,36,15,59,908,0.38,0.93,0.71,0.48,25,17,34,8,959,0.68,0.96,0.33,0.46
PF13713,PF16696:PF11464:PF08381,7,18,7,0,11,1000,0.39,0.99,1.0,0.62,2,2,5,0,1011,1.0,1.0,0.29,0.53
PF08152,PF10175:PF11719:PF00607,11,21,4,7,17,990,0.19,0.98,0.36,0.25,4,3,8,1,1006,0.75,0.99,0.27,0.45
PF16179,PF00554:PF16180:PF03020,16,21,16,0,5,997,0.76,1.0,1.0,0.87,4,4,12,0,1002,1.0,0.99,0.25,0.5
PF02312,PF02525:PF10705:PF06342,2,3,0,2,3,1013,0.0,1.0,0.0,-0.0,0,0,2,0,1016,0,1.0,0.0,0
PF13239,PF13811:PF00055:PF01672,0,24,0,0,24,994,0.0,0.98,0,0,0,0,0,0,1018,0,1.0,0,0
PF11914,PF11970:PF09732:PF16741,0,16,0,0,16,1002,0.0,0.98,0,0,0,0,0,0,1018,0,1.0,0,0
PF02132,PF08275:PF01807:PF10410,1,6,0,1,6,1011,0.0,0.99,0.0,-0.0,4,0,1,4,1013,0.0,1.0,0.0,-0.0
PF11902,PF06251:PF03241:PF03090,0,0,0,0,0,1018,0,1.0,0,0,0,0,0,0,1018,0,1.0,0,0
PF16090,PF09667:PF13775:PF12444,4,1,0,4,1,1013,0.0,1.0,0.0,-0.0,0,0,4,0,1014,0,1.0,0.0,0
PF05497,PF14935:PF15008:PF00965,5,8,0,5,8,1005,0.0,0.99,0.0,-0.01,0,0,5,0,1013,0,1.0,0.0,0
PF01421,PF01562:PF05986:PF00200,33,44,31,2,13,972,0.7,0.99,0.94,0.81,25,20,13,5,980,0.8,0.98,0.61,0.69
PF10190,PF02284:PF02046:PF12020,6,8,3,3,5,1007,0.38,0.99,0.5,0.43,1,0,6,1,1011,0.0,0.99,0.0,-0.0
PF03979,PF04546:PF00140:PF08281,6,9,6,0,3,1009,0.67,1.0,1.0,0.82,4,4,2,0,1012,1.0,1.0,0.67,0.82
PF01485,PF05773:PF16678:PF08572,60,39,22,38,17,941,0.56,0.95,0.37,0.43,3,3,57,0,958,1.0,0.94,0.05,0.22
PF03907,PF17078:PF15863:PF10664,1,3,1,0,2,1015,0.33,1.0,1.0,0.58,0,0,1,0,1017,0,1.0,0.0,0
PF09290,PF08275:PF01807:PF10410,3,6,0,3,6,1009,0.0,0.99,0.0,-0.0,4,0,3,4,1011,0.0,0.99,0.0,-0.0
PF03994,PF11751:PF08479:PF01136,1,1,0,1,1,1016,0.0,1.0,0.0,-0.0,0,0,1,0,1017,0,1.0,0.0,0
PF01215,PF10183:PF04667:PF08561,10,18,2,8,16,992,0.11,0.98,0.2,0.14,1,0,10,1,1007,0.0,0.99,0.0,-0.0
PF04539,PF04545:PF08281:PF04542,15,27,15,0,12,991,0.56,0.99,1.0,0.74,18,12,3,6,997,0.67,0.99,0.8,0.73
PF16788,PF14611:PF00649:PF15620,3,12,0,3,12,1003,0.0,0.99,0.0,-0.01,0,0,3,0,1015,0,1.0,0.0,0
PF00910,PF00680:PF12381:PF12231,14,15,12,2,3,1001,0.8,1.0,0.86,0.83,4,4,10,0,1004,1.0,0.99,0.29,0.53
PF07399,PF10694:PF07706:PF04260,2,7,1,1,6,1010,0.14,0.99,0.5,0.26,1,1,1,0,1016,1.0,1.0,0.5,0.71
PF15973,PF03103:PF05428:PF10542,0,8,0,0,8,1010,0.0,0.99,0,0,0,0,0,0,1018,0,1.0,0,0
PF01695,PF13269:PF08479:PF12461,7,0,0,7,0,1011,0,0.99,0.0,0,0,0,7,0,1011,0,0.99,0.0,0
PF16761,PF06165:PF10395:PF12231,6,7,4,2,3,1009,0.57,1.0,0.67,0.61,0,0,6,0,1012,0,0.99,0.0,0
PF14467,PF08299:PF14882:PF07411,0,2,0,0,2,1016,0.0,1.0,0,0,0,0,0,0,1018,0,1.0,0,0
PF12889,PF03354:PF02591:PF01429,0,23,0,0,23,995,0.0,0.98,0,0,0,0,0,0,1018,0,1.0,0,0
PF07199,PF15337:PF03525:PF15774,0,3,0,0,3,1015,0.0,1.0,0,0,0,0,0,0,1018,0,1.0,0,0
PF04614,PF02681:PF09366:PF09419,7,19,2,5,17,994,0.11,0.98,0.29,0.16,3,1,6,2,1009,0.33,0.99,0.14,0.21
PF10681,PF07544:PF07335:PF06377,2,8,0,2,8,1008,0.0,0.99,0.0,-0.0,1,0,2,1,1015,0.0,1.0,0.0,-0.0
PF08206,PF08529:PF13184:PF09876,1,4,1,0,3,1014,0.25,1.0,1.0,0.5,4,1,0,3,1014,0.25,1.0,1.0,0.5
PF12761,PF16880:PF12763:PF08226,7,43,5,2,38,973,0.12,0.96,0.71,0.28,17,4,3,13,998,0.24,0.98,0.57,0.36
PF12597,PF06232:PF14774:PF06108,9,14,3,6,11,998,0.21,0.98,0.33,0.26,1,1,8,0,1009,1.0,0.99,0.11,0.33
PF13810,PF05841:PF10295:PF03525,1,3,0,1,3,1014,0.0,1.0,0.0,-0.0,0,0,1,0,1017,0,1.0,0.0,0
PF11026,PF01913:PF15518:PF11751,0,2,0,0,2,1016,0.0,1.0,0,0,0,0,0,0,1018,0,1.0,0,0
PF13954,PF00345:PF13953:PF02056,3,12,3,0,9,1006,0.25,0.99,1.0,0.5,3,3,0,0,1015,1.0,1.0,1.0,1.0
PF03564,PF07245:PF05380:PF05585,36,40,24,12,16,966,0.6,0.97,0.67,0.62,13,13,23,0,982,1.0,0.98,0.36,0.59
PF16855,PF04101:PF01554:PF00156,0,59,0,0,59,959,0.0,0.94,0,0,12,0,0,12,1006,0.0,0.99,0,0
PF02187,PF14923:PF08976:PF00307,16,75,11,5,64,938,0.15,0.93,0.69,0.3,5,4,12,1,1001,0.8,0.99,0.25,0.44
PF03301,PF08127:PF00396:PF12131,6,13,3,3,10,1002,0.23,0.99,0.5,0.33,3,1,5,2,1010,0.33,0.99,0.17,0.23
PF00355,PF01180:PF07992:PF08417,39,101,30,9,71,908,0.3,0.92,0.77,0.45,17,10,29,7,972,0.59,0.96,0.26,0.37
PF10493,PF08696:PF07539:PF17034,4,22,3,1,19,995,0.14,0.98,0.75,0.31,2,2,2,0,1014,1.0,1.0,0.5,0.71
PF03775,PF06890:PF05666:PF05840,0,0,0,0,0,1018,0,1.0,0,0,0,0,0,0,1018,0,1.0,0,0
PF01595,PF00654:PF00571:PF00893,18,63,11,7,52,948,0.17,0.94,0.61,0.31,30,4,14,26,974,0.13,0.96,0.22,0.15
PF01666,PF04562:PF12628:PF04370,0,0,0,0,0,1018,0,1.0,0,0,0,0,0,0,1018,0,1.0,0,0
PF08502,PF02436:PF00682:PF07836,9,22,9,0,13,996,0.41,0.99,1.0,0.64,4,3,6,1,1008,0.75,0.99,0.33,0.5
PF05837,PF13096:PF02083:PF15934,1,3,0,1,3,1014,0.0,1.0,0.0,-0.0,0,0,1,0,1017,0,1.0,0.0,0
PF13360,PF13570:PF07774:PF01011,26,24,18,8,6,986,0.75,0.99,0.69,0.71,4,4,22,0,992,1.0,0.98,0.15,0.39
PF14777,PF14886:PF09232:PF17124,4,4,3,1,1,1013,0.75,1.0,0.75,0.75,0,0,4,0,1014,0,1.0,0.0,0
PF02166,PF02155:PF02159:PF12743,6,11,5,1,6,1006,0.45,0.99,0.83,0.61,6,5,1,1,1011,0.83,1.0,0.83,0.83
PF11765,PF15146:PF08811:PF05203,1,11,0,1,11,1006,0.0,0.99,0.0,-0.0,0,0,1,0,1017,0,1.0,0.0,0
PF05443,PF11862:PF11245:PF10988,2,1,0,2,1,1015,0.0,1.0,0.0,-0.0,0,0,2,0,1016,0,1.0,0.0,0
PF16940,PF10177:PF03546:PF10198,5,5,0,5,5,1008,0.0,0.99,0.0,-0.0,1,0,5,1,1012,0.0,0.99,0.0,-0.0
PF12145,PF06333:PF11597:PF15950,6,9,1,5,8,1004,0.11,0.99,0.17,0.13,5,1,5,4,1008,0.2,0.99,0.17,0.18
PF08323,PF00862:PF12038:PF15924,6,16,1,5,15,997,0.06,0.98,0.17,0.09,1,0,6,1,1011,0.0,0.99,0.0,-0.0
PF02548,PF11779:PF05042:PF01680,13,16,4,9,12,993,0.25,0.98,0.31,0.27,1,1,12,0,1005,1.0,0.99,0.08,0.28
PF04801,PF03299:PF06886:PF04000,14,26,2,12,24,980,0.08,0.96,0.14,0.09,5,2,12,3,1001,0.4,0.99,0.14,0.23
PF16320,PF13259:PF00542:PF11429,9,14,9,0,5,1004,0.64,1.0,1.0,0.8,2,2,7,0,1009,1.0,0.99,0.22,0.47
PF03090,PF11751:PF13722:PF03241,0,0,0,0,0,1018,0,1.0,0,0,0,0,0,0,1018,0,1.0,0,0
PF02845,PF01735:PF15625:PF13441,32,19,5,27,14,972,0.26,0.96,0.16,0.18,1,1,31,0,986,1.0,0.97,0.03,0.17
PF12299,PF07157:PF03831:PF04865,0,0,0,0,0,1018,0,1.0,0,0,0,0,0,0,1018,0,1.0,0,0
PF15130,PF15231:PF15060:PF15685,1,0,0,1,0,1017,0,1.0,0.0,0,0,0,1,0,1017,0,1.0,0.0,0
PF00591,PF07831:PF02885:PF08125,5,13,5,0,8,1005,0.38,0.99,1.0,0.62,2,2,3,0,1013,1.0,1.0,0.4,0.63
PF06852,PF11581:PF01666:PF06681,0,0,0,0,0,1018,0,1.0,0,0,0,0,0,0,1018,0,1.0,0,0
PF13478,PF04290:PF06808:PF06240,6,9,6,0,3,1009,0.67,1.0,1.0,0.82,6,6,0,0,1012,1.0,1.0,1.0,1.0
PF02681,PF06206:PF12638:PF06373,5,6,2,3,4,1009,0.33,0.99,0.4,0.36,0,0,5,0,1013,0,1.0,0.0,0
PF07448,PF14986:PF09232:PF15559,0,0,0,0,0,1018,0,1.0,0,0,0,0,0,0,1018,0,1.0,0,0
PF04352,PF01752:PF17206:PF15463,0,4,0,0,4,1014,0.0,1.0,0,0,0,0,0,0,1018,0,1.0,0,0
PF11638,PF14841:PF12019:PF05857,2,2,1,1,1,1015,0.5,1.0,0.5,0.5,0,0,2,0,1016,0,1.0,0.0,0
PF08271,PF00382:PF07741:PF11521,12,23,12,0,11,995,0.52,0.99,1.0,0.72,8,3,9,5,1001,0.38,0.99,0.25,0.3
PF01053,PF04828:PF08544:PF02656,34,62,18,16,44,940,0.29,0.94,0.53,0.36,12,10,24,2,982,0.83,0.97,0.29,0.49
PF07695,PF04122:PF12532:PF14607,1,0,0,1,0,1017,0,1.0,0.0,0,0,0,1,0,1017,0,1.0,0.0,0
PF16772,PF08558:PF14379:PF16495,2,18,2,0,16,1000,0.11,0.98,1.0,0.33,2,0,2,2,1014,0.0,1.0,0.0,-0.0
PF00632,PF00658:PF07035:PF10350,61,23,11,50,12,945,0.48,0.94,0.18,0.27,7,6,55,1,956,0.86,0.94,0.1,0.28
PF13689,PF12019:PF06082:PF03831,0,1,0,0,1,1017,0.0,1.0,0,0,0,0,0,0,1018,0,1.0,0,0
PF11734,PF09179:PF06041:PF05280,3,14,3,0,11,1004,0.21,0.99,1.0,0.46,1,1,2,0,1015,1.0,1.0,0.33,0.58
PF12314,PF12402:PF15999:PF04087,0,3,0,0,3,1015,0.0,1.0,0,0,0,0,0,0,1018,0,1.0,0,0
PF08923,PF10457:PF07059:PF12221,3,12,2,1,10,1005,0.17,0.99,0.67,0.33,2,1,2,1,1014,0.5,1.0,0.33,0.41
PF12253,PF08634:PF16944:PF05334,3,5,0,3,5,1010,0.0,0.99,0.0,-0.0,0,0,3,0,1015,0,1.0,0.0,0
PF03847,PF07816:PF04484:PF09754,7,12,3,4,9,1002,0.25,0.99,0.43,0.32,2,2,5,0,1011,1.0,1.0,0.29,0.53
PF00929,PF15870:PF13423:PF00641,50,63,24,26,39,929,0.38,0.94,0.48,0.39,6,6,44,0,968,1.0,0.96,0.12,0.34
PF15044,PF13236:PF12807:PF05303,5,15,5,0,10,1003,0.33,0.99,1.0,0.57,6,5,0,1,1012,0.83,1.0,1.0,0.91
PF10274,PF11977:PF09736:PF11768,12,13,6,6,7,999,0.46,0.99,0.5,0.47,2,2,10,0,1006,1.0,0.99,0.17,0.41
PF05673,PF10566:PF02554:PF06505,0,0,0,0,0,1018,0,1.0,0,0,0,0,0,0,1018,0,1.0,0,0
PF00295,PF12708:PF04231:PF01063,33,33,13,20,20,965,0.39,0.96,0.39,0.37,2,2,31,0,985,1.0,0.97,0.06,0.24
PF09206,PF05270:PF09175:PF08742,3,32,2,1,30,985,0.06,0.97,0.67,0.2,5,1,2,4,1011,0.2,0.99,0.33,0.26
PF01503,PF01502:PF00815:PF14652,15,23,11,4,12,991,0.48,0.98,0.73,0.58,8,8,7,0,1003,1.0,0.99,0.53,0.73
PF06023,PF06305:PF08317:PF03589,0,7,0,0,7,1011,0.0,0.99,0,0,2,0,0,2,1016,0.0,1.0,0,0
PF05769,PF05346:PF08552:PF07797,8,25,5,3,20,990,0.2,0.98,0.62,0.35,2,0,8,2,1008,0.0,0.99,0.0,-0.0
PF04525,PF04674:PF04535:PF06749,4,14,2,2,12,1002,0.14,0.99,0.5,0.26,3,2,2,1,1013,0.67,1.0,0.5,0.58
PF13368,PF01751:PF01131:PF00986,6,36,6,0,30,982,0.17,0.97,1.0,0.4,24,6,0,18,994,0.25,0.98,1.0,0.5
PF08126,PF15518:PF16888:PF13780,2,1,0,2,1,1015,0.0,1.0,0.0,-0.0,0,0,2,0,1016,0,1.0,0.0,0
PF06989,PF11460:PF12855:PF08653,0,3,0,0,3,1015,0.0,1.0,0,0,0,0,0,0,1018,0,1.0,0,0
PF01957,PF10726:PF05518:PF07273,0,0,0,0,0,1018,0,1.0,0,0,0,0,0,0,1018,0,1.0,0,0
PF01479,PF16065:PF01929:PF01777,43,32,17,26,15,960,0.53,0.96,0.4,0.44,7,6,37,1,974,0.86,0.96,0.14,0.34
PF00651,PF12313:PF00887:PF09494,138,54,36,102,18,862,0.67,0.88,0.26,0.37,5,5,133,0,880,1.0,0.87,0.04,0.18
PF15205,PF09252:PF14986:PF03379,0,1,0,0,1,1017,0.0,1.0,0,0,0,0,0,0,1018,0,1.0,0,0
PF14849,PF10139:PF13746:PF02753,2,7,0,2,7,1009,0.0,0.99,0.0,-0.0,0,0,2,0,1016,0,1.0,0.0,0
PF02037,PF14443:PF02891:PF16294,61,17,11,50,6,951,0.65,0.94,0.18,0.32,4,4,57,0,957,1.0,0.94,0.07,0.25
PF15633,PF15482:PF06681:PF17206,0,1,0,0,1,1017,0.0,1.0,0,0,0,0,0,0,1018,0,1.0,0,0
PF04710,PF16720:PF03784:PF07084,4,3,0,4,3,1011,0.0,0.99,0.0,-0.0,0,0,4,0,1014,0,1.0,0.0,0
PF15181,PF16477:PF15703:PF02063,1,3,0,1,3,1014,0.0,1.0,0.0,-0.0,0,0,1,0,1017,0,1.0,0.0,0
PF09050,PF09051:PF09049:PF07014,0,0,0,0,0,1018,0,1.0,0,0,0,0,0,0,1018,0,1.0,0,0
PF03909,PF08567:PF16978:PF12632,19,21,11,8,10,989,0.52,0.98,0.58,0.54,3,3,16,0,999,1.0,0.98,0.16,0.39
PF01213,PF08603:PF01288:PF00809,11,24,10,1,14,993,0.42,0.99,0.91,0.61,8,3,8,5,1002,0.38,0.99,0.27,0.31
PF13195,PF01869:PF05242:PF10294,0,46,0,0,46,972,0.0,0.95,0,0,7,0,0,7,1011,0.0,0.99,0,0
PF07259,PF15120:PF15849:PF15839,1,2,0,1,2,1015,0.0,1.0,0.0,-0.0,0,0,1,0,1017,0,1.0,0.0,0
PF15684,PF14653:PF15071:PF11029,0,2,0,0,2,1016,0.0,1.0,0,0,0,0,0,0,1018,0,1.0,0,0
PF06580,PF07730:PF09239:PF02954,9,13,3,6,10,999,0.23,0.98,0.33,0.27,3,1,8,2,1007,0.33,0.99,0.11,0.19
PF00749,PF03950:PF04557:PF00458,35,31,24,11,7,976,0.77,0.98,0.69,0.72,16,16,19,0,983,1.0,0.98,0.46,0.67
PF05321,PF00550:PF02769:PF00560,0,103,0,0,103,915,0.0,0.9,0,0,24,0,0,24,994,0.0,0.98,0,0
PF08762,PF12381:PF12264:PF01660,4,8,4,0,4,1010,0.5,1.0,1.0,0.71,4,4,0,0,1014,1.0,1.0,1.0,1.0
PF16263,PF07338:PF13390:PF02113,0,6,0,0,6,1012,0.0,0.99,0,0,0,0,0,0,1018,0,1.0,0,0
PF08378,PF10333:PF02361:PF06369,1,6,0,1,6,1011,0.0,0.99,0.0,-0.0,0,0,1,0,1017,0,1.0,0.0,0
PF09250,PF17007:PF15518:PF08411,1,2,0,1,2,1015,0.0,1.0,0.0,-0.0,0,0,1,0,1017,0,1.0,0.0,0
PF13860,PF12461:PF14052:PF03406,1,0,0,1,0,1017,0,1.0,0.0,0,0,0,1,0,1017,0,1.0,0.0,0
PF07789,PF11030:PF05416:PF14760,0,3,0,0,3,1015,0.0,1.0,0,0,0,0,0,0,1018,0,1.0,0,0
PF09472,PF14421:PF06057:PF15441,1,2,0,1,2,1015,0.0,1.0,0.0,-0.0,0,0,1,0,1017,0,1.0,0.0,0
PF07400,PF15211:PF15138:PF16649,0,1,0,0,1,1017,0.0,1.0,0,0,1,0,0,1,1017,0.0,1.0,0,0
PF01331,PF02940:PF14671:PF03919,15,22,13,2,9,994,0.59,0.99,0.87,0.71,4,4,11,0,1003,1.0,0.99,0.27,0.51
PF16678,PF09409:PF01485:PF09186,8,71,8,0,63,947,0.11,0.94,1.0,0.33,17,6,2,11,999,0.35,0.99,0.75,0.51
PF12848,PF03649:PF13732:PF08352,21,9,4,17,5,992,0.44,0.98,0.19,0.28,2,2,19,0,997,1.0,0.98,0.1,0.31
PF03648,PF07477:PF07488:PF02065,3,9,3,0,6,1009,0.33,0.99,1.0,0.58,4,3,0,1,1014,0.75,1.0,1.0,0.87
PF00736,PF10587:PF14768:PF14766,28,18,18,10,0,990,1.0,0.99,0.64,0.8,3,3,25,0,990,1.0,0.98,0.11,0.32
PF05232,PF08497:PF03428:PF17206,0,1,0,0,1,1017,0.0,1.0,0,0,0,0,0,0,1018,0,1.0,0,0
PF07898,PF15013:PF04979:PF01097,6,24,2,4,22,990,0.08,0.97,0.33,0.16,1,0,6,1,1011,0.0,0.99,0.0,-0.0
PF06252,PF02080:PF09795:PF02479,0,3,0,0,3,1015,0.0,1.0,0,0,0,0,0,0,1018,0,1.0,0,0
PF09379,PF09380:PF08736:PF11819,40,33,30,10,3,975,0.91,0.99,0.75,0.82,19,17,23,2,976,0.89,0.98,0.42,0.61
PF13823,PF16912:PF02302:PF12242,2,2,0,2,2,1014,0.0,1.0,0.0,-0.0,0,0,2,0,1016,0,1.0,0.0,0
PF15727,PF09669:PF10109:PF04466,0,1,0,0,1,1017,0.0,1.0,0,0,0,0,0,0,1018,0,1.0,0,0
PF12794,PF05065:PF15400:PF00524,2,5,0,2,5,1011,0.0,0.99,0.0,-0.0,0,0,2,0,1016,0,1.0,0.0,0
PF09538,PF13965:PF01079:PF08399,0,23,0,0,23,995,0.0,0.98,0,0,3,0,0,3,1015,0.0,1.0,0,0
PF00349,PF03727:PF09764:PF06880,20,24,20,0,4,994,0.83,1.0,1.0,0.91,5,5,15,0,998,1.0,0.99,0.25,0.5
PF13925,PF09453:PF15512:PF08232,6,20,3,3,17,995,0.15,0.98,0.5,0.27,2,1,5,1,1011,0.5,0.99,0.17,0.29
PF08158,PF05285:PF12530:PF09511,7,25,6,1,19,992,0.24,0.98,0.86,0.45,2,1,6,1,1010,0.5,0.99,0.14,0.26
PF03664,PF00457:PF01083:PF01670,6,20,5,1,15,997,0.25,0.98,0.83,0.45,5,2,4,3,1009,0.4,0.99,0.33,0.36
PF07805,PF08497:PF01706:PF03050,1,1,0,1,1,1016,0.0,1.0,0.0,-0.0,0,0,1,0,1017,0,1.0,0.0,0
PF13449,PF05014:PF06581:PF03576,4,3,1,3,2,1012,0.33,1.0,0.25,0.29,0,0,4,0,1014,0,1.0,0.0,0
PF10573,PF03713:PF15169:PF11584,3,0,0,3,0,1015,0,1.0,0.0,0,0,0,3,0,1015,0,1.0,0.0,0
PF01252,PF03971:PF13663:PF04932,4,3,0,4,3,1011,0.0,0.99,0.0,-0.0,0,0,4,0,1014,0,1.0,0.0,0
PF07660,PF03241:PF11863:PF15281,1,3,0,1,3,1014,0.0,1.0,0.0,-0.0,0,0,1,0,1017,0,1.0,0.0,0
PF14944,PF09303:PF09049:PF09051,4,2,0,4,2,1012,0.0,0.99,0.0,-0.0,0,0,4,0,1014,0,1.0,0.0,0
PF12579,PF11669:PF08265:PF10672,0,17,0,0,17,1001,0.0,0.98,0,0,0,0,0,0,1018,0,1.0,0,0
PF00526,PF17210:PF05914:PF00746,1,8,0,1,8,1009,0.0,0.99,0.0,-0.0,0,0,1,0,1017,0,1.0,0.0,0
PF02445,PF03458:PF16576:PF05658,3,2,0,3,2,1013,0.0,1.0,0.0,-0.0,0,0,3,0,1015,0,1.0,0.0,0
PF12248,PF11901:PF09458:PF07703,14,33,6,8,27,977,0.18,0.97,0.43,0.26,6,3,11,3,1001,0.5,0.99,0.21,0.32
PF16909,PF06650:PF12624:PF16910,24,35,22,2,13,981,0.63,0.99,0.92,0.75,18,14,10,4,990,0.78,0.99,0.58,0.67
PF12465,PF10584:PF00227:PF14953,3,88,3,0,85,930,0.03,0.92,1.0,0.18,32,2,1,30,985,0.06,0.97,0.67,0.2
PF00784,PF16735:PF00063:PF05902,24,75,15,9,60,934,0.2,0.93,0.62,0.33,5,3,21,2,992,0.6,0.98,0.12,0.27
PF16983,PF02219:PF10022:PF16401,4,15,0,4,15,999,0.0,0.98,0.0,-0.01,1,0,4,1,1013,0.0,1.0,0.0,-0.0
PF08119,PF12084:PF07700:PF06873,1,14,0,1,14,1003,0.0,0.99,0.0,-0.0,0,0,1,0,1017,0,1.0,0.0,0
PF14008,PF16656:PF02872:PF05011,26,41,22,4,19,973,0.54,0.98,0.85,0.66,8,7,19,1,991,0.88,0.98,0.27,0.48
PF02222,PF01259:PF00731:PF01729,8,25,6,2,19,991,0.24,0.98,0.75,0.42,5,2,6,3,1007,0.4,0.99,0.25,0.31
PF09109,PF12856:PF08453:PF09108,0,3,0,0,3,1015,0.0,1.0,0,0,0,0,0,0,1018,0,1.0,0,0
PF09786,PF10574:PF12016:PF00928,7,38,3,4,35,976,0.08,0.96,0.43,0.17,0,0,7,0,1011,0,0.99,0.0,0
PF13600,PF09727:PF07926:PF09762,2,14,0,2,14,1002,0.0,0.98,0.0,-0.01,3,0,2,3,1013,0.0,1.0,0.0,-0.0
PF14541,PF14543:PF04833:PF06414,27,35,23,4,12,979,0.66,0.98,0.85,0.74,5,4,23,1,990,0.8,0.98,0.15,0.34
PF12118,PF08808:PF02530:PF03592,1,1,0,1,1,1016,0.0,1.0,0.0,-0.0,0,0,1,0,1017,0,1.0,0.0,0
PF09831,PF00854:PF02705:PF00535,0,88,0,0,88,930,0.0,0.91,0,0,14,0,0,14,1004,0.0,0.99,0,0
PF06675,PF15633:PF05988:PF15775,0,2,0,0,2,1016,0.0,1.0,0,0,0,0,0,0,1018,0,1.0,0,0
PF02909,PF05043:PF12200:PF15163,3,8,3,0,5,1010,0.38,1.0,1.0,0.61,1,1,2,0,1015,1.0,1.0,0.33,0.58
PF02540,PF00977:PF04715:PF01177,22,30,7,15,23,973,0.23,0.96,0.32,0.25,4,3,19,1,995,0.75,0.98,0.14,0.31
PF11308,PF04320:PF07312:PF11529,0,1,0,0,1,1017,0.0,1.0,0,0,0,0,0,0,1018,0,1.0,0,0
PF00145,PF12047:PF02008:PF01426,28,47,19,9,28,962,0.4,0.96,0.68,0.51,15,12,16,3,987,0.8,0.98,0.43,0.58
PF03880,PF03461:PF07652:PF10927,5,8,2,3,6,1007,0.25,0.99,0.4,0.31,1,1,4,0,1013,1.0,1.0,0.2,0.45
PF16655,PF09423:PF14831:PF09029,3,17,3,0,14,1001,0.18,0.99,1.0,0.42,1,0,3,1,1014,0.0,1.0,0.0,-0.0
PF12657,PF09453:PF15787:PF12234,8,26,2,6,24,986,0.08,0.97,0.25,0.13,4,1,7,3,1007,0.25,0.99,0.12,0.17
PF10374,PF13638:PF10373:PF02091,8,27,8,0,19,991,0.3,0.98,1.0,0.54,5,3,5,2,1008,0.6,0.99,0.38,0.47
PF14962,PF14721:PF14759:PF16020,2,10,2,0,8,1008,0.2,0.99,1.0,0.45,2,2,0,0,1016,1.0,1.0,1.0,1.0
PF14931,PF15069:PF15551:PF03437,1,2,0,1,2,1015,0.0,1.0,0.0,-0.0,0,0,1,0,1017,0,1.0,0.0,0
PF07405,PF01913:PF15355:PF05939,0,1,0,0,1,1017,0.0,1.0,0,0,0,0,0,0,1018,0,1.0,0,0
PF00407,PF03032:PF07712:PF03030,7,14,4,3,10,1001,0.29,0.99,0.57,0.4,1,1,6,0,1011,1.0,0.99,0.14,0.38
PF03302,PF09132:PF04385:PF02057,4,4,0,4,4,1010,0.0,0.99,0.0,-0.0,0,0,4,0,1014,0,1.0,0.0,0
PF02301,PF05653:PF14719:PF12998,11,39,5,6,34,973,0.13,0.96,0.45,0.23,4,2,9,2,1005,0.5,0.99,0.18,0.3
PF09305,PF15397:PF15110:PF07392,0,7,0,0,7,1011,0.0,0.99,0,0,2,0,0,2,1016,0.0,1.0,0,0
PF13180,PF12812:PF00219:PF03572,32,23,10,22,13,973,0.43,0.97,0.31,0.35,2,2,30,0,986,1.0,0.97,0.06,0.25
PF13847,PF08241:PF00155:PF05175,39,155,23,16,132,847,0.15,0.85,0.59,0.24,42,16,23,26,953,0.38,0.95,0.41,0.37
PF00920,PF14027:PF04597:PF01730,20,25,8,12,17,981,0.32,0.97,0.4,0.34,3,1,19,2,996,0.33,0.98,0.05,0.12
PF03529,PF12284:PF12045:PF13293,2,1,1,1,0,1016,1.0,1.0,0.5,0.71,1,1,1,0,1016,1.0,1.0,0.5,0.71
PF08799,PF08145:PF08149:PF04494,13,17,4,9,13,992,0.24,0.98,0.31,0.26,3,2,11,1,1004,0.67,0.99,0.15,0.32
PF00528,PF08402:PF08352:PF13732,34,11,8,26,3,981,0.73,0.97,0.24,0.4,3,3,31,0,984,1.0,0.97,0.09,0.29
PF07562,PF01547:PF02608:PF00003,14,48,14,0,34,970,0.29,0.97,1.0,0.53,8,5,9,3,1001,0.62,0.99,0.36,0.47
PF15658,PF09500:PF00479:PF08015,0,15,0,0,15,1003,0.0,0.99,0,0,1,0,0,1,1017,0.0,1.0,0,0
PF03126,PF02201:PF08766:PF10360,16,42,11,5,31,971,0.26,0.96,0.69,0.41,19,8,8,11,991,0.42,0.98,0.5,0.45
PF02863,PF08021:PF06805:PF03831,2,0,0,2,0,1016,0,1.0,0.0,0,0,0,2,0,1016,0,1.0,0.0,0
PF16473,PF05202:PF15518:PF04612,1,2,0,1,2,1015,0.0,1.0,0.0,-0.0,0,0,1,0,1017,0,1.0,0.0,0
PF01656,PF05825:PF08656:PF01741,10,6,3,7,3,1005,0.5,0.99,0.3,0.38,0,0,10,0,1008,0,0.99,0.0,0
PF02889,PF14308:PF14237:PF11875,36,20,9,27,11,971,0.45,0.96,0.25,0.32,1,1,35,0,982,1.0,0.97,0.03,0.16
PF17053,PF17049:PF17010:PF15776,0,3,0,0,3,1015,0.0,1.0,0,0,0,0,0,0,1018,0,1.0,0,0
PF08270,PF13610:PF08751:PF09365,0,7,0,0,7,1011,0.0,0.99,0,0,0,0,0,0,1018,0,1.0,0,0
PF08566,PF09348:PF02575:PF12046,5,7,2,3,5,1008,0.29,0.99,0.4,0.33,0,0,5,0,1013,0,1.0,0.0,0
PF14547,PF14159:PF03168:PF04759,1,16,0,1,16,1001,0.0,0.98,0.0,-0.0,0,0,1,0,1017,0,1.0,0.0,0
PF01425,PF01328:PF00515:PF13813,66,69,22,44,47,905,0.32,0.91,0.33,0.28,13,10,56,3,949,0.77,0.94,0.15,0.33
PF01151,PF00048:PF01124:PF12643,11,25,6,5,19,988,0.24,0.98,0.55,0.35,2,2,9,0,1007,1.0,0.99,0.18,0.42
PF05216,PF06404:PF09778:PF00277,8,3,0,8,3,1007,0.0,0.99,0.0,-0.0,0,0,8,0,1010,0,0.99,0.0,0
PF02899,PF13356:PF09003:PF13276,6,10,2,4,8,1004,0.2,0.99,0.33,0.25,1,1,5,0,1012,1.0,1.0,0.17,0.41
PF01746,PF12298:PF11250:PF02234,18,15,3,15,12,988,0.2,0.97,0.17,0.17,1,0,18,1,999,0.0,0.98,0.0,-0.0
PF03102,PF08666:PF14918:PF16173,2,8,0,2,8,1008,0.0,0.99,0.0,-0.0,0,0,2,0,1016,0,1.0,0.0,0
PF12681,PF11124:PF15828:PF15224,0,2,0,0,2,1016,0.0,1.0,0,0,0,0,0,0,1018,0,1.0,0,0
PF12779,PF04984:PF05662:PF11492,0,4,0,0,4,1014,0.0,1.0,0,0,0,0,0,0,1018,0,1.0,0,0
PF04399,PF07987:PF03540:PF14497,2,42,1,1,41,975,0.02,0.96,0.5,0.1,2,1,1,1,1015,0.5,1.0,0.5,0.5
PF09451,PF06697:PF01670:PF08536,9,11,0,9,11,998,0.0,0.98,0.0,-0.01,1,0,9,1,1008,0.0,0.99,0.0,-0.0
PF04358,PF16205:PF03491:PF09358,0,22,0,0,22,996,0.0,0.98,0,0,4,0,0,4,1014,0.0,1.0,0,0
PF03223,PF01158:PF01875:PF03842,8,15,4,4,11,999,0.27,0.99,0.5,0.36,2,0,8,2,1008,0.0,0.99,0.0,-0.0
PF04828,PF02515:PF01738:PF03328,23,45,12,11,33,962,0.27,0.96,0.52,0.35,14,9,14,5,990,0.64,0.98,0.39,0.49
PF10480,PF03306:PF17084:PF04624,0,7,0,0,7,1011,0.0,0.99,0,0,0,0,0,0,1018,0,1.0,0,0
PF12707,PF12843:PF09951:PF05838,0,0,0,0,0,1018,0,1.0,0,0,0,0,0,0,1018,0,1.0,0,0
PF16872,PF02108:PF05164:PF13005,0,0,0,0,0,1018,0,1.0,0,0,0,0,0,0,1018,0,1.0,0,0
PF15123,PF07458:PF02202:PF15333,0,0,0,0,0,1018,0,1.0,0,0,0,0,0,0,1018,0,1.0,0,0
PF00672,PF00990:PF00015:PF08448,21,22,14,7,8,989,0.64,0.99,0.67,0.64,10,10,11,0,997,1.0,0.99,0.48,0.69
PF11995,PF13118:PF14739:PF13931,4,8,3,1,5,1009,0.38,0.99,0.75,0.53,3,3,1,0,1014,1.0,1.0,0.75,0.87
PF01464,PF13462:PF11303:PF06373,4,11,1,3,10,1004,0.09,0.99,0.25,0.15,0,0,4,0,1014,0,1.0,0.0,0
PF09735,PF10480:PF08158:PF17215,5,13,0,5,13,1000,0.0,0.98,0.0,-0.01,0,0,5,0,1013,0,1.0,0.0,0
PF16564,PF14048:PF01429:PF07574,7,35,7,0,28,983,0.2,0.97,1.0,0.44,8,2,5,6,1005,0.25,0.99,0.29,0.26
PF13205,PF07494:PF10566:PF06798,3,1,0,3,1,1014,0.0,1.0,0.0,-0.0,0,0,3,0,1015,0,1.0,0.0,0
PF11057,PF15212:PF15041:PF15356,0,1,0,0,1,1017,0.0,1.0,0,0,0,0,0,0,1018,0,1.0,0,0
PF12528,PF15938:PF00682:PF00129,0,24,0,0,24,994,0.0,0.98,0,0,5,0,0,5,1013,0.0,1.0,0,0
PF07425,PF08719:PF01872:PF08211,0,31,0,0,31,987,0.0,0.97,0,0,5,0,0,5,1013,0.0,1.0,0,0
PF12049,PF07223:PF10571:PF06420,0,2,0,0,2,1016,0.0,1.0,0,0,0,0,0,0,1018,0,1.0,0,0
PF05525,PF00240:PF08096:PF02182,1,91,0,1,91,926,0.0,0.91,0.0,-0.01,15,0,1,15,1002,0.0,0.98,0.0,-0.0
PF07909,PF05295:PF10630:PF15722,0,0,0,0,0,1018,0,1.0,0,0,0,0,0,0,1018,0,1.0,0,0
PF01722,PF04493:PF01652:PF01261,16,50,8,8,42,960,0.16,0.95,0.5,0.26,6,3,13,3,999,0.5,0.98,0.19,0.3
PF12061,PF05659:PF07725:PF00619,2,35,2,0,33,983,0.06,0.97,1.0,0.24,9,1,1,8,1008,0.11,0.99,0.5,0.23
PF06201,PF15928:PF07449:PF10961,18,7,1,17,6,994,0.14,0.98,0.06,0.08,0,0,18,0,1000,0,0.98,0.0,0
PF01674,PF00965:PF10853:PF04176,8,16,2,6,14,996,0.12,0.98,0.25,0.17,2,0,8,2,1008,0.0,0.99,0.0,-0.0
PF13640,PF08336:PF04406:PF01553,39,76,24,15,52,927,0.32,0.93,0.62,0.41,11,9,30,2,977,0.82,0.97,0.23,0.42
PF01204,PF07492:PF08583:PF04800,23,26,13,10,13,982,0.5,0.98,0.57,0.52,6,5,18,1,994,0.83,0.98,0.22,0.42
PF14672,PF15172:PF12046:PF00714,0,2,0,0,2,1016,0.0,1.0,0,0,0,0,0,0,1018,0,1.0,0,0
PF00290,PF14821:PF00585:PF00291,4,56,2,2,54,960,0.04,0.94,0.5,0.12,11,0,4,11,1003,0.0,0.99,0.0,-0.01
PF15233,PF11291:PF05685:PF08651,4,2,0,4,2,1012,0.0,0.99,0.0,-0.0,0,0,4,0,1014,0,1.0,0.0,0
PF01012,PF00766:PF00297:PF12260,21,33,13,8,20,977,0.39,0.97,0.62,0.48,3,3,18,0,997,1.0,0.98,0.14,0.37
PF16553,PF15898:PF09372:PF09310,1,3,1,0,2,1015,0.33,1.0,1.0,0.58,0,0,1,0,1017,0,1.0,0.0,0
PF09229,PF08327:PF13339:PF11710,18,38,16,2,22,978,0.42,0.98,0.89,0.6,6,4,14,2,998,0.67,0.98,0.22,0.38
PF14955,PF14935:PF14799:PF15013,5,8,0,5,8,1005,0.0,0.99,0.0,-0.01,1,0,5,1,1012,0.0,0.99,0.0,-0.0
PF09348,PF08576:PF12046:PF17032,1,3,0,1,3,1014,0.0,1.0,0.0,-0.0,0,0,1,0,1017,0,1.0,0.0,0
PF03144,PF08938:PF08100:PF04760,59,18,12,47,6,953,0.67,0.95,0.2,0.35,3,3,56,0,959,1.0,0.94,0.05,0.22
PF11916,PF13001:PF12755:PF12074,6,24,6,0,18,994,0.25,0.98,1.0,0.5,7,2,4,5,1007,0.29,0.99,0.33,0.3
PF11237,PF06412:PF05872:PF13254,0,2,0,0,2,1016,0.0,1.0,0,0,0,0,0,0,1018,0,1.0,0,0
PF00080,PF00403:PF01347:PF09172,19,43,9,10,34,965,0.21,0.96,0.47,0.3,14,6,13,8,991,0.43,0.98,0.32,0.36
PF12223,PF04148:PF05176:PF01774,1,10,0,1,10,1007,0.0,0.99,0.0,-0.0,4,0,1,4,1013,0.0,1.0,0.0,-0.0
PF07042,PF06433:PF08096:PF01949,0,3,0,0,3,1015,0.0,1.0,0,0,0,0,0,0,1018,0,1.0,0,0
PF12544,PF05707:PF17206:PF14328,0,1,0,0,1,1017,0.0,1.0,0,0,0,0,0,0,1018,0,1.0,0,0
PF06399,PF04279:PF01316:PF11111,1,4,1,0,3,1014,0.25,1.0,1.0,0.5,0,0,1,0,1017,0,1.0,0.0,0
PF00945,PF14534:PF08002:PF16001,4,1,1,3,0,1014,1.0,1.0,0.25,0.5,0,0,4,0,1014,0,1.0,0.0,0
PF06674,PF07377:PF05280:PF04986,3,5,3,0,2,1013,0.6,1.0,1.0,0.77,3,3,0,0,1015,1.0,1.0,1.0,1.0
PF13395,PF13635:PF03845:PF13390,0,8,0,0,8,1010,0.0,0.99,0,0,0,0,0,0,1018,0,1.0,0,0
PF15689,PF15690:PF15688:PF15687,0,0,0,0,0,1018,0,1.0,0,0,0,0,0,0,1018,0,1.0,0,0
PF09510,PF08795:PF11214:PF06724,0,0,0,0,0,1018,0,1.0,0,0,0,0,0,0,1018,0,1.0,0,0
PF14840,PF06144:PF01121:PF04390,3,17,3,0,14,1001,0.18,0.99,1.0,0.42,4,3,0,1,1014,0.75,1.0,1.0,0.87
PF02066,PF06892:PF00353:PF02607,0,5,0,0,5,1013,0.0,1.0,0,0,0,0,0,0,1018,0,1.0,0,0
PF11029,PF15071:PF15884:PF04736,2,4,1,1,3,1013,0.25,1.0,0.5,0.35,0,0,2,0,1016,0,1.0,0.0,0
PF10581,PF02078:PF02750:PF15805,0,4,0,0,4,1014,0.0,1.0,0,0,0,0,0,0,1018,0,1.0,0,0
PF05939,PF06805:PF03428:PF01913,0,1,0,0,1,1017,0.0,1.0,0,0,0,0,0,0,1018,0,1.0,0,0
PF12143,PF12142:PF14830:PF12326,2,6,2,0,4,1012,0.33,1.0,1.0,0.58,1,1,1,0,1016,1.0,1.0,0.5,0.71
PF07452,PF00093:PF00007:PF09206,1,29,1,0,28,989,0.03,0.97,1.0,0.18,7,1,0,6,1011,0.14,0.99,1.0,0.38
PF00135,PF08674:PF06884:PF11095,82,12,8,74,4,932,0.67,0.92,0.1,0.24,1,1,81,0,936,1.0,0.92,0.01,0.11
PF10300,PF13174:PF03661:PF13176,14,49,6,8,43,961,0.12,0.95,0.43,0.21,13,4,10,9,995,0.31,0.98,0.29,0.29
PF14487,PF10118:PF08437:PF07399,2,8,0,2,8,1008,0.0,0.99,0.0,-0.0,0,0,2,0,1016,0,1.0,0.0,0
PF10735,PF08262:PF10960:PF15440,0,3,0,0,3,1015,0.0,1.0,0,0,0,0,0,0,1018,0,1.0,0,0
PF11321,PF09585:PF06876:PF15169,2,1,0,2,1,1015,0.0,1.0,0.0,-0.0,0,0,2,0,1016,0,1.0,0.0,0
PF00123,PF16680:PF02189:PF11628,7,7,0,7,7,1004,0.0,0.99,0.0,-0.01,1,0,7,1,1010,0.0,0.99,0.0,-0.0
PF02244,PF00246:PF09759:PF00393,21,53,21,0,32,965,0.4,0.97,1.0,0.62,10,8,13,2,995,0.8,0.99,0.38,0.55
PF12896,PF12341:PF10313:PF12931,14,20,6,8,14,990,0.3,0.98,0.43,0.35,7,3,11,4,1000,0.43,0.99,0.21,0.3
PF06364,PF02952:PF16011:PF07021,2,4,0,2,4,1012,0.0,0.99,0.0,-0.0,0,0,2,0,1016,0,1.0,0.0,0
PF14076,PF04991:PF05154:PF07162,0,33,0,0,33,985,0.0,0.97,0,0,4,0,0,4,1014,0.0,1.0,0,0
PF15391,PF12628:PF06724:PF08744,1,0,0,1,0,1017,0,1.0,0.0,0,0,0,1,0,1017,0,1.0,0.0,0
PF09618,PF14982:PF07505:PF10514,1,0,0,1,0,1017,0,1.0,0.0,0,0,0,1,0,1017,0,1.0,0.0,0
PF12424,PF12409:PF16212:PF12515,9,53,4,5,49,960,0.08,0.95,0.44,0.17,8,3,6,5,1004,0.38,0.99,0.33,0.35
PF04788,PF03195:PF04107:PF14159,5,11,3,2,8,1005,0.27,0.99,0.6,0.4,2,1,4,1,1012,0.5,1.0,0.2,0.31
PF10455,PF10224:PF09424:PF02284,3,15,0,3,15,1000,0.0,0.98,0.0,-0.01,1,0,3,1,1014,0.0,1.0,0.0,-0.0
PF15011,PF10195:PF04930:PF14989,4,12,1,3,11,1003,0.08,0.99,0.25,0.14,0,0,4,0,1014,0,1.0,0.0,0
PF15260,PF06679:PF15475:PF05825,2,3,0,2,3,1013,0.0,1.0,0.0,-0.0,0,0,2,0,1016,0,1.0,0.0,0
PF11967,PF01514:PF01752:PF16449,0,2,0,0,2,1016,0.0,1.0,0,0,0,0,0,0,1018,0,1.0,0,0
PF07045,PF06890:PF08707:PF06651,1,1,0,1,1,1016,0.0,1.0,0.0,-0.0,0,0,1,0,1017,0,1.0,0.0,0
PF06772,PF12224:PF08589:PF03576,7,13,0,7,13,998,0.0,0.98,0.0,-0.01,0,0,7,0,1011,0,0.99,0.0,0
PF06632,PF03652:PF01279:PF00214,3,7,2,1,5,1010,0.29,0.99,0.67,0.43,1,0,3,1,1014,0.0,1.0,0.0,-0.0
PF00215,PF04275:PF13793:PF00156,26,44,16,10,28,964,0.36,0.96,0.62,0.46,18,7,19,11,981,0.39,0.97,0.27,0.31
PF13503,PF09287:PF15773:PF01339,0,7,0,0,7,1011,0.0,0.99,0,0,0,0,0,0,1018,0,1.0,0,0
PF10042,PF00038:PF08757:PF00932,2,26,0,2,26,990,0.0,0.97,0.0,-0.01,6,0,2,6,1010,0.0,0.99,0.0,-0.0
PF02881,PF00448:PF02978:PF04086,31,39,30,1,9,978,0.77,0.99,0.97,0.86,32,27,4,5,982,0.84,0.99,0.87,0.85
PF03392,PF08122:PF00965:PF06083,2,13,0,2,13,1003,0.0,0.99,0.0,-0.01,0,0,2,0,1016,0,1.0,0.0,0
PF17105,PF12157:PF12064:PF17035,4,19,3,1,16,998,0.16,0.98,0.75,0.34,4,3,1,1,1013,0.75,1.0,0.75,0.75
PF01717,PF08267:PF14577:PF01808,14,17,4,10,13,991,0.24,0.98,0.29,0.25,1,1,13,0,1004,1.0,0.99,0.07,0.27
PF03913,PF13629:PF03739:PF09493,0,5,0,0,5,1013,0.0,1.0,0,0,1,0,0,1,1017,0.0,1.0,0,0
PF00551,PF02911:PF00586:PF01071,24,27,14,10,13,981,0.52,0.98,0.58,0.54,10,8,16,2,992,0.8,0.98,0.33,0.51
PF03467,PF04098:PF16131:PF04146,11,40,7,4,33,974,0.17,0.96,0.64,0.32,9,5,6,4,1003,0.56,0.99,0.45,0.5
PF04277,PF15214:PF15272:PF15325,2,3,0,2,3,1013,0.0,1.0,0.0,-0.0,0,0,2,0,1016,0,1.0,0.0,0
PF09445,PF12237:PF00397:PF00639,11,89,8,3,81,926,0.09,0.92,0.73,0.24,11,2,9,9,998,0.18,0.98,0.18,0.17
PF03508,PF03509:PF16791:PF00029,0,8,0,0,8,1010,0.0,0.99,0,0,0,0,0,0,1018,0,1.0,0,0
PF03968,PF05853:PF17051:PF08945,1,1,0,1,1,1016,0.0,1.0,0.0,-0.0,0,0,1,0,1017,0,1.0,0.0,0
PF02836,PF02837:PF02929:PF16353,18,16,12,6,4,996,0.75,0.99,0.67,0.7,5,5,13,0,1000,1.0,0.99,0.28,0.52
PF16561,PF04739:PF14671:PF09192,21,11,9,12,2,995,0.82,0.99,0.43,0.59,2,2,19,0,997,1.0,0.98,0.1,0.31
PF16575,PF06807:PF16573:PF10179,21,13,10,11,3,994,0.77,0.99,0.48,0.6,8,8,13,0,997,1.0,0.99,0.38,0.61
PF02958,PF07914:PF06477:PF02995,29,25,11,18,14,975,0.44,0.97,0.38,0.39,2,1,28,1,988,0.5,0.97,0.03,0.13
PF12431,PF01339:PF12532:PF02645,0,7,0,0,7,1011,0.0,0.99,0,0,0,0,0,0,1018,0,1.0,0,0
PF07238,PF06761:PF02951:PF13700,1,4,0,1,4,1013,0.0,1.0,0.0,-0.0,1,0,1,1,1016,0.0,1.0,0.0,-0.0
PF10694,PF07399:PF04260:PF07706,3,6,1,2,5,1010,0.17,0.99,0.33,0.23,1,1,2,0,1015,1.0,1.0,0.33,0.58
PF01300,PF01184:PF12867:PF02487,17,34,9,8,25,976,0.26,0.97,0.53,0.36,4,2,15,2,999,0.5,0.98,0.12,0.24
PF17121,PF14824:PF13241:PF14823,4,10,0,4,10,1004,0.0,0.99,0.0,-0.01,10,0,4,10,1004,0.0,0.99,0.0,-0.01
PF14880,PF15055:PF14986:PF02950,5,1,0,5,1,1012,0.0,0.99,0.0,-0.0,0,0,5,0,1013,0,1.0,0.0,0
PF13093,PF08228:PF08656:PF13933,1,5,0,1,5,1012,0.0,0.99,0.0,-0.0,0,0,1,0,1017,0,1.0,0.0,0
PF09180,PF00458:PF03950:PF03129,8,55,8,0,47,963,0.15,0.95,1.0,0.37,18,6,2,12,998,0.33,0.99,0.75,0.49
PF00810,PF02284:PF05995:PF05047,13,21,5,8,16,989,0.24,0.98,0.38,0.29,4,2,11,2,1003,0.5,0.99,0.15,0.27
PF11375,PF04567:PF00787:PF00333,0,88,0,0,88,930,0.0,0.91,0,0,18,0,0,18,1000,0.0,0.98,0,0
PF06247,PF14911:PF12350:PF12853,0,9,0,0,9,1009,0.0,0.99,0,0,0,0,0,0,1018,0,1.0,0,0
PF10890,PF10459:PF15976:PF08453,1,4,0,1,4,1013,0.0,1.0,0.0,-0.0,0,0,1,0,1017,0,1.0,0.0,0
PF04636,PF05428:PF01153:PF15010,8,14,2,6,12,998,0.14,0.98,0.25,0.18,0,0,8,0,1010,0,0.99,0.0,0
PF12764,PF13876:PF07494:PF13721,5,5,0,5,5,1008,0.0,0.99,0.0,-0.0,0,0,5,0,1013,0,1.0,0.0,0
PF04994,PF05229:PF06505:PF11751,0,0,0,0,0,1018,0,1.0,0,0,0,0,0,0,1018,0,1.0,0,0
PF00518,PF16886:PF07497:PF00995,1,38,1,0,37,980,0.03,0.96,1.0,0.16,11,1,0,10,1007,0.09,0.99,1.0,0.3
PF06799,PF09597:PF06376:PF00321,3,3,2,1,1,1014,0.67,1.0,0.67,0.67,0,0,3,0,1015,0,1.0,0.0,0
PF00852,PF17039:PF01066:PF05277,23,52,15,8,37,958,0.29,0.96,0.65,0.42,12,11,12,1,994,0.92,0.99,0.48,0.66
PF03170,PF07243:PF13094:PF15333,1,1,0,1,1,1016,0.0,1.0,0.0,-0.0,0,0,1,0,1017,0,1.0,0.0,0
PF10257,PF14611:PF05041:PF11977,11,20,3,8,17,990,0.15,0.98,0.27,0.19,2,0,11,2,1005,0.0,0.99,0.0,-0.0
PF15770,PF15334:PF15760:PF15680,0,0,0,0,0,1018,0,1.0,0,0,0,0,0,0,1018,0,1.0,0,0
PF15292,PF15090:PF15309:PF15232,0,4,0,0,4,1014,0.0,1.0,0,0,0,0,0,0,1018,0,1.0,0,0
PF10254,PF15499:PF14636:PF15999,4,12,0,4,12,1002,0.0,0.98,0.0,-0.01,2,0,4,2,1012,0.0,0.99,0.0,-0.0
PF06045,PF14683:PF14686:PF09284,3,17,3,0,14,1001,0.18,0.99,1.0,0.42,15,3,0,12,1003,0.2,0.99,1.0,0.44
PF15943,PF00967:PF04237:PF03345,0,15,0,0,15,1003,0.0,0.99,0,0,1,0,0,1,1017,0.0,1.0,0,0
PF03371,PF04000:PF13339:PF11891,14,29,9,5,20,984,0.31,0.98,0.64,0.44,7,6,8,1,1003,0.86,0.99,0.43,0.6
PF01384,PF01597:PF05995:PF02284,16,32,4,12,28,974,0.12,0.96,0.25,0.16,5,2,14,3,999,0.4,0.98,0.12,0.22
PF00311,PF04802:PF01159:PF02946,6,28,3,3,25,987,0.11,0.97,0.5,0.22,3,1,5,2,1010,0.33,0.99,0.17,0.23
PF10938,PF06185:PF01518:PF14057,0,2,0,0,2,1016,0.0,1.0,0,0,0,0,0,0,1018,0,1.0,0,0
PF15144,PF17075:PF06160:PF13286,0,6,0,0,6,1012,0.0,0.99,0,0,0,0,0,0,1018,0,1.0,0,0
PF02460,PF16414:PF12349:PF03176,44,38,26,18,12,962,0.68,0.97,0.59,0.62,11,10,34,1,973,0.91,0.97,0.23,0.45
PF03643,PF09751:PF16969:PF04418,13,19,5,8,14,991,0.26,0.98,0.38,0.31,3,2,11,1,1004,0.67,0.99,0.15,0.32
PF03399,PF16769:PF16768:PF16766,23,2,2,21,0,995,1.0,0.98,0.09,0.29,1,1,22,0,995,1.0,0.98,0.04,0.21
PF13862,PF16053:PF09419:PF00902,6,26,2,4,24,988,0.08,0.97,0.33,0.15,2,0,6,2,1010,0.0,0.99,0.0,-0.0
PF08252,PF06508:PF06418:PF00697,0,26,0,0,26,992,0.0,0.97,0,0,1,0,0,1,1017,0.0,1.0,0,0
PF07759,PF00040:PF03669:PF10867,0,26,0,0,26,992,0.0,0.97,0,0,1,0,0,1,1017,0.0,1.0,0,0
PF06073,PF16859:PF09937:PF09707,0,0,0,0,0,1018,0,1.0,0,0,0,0,0,0,1018,0,1.0,0,0
PF04891,PF02217:PF14344:PF02557,1,5,0,1,5,1012,0.0,0.99,0.0,-0.0,0,0,1,0,1017,0,1.0,0.0,0
PF17157,PF16931:PF15039:PF02122,0,1,0,0,1,1017,0.0,1.0,0,0,0,0,0,0,1018,0,1.0,0,0
PF06838,PF02534:PF11759:PF17085,1,7,0,1,7,1010,0.0,0.99,0.0,-0.0,0,0,1,0,1017,0,1.0,0.0,0
PF02416,PF09419:PF11264:PF00236,9,13,3,6,10,999,0.23,0.98,0.33,0.27,0,0,9,0,1009,0,0.99,0.0,0
PF07647,PF00536:PF12485:PF16533,41,62,27,14,35,942,0.44,0.95,0.66,0.51,2,2,39,0,977,1.0,0.96,0.05,0.22
PF15353,PF04087:PF05178:PF15999,5,11,1,4,10,1003,0.09,0.99,0.2,0.13,0,0,5,0,1013,0,1.0,0.0,0
PF14762,PF14763:PF14761:PF09303,0,4,0,0,4,1014,0.0,1.0,0,0,0,0,0,0,1018,0,1.0,0,0
PF11416,PF09177:PF00804:PF02269,5,36,3,2,33,980,0.08,0.97,0.6,0.21,8,2,3,6,1007,0.25,0.99,0.4,0.31
PF00169,PF00620:PF00130:PF01237,137,127,79,58,48,833,0.62,0.9,0.58,0.54,46,40,97,6,875,0.87,0.9,0.29,0.47
PF12110,PF04096:PF13634:PF14636,15,26,13,2,13,990,0.5,0.99,0.87,0.65,9,6,9,3,1000,0.67,0.99,0.4,0.51
PF13145,PF17193:PF08404:PF09614,7,0,0,7,0,1011,0,0.99,0.0,0,0,0,7,0,1011,0,0.99,0.0,0
PF15009,PF14954:PF15260:PF12020,1,4,0,1,4,1013,0.0,1.0,0.0,-0.0,0,0,1,0,1017,0,1.0,0.0,0
PF06101,PF12624:PF06650:PF16910,13,35,4,9,31,974,0.11,0.96,0.31,0.17,18,2,11,16,989,0.11,0.97,0.15,0.12
PF00594,PF12032:PF09272:PF16030,8,19,2,6,17,993,0.11,0.98,0.25,0.15,1,1,7,0,1010,1.0,0.99,0.12,0.35
PF06677,PF10234:PF09789:PF05346,3,20,1,2,19,996,0.05,0.98,0.33,0.12,1,1,2,0,1015,1.0,1.0,0.33,0.58
PF06123,PF02014:PF00271:PF04969,0,246,0,0,246,772,0.0,0.76,0,0,42,0,0,42,976,0.0,0.96,0,0
PF11027,PF14865:PF15480:PF10974,2,1,0,2,1,1015,0.0,1.0,0.0,-0.0,0,0,2,0,1016,0,1.0,0.0,0
PF06920,PF14429:PF11878:PF16172,13,14,6,7,8,997,0.43,0.99,0.46,0.44,8,6,7,2,1003,0.75,0.99,0.46,0.58
PF13859,PF16692:PF10699:PF12928,0,14,0,0,14,1004,0.0,0.99,0,0,0,0,0,0,1018,0,1.0,0,0
PF15034,PF08501:PF01487:PF01488,0,26,0,0,26,992,0.0,0.97,0,0,15,0,0,15,1003,0.0,0.99,0,0
PF00517,PF12600:PF15073:PF04428,5,4,0,5,4,1009,0.0,0.99,0.0,-0.0,0,0,5,0,1013,0,1.0,0.0,0
PF09996,PF15055:PF02202:PF17062,0,0,0,0,0,1018,0,1.0,0,0,0,0,0,0,1018,0,1.0,0,0
PF06657,PF10155:PF16545:PF03315,6,14,1,5,13,999,0.07,0.98,0.17,0.1,3,1,5,2,1010,0.33,0.99,0.17,0.23
PF00112,PF08246:PF08773:PF12131,60,35,32,28,3,955,0.91,0.97,0.53,0.69,2,2,58,0,958,1.0,0.94,0.03,0.18
PF11598,PF01414:PF00129:PF13344,2,33,2,0,31,985,0.06,0.97,1.0,0.24,7,2,0,5,1011,0.29,1.0,1.0,0.53
PF10755,PF15085:PF15097:PF15186,0,4,0,0,4,1014,0.0,1.0,0,0,0,0,0,0,1018,0,1.0,0,0
PF04910,PF15929:PF09816:PF15279,8,6,3,5,3,1007,0.5,0.99,0.38,0.43,0,0,8,0,1010,0,0.99,0.0,0
PF06403,PF11751:PF15128:PF07157,1,0,0,1,0,1017,0,1.0,0.0,0,0,0,1,0,1017,0,1.0,0.0,0
PF15755,PF15046:PF15175:PF08945,2,3,0,2,3,1013,0.0,1.0,0.0,-0.0,0,0,2,0,1016,0,1.0,0.0,0
PF11985,PF02050:PF07916:PF09432,0,0,0,0,0,1018,0,1.0,0,0,0,0,0,0,1018,0,1.0,0,0
PF01262,PF12769:PF02233:PF05222,11,18,9,2,9,998,0.5,0.99,0.82,0.63,7,7,4,0,1007,1.0,1.0,0.64,0.8
PF15134,PF15036:PF14865:PF11771,1,1,0,1,1,1016,0.0,1.0,0.0,-0.0,0,0,1,0,1017,0,1.0,0.0,0
PF06995,PF12080:PF08497:PF07195,0,0,0,0,0,1018,0,1.0,0,0,0,0,0,0,1018,0,1.0,0,0
PF01540,PF00201:PF12819:PF11721,0,78,0,0,78,940,0.0,0.92,0,0,16,0,0,16,1002,0.0,0.98,0,0
PF14692,PF12782:PF15622:PF15362,0,1,0,0,1,1017,0.0,1.0,0,0,0,0,0,0,1018,0,1.0,0,0
PF02511,PF15763:PF12194:PF15848,2,1,0,2,1,1015,0.0,1.0,0.0,-0.0,0,0,2,0,1016,0,1.0,0.0,0
PF06897,PF15281:PF10412:PF15141,0,3,0,0,3,1015,0.0,1.0,0,0,0,0,0,0,1018,0,1.0,0,0
PF16294,PF14443:PF10172:PF01465,5,22,3,2,19,994,0.14,0.98,0.6,0.28,1,0,5,1,1012,0.0,0.99,0.0,-0.0
PF02383,PF08952:PF03372:PF12456,35,69,22,13,47,936,0.32,0.94,0.63,0.42,9,8,27,1,982,0.89,0.97,0.23,0.44
PF09696,PF10244:PF05039:PF15370,9,10,4,5,6,1003,0.4,0.99,0.44,0.42,1,0,9,1,1008,0.0,0.99,0.0,-0.0
PF12855,PF07051:PF06989:PF08653,2,2,0,2,2,1014,0.0,1.0,0.0,-0.0,0,0,2,0,1016,0,1.0,0.0,0
PF00909,PF03595:PF13023:PF02133,29,43,10,19,33,956,0.23,0.95,0.34,0.26,8,6,23,2,987,0.75,0.98,0.21,0.39
PF03261,PF14735:PF05428:PF11703,4,5,1,3,4,1010,0.2,0.99,0.25,0.22,0,0,4,0,1014,0,1.0,0.0,0
PF05254,PF09748:PF05512:PF03386,8,15,2,6,13,997,0.13,0.98,0.25,0.17,2,0,8,2,1008,0.0,0.99,0.0,-0.0
PF01588,PF16714:PF00579:PF06644,28,46,13,15,33,957,0.28,0.95,0.46,0.34,8,8,20,0,990,1.0,0.98,0.29,0.53
PF03865,PF13722:PF10554:PF06826,0,1,0,0,1,1017,0.0,1.0,0,0,0,0,0,0,1018,0,1.0,0,0
PF05741,PF07939:PF15247:PF02234,8,15,3,5,12,998,0.2,0.98,0.38,0.27,2,2,6,0,1010,1.0,0.99,0.25,0.5
PF00581,PF06617:PF00566:PF12368,53,87,31,22,56,909,0.36,0.92,0.58,0.42,5,5,48,0,965,1.0,0.95,0.09,0.3
PF15287,PF14049:PF14047:PF15779,4,4,1,3,3,1011,0.25,0.99,0.25,0.25,0,0,4,0,1014,0,1.0,0.0,0
PF12053,PF09045:PF15737:PF13945,4,3,1,3,2,1012,0.33,1.0,0.25,0.29,1,1,3,0,1014,1.0,1.0,0.25,0.5
PF09456,PF06761:PF08334:PF04466,3,1,0,3,1,1014,0.0,1.0,0.0,-0.0,0,0,3,0,1015,0,1.0,0.0,0
PF05233,PF07879:PF15546:PF17192,1,1,1,0,0,1017,1.0,1.0,1.0,1.0,1,1,0,0,1017,1.0,1.0,1.0,1.0
PF06032,PF05378:PF02538:PF01968,8,28,8,0,20,990,0.29,0.98,1.0,0.53,28,8,0,20,990,0.29,0.98,1.0,0.53
PF07766,PF01985:PF13863:PF09730,15,19,6,9,13,990,0.32,0.98,0.4,0.34,2,2,13,0,1003,1.0,0.99,0.13,0.36
PF03616,PF08497:PF02465:PF11245,1,0,0,1,0,1017,0,1.0,0.0,0,0,0,1,0,1017,0,1.0,0.0,0
PF08395,PF06151:PF05680:PF06477,25,16,6,19,10,983,0.38,0.97,0.24,0.29,0,0,25,0,993,0,0.98,0.0,0
PF08100,PF00891:PF16864:PF02545,7,41,7,0,34,977,0.17,0.97,1.0,0.41,17,2,5,15,996,0.12,0.98,0.29,0.17
PF09047,PF15232:PF15392:PF08101,1,1,1,0,0,1017,1.0,1.0,1.0,1.0,0,0,1,0,1017,0,1.0,0.0,0
PF00306,PF01333:PF03118:PF07850,12,20,3,9,17,989,0.15,0.97,0.25,0.18,3,1,11,2,1004,0.33,0.99,0.08,0.16
PF02059,PF10343:PF10626:PF03082,2,15,0,2,15,1001,0.0,0.98,0.0,-0.01,0,0,2,0,1016,0,1.0,0.0,0
PF01988,PF01386:PF10342:PF00677,18,19,3,15,16,984,0.16,0.97,0.17,0.15,0,0,18,0,1000,0,0.98,0.0,0
PF07435,PF09648:PF10554:PF13876,0,1,0,0,1,1017,0.0,1.0,0,0,0,0,0,0,1018,0,1.0,0,0
PF06918,PF16034:PF04423:PF08912,2,11,0,2,11,1005,0.0,0.99,0.0,-0.0,2,0,2,2,1014,0.0,1.0,0.0,-0.0
PF04646,PF06830:PF04833:PF01458,7,4,2,5,2,1009,0.5,0.99,0.29,0.37,0,0,7,0,1011,0,0.99,0.0,0
PF16050,PF05179:PF03269:PF14642,8,6,5,3,1,1009,0.83,1.0,0.62,0.72,0,0,8,0,1010,0,0.99,0.0,0
PF07709,PF17085:PF14231:PF02740,1,1,0,1,1,1016,0.0,1.0,0.0,-0.0,0,0,1,0,1017,0,1.0,0.0,0
PF08766,PF02229:PF03126:PF02201,32,38,20,12,18,968,0.53,0.97,0.62,0.56,15,9,23,6,980,0.6,0.97,0.28,0.4
PF14976,PF07021:PF02503:PF15770,2,2,0,2,2,1014,0.0,1.0,0.0,-0.0,1,0,2,1,1015,0.0,1.0,0.0,-0.0
PF03743,PF05939:PF08744:PF04740,7,0,0,7,0,1011,0,0.99,0.0,0,0,0,7,0,1011,0,0.99,0.0,0
PF05303,PF15044:PF13236:PF12807,4,14,3,1,11,1003,0.21,0.99,0.75,0.4,6,3,1,3,1011,0.5,1.0,0.75,0.61
PF07812,PF08454:PF16558:PF02825,0,38,0,0,38,980,0.0,0.96,0,0,8,0,0,8,1010,0.0,0.99,0,0
PF08606,PF04158:PF16699:PF08145,19,13,6,13,7,992,0.46,0.98,0.32,0.37,1,1,18,0,999,1.0,0.98,0.05,0.23
PF05712,PF01853:PF08169:PF08474,22,35,6,16,29,967,0.17,0.96,0.27,0.19,5,3,19,2,994,0.6,0.98,0.14,0.28
PF07963,PF00482:PF02501:PF03934,2,2,2,0,0,1016,1.0,1.0,1.0,1.0,2,2,0,0,1016,1.0,1.0,1.0,1.0
PF07344,PF03242:PF05512:PF09748,0,15,0,0,15,1003,0.0,0.99,0,0,2,0,0,2,1016,0.0,1.0,0,0
PF02019,PF06760:PF08917:PF14786,4,4,2,2,2,1012,0.5,1.0,0.5,0.5,2,2,2,0,1014,1.0,1.0,0.5,0.71
PF01113,PF05173:PF03986:PF10381,8,15,5,3,10,1000,0.33,0.99,0.62,0.45,9,0,8,9,1001,0.0,0.98,0.0,-0.01
PF11422,PF14607:PF11614:PF04122,0,4,0,0,4,1014,0.0,1.0,0,0,0,0,0,0,1018,0,1.0,0,0
PF16988,PF04157:PF11605:PF02040,3,19,3,0,16,999,0.16,0.98,1.0,0.39,5,3,0,2,1013,0.6,1.0,1.0,0.77
PF05222,PF12769:PF02233:PF04455,18,10,8,10,2,998,0.8,0.99,0.44,0.59,6,6,12,0,1000,1.0,0.99,0.33,0.57
PF14702,PF06202:PF14701:PF14699,2,4,2,0,2,1014,0.5,1.0,1.0,0.71,2,2,0,0,1016,1.0,1.0,1.0,1.0
PF04888,PF09688:PF06764:PF02427,0,0,0,0,0,1018,0,1.0,0,0,0,0,0,0,1018,0,1.0,0,0
PF04588,PF01896:PF09793:PF10280,13,18,4,9,14,991,0.22,0.98,0.31,0.25,3,2,11,1,1004,0.67,0.99,0.15,0.32
PF08279,PF02912:PF03147:PF13280,10,21,5,5,16,992,0.24,0.98,0.5,0.34,5,4,6,1,1007,0.8,0.99,0.4,0.56
PF06025,PF06012:PF12057:PF10427,9,8,5,4,3,1006,0.62,0.99,0.56,0.59,2,1,8,1,1008,0.5,0.99,0.11,0.23
PF08621,PF12830:PF15275:PF10363,5,15,1,4,14,999,0.07,0.98,0.2,0.11,1,1,4,0,1013,1.0,1.0,0.2,0.45
PF05768,PF01796:PF06315:PF02464,7,15,3,4,12,999,0.2,0.98,0.43,0.29,1,1,6,0,1011,1.0,0.99,0.14,0.38
PF08242,PF00109:PF14765:PF08659,37,64,28,9,36,945,0.44,0.96,0.76,0.56,44,26,11,18,963,0.59,0.97,0.7,0.63
PF11548,PF14948:PF09414:PF00102,4,56,4,0,52,962,0.07,0.95,1.0,0.26,7,3,1,4,1010,0.43,1.0,0.75,0.56
PF08108,PF04825:PF08416:PF16742,0,26,0,0,26,992,0.0,0.97,0,0,3,0,0,3,1015,0.0,1.0,0,0
PF09428,PF09962:PF03745:PF05448,1,3,0,1,3,1014,0.0,1.0,0.0,-0.0,0,0,1,0,1017,0,1.0,0.0,0
PF03612,PF03829:PF03608:PF00455,2,3,2,0,1,1015,0.67,1.0,1.0,0.82,2,2,0,0,1016,1.0,1.0,1.0,1.0
PF15180,PF17062:PF17015:PF10664,3,1,0,3,1,1014,0.0,1.0,0.0,-0.0,0,0,3,0,1015,0,1.0,0.0,0
PF06452,PF08792:PF12658:PF15211,10,1,0,10,1,1007,0.0,0.99,0.0,-0.0,0,0,10,0,1008,0,0.99,0.0,0
PF13610,PF11751:PF09432:PF07505,1,0,0,1,0,1017,0,1.0,0.0,0,0,0,1,0,1017,0,1.0,0.0,0
PF07476,PF13007:PF08299:PF06890,0,2,0,0,2,1016,0.0,1.0,0,0,0,0,0,0,1018,0,1.0,0,0
PF13570,PF13360:PF01011:PF07774,7,29,4,3,25,986,0.14,0.97,0.57,0.27,18,4,3,14,997,0.22,0.98,0.57,0.35
PF08919,PF09027:PF15303:PF08416,10,13,3,7,10,998,0.23,0.98,0.3,0.25,2,1,9,1,1007,0.5,0.99,0.1,0.22
PF14518,PF08297:PF08674:PF15280,3,3,1,2,2,1013,0.33,1.0,0.33,0.33,0,0,3,0,1015,0,1.0,0.0,0
PF11862,PF14258:PF06798:PF03241,1,0,0,1,0,1017,0,1.0,0.0,0,0,0,1,0,1017,0,1.0,0.0,0
PF13742,PF11751:PF03090:PF03241,2,0,0,2,0,1016,0,1.0,0.0,0,0,0,2,0,1016,0,1.0,0.0,0
PF03888,PF17188:PF11874:PF08497,0,0,0,0,0,1018,0,1.0,0,0,0,0,0,0,1018,0,1.0,0,0
PF03409,PF10325:PF02118:PF14747,2,7,1,1,6,1010,0.14,0.99,0.5,0.26,0,0,2,0,1016,0,1.0,0.0,0
PF15620,PF15622:PF15058:PF10198,0,7,0,0,7,1011,0.0,0.99,0,0,1,0,0,1,1017,0.0,1.0,0,0
PF03819,PF15809:PF00770:PF08040,1,2,0,1,2,1015,0.0,1.0,0.0,-0.0,0,0,1,0,1017,0,1.0,0.0,0
PF01121,PF01467:PF07072:PF13656,14,42,10,4,32,972,0.24,0.96,0.71,0.4,11,8,6,3,1001,0.73,0.99,0.57,0.64
PF03791,PF03790:PF12737:PF16493,3,1,1,2,0,1015,1.0,1.0,0.33,0.58,1,1,2,0,1015,1.0,1.0,0.33,0.58
PF07743,PF09350:PF09320:PF00684,17,16,3,14,13,988,0.19,0.97,0.18,0.17,1,0,17,1,1000,0.0,0.98,0.0,-0.0
PF09294,PF07140:PF01108:PF01733,2,18,1,1,17,999,0.06,0.98,0.5,0.16,2,1,1,1,1015,0.5,1.0,0.5,0.5
PF03464,PF03463:PF03465:PF04927,8,11,8,0,3,1007,0.73,1.0,1.0,0.85,8,8,0,0,1010,1.0,1.0,1.0,1.0
PF09394,PF08857:PF08843:PF10868,0,0,0,0,0,1018,0,1.0,0,0,0,0,0,0,1018,0,1.0,0,0
PF04111,PF15285:PF07800:PF04422,12,5,0,12,5,1001,0.0,0.98,0.0,-0.01,0,0,12,0,1006,0,0.99,0.0,0
PF08059,PF02099:PF11470:PF04000,10,26,5,5,21,987,0.19,0.97,0.5,0.3,4,3,7,1,1007,0.75,0.99,0.3,0.47
PF02689,PF05970:PF13538:PF14214,7,48,7,0,41,970,0.15,0.96,1.0,0.37,18,6,1,12,999,0.33,0.99,0.86,0.53
PF03849,PF00793:PF00797:PF12239,11,30,2,9,28,979,0.07,0.96,0.18,0.09,4,1,10,3,1004,0.25,0.99,0.09,0.15
PF03403,PF07470:PF10503:PF00457,21,26,5,16,21,976,0.19,0.96,0.24,0.2,6,1,20,5,992,0.17,0.98,0.05,0.08
PF03141,PF05097:PF04646:PF14547,20,13,5,15,8,990,0.38,0.98,0.25,0.3,0,0,20,0,998,0,0.98,0.0,0
PF15745,PF15053:PF07464:PF15475,3,4,1,2,3,1012,0.25,1.0,0.33,0.29,0,0,3,0,1015,0,1.0,0.0,0
PF02800,PF00044:PF02672:PF00121,28,35,21,7,14,976,0.6,0.98,0.75,0.66,8,7,21,1,989,0.88,0.98,0.25,0.46
PF01033,PF09412:PF00629:PF01663,18,63,16,2,47,953,0.25,0.95,0.89,0.46,16,7,11,9,991,0.44,0.98,0.39,0.4
PF01210,PF07479:PF03023:PF02317,27,34,26,1,8,983,0.76,0.99,0.96,0.85,7,6,21,1,990,0.86,0.98,0.22,0.43
PF07195,PF08274:PF08345:PF02465,0,1,0,0,1,1017,0.0,1.0,0,0,0,0,0,0,1018,0,1.0,0,0
PF04699,PF03152:PF16558:PF06730,5,25,2,3,23,990,0.08,0.97,0.4,0.17,3,1,4,2,1011,0.33,0.99,0.2,0.26
PF10982,PF06995:PF06934:PF02119,1,2,0,1,2,1015,0.0,1.0,0.0,-0.0,0,0,1,0,1017,0,1.0,0.0,0
PF13775,PF09667:PF12336:PF12067,1,4,0,1,4,1013,0.0,1.0,0.0,-0.0,0,0,1,0,1017,0,1.0,0.0,0
PF06942,PF15434:PF11873:PF03244,0,1,0,0,1,1017,0.0,1.0,0,0,0,0,0,0,1018,0,1.0,0,0
PF01209,PF01294:PF06825:PF04690,10,10,1,9,9,999,0.1,0.98,0.1,0.09,1,0,10,1,1007,0.0,0.99,0.0,-0.0
PF11768,PF15279:PF14646:PF15396,0,8,0,0,8,1010,0.0,0.99,0,0,1,0,0,1,1017,0.0,1.0,0,0
PF08614,PF14077:PF13925:PF12265,6,13,3,3,10,1002,0.23,0.99,0.5,0.33,3,2,4,1,1011,0.67,1.0,0.33,0.47
PF09984,PF05272:PF12729:PF14690,2,1,1,1,0,1016,1.0,1.0,0.5,0.71,0,0,2,0,1016,0,1.0,0.0,0
PF13677,PF13205:PF01914:PF10566,0,3,0,0,3,1015,0.0,1.0,0,0,0,0,0,0,1018,0,1.0,0,0
PF02676,PF15679:PF10102:PF02475,10,24,7,3,17,991,0.29,0.98,0.7,0.44,1,1,9,0,1008,1.0,0.99,0.1,0.31
PF00130,PF00609:PF00017:PF00169,60,175,43,17,132,826,0.25,0.85,0.72,0.36,44,30,30,14,944,0.68,0.96,0.5,0.56
PF09986,PF05124:PF11392:PF06103,0,0,0,0,0,1018,0,1.0,0,0,0,0,0,0,1018,0,1.0,0,0
PF07496,PF00628:PF10513:PF05964,20,104,17,3,87,911,0.16,0.91,0.85,0.35,29,9,11,20,978,0.31,0.97,0.45,0.36
PF01458,PF06830:PF12579:PF07786,2,5,1,1,4,1012,0.2,1.0,0.5,0.31,0,0,2,0,1016,0,1.0,0.0,0
PF06347,PF10951:PF11039:PF08308,5,0,0,5,0,1013,0,1.0,0.0,0,0,0,5,0,1013,0,1.0,0.0,0
PF13786,PF07804:PF03613:PF08982,3,4,0,3,4,1011,0.0,0.99,0.0,-0.0,0,0,3,0,1015,0,1.0,0.0,0
PF06097,PF15771:PF15184:PF14328,0,1,0,0,1,1017,0.0,1.0,0,0,0,0,0,0,1018,0,1.0,0,0
PF00425,PF04715:PF00977:PF00958,17,36,13,4,23,978,0.36,0.97,0.76,0.51,8,5,12,3,998,0.62,0.99,0.29,0.42
PF01083,PF00457:PF01670:PF03664,16,12,7,9,5,997,0.58,0.99,0.44,0.5,3,2,14,1,1001,0.67,0.99,0.12,0.28
PF13947,PF08488:PF14380:PF00139,19,29,10,9,19,980,0.34,0.97,0.53,0.41,6,6,13,0,999,1.0,0.99,0.32,0.56
PF02485,PF09362:PF12529:PF11790,17,17,4,13,13,988,0.24,0.97,0.24,0.22,3,1,16,2,999,0.33,0.98,0.06,0.13
PF12385,PF12843:PF04370:PF07243,0,0,0,0,0,1018,0,1.0,0,0,0,0,0,0,1018,0,1.0,0,0
PF04810,PF04815:PF08033:PF04811,25,29,25,0,4,989,0.86,1.0,1.0,0.93,24,22,3,2,991,0.92,1.0,0.88,0.9
PF12134,PF10596:PF08084:PF10597,17,18,17,0,1,1000,0.94,1.0,1.0,0.97,15,15,2,0,1001,1.0,1.0,0.88,0.94
PF04930,PF15011:PF10195:PF01596,9,17,3,6,14,995,0.18,0.98,0.33,0.23,3,1,8,2,1007,0.33,0.99,0.11,0.19
PF05065,PF00524:PF06210:PF13005,1,4,0,1,4,1013,0.0,1.0,0.0,-0.0,0,0,1,0,1017,0,1.0,0.0,0
PF01755,PF10155:PF14441:PF10505,11,17,2,9,15,992,0.12,0.98,0.18,0.13,0,0,11,0,1007,0,0.99,0.0,0
PF11566,PF09346:PF03048:PF04300,7,9,2,5,7,1004,0.22,0.99,0.29,0.25,1,1,6,0,1011,1.0,0.99,0.14,0.38
PF04970,PF02594:PF01127:PF05291,11,23,4,7,19,988,0.17,0.97,0.36,0.24,3,2,9,1,1006,0.67,0.99,0.18,0.34
PF12496,PF00616:PF02589:PF09304,9,25,2,7,23,986,0.08,0.97,0.22,0.12,2,0,9,2,1007,0.0,0.99,0.0,-0.0
PF03882,PF17192:PF04350:PF04288,0,0,0,0,0,1018,0,1.0,0,0,0,0,0,0,1018,0,1.0,0,0
PF09366,PF07939:PF09419:PF08536,6,16,1,5,15,997,0.06,0.98,0.17,0.09,1,0,6,1,1011,0.0,0.99,0.0,-0.0
PF04413,PF15924:PF12038:PF13439,1,28,1,0,27,990,0.04,0.97,1.0,0.19,2,1,0,1,1016,0.5,1.0,1.0,0.71
PF12054,PF08658:PF13892:PF15790,10,21,3,7,18,990,0.14,0.98,0.3,0.2,5,2,8,3,1005,0.4,0.99,0.2,0.28
PF07897,PF16136:PF16135:PF05266,1,15,1,0,14,1003,0.07,0.99,1.0,0.26,1,1,0,0,1017,1.0,1.0,1.0,1.0
PF06970,PF04625:PF10279:PF07916,0,1,0,0,1,1017,0.0,1.0,0,0,0,0,0,0,1018,0,1.0,0,0
PF10276,PF07939:PF09805:PF15910,1,10,0,1,10,1007,0.0,0.99,0.0,-0.0,1,0,1,1,1016,0.0,1.0,0.0,-0.0
PF05034,PF14842:PF08886:PF03428,0,0,0,0,0,1018,0,1.0,0,0,0,0,0,0,1018,0,1.0,0,0
PF08550,PF11702:PF07573:PF10491,13,8,7,6,1,1004,0.88,0.99,0.54,0.68,0,0,13,0,1005,0,0.99,0.0,0
PF14615,PF03713:PF03907:PF08857,7,1,0,7,1,1010,0.0,0.99,0.0,-0.0,0,0,7,0,1011,0,0.99,0.0,0
PF08656,PF16594:PF07961:PF15715,2,1,0,2,1,1015,0.0,1.0,0.0,-0.0,0,0,2,0,1016,0,1.0,0.0,0
PF13877,PF15867:PF16546:PF04049,7,23,3,4,20,991,0.13,0.98,0.43,0.23,4,1,6,3,1008,0.25,0.99,0.14,0.18
PF07338,PF06798:PF06890:PF15281,5,3,0,5,3,1010,0.0,0.99,0.0,-0.0,0,0,5,0,1013,0,1.0,0.0,0
PF01781,PF08269:PF06773:PF03243,9,3,0,9,3,1006,0.0,0.99,0.0,-0.01,0,0,9,0,1009,0,0.99,0.0,0
PF05003,PF01343:PF13015:PF04871,2,32,1,1,31,985,0.03,0.97,0.5,0.12,9,1,1,8,1008,0.11,0.99,0.5,0.23
PF02058,PF01668:PF17112:PF10106,1,3,0,1,3,1014,0.0,1.0,0.0,-0.0,0,0,1,0,1017,0,1.0,0.0,0
PF11729,PF11561:PF04222:PF10117,0,1,0,0,1,1017,0.0,1.0,0,0,0,0,0,0,1018,0,1.0,0,0
PF14842,PF14841:PF15518:PF01706,0,2,0,0,2,1016,0.0,1.0,0,0,1,0,0,1,1017,0.0,1.0,0,0
PF04965,PF05939:PF05974:PF08744,0,0,0,0,0,1018,0,1.0,0,0,0,0,0,0,1018,0,1.0,0,0
PF11968,PF10218:PF15243:PF07114,8,3,0,8,3,1007,0.0,0.99,0.0,-0.0,0,0,8,0,1010,0,0.99,0.0,0
PF05558,PF15125:PF02202:PF15046,1,6,0,1,6,1011,0.0,0.99,0.0,-0.0,0,0,1,0,1017,0,1.0,0.0,0
PF14786,PF08917:PF06760:PF11629,2,6,2,0,4,1012,0.33,1.0,1.0,0.58,2,2,0,0,1016,1.0,1.0,1.0,1.0
PF13593,PF05254:PF03386:PF05512,5,11,2,3,9,1004,0.18,0.99,0.4,0.26,0,0,5,0,1013,0,1.0,0.0,0
PF17213,PF12297:PF16830:PF10481,3,4,0,3,4,1011,0.0,0.99,0.0,-0.0,0,0,3,0,1015,0,1.0,0.0,0
PF02733,PF02734:PF13684:PF00276,14,34,13,1,21,983,0.38,0.98,0.93,0.59,9,6,8,3,1001,0.67,0.99,0.43,0.53
PF03845,PF15518:PF02399:PF03930,8,3,0,8,3,1007,0.0,0.99,0.0,-0.0,0,0,8,0,1010,0,0.99,0.0,0
PF12473,PF16183:PF12423:PF14739,20,19,15,5,4,994,0.79,0.99,0.75,0.76,14,14,6,0,998,1.0,0.99,0.7,0.83
PF09345,PF07718:PF14806:PF12436,0,19,0,0,19,999,0.0,0.98,0,0,8,0,0,8,1010,0.0,0.99,0,0
PF10355,PF10348:PF16978:PF09729,5,22,5,0,17,996,0.23,0.98,1.0,0.47,4,1,4,3,1010,0.25,0.99,0.2,0.22
PF00194,PF10263:PF14521:PF00354,27,37,8,19,29,962,0.22,0.95,0.3,0.23,8,4,23,4,987,0.5,0.97,0.15,0.26
PF07653,PF00018:PF00620:PF14604,56,153,45,11,108,854,0.29,0.88,0.8,0.44,66,35,21,31,931,0.53,0.95,0.62,0.55
PF08446,PF00672:PF08448:PF00512,13,51,13,0,38,967,0.25,0.96,1.0,0.5,19,9,4,10,995,0.47,0.99,0.69,0.57
PF12350,PF12243:PF00165:PF01386,3,10,2,1,8,1007,0.2,0.99,0.67,0.36,0,0,3,0,1015,0,1.0,0.0,0
PF03625,PF14519:PF08092:PF08843,1,1,0,1,1,1016,0.0,1.0,0.0,-0.0,0,0,1,0,1017,0,1.0,0.0,0
PF16401,PF16692:PF09949:PF10022,1,18,0,1,18,999,0.0,0.98,0.0,-0.0,2,0,1,2,1015,0.0,1.0,0.0,-0.0
PF06337,PF14836:PF13446:PF14533,17,15,7,10,8,993,0.47,0.98,0.41,0.43,4,4,13,0,1001,1.0,0.99,0.24,0.48
PF13721,PF03428:PF11863:PF05509,3,1,0,3,1,1014,0.0,1.0,0.0,-0.0,0,0,3,0,1015,0,1.0,0.0,0
PF09732,PF09368:PF11970:PF15070,11,7,1,10,6,1001,0.14,0.98,0.09,0.11,0,0,11,0,1007,0,0.99,0.0,0
PF15693,PF15694:PF06881:PF07500,0,18,0,0,18,1000,0.0,0.98,0,0,2,0,0,2,1016,0.0,1.0,0,0
PF01170,PF13391:PF02926:PF04504,14,28,7,7,21,983,0.25,0.97,0.5,0.34,5,2,12,3,1001,0.4,0.99,0.14,0.23
PF10443,PF08081:PF12220:PF08075,7,11,2,5,9,1002,0.18,0.99,0.29,0.22,3,1,6,2,1009,0.33,0.99,0.14,0.21
PF02600,PF07464:PF02087:PF15158,1,3,0,1,3,1014,0.0,1.0,0.0,-0.0,0,0,1,0,1017,0,1.0,0.0,0
PF08857,PF09962:PF03238:PF14862,0,1,0,0,1,1017,0.0,1.0,0,0,0,0,0,0,1018,0,1.0,0,0
PF02780,PF00456:PF02779:PF13292,32,44,31,1,13,973,0.7,0.99,0.97,0.82,11,11,21,0,986,1.0,0.98,0.34,0.58
PF04642,PF15553:PF04370:PF15482,1,0,0,1,0,1017,0,1.0,0.0,0,0,0,1,0,1017,0,1.0,0.0,0
PF03212,PF17007:PF07409:PF06995,0,0,0,0,0,1018,0,1.0,0,0,0,0,0,0,1018,0,1.0,0,0
PF04176,PF04716:PF06658:PF02284,9,19,5,4,14,995,0.26,0.98,0.56,0.37,2,2,7,0,1009,1.0,0.99,0.22,0.47
PF16886,PF07497:PF11421:PF00401,16,5,1,15,4,998,0.2,0.98,0.06,0.1,1,1,15,0,1002,1.0,0.99,0.06,0.25
PF09485,PF03807:PF03417:PF03463,1,21,1,0,20,997,0.05,0.98,1.0,0.22,5,1,0,4,1013,0.2,1.0,1.0,0.45
PF06581,PF06875:PF14653:PF02427,0,0,0,0,0,1018,0,1.0,0,0,0,0,0,0,1018,0,1.0,0,0
PF05020,PF05021:PF11543:PF00833,9,26,9,0,17,992,0.35,0.98,1.0,0.58,8,7,2,1,1008,0.88,1.0,0.78,0.82
PF11142,PF10241:PF05153:PF08997,0,23,0,0,23,995,0.0,0.98,0,0,2,0,0,2,1016,0.0,1.0,0,0
PF13244,PF17152:PF15577:PF15856,0,5,0,0,5,1013,0.0,1.0,0,0,0,0,0,0,1018,0,1.0,0,0
PF12729,PF04738:PF07157:PF13722,1,0,0,1,0,1017,0,1.0,0.0,0,0,0,1,0,1017,0,1.0,0.0,0
PF02615,PF03962:PF09495:PF06842,8,14,4,4,10,1000,0.29,0.99,0.5,0.37,3,1,7,2,1008,0.33,0.99,0.12,0.2
PF11470,PF09429:PF09041:PF08605,6,12,2,4,10,1002,0.17,0.99,0.33,0.23,1,0,6,1,1011,0.0,0.99,0.0,-0.0
PF00377,PF01620:PF15973:PF11587,2,0,0,2,0,1016,0,1.0,0.0,0,0,0,2,0,1016,0,1.0,0.0,0
PF04883,PF13942:PF06094:PF17029,0,18,0,0,18,1000,0.0,0.98,0,0,0,0,0,0,1018,0,1.0,0,0
PF01989,PF04412:PF00073:PF00680,1,13,1,0,12,1005,0.08,0.99,1.0,0.28,12,0,1,12,1005,0.0,0.99,0.0,-0.0
PF07213,PF14967:PF15741:PF15069,5,3,2,3,1,1012,0.67,1.0,0.4,0.51,0,0,5,0,1013,0,1.0,0.0,0
PF13441,PF06547:PF15419:PF13705,2,7,2,0,5,1011,0.29,1.0,1.0,0.53,2,2,0,0,1016,1.0,1.0,1.0,1.0
PF03528,PF09311:PF11409:PF16696,5,6,5,0,1,1012,0.83,1.0,1.0,0.91,2,2,3,0,1013,1.0,1.0,0.4,0.63
PF16529,PF15246:PF16501:PF10264,5,6,2,3,4,1009,0.33,0.99,0.4,0.36,0,0,5,0,1013,0,1.0,0.0,0
PF11551,PF06827:PF02283:PF10076,3,10,3,0,7,1008,0.3,0.99,1.0,0.55,1,1,2,0,1015,1.0,1.0,0.33,0.58
PF08702,PF12160:PF05889:PF00147,3,51,3,0,48,967,0.06,0.95,1.0,0.24,4,3,0,1,1014,0.75,1.0,1.0,0.87
PF09273,PF05033:PF15811:PF11764,17,31,6,11,25,976,0.19,0.96,0.35,0.24,6,2,15,4,997,0.33,0.98,0.12,0.19
PF03626,PF07726:PF12592:PF05762,2,7,2,0,5,1011,0.29,1.0,1.0,0.53,3,2,0,1,1015,0.67,1.0,1.0,0.82
PF09611,PF15529:PF01580:PF06007,0,7,0,0,7,1011,0.0,0.99,0,0,0,0,0,0,1018,0,1.0,0,0
PF00004,PF12037:PF05362:PF14629,157,25,22,135,3,858,0.88,0.86,0.14,0.32,3,3,154,0,861,1.0,0.85,0.02,0.13
PF14712,PF00159:PF01279:PF12597,10,12,2,8,10,998,0.17,0.98,0.2,0.17,1,0,10,1,1007,0.0,0.99,0.0,-0.0
PF00366,PF16205:PF14853:PF02607,15,20,11,4,9,994,0.55,0.99,0.73,0.63,1,1,14,0,1003,1.0,0.99,0.07,0.26
PF12480,PF08729:PF12516:PF12509,4,8,1,3,7,1007,0.12,0.99,0.25,0.17,0,0,4,0,1014,0,1.0,0.0,0
PF10319,PF10326:PF10318:PF10325,1,32,0,1,32,985,0.0,0.97,0.0,-0.01,4,0,1,4,1013,0.0,1.0,0.0,-0.0
PF09286,PF16470:PF05922:PF12583,15,33,7,8,26,977,0.21,0.97,0.47,0.3,6,4,11,2,1001,0.67,0.99,0.27,0.42
PF03208,PF00430:PF04667:PF02704,8,14,2,6,12,998,0.14,0.98,0.25,0.18,2,2,6,0,1010,1.0,0.99,0.25,0.5
PF02982,PF07464:PF06766:PF04736,5,4,0,5,4,1009,0.0,0.99,0.0,-0.0,0,0,5,0,1013,0,1.0,0.0,0
PF13844,PF13414:PF14260:PF16197,13,76,12,1,64,941,0.16,0.94,0.92,0.37,15,5,8,10,995,0.33,0.98,0.38,0.35
PF08331,PF15052:PF15485:PF04642,0,4,0,0,4,1014,0.0,1.0,0,0,0,0,0,0,1018,0,1.0,0,0
PF08652,PF01066:PF06237:PF04833,5,39,4,1,35,978,0.1,0.96,0.8,0.28,1,0,5,1,1012,0.0,0.99,0.0,-0.0
PF14498,PF10350:PF06964:PF08427,10,30,7,3,23,985,0.23,0.97,0.7,0.39,2,2,8,0,1008,1.0,0.99,0.2,0.45
PF13619,PF11573:PF01392:PF00051,0,44,0,0,44,974,0.0,0.96,0,0,17,0,0,17,1001,0.0,0.98,0,0
PF04721,PF07912:PF10404:PF10403,4,13,3,1,10,1004,0.23,0.99,0.75,0.41,7,3,1,4,1010,0.43,1.0,0.75,0.56
PF10076,PF05947:PF01752:PF16967,0,2,0,0,2,1016,0.0,1.0,0,0,0,0,0,0,1018,0,1.0,0,0
PF01669,PF15762:PF09428:PF03745,1,1,0,1,1,1016,0.0,1.0,0.0,-0.0,0,0,1,0,1017,0,1.0,0.0,0
PF16794,PF12884:PF12509:PF13916,7,9,1,6,8,1003,0.11,0.99,0.14,0.12,0,0,7,0,1011,0,0.99,0.0,0
PF02811,PF09587:PF03576:PF00545,12,8,1,11,7,999,0.12,0.98,0.08,0.09,0,0,12,0,1006,0,0.99,0.0,0
PF11907,PF13089:PF13090:PF09966,1,2,1,0,1,1016,0.5,1.0,1.0,0.71,1,1,0,0,1017,1.0,1.0,1.0,1.0
PF11443,PF03059:PF02684:PF04863,6,8,1,5,7,1005,0.12,0.99,0.17,0.14,0,0,6,0,1012,0,0.99,0.0,0
PF14534,PF17050:PF00770:PF05355,0,5,0,0,5,1013,0.0,1.0,0,0,0,0,0,0,1018,0,1.0,0,0
PF07321,PF02863:PF03090:PF15662,0,2,0,0,2,1016,0.0,1.0,0,0,0,0,0,0,1018,0,1.0,0,0
PF07879,PF05233:PF15546:PF17192,1,1,1,0,0,1017,1.0,1.0,1.0,1.0,1,1,0,0,1017,1.0,1.0,1.0,1.0
PF11924,PF07411:PF15150:PF13780,1,0,0,1,0,1017,0,1.0,0.0,0,0,0,1,0,1017,0,1.0,0.0,0
PF06110,PF03079:PF04377:PF06212,10,25,6,4,19,989,0.24,0.98,0.6,0.37,0,0,10,0,1008,0,0.99,0.0,0
PF00554,PF16179:PF16180:PF16181,18,16,16,2,0,1000,1.0,1.0,0.89,0.94,3,3,15,0,1000,1.0,0.99,0.17,0.41
PF12529,PF02485:PF09362:PF03229,2,27,2,0,25,991,0.07,0.98,1.0,0.27,1,0,2,1,1015,0.0,1.0,0.0,-0.0
PF03157,PF13402:PF02769:PF16327,1,20,0,1,20,997,0.0,0.98,0.0,-0.0,0,0,1,0,1017,0,1.0,0.0,0
PF14565,PF00714:PF00727:PF06351,1,7,0,1,7,1010,0.0,0.99,0.0,-0.0,0,0,1,0,1017,0,1.0,0.0,0
PF15865,PF03511:PF12612:PF12530,0,14,0,0,14,1004,0.0,0.99,0,0,1,0,0,1,1017,0.0,1.0,0,0
PF14963,PF15130:PF15872:PF03437,2,3,1,1,2,1014,0.33,1.0,0.5,0.41,0,0,2,0,1016,0,1.0,0.0,0
PF03344,PF09444:PF06513:PF15030,1,2,0,1,2,1015,0.0,1.0,0.0,-0.0,0,0,1,0,1017,0,1.0,0.0,0
PF01015,PF16054:PF01907:PF01176,9,19,4,5,15,994,0.21,0.98,0.44,0.3,7,2,7,5,1004,0.29,0.99,0.22,0.25
PF04224,PF14759:PF04324:PF14962,3,14,1,2,13,1002,0.07,0.99,0.33,0.15,3,1,2,2,1013,0.33,1.0,0.33,0.33
PF03514,PF07887:PF12041:PF03181,20,17,11,9,6,992,0.65,0.99,0.55,0.59,2,1,19,1,997,0.5,0.98,0.05,0.15
PF02530,PF17206:PF10106:PF06725,1,3,0,1,3,1014,0.0,1.0,0.0,-0.0,0,0,1,0,1017,0,1.0,0.0,0
PF02219,PF03385:PF07034:PF10022,8,12,3,5,9,1001,0.25,0.99,0.38,0.3,1,1,7,0,1010,1.0,0.99,0.12,0.35
PF10359,PF10305:PF10344:PF10293,3,5,3,0,2,1013,0.6,1.0,1.0,0.77,4,3,0,1,1014,0.75,1.0,1.0,0.87
PF08392,PF08545:PF08541:PF00351,8,28,7,1,21,989,0.25,0.98,0.88,0.46,6,4,4,2,1008,0.67,0.99,0.5,0.57
PF05513,PF05509:PF07178:PF05309,1,1,1,0,0,1017,1.0,1.0,1.0,1.0,1,1,0,0,1017,1.0,1.0,1.0,1.0
PF11860,PF13421:PF08298:PF15272,0,0,0,0,0,1018,0,1.0,0,0,0,0,0,0,1018,0,1.0,0,0
PF06766,PF15370:PF15359:PF06912,2,7,0,2,7,1009,0.0,0.99,0.0,-0.0,1,0,2,1,1015,0.0,1.0,0.0,-0.0
PF13824,PF06047:PF07222:PF14441,4,12,2,2,10,1004,0.17,0.99,0.5,0.28,1,1,3,0,1014,1.0,1.0,0.25,0.5
PF01513,PF01758:PF03062:PF09335,13,58,7,6,51,954,0.12,0.94,0.54,0.24,8,4,9,4,1001,0.5,0.99,0.31,0.39
PF08672,PF10557:PF00888:PF03256,12,48,11,1,37,969,0.23,0.96,0.92,0.45,29,6,6,23,983,0.21,0.97,0.5,0.31
PF00083,PF07690:PF01966:PF06624,133,244,89,44,155,730,0.36,0.8,0.67,0.39,25,23,110,2,883,0.92,0.89,0.17,0.37
PF03245,PF15380:PF10951:PF05513,0,1,0,0,1,1017,0.0,1.0,0,0,0,0,0,0,1018,0,1.0,0,0
PF09354,PF16675:PF08430:PF16676,4,8,4,0,4,1010,0.5,1.0,1.0,0.71,3,2,2,1,1013,0.67,1.0,0.5,0.58
PF08746,PF05129:PF03298:PF07574,8,23,8,0,15,995,0.35,0.99,1.0,0.59,3,3,5,0,1010,1.0,1.0,0.38,0.61
PF13785,PF15117:PF02530:PF08808,0,1,0,0,1,1017,0.0,1.0,0,0,0,0,0,0,1018,0,1.0,0,0
PF10045,PF08744:PF06651:PF05887,0,0,0,0,0,1018,0,1.0,0,0,0,0,0,0,1018,0,1.0,0,0
PF14749,PF01756:PF09317:PF08028,14,20,11,3,9,995,0.55,0.99,0.79,0.65,3,2,12,1,1003,0.67,0.99,0.14,0.3
PF14667,PF01554:PF11136:PF10623,2,28,2,0,26,990,0.07,0.97,1.0,0.26,0,0,2,0,1016,0,1.0,0.0,0
PF09112,PF09113:PF05787:PF16126,0,1,0,0,1,1017,0.0,1.0,0,0,0,0,0,0,1018,0,1.0,0,0
PF11852,PF03714:PF02806:PF02922,2,23,2,0,21,995,0.09,0.98,1.0,0.29,14,2,0,12,1004,0.14,0.99,1.0,0.38
PF07200,PF10520:PF04729:PF07412,13,13,4,9,9,996,0.31,0.98,0.31,0.3,3,2,11,1,1004,0.67,0.99,0.15,0.32
PF16155,PF06445:PF09397:PF09587,3,12,1,2,11,1004,0.08,0.99,0.33,0.16,3,0,3,3,1012,0.0,0.99,0.0,-0.0
PF15307,PF13011:PF12658:PF00669,0,2,0,0,2,1016,0.0,1.0,0,0,0,0,0,0,1018,0,1.0,0,0
PF13460,PF08547:PF01370:PF05368,49,98,33,16,65,904,0.34,0.92,0.67,0.44,27,19,30,8,961,0.7,0.96,0.39,0.51
PF12483,PF01980:PF13225:PF04706,3,10,1,2,9,1006,0.1,0.99,0.33,0.18,1,0,3,1,1014,0.0,1.0,0.0,-0.0
PF00346,PF01731:PF00243:PF13391,12,22,3,9,19,987,0.14,0.97,0.25,0.17,1,1,11,0,1006,1.0,0.99,0.08,0.29
PF13332,PF04232:PF00768:PF04546,0,14,0,0,14,1004,0.0,0.99,0,0,0,0,0,0,1018,0,1.0,0,0
PF01522,PF09347:PF01607:PF07502,33,56,11,22,45,940,0.2,0.93,0.33,0.22,5,4,29,1,984,0.8,0.97,0.12,0.3
PF01168,PF14031:PF00842:PF07975,15,10,8,7,2,1001,0.8,0.99,0.53,0.65,1,1,14,0,1003,1.0,0.99,0.07,0.26
PF11898,PF02559:PF12029:PF09369,3,8,2,1,6,1009,0.25,0.99,0.67,0.41,2,2,1,0,1015,1.0,1.0,0.67,0.82
PF03967,PF08748:PF10468:PF09498,1,1,0,1,1,1016,0.0,1.0,0.0,-0.0,0,0,1,0,1017,0,1.0,0.0,0
PF09236,PF15838:PF15754:PF08093,1,1,0,1,1,1016,0.0,1.0,0.0,-0.0,0,0,1,0,1017,0,1.0,0.0,0
PF13342,PF11304:PF01628:PF04865,2,2,1,1,1,1015,0.5,1.0,0.5,0.5,0,0,2,0,1016,0,1.0,0.0,0
PF10964,PF05125:PF00370:PF15875,0,42,0,0,42,976,0.0,0.96,0,0,0,0,0,0,1018,0,1.0,0,0
PF04665,PF10544:PF04383:PF03288,3,15,3,0,12,1003,0.2,0.99,1.0,0.44,2,1,2,1,1014,0.5,1.0,0.33,0.41
PF06977,PF15082:PF05894:PF10618,0,3,0,0,3,1015,0.0,1.0,0,0,0,0,0,0,1018,0,1.0,0,0
PF04229,PF09796:PF10340:PF08843,5,6,1,4,5,1008,0.17,0.99,0.2,0.18,0,0,5,0,1013,0,1.0,0.0,0
PF10223,PF06910:PF06468:PF02014,2,16,2,0,14,1002,0.12,0.99,1.0,0.35,5,1,1,4,1012,0.2,1.0,0.5,0.31
PF04678,PF08265:PF10276:PF03045,16,18,4,12,14,988,0.22,0.97,0.25,0.22,2,1,15,1,1001,0.5,0.98,0.06,0.17
PF16093,PF10181:PF09769:PF00499,8,8,3,5,5,1005,0.38,0.99,0.38,0.37,0,0,8,0,1010,0,0.99,0.0,0
PF13588,PF06798:PF03090:PF07157,2,0,0,2,0,1016,0,1.0,0.0,0,0,0,2,0,1016,0,1.0,0.0,0
PF05756,PF10106:PF15485:PF08744,0,1,0,0,1,1017,0.0,1.0,0,0,0,0,0,0,1018,0,1.0,0,0
PF16922,PF00525:PF10381:PF14803,6,15,3,3,12,1000,0.2,0.99,0.5,0.31,1,1,5,0,1012,1.0,1.0,0.17,0.41
PF04968,PF14050:PF04969:PF05002,13,49,10,3,39,966,0.2,0.96,0.77,0.38,20,5,8,15,990,0.25,0.98,0.38,0.3
PF16540,PF13931:PF14739:PF16796,8,11,3,5,8,1002,0.27,0.99,0.38,0.31,5,3,5,2,1008,0.6,0.99,0.38,0.47
PF03886,PF04288:PF15285:PF12659,1,1,0,1,1,1016,0.0,1.0,0.0,-0.0,0,0,1,0,1017,0,1.0,0.0,0
PF10475,PF10474:PF06148:PF07928,4,17,4,0,13,1001,0.24,0.99,1.0,0.48,3,3,1,0,1014,1.0,1.0,0.75,0.87
PF05544,PF02162:PF07086:PF04371,2,7,1,1,6,1010,0.14,0.99,0.5,0.26,0,0,2,0,1016,0,1.0,0.0,0
PF13464,PF04375:PF12835:PF09684,1,2,0,1,2,1015,0.0,1.0,0.0,-0.0,1,0,1,1,1016,0.0,1.0,0.0,-0.0
PF15702,PF08570:PF15480:PF15843,3,3,0,3,3,1012,0.0,0.99,0.0,-0.0,0,0,3,0,1015,0,1.0,0.0,0
PF12783,PF16213:PF09324:PF16206,24,24,18,6,6,988,0.75,0.99,0.75,0.74,15,15,9,0,994,1.0,0.99,0.62,0.79
PF04189,PF02731:PF05334:PF10998,12,12,1,11,11,995,0.08,0.98,0.08,0.07,0,0,12,0,1006,0,0.99,0.0,0
PF15908,PF10481:PF05104:PF12297,5,4,0,5,4,1009,0.0,0.99,0.0,-0.0,0,0,5,0,1013,0,1.0,0.0,0
PF08438,PF09269:PF05128:PF15086,5,6,3,2,3,1010,0.5,1.0,0.6,0.55,1,1,4,0,1013,1.0,1.0,0.2,0.45
PF08757,PF10042:PF10104:PF04478,4,13,1,3,12,1002,0.08,0.99,0.25,0.13,0,0,4,0,1014,0,1.0,0.0,0
PF03405,PF05910:PF00197:PF06404,3,12,1,2,11,1004,0.08,0.99,0.33,0.16,0,0,3,0,1015,0,1.0,0.0,0
PF08292,PF03876:PF00575:PF14878,5,43,5,0,38,975,0.12,0.96,1.0,0.33,17,3,2,14,999,0.18,0.98,0.6,0.32
PF15289,PF09991:PF12646:PF13367,0,3,0,0,3,1015,0.0,1.0,0,0,0,0,0,0,1018,0,1.0,0,0
PF02736,PF01576:PF00063:PF14432,24,93,23,1,70,924,0.25,0.93,0.96,0.47,36,16,8,20,974,0.44,0.97,0.67,0.53
PF15281,PF02277:PF17076:PF06798,3,3,0,3,3,1012,0.0,0.99,0.0,-0.0,0,0,3,0,1015,0,1.0,0.0,0
PF11880,PF04932:PF11862:PF13098,3,6,0,3,6,1009,0.0,0.99,0.0,-0.0,0,0,3,0,1015,0,1.0,0.0,0
PF08219,PF08228:PF10664:PF02448,0,4,0,0,4,1014,0.0,1.0,0,0,0,0,0,0,1018,0,1.0,0,0
PF07377,PF06674:PF05280:PF14882,3,4,3,0,1,1014,0.75,1.0,1.0,0.87,3,3,0,0,1015,1.0,1.0,1.0,1.0
PF00102,PF14948:PF11548:PF09414,54,10,8,46,2,962,0.8,0.95,0.15,0.33,3,3,51,0,964,1.0,0.95,0.06,0.23
PF14912,PF06401:PF14910:PF02165,4,6,0,4,6,1008,0.0,0.99,0.0,-0.0,0,0,4,0,1014,0,1.0,0.0,0
PF14750,PF09797:PF08568:PF10221,10,18,4,6,14,994,0.22,0.98,0.4,0.29,3,2,8,1,1007,0.67,0.99,0.2,0.36
PF03992,PF16166:PF13405:PF13202,23,78,8,15,70,925,0.1,0.92,0.35,0.16,26,5,18,21,974,0.19,0.96,0.22,0.18
PF01701,PF10856:PF15319:PF01840,1,0,0,1,0,1017,0,1.0,0.0,0,0,0,1,0,1017,0,1.0,0.0,0
PF09262,PF16725:PF05695:PF09263,12,13,6,6,7,999,0.46,0.99,0.5,0.47,1,1,11,0,1006,1.0,0.99,0.08,0.29
PF07556,PF01136:PF05857:PF11751,0,1,0,0,1,1017,0.0,1.0,0,0,0,0,0,0,1018,0,1.0,0,0
PF09201,PF03320:PF14842:PF15272,4,5,0,4,5,1009,0.0,0.99,0.0,-0.0,0,0,4,0,1014,0,1.0,0.0,0
PF03331,PF01959:PF02175:PF15377,1,4,0,1,4,1013,0.0,1.0,0.0,-0.0,0,0,1,0,1017,0,1.0,0.0,0
PF00503,PF03332:PF04922:PF06093,44,22,14,30,8,966,0.64,0.96,0.32,0.43,4,4,40,0,974,1.0,0.96,0.09,0.3
PF03876,PF08292:PF00575:PF08206,16,36,11,5,25,977,0.31,0.97,0.69,0.45,4,4,12,0,1002,1.0,0.99,0.25,0.5
PF04526,PF03188:PF16010:PF03351,2,46,2,0,44,972,0.04,0.96,1.0,0.2,15,1,1,14,1002,0.07,0.99,0.5,0.18
PF07573,PF11702:PF15518:PF12603,4,2,0,4,2,1012,0.0,0.99,0.0,-0.0,1,0,4,1,1013,0.0,1.0,0.0,-0.0
PF14953,PF05233:PF07879:PF15104,3,1,1,2,0,1015,1.0,1.0,0.33,0.58,1,1,2,0,1015,1.0,1.0,0.33,0.58
PF05887,PF03944:PF01790:PF01514,0,4,0,0,4,1014,0.0,1.0,0,0,0,0,0,0,1018,0,1.0,0,0
PF16673,PF08941:PF02176:PF06803,4,23,3,1,20,994,0.13,0.98,0.75,0.31,6,3,1,3,1011,0.5,1.0,0.75,0.61
PF10962,PF12608:PF16639:PF03118,0,15,0,0,15,1003,0.0,0.99,0,0,0,0,0,0,1018,0,1.0,0,0
PF05445,PF03044:PF01219:PF07829,2,2,0,2,2,1014,0.0,1.0,0.0,-0.0,0,0,2,0,1016,0,1.0,0.0,0
PF02210,PF00054:PF00028:PF01049,40,54,29,11,25,953,0.54,0.96,0.72,0.61,14,11,29,3,975,0.79,0.97,0.28,0.45
PF15549,PF14986:PF15333:PF02950,1,1,0,1,1,1016,0.0,1.0,0.0,-0.0,0,0,1,0,1017,0,1.0,0.0,0
PF03732,PF01107:PF08284:PF12259,58,27,20,38,7,953,0.74,0.96,0.34,0.49,4,4,54,0,960,1.0,0.95,0.07,0.26
PF00576,PF00711:PF00340:PF07771,6,2,0,6,2,1010,0.0,0.99,0.0,-0.0,0,0,6,0,1012,0,0.99,0.0,0
PF09087,PF10438:PF05400:PF06024,1,1,1,0,0,1017,1.0,1.0,1.0,1.0,1,1,0,0,1017,1.0,1.0,1.0,1.0
PF04765,PF03195:PF08643:PF04788,10,13,3,7,10,998,0.23,0.98,0.3,0.25,5,2,8,3,1005,0.4,0.99,0.2,0.28
PF14308,PF14901:PF00684:PF09350,11,7,1,10,6,1001,0.14,0.98,0.09,0.11,0,0,11,0,1007,0,0.99,0.0,0
PF16216,PF15272:PF08483:PF01136,0,2,0,0,2,1016,0.0,1.0,0,0,0,0,0,0,1018,0,1.0,0,0
PF05083,PF01514:PF01752:PF17076,0,2,0,0,2,1016,0.0,1.0,0,0,0,0,0,0,1018,0,1.0,0,0
PF04090,PF10104:PF11001:PF15045,2,12,1,1,11,1005,0.08,0.99,0.5,0.2,3,1,1,2,1014,0.33,1.0,0.5,0.41
PF11658,PF05001:PF11523:PF05316,0,14,0,0,14,1004,0.0,0.99,0,0,2,0,0,2,1016,0.0,1.0,0,0
PF16311,PF15141:PF09216:PF17049,0,1,0,0,1,1017,0.0,1.0,0,0,0,0,0,0,1018,0,1.0,0,0
PF09424,PF10224:PF12900:PF08787,6,13,1,5,12,1000,0.08,0.98,0.17,0.11,0,0,6,0,1012,0,0.99,0.0,0
PF01137,PF05189:PF03972:PF05995,11,17,6,5,11,996,0.35,0.98,0.55,0.43,3,3,8,0,1007,1.0,0.99,0.27,0.52
PF15893,PF03458:PF02740:PF11035,0,4,0,0,4,1014,0.0,1.0,0,0,0,0,0,0,1018,0,1.0,0,0
PF00372,PF03722:PF03723:PF16126,6,10,5,1,5,1007,0.5,0.99,0.83,0.64,7,5,1,2,1010,0.71,1.0,0.83,0.77
PF07530,PF16012:PF12259:PF16297,6,14,4,2,10,1002,0.29,0.99,0.67,0.43,2,1,5,1,1011,0.5,0.99,0.17,0.29
PF13942,PF06451:PF14995:PF15429,0,6,0,0,6,1012,0.0,0.99,0,0,1,0,0,1,1017,0.0,1.0,0,0
PF09988,PF02295:PF05010:PF15255,0,15,0,0,15,1003,0.0,0.99,0,0,1,0,0,1,1017,0.0,1.0,0,0
PF06708,PF05014:PF10868:PF09459,2,4,1,1,3,1013,0.25,1.0,0.5,0.35,0,0,2,0,1016,0,1.0,0.0,0
PF11262,PF16134:PF11732:PF16685,6,10,6,0,4,1008,0.6,1.0,1.0,0.77,6,6,0,0,1012,1.0,1.0,1.0,1.0
PF11037,PF17022:PF05962:PF10412,0,1,0,0,1,1017,0.0,1.0,0,0,0,0,0,0,1018,0,1.0,0,0
PF06930,PF08373:PF03485:PF05746,0,39,0,0,39,979,0.0,0.96,0,0,21,0,0,21,997,0.0,0.98,0,0
PF06482,PF06121:PF01534:PF02191,5,18,3,2,15,998,0.17,0.98,0.6,0.31,4,2,3,2,1011,0.5,1.0,0.4,0.44
PF13651,PF07373:PF00621:PF05437,0,78,0,0,78,940,0.0,0.92,0,0,0,0,0,0,1018,0,1.0,0,0
PF01027,PF01248:PF07542:PF04505,25,52,11,14,41,952,0.21,0.95,0.44,0.28,9,6,19,3,990,0.67,0.98,0.24,0.39
PF11849,PF05736:PF16822:PF02119,0,2,0,0,2,1016,0.0,1.0,0,0,0,0,0,0,1018,0,1.0,0,0
PF06052,PF07883:PF06249:PF02560,3,32,3,0,29,986,0.09,0.97,1.0,0.3,5,0,3,5,1010,0.0,0.99,0.0,-0.0
PF02196,PF09128:PF13543:PF06395,12,12,4,8,8,998,0.33,0.98,0.33,0.33,3,3,9,0,1006,1.0,0.99,0.25,0.5
PF04541,PF15091:PF10116:PF12318,0,0,0,0,0,1018,0,1.0,0,0,0,0,0,0,1018,0,1.0,0,0
PF12503,PF12467:PF14841:PF05016,5,5,5,0,0,1013,1.0,1.0,1.0,1.0,1,1,4,0,1013,1.0,1.0,0.2,0.45
PF00614,PF13091:PF12357:PF01735,17,44,12,5,32,969,0.27,0.96,0.71,0.42,7,4,13,3,998,0.57,0.98,0.24,0.36
PF16005,PF00714:PF00537:PF10716,0,3,0,0,3,1015,0.0,1.0,0,0,0,0,0,0,1018,0,1.0,0,0
PF11885,PF03085:PF02112:PF15067,8,7,0,8,7,1003,0.0,0.99,0.0,-0.01,1,0,8,1,1009,0.0,0.99,0.0,-0.0
PF15465,PF15775:PF02565:PF05083,1,0,0,1,0,1017,0,1.0,0.0,0,0,0,1,0,1017,0,1.0,0.0,0
PF14980,PF07661:PF05167:PF15482,0,3,0,0,3,1015,0.0,1.0,0,0,0,0,0,0,1018,0,1.0,0,0
PF15799,PF12904:PF05914:PF07085,1,7,1,0,6,1011,0.14,0.99,1.0,0.38,1,0,1,1,1016,0.0,1.0,0.0,-0.0
PF00092,PF08473:PF06668:PF13768,55,22,15,40,7,956,0.68,0.95,0.27,0.41,6,6,49,0,963,1.0,0.95,0.11,0.32
PF01228,PF02901:PF07963:PF04232,2,12,2,0,10,1006,0.17,0.99,1.0,0.41,0,0,2,0,1016,0,1.0,0.0,0
PF04468,PF15050:PF07392:PF15673,7,3,0,7,3,1008,0.0,0.99,0.0,-0.0,0,0,7,0,1011,0,0.99,0.0,0
PF06041,PF11734:PF16503:PF09179,8,10,2,6,8,1002,0.2,0.99,0.25,0.22,3,1,7,2,1008,0.33,0.99,0.12,0.2
PF01726,PF16965:PF00796:PF10974,1,1,0,1,1,1016,0.0,1.0,0.0,-0.0,0,0,1,0,1017,0,1.0,0.0,0
PF10233,PF15359:PF09793:PF00159,8,9,2,6,7,1003,0.22,0.99,0.25,0.23,1,1,7,0,1010,1.0,0.99,0.12,0.35
PF10251,PF14931:PF15551:PF02371,3,4,1,2,3,1012,0.25,1.0,0.33,0.29,0,0,3,0,1015,0,1.0,0.0,0
PF08235,PF16876:PF04571:PF05029,11,17,11,0,6,1001,0.65,0.99,1.0,0.8,10,10,1,0,1007,1.0,1.0,0.91,0.95
PF06912,PF12716:PF07544:PF06108,3,12,0,3,12,1003,0.0,0.99,0.0,-0.01,0,0,3,0,1015,0,1.0,0.0,0
PF13767,PF14841:PF13722:PF07157,0,1,0,0,1,1017,0.0,1.0,0,0,0,0,0,0,1018,0,1.0,0,0
PF10536,PF03108:PF04434:PF10551,22,60,12,10,48,948,0.2,0.94,0.55,0.31,24,8,14,16,980,0.33,0.97,0.36,0.33
PF12971,PF12972:PF05089:PF03648,8,13,8,0,5,1005,0.62,1.0,1.0,0.78,9,6,2,3,1007,0.67,1.0,0.75,0.7
PF09235,PF16517:PF15000:PF16117,1,9,1,0,8,1009,0.11,0.99,1.0,0.33,0,0,1,0,1017,0,1.0,0.0,0
PF12773,PF13287:PF16700:PF15808,3,9,2,1,7,1008,0.22,0.99,0.67,0.38,1,1,2,0,1015,1.0,1.0,0.33,0.58
PF05452,PF06853:PF07905:PF04353,0,1,0,0,1,1017,0.0,1.0,0,0,0,0,0,0,1018,0,1.0,0,0
PF08524,PF01416:PF09789:PF02940,6,29,4,2,25,987,0.14,0.97,0.67,0.3,4,3,3,1,1011,0.75,1.0,0.5,0.61
PF14313,PF07661:PF01292:PF09556,0,9,0,0,9,1009,0.0,0.99,0,0,0,0,0,0,1018,0,1.0,0,0
PF12552,PF14383:PF14309:PF08729,4,11,4,0,7,1007,0.36,0.99,1.0,0.6,5,1,3,4,1010,0.2,0.99,0.25,0.22
PF00303,PF00186:PF12940:PF09265,6,24,2,4,22,990,0.08,0.97,0.33,0.16,3,0,6,3,1009,0.0,0.99,0.0,-0.0
PF01018,PF08701:PF13167:PF06071,10,13,3,7,10,998,0.23,0.98,0.3,0.25,3,2,8,1,1007,0.67,0.99,0.2,0.36
PF07965,PF08725:PF17205:PF00362,4,11,4,0,7,1007,0.36,0.99,1.0,0.6,9,4,0,5,1009,0.44,1.0,1.0,0.67
PF04898,PF01645:PF00310:PF14691,7,17,7,0,10,1001,0.41,0.99,1.0,0.64,6,6,1,0,1011,1.0,1.0,0.86,0.93
PF00903,PF00120:PF00891:PF13813,36,52,18,18,34,948,0.35,0.95,0.5,0.39,14,11,25,3,979,0.79,0.97,0.31,0.48
PF08501,PF01487:PF01488:PF00745,17,25,15,2,10,991,0.6,0.99,0.88,0.72,13,6,11,7,994,0.46,0.98,0.35,0.39
PF00205,PF02775:PF02776:PF11903,26,31,26,0,5,987,0.84,1.0,1.0,0.91,23,23,3,0,992,1.0,1.0,0.88,0.94
PF12743,PF12577:PF02159:PF02161,6,11,6,0,5,1007,0.55,1.0,1.0,0.74,5,5,1,0,1012,1.0,1.0,0.83,0.91
PF01855,PF17147:PF01558:PF10371,14,8,8,6,0,1004,1.0,0.99,0.57,0.75,6,6,8,0,1004,1.0,0.99,0.43,0.65
PF14251,PF15775:PF15856:PF13742,2,3,0,2,3,1013,0.0,1.0,0.0,-0.0,0,0,2,0,1016,0,1.0,0.0,0
PF11820,PF01959:PF15252:PF14967,3,5,1,2,4,1011,0.2,0.99,0.33,0.26,0,0,3,0,1015,0,1.0,0.0,0
PF11981,PF12840:PF15482:PF11037,0,0,0,0,0,1018,0,1.0,0,0,0,0,0,0,1018,0,1.0,0,0
PF11002,PF12188:PF09418:PF04308,2,4,0,2,4,1012,0.0,0.99,0.0,-0.0,0,0,2,0,1016,0,1.0,0.0,0
PF04326,PF09848:PF00273:PF12735,5,9,1,4,8,1005,0.11,0.99,0.2,0.14,0,0,5,0,1013,0,1.0,0.0,0
PF08236,PF11764:PF12237:PF09445,14,19,8,6,11,993,0.42,0.98,0.57,0.48,2,2,12,0,1004,1.0,0.99,0.14,0.38
PF16048,PF08018:PF16047:PF08023,0,0,0,0,0,1018,0,1.0,0,0,0,0,0,0,1018,0,1.0,0,0
PF14111,PF14392:PF03828:PF01107,57,48,28,29,20,941,0.58,0.95,0.49,0.51,9,8,49,1,960,0.89,0.95,0.14,0.34
PF14745,PF14744:PF14746:PF03894,6,10,6,0,4,1008,0.6,1.0,1.0,0.77,5,4,2,1,1011,0.8,1.0,0.67,0.73
PF00931,PF07725:PF01582:PF11835,82,41,29,53,12,924,0.71,0.94,0.35,0.47,13,12,70,1,935,0.92,0.93,0.15,0.35
PF07103,PF02353:PF07287:PF07247,3,28,2,1,26,989,0.07,0.97,0.67,0.21,8,1,2,7,1008,0.12,0.99,0.33,0.2
PF06625,PF00214:PF00714:PF14473,4,2,0,4,2,1012,0.0,0.99,0.0,-0.0,0,0,4,0,1014,0,1.0,0.0,0
PF05173,PF01113:PF14693:PF01729,5,20,5,0,15,998,0.25,0.99,1.0,0.5,1,1,4,0,1013,1.0,1.0,0.2,0.45
PF03949,PF00390:PF04515:PF00456,16,41,15,1,26,976,0.37,0.97,0.94,0.58,3,3,13,0,1002,1.0,0.99,0.19,0.43
PF02639,PF14467:PF01552:PF05016,2,12,0,2,12,1004,0.0,0.99,0.0,-0.0,0,0,2,0,1016,0,1.0,0.0,0
PF15179,PF15119:PF15325:PF02565,1,2,0,1,2,1015,0.0,1.0,0.0,-0.0,0,0,1,0,1017,0,1.0,0.0,0
PF07899,PF09730:PF01980:PF03469,6,15,2,4,13,999,0.13,0.98,0.33,0.2,1,0,6,1,1011,0.0,0.99,0.0,-0.0
PF07999,PF07077:PF02559:PF08494,2,4,2,0,2,1014,0.5,1.0,1.0,0.71,3,2,0,1,1015,0.67,1.0,1.0,0.82
PF03227,PF03489:PF02199:PF10853,12,11,3,9,8,998,0.27,0.98,0.25,0.25,2,1,11,1,1005,0.5,0.99,0.08,0.2
PF07941,PF11404:PF16799:PF08763,3,9,1,2,8,1007,0.11,0.99,0.33,0.19,1,1,2,0,1015,1.0,1.0,0.33,0.58
PF13419,PF01687:PF01636:PF00475,55,65,24,31,41,922,0.37,0.93,0.44,0.36,10,7,48,3,960,0.7,0.95,0.13,0.28
PF15136,PF11435:PF14467:PF14251,2,3,0,2,3,1013,0.0,1.0,0.0,-0.0,0,0,2,0,1016,0,1.0,0.0,0
PF03934,PF02501:PF05134:PF04612,2,2,2,0,0,1016,1.0,1.0,1.0,1.0,2,2,0,0,1016,1.0,1.0,1.0,1.0
PF07535,PF08630:PF08634:PF15275,6,10,4,2,6,1006,0.4,0.99,0.67,0.51,0,0,6,0,1012,0,0.99,0.0,0
PF08767,PF03378:PF03810:PF08389,11,64,9,2,55,952,0.14,0.94,0.82,0.33,28,8,3,20,987,0.29,0.98,0.73,0.45
PF08159,PF12490:PF11540:PF08596,12,10,5,7,5,1001,0.5,0.99,0.42,0.45,2,2,10,0,1006,1.0,0.99,0.17,0.41
PF11808,PF06078:PF06114:PF14398,2,4,0,2,4,1012,0.0,0.99,0.0,-0.0,0,0,2,0,1016,0,1.0,0.0,0
PF16957,PF01312:PF07016:PF14690,2,0,0,2,0,1016,0,1.0,0.0,0,0,0,2,0,1016,0,1.0,0.0,0
PF12346,PF00319:PF02665:PF12347,1,21,1,0,20,997,0.05,0.98,1.0,0.22,6,0,1,6,1011,0.0,0.99,0.0,-0.0
PF02532,PF10856:PF04624:PF02074,0,2,0,0,2,1016,0.0,1.0,0,0,0,0,0,0,1018,0,1.0,0,0
PF02544,PF13506:PF01731:PF03088,26,25,4,22,21,971,0.16,0.96,0.15,0.14,1,0,26,1,991,0.0,0.97,0.0,-0.01
PF06813,PF05978:PF10022:PF03209,6,22,1,5,21,991,0.05,0.97,0.17,0.08,1,1,5,0,1012,1.0,1.0,0.17,0.41
PF10454,PF06695:PF15062:PF02427,0,0,0,0,0,1018,0,1.0,0,0,0,0,0,0,1018,0,1.0,0,0
PF15797,PF10104:PF15045:PF07051,4,9,1,3,8,1006,0.11,0.99,0.25,0.16,0,0,4,0,1014,0,1.0,0.0,0
PF00049,PF08365:PF00375:PF10261,8,15,3,5,12,998,0.2,0.98,0.38,0.27,1,1,7,0,1010,1.0,0.99,0.12,0.35
PF13241,PF14823:PF14824:PF00590,10,23,10,0,13,995,0.43,0.99,1.0,0.66,9,9,1,0,1008,1.0,1.0,0.9,0.95
PF13548,PF13677:PF16925:PF02369,1,1,0,1,1,1016,0.0,1.0,0.0,-0.0,0,0,1,0,1017,0,1.0,0.0,0
PF11315,PF14279:PF07809:PF00127,5,3,0,5,3,1010,0.0,0.99,0.0,-0.0,0,0,5,0,1013,0,1.0,0.0,0
PF13908,PF14719:PF09398:PF08265,2,19,0,2,19,997,0.0,0.98,0.0,-0.01,2,0,2,2,1014,0.0,1.0,0.0,-0.0
PF00348,PF03834:PF01215:PF06244,45,30,16,29,14,959,0.53,0.96,0.36,0.41,5,4,41,1,972,0.8,0.96,0.09,0.26
PF06008,PF06009:PF00055:PF03801,4,29,3,1,26,988,0.1,0.97,0.75,0.27,5,3,1,2,1012,0.6,1.0,0.75,0.67
PF12567,PF12453:PF16066:PF03673,2,2,2,0,0,1016,1.0,1.0,1.0,1.0,1,1,1,0,1016,1.0,1.0,0.5,0.71
PF08599,PF14348:PF16771:PF11862,1,2,0,1,2,1015,0.0,1.0,0.0,-0.0,0,0,1,0,1017,0,1.0,0.0,0
PF16501,PF11500:PF05715:PF10377,0,8,0,0,8,1010,0.0,0.99,0,0,1,0,0,1,1017,0.0,1.0,0,0
PF15191,PF14621:PF12012:PF02165,0,11,0,0,11,1007,0.0,0.99,0,0,1,0,0,1,1017,0.0,1.0,0,0
PF15454,PF10224:PF10780:PF10244,4,10,2,2,8,1006,0.2,0.99,0.5,0.31,2,0,4,2,1012,0.0,0.99,0.0,-0.0
PF02495,PF11731:PF05929:PF04672,0,0,0,0,0,1018,0,1.0,0,0,0,0,0,0,1018,0,1.0,0,0
PF11304,PF08479:PF10554:PF11019,0,0,0,0,0,1018,0,1.0,0,0,0,0,0,0,1018,0,1.0,0,0
PF11851,PF15951:PF01056:PF02344,1,14,1,0,13,1004,0.07,0.99,1.0,0.27,4,1,0,3,1014,0.25,1.0,1.0,0.5
PF07642,PF04958:PF09694:PF03402,0,6,0,0,6,1012,0.0,0.99,0,0,0,0,0,0,1018,0,1.0,0,0
PF02828,PF00625:PF10608:PF09060,9,40,9,0,31,978,0.23,0.97,1.0,0.47,1,1,8,0,1009,1.0,0.99,0.11,0.33
PF04904,PF04902:PF04905:PF15025,2,6,2,0,4,1012,0.33,1.0,1.0,0.58,1,0,2,1,1015,0.0,1.0,0.0,-0.0
PF09237,PF09494:PF12507:PF03131,3,23,2,1,21,994,0.09,0.98,0.67,0.24,4,1,2,3,1012,0.25,1.0,0.33,0.29
PF09923,PF16416:PF04279:PF14983,2,3,0,2,3,1013,0.0,1.0,0.0,-0.0,0,0,2,0,1016,0,1.0,0.0,0
PF08226,PF12761:PF08824:PF05640,12,9,2,10,7,999,0.22,0.98,0.17,0.18,1,1,11,0,1006,1.0,0.99,0.08,0.29
PF04354,PF06586:PF07178:PF02924,1,1,0,1,1,1016,0.0,1.0,0.0,-0.0,1,0,1,1,1016,0.0,1.0,0.0,-0.0
PF08314,PF15492:PF17167:PF08696,5,12,1,4,11,1002,0.08,0.99,0.2,0.12,1,0,5,1,1012,0.0,0.99,0.0,-0.0
PF06393,PF02941:PF15107:PF15085,2,3,0,2,3,1013,0.0,1.0,0.0,-0.0,0,0,2,0,1016,0,1.0,0.0,0
PF01359,PF06159:PF07542:PF14811,45,16,7,38,9,964,0.44,0.95,0.16,0.24,2,1,44,1,972,0.5,0.96,0.02,0.1
PF07523,PF09327:PF06458:PF04740,0,0,0,0,0,1018,0,1.0,0,0,0,0,0,0,1018,0,1.0,0,0
PF05652,PF06414:PF10179:PF01432,11,36,7,4,29,978,0.19,0.97,0.64,0.34,3,2,9,1,1006,0.67,0.99,0.18,0.34
PF04423,PF16034:PF07989:PF16574,4,16,1,3,15,999,0.06,0.98,0.25,0.12,1,0,4,1,1013,0.0,1.0,0.0,-0.0
PF02669,PF03814:PF06798:PF02277,1,4,1,0,3,1014,0.25,1.0,1.0,0.5,0,0,1,0,1017,0,1.0,0.0,0
PF12854,PF13041:PF03612:PF13762,62,131,60,2,71,885,0.46,0.93,0.97,0.64,1,0,62,1,955,0.0,0.94,0.0,-0.01
PF05709,PF03522:PF00310:PF04898,0,27,0,0,27,991,0.0,0.97,0,0,7,0,0,7,1011,0.0,0.99,0,0
PF14885,PF17049:PF00669:PF03548,1,5,0,1,5,1012,0.0,0.99,0.0,-0.0,0,0,1,0,1017,0,1.0,0.0,0
PF01654,PF07681:PF14962:PF00070,5,6,2,3,4,1009,0.33,0.99,0.4,0.36,1,1,4,0,1013,1.0,1.0,0.2,0.45
PF04156,PF12362:PF06181:PF08093,0,2,0,0,2,1016,0.0,1.0,0,0,0,0,0,0,1018,0,1.0,0,0
PF04177,PF15377:PF08038:PF00235,11,13,4,7,9,998,0.31,0.98,0.36,0.33,0,0,11,0,1007,0,0.99,0.0,0
PF11620,PF04621:PF00178:PF15661,2,30,2,0,28,988,0.07,0.97,1.0,0.25,5,2,0,3,1013,0.4,1.0,1.0,0.63
PF10544,PF04383:PF04665:PF03288,12,7,4,8,3,1003,0.57,0.99,0.33,0.43,1,1,11,0,1006,1.0,0.99,0.08,0.29
PF04349,PF01514:PF03944:PF03616,0,3,0,0,3,1015,0.0,1.0,0,0,0,0,0,0,1018,0,1.0,0,0
PF09912,PF11128:PF05463:PF11750,0,1,0,0,1,1017,0.0,1.0,0,0,0,0,0,0,1018,0,1.0,0,0
PF15749,PF01666:PF13810:PF08208,4,6,0,4,6,1008,0.0,0.99,0.0,-0.0,0,0,4,0,1014,0,1.0,0.0,0
PF08137,PF09419:PF11264:PF12023,0,13,0,0,13,1005,0.0,0.99,0,0,3,0,0,3,1015,0.0,1.0,0,0
PF09271,PF09270:PF16422:PF16423,13,15,13,0,2,1003,0.87,1.0,1.0,0.93,3,2,11,1,1004,0.67,0.99,0.15,0.32
PF04076,PF04451:PF02413:PF08795,0,1,0,0,1,1017,0.0,1.0,0,0,0,0,0,0,1018,0,1.0,0,0
PF00786,PF05210:PF13281:PF08776,32,14,7,25,7,979,0.5,0.97,0.22,0.32,4,3,29,1,985,0.75,0.97,0.09,0.26
PF06060,PF14674:PF14677:PF14678,2,4,0,2,4,1012,0.0,0.99,0.0,-0.0,1,0,2,1,1015,0.0,1.0,0.0,-0.0
PF15389,PF12540:PF15230:PF12478,1,6,0,1,6,1011,0.0,0.99,0.0,-0.0,0,0,1,0,1017,0,1.0,0.0,0
PF11838,PF01433:PF11940:PF12612,37,58,35,2,23,958,0.6,0.98,0.95,0.74,10,6,31,4,977,0.6,0.97,0.16,0.3
PF03878,PF07809:PF09419:PF07816,11,11,1,10,10,997,0.09,0.98,0.09,0.08,0,0,11,0,1007,0,0.99,0.0,0
PF02408,PF12733:PF03385:PF14764,2,6,1,1,5,1011,0.17,0.99,0.5,0.29,1,1,1,0,1016,1.0,1.0,0.5,0.71
PF03613,PF14328:PF04954:PF07495,0,1,0,0,1,1017,0.0,1.0,0,0,0,0,0,0,1018,0,1.0,0,0
PF05542,PF02470:PF01980:PF04921,3,16,1,2,15,1000,0.06,0.98,0.33,0.14,0,0,3,0,1015,0,1.0,0.0,0
PF00459,PF12311:PF00810:PF10185,27,17,9,18,8,983,0.53,0.97,0.33,0.41,2,2,25,0,991,1.0,0.98,0.07,0.27
PF13911,PF01632:PF02046:PF01097,17,11,1,16,10,991,0.09,0.97,0.06,0.06,0,0,17,0,1001,0,0.98,0.0,0
PF01263,PF05042:PF00197:PF04520,21,5,1,20,4,993,0.2,0.98,0.05,0.09,0,0,21,0,997,0,0.98,0.0,0
PF11974,PF02655:PF05488:PF15322,1,2,0,1,2,1015,0.0,1.0,0.0,-0.0,0,0,1,0,1017,0,1.0,0.0,0
PF01077,PF03460:PF13806:PF01855,15,25,15,0,10,993,0.6,0.99,1.0,0.77,13,13,2,0,1003,1.0,1.0,0.87,0.93
PF06277,PF11921:PF16094:PF12369,0,6,0,0,6,1012,0.0,0.99,0,0,2,0,0,2,1016,0.0,1.0,0,0
PF01352,PF02023:PF12417:PF14291,43,34,16,27,18,957,0.47,0.96,0.37,0.4,9,8,35,1,974,0.89,0.96,0.19,0.4
PF08608,PF13597:PF06969:PF12345,12,4,2,10,2,1004,0.5,0.99,0.17,0.28,2,2,10,0,1006,1.0,0.99,0.17,0.41
PF09663,PF15128:PF01752:PF05857,2,2,0,2,2,1014,0.0,1.0,0.0,-0.0,0,0,2,0,1016,0,1.0,0.0,0
PF00848,PF08802:PF04305:PF08417,13,16,5,8,11,994,0.31,0.98,0.38,0.34,3,3,10,0,1005,1.0,0.99,0.23,0.48
PF14316,PF08093:PF07192:PF08291,0,1,0,0,1,1017,0.0,1.0,0,0,0,0,0,0,1018,0,1.0,0,0
PF05725,PF00526:PF06151:PF17210,21,9,1,20,8,989,0.11,0.97,0.05,0.06,0,0,21,0,997,0,0.98,0.0,0
PF10452,PF03553:PF03275:PF15175,2,2,0,2,2,1014,0.0,1.0,0.0,-0.0,0,0,2,0,1016,0,1.0,0.0,0
PF11711,PF10775:PF13741:PF15910,1,2,0,1,2,1015,0.0,1.0,0.0,-0.0,0,0,1,0,1017,0,1.0,0.0,0
PF10632,PF09072:PF03442:PF16499,1,24,1,0,23,994,0.04,0.98,1.0,0.2,7,1,0,6,1011,0.14,0.99,1.0,0.38
PF05930,PF15529:PF14841:PF14842,0,1,0,0,1,1017,0.0,1.0,0,0,0,0,0,0,1018,0,1.0,0,0
PF04063,PF04064:PF04615:PF16086,3,18,3,0,15,1000,0.17,0.99,1.0,0.41,1,1,2,0,1015,1.0,1.0,0.33,0.58
PF10348,PF10355:PF16978:PF09729,7,22,7,0,15,996,0.32,0.99,1.0,0.56,3,2,5,1,1010,0.67,0.99,0.29,0.43
PF12087,PF10061:PF12276:PF05523,0,0,0,0,0,1018,0,1.0,0,0,0,0,0,0,1018,0,1.0,0,0
PF11703,PF15703:PF15551:PF15814,0,0,0,0,0,1018,0,1.0,0,0,0,0,0,0,1018,0,1.0,0,0
PF11954,PF07930:PF01427:PF06176,5,5,0,5,5,1008,0.0,0.99,0.0,-0.0,0,0,5,0,1013,0,1.0,0.0,0
PF01153,PF04636:PF04155:PF13695,11,21,1,10,20,987,0.05,0.97,0.09,0.05,3,0,11,3,1004,0.0,0.99,0.0,-0.01
PF07265,PF12044:PF07735:PF00984,0,21,0,0,21,997,0.0,0.98,0,0,1,0,0,1,1017,0.0,1.0,0,0
PF11019,PF05840:PF02277:PF03090,0,3,0,0,3,1015,0.0,1.0,0,0,0,0,0,0,1018,0,1.0,0,0
PF12542,PF16741:PF16099:PF11521,12,5,0,12,5,1001,0.0,0.98,0.0,-0.01,0,0,12,0,1006,0,0.99,0.0,0
PF12922,PF12717:PF12157:PF12887,17,29,17,0,12,989,0.59,0.99,1.0,0.76,2,2,15,0,1001,1.0,0.99,0.12,0.34
PF13340,PF09684:PF04586:PF02452,3,4,2,1,2,1013,0.5,1.0,0.67,0.58,0,0,3,0,1015,0,1.0,0.0,0
PF08432,PF02399:PF13995:PF17014,0,2,0,0,2,1016,0.0,1.0,0,0,0,0,0,0,1018,0,1.0,0,0
PF13017,PF00505:PF09011:PF13775,2,62,1,1,61,955,0.02,0.94,0.5,0.08,16,1,1,15,1001,0.06,0.98,0.5,0.17
PF04603,PF01774:PF02284:PF06108,4,18,2,2,16,998,0.11,0.98,0.5,0.23,1,0,4,1,1013,0.0,1.0,0.0,-0.0
PF01128,PF04736:PF06581:PF15370,4,4,0,4,4,1010,0.0,0.99,0.0,-0.0,0,0,4,0,1014,0,1.0,0.0,0
PF09754,PF06127:PF01097:PF09631,6,16,1,5,15,997,0.06,0.98,0.17,0.09,1,0,6,1,1011,0.0,0.99,0.0,-0.0
PF10846,PF15211:PF10992:PF15047,8,2,0,8,2,1008,0.0,0.99,0.0,-0.0,0,0,8,0,1010,0,0.99,0.0,0
PF10327,PF10325:PF10319:PF10318,5,16,4,1,12,1001,0.25,0.99,0.8,0.44,2,1,4,1,1012,0.5,1.0,0.2,0.31
PF13468,PF07961:PF08228:PF09232,7,3,0,7,3,1008,0.0,0.99,0.0,-0.0,0,0,7,0,1011,0,0.99,0.0,0
PF08676,PF16413:PF01119:PF09239,24,28,15,9,13,981,0.54,0.98,0.62,0.57,13,4,20,9,985,0.31,0.97,0.17,0.21
PF05972,PF05923:PF05924:PF16704,7,10,7,0,3,1008,0.7,1.0,1.0,0.84,7,7,0,0,1011,1.0,1.0,1.0,1.0
PF10662,PF05128:PF06780:PF15086,2,3,1,1,2,1014,0.33,1.0,0.5,0.41,1,1,1,0,1016,1.0,1.0,0.5,0.71
PF07486,PF07805:PF03406:PF09951,2,1,0,2,1,1015,0.0,1.0,0.0,-0.0,0,0,2,0,1016,0,1.0,0.0,0
PF10033,PF16944:PF05030:PF00649,2,15,0,2,15,1001,0.0,0.98,0.0,-0.01,1,0,2,1,1015,0.0,1.0,0.0,-0.0
PF13874,PF05064:PF13634:PF12314,15,21,7,8,14,989,0.33,0.98,0.47,0.38,3,2,13,1,1002,0.67,0.99,0.13,0.29
PF00661,PF09538:PF00035:PF00933,1,68,0,1,68,949,0.0,0.93,0.0,-0.01,21,0,1,21,996,0.0,0.98,0.0,-0.0
PF14061,PF16737:PF14051:PF12269,6,12,2,4,10,1002,0.17,0.99,0.33,0.23,2,1,5,1,1011,0.5,0.99,0.17,0.29
PF00756,PF12311:PF05724:PF08584,17,16,3,14,13,988,0.19,0.97,0.18,0.17,0,0,17,0,1001,0,0.98,0.0,0
PF13741,PF10775:PF10310:PF08656,2,2,1,1,1,1015,0.5,1.0,0.5,0.5,2,1,1,1,1015,0.5,1.0,0.5,0.5
PF17123,PF14624:PF13436:PF13639,17,123,15,2,108,893,0.12,0.89,0.88,0.3,7,6,11,1,1000,0.86,0.99,0.35,0.55
PF09801,PF05512:PF06219:PF03239,8,11,0,8,11,999,0.0,0.98,0.0,-0.01,1,0,8,1,1009,0.0,0.99,0.0,-0.0
PF08383,PF00473:PF15010:PF01705,4,13,1,3,12,1002,0.08,0.99,0.25,0.13,2,1,3,1,1013,0.5,1.0,0.25,0.35
PF00086,PF09307:PF08831:PF00095,25,32,13,12,19,974,0.41,0.97,0.52,0.44,3,3,22,0,993,1.0,0.98,0.12,0.34
PF04798,PF09585:PF02655:PF16001,0,4,0,0,4,1014,0.0,1.0,0,0,0,0,0,0,1018,0,1.0,0,0
PF07990,PF12600:PF15073:PF00806,4,22,3,1,19,995,0.14,0.98,0.75,0.31,0,0,4,0,1014,0,1.0,0.0,0
PF02912,PF03147:PF08279:PF09012,5,25,4,1,21,992,0.16,0.98,0.8,0.35,4,3,2,1,1012,0.75,1.0,0.6,0.67
PF11022,PF03401:PF11697:PF08497,0,1,0,0,1,1017,0.0,1.0,0,0,0,0,0,0,1018,0,1.0,0,0
PF16180,PF16181:PF00554:PF16179,2,18,2,0,16,1000,0.11,0.98,1.0,0.33,16,2,0,14,1002,0.12,0.99,1.0,0.35
PF02491,PF12327:PF14819:PF08114,2,7,2,0,5,1011,0.29,1.0,1.0,0.53,0,0,2,0,1016,0,1.0,0.0,0
PF11369,PF17084:PF11638:PF06890,0,2,0,0,2,1016,0.0,1.0,0,0,0,0,0,0,1018,0,1.0,0,0
PF09810,PF10303:PF04422:PF04432,4,1,0,4,1,1013,0.0,1.0,0.0,-0.0,0,0,4,0,1014,0,1.0,0.0,0
PF06535,PF06534:PF05076:PF17187,0,4,0,0,4,1014,0.0,1.0,0,0,1,0,0,1,1017,0.0,1.0,0,0
PF08765,PF11421:PF07497:PF07498,0,14,0,0,14,1004,0.0,0.99,0,0,3,0,0,3,1015,0.0,1.0,0,0
PF08449,PF00827:PF05510:PF15388,29,16,8,21,8,981,0.5,0.97,0.28,0.36,2,2,27,0,989,1.0,0.97,0.07,0.26
PF07214,PF12834:PF03934:PF17007,0,2,0,0,2,1016,0.0,1.0,0,0,0,0,0,0,1018,0,1.0,0,0
PF16891,PF04152:PF05011:PF10360,14,25,6,8,19,985,0.24,0.97,0.43,0.31,6,3,11,3,1001,0.5,0.99,0.21,0.32
PF12260,PF14875:PF01012:PF15985,10,30,4,6,26,982,0.13,0.97,0.4,0.22,4,1,9,3,1005,0.25,0.99,0.1,0.15
PF11503,PF00954:PF13965:PF04474,0,27,0,0,27,991,0.0,0.97,0,0,3,0,0,3,1015,0.0,1.0,0,0
PF03925,PF07157:PF06070:PF06505,1,1,0,1,1,1016,0.0,1.0,0.0,-0.0,0,0,1,0,1017,0,1.0,0.0,0
PF07823,PF08189:PF15014:PF07080,5,4,0,5,4,1009,0.0,0.99,0.0,-0.0,0,0,5,0,1013,0,1.0,0.0,0
PF16176,PF12598:PF11078:PF00907,4,19,4,0,15,999,0.21,0.99,1.0,0.46,2,1,3,1,1013,0.5,1.0,0.25,0.35
PF12192,PF08404:PF15128:PF08497,0,0,0,0,0,1018,0,1.0,0,0,0,0,0,0,1018,0,1.0,0,0
PF16853,PF04349:PF07833:PF13421,1,6,0,1,6,1011,0.0,0.99,0.0,-0.0,0,0,1,0,1017,0,1.0,0.0,0
PF12923,PF13865:PF08081:PF12220,14,14,6,8,8,996,0.43,0.98,0.43,0.42,2,2,12,0,1004,1.0,0.99,0.14,0.38
PF07152,PF01588:PF00579:PF00498,0,114,0,0,114,904,0.0,0.89,0,0,28,0,0,28,990,0.0,0.97,0,0
PF09844,PF15588:PF04559:PF06834,0,0,0,0,0,1018,0,1.0,0,0,0,0,0,0,1018,0,1.0,0,0
PF05958,PF03467:PF04059:PF10443,17,19,6,11,13,988,0.32,0.98,0.35,0.32,3,2,15,1,1000,0.67,0.98,0.12,0.28
PF03522,PF08403:PF00324:PF07875,17,50,16,1,34,967,0.32,0.97,0.94,0.54,1,1,16,0,1001,1.0,0.98,0.06,0.24
PF13901,PF08399:PF13768:PF15057,24,28,11,13,17,977,0.39,0.97,0.46,0.41,9,7,17,2,992,0.78,0.98,0.29,0.47
PF14049,PF14047:PF15805:PF10488,0,1,0,0,1,1017,0.0,1.0,0,0,0,0,0,0,1018,0,1.0,0,0
PF05518,PF04301:PF01957:PF10761,0,0,0,0,0,1018,0,1.0,0,0,0,0,0,0,1018,0,1.0,0,0
PF05755,PF15786:PF02569:PF09784,2,12,1,1,11,1005,0.08,0.99,0.5,0.2,0,0,2,0,1016,0,1.0,0.0,0
PF04452,PF09991:PF06954:PF15289,2,1,0,2,1,1015,0.0,1.0,0.0,-0.0,0,0,2,0,1016,0,1.0,0.0,0
PF13994,PF17029:PF16923:PF05661,0,8,0,0,8,1010,0.0,0.99,0,0,0,0,0,0,1018,0,1.0,0,0
PF08795,PF06724:PF15482:PF02277,0,3,0,0,3,1015,0.0,1.0,0,0,0,0,0,0,1018,0,1.0,0,0
PF04085,PF05065:PF15676:PF13005,0,1,0,0,1,1017,0.0,1.0,0,0,0,0,0,0,1018,0,1.0,0,0
PF06653,PF15556:PF10994:PF15828,2,2,0,2,2,1014,0.0,1.0,0.0,-0.0,0,0,2,0,1016,0,1.0,0.0,0
PF04391,PF03241:PF11751:PF14690,0,0,0,0,0,1018,0,1.0,0,0,0,0,0,0,1018,0,1.0,0,0
PF00873,PF13953:PF13954:PF00345,7,5,3,4,2,1009,0.6,0.99,0.43,0.5,3,2,5,1,1010,0.67,0.99,0.29,0.43
PF05870,PF03576:PF10340:PF09056,2,4,0,2,4,1012,0.0,0.99,0.0,-0.0,0,0,2,0,1016,0,1.0,0.0,0
PF01130,PF16969:PF05693:PF03096,23,20,7,16,13,982,0.35,0.97,0.3,0.31,2,2,21,0,995,1.0,0.98,0.09,0.29
PF15716,PF08093:PF05853:PF15175,0,2,0,0,2,1016,0.0,1.0,0,0,0,0,0,0,1018,0,1.0,0,0
PF06087,PF10283:PF08797:PF10228,22,31,13,9,18,978,0.42,0.97,0.59,0.48,11,8,14,3,993,0.73,0.98,0.36,0.51
PF01944,PF14258:PF07499:PF13722,0,2,0,0,2,1016,0.0,1.0,0,0,0,0,0,0,1018,0,1.0,0,0
PF01645,PF04898:PF00310:PF14691,6,17,6,0,11,1001,0.35,0.99,1.0,0.59,7,6,0,1,1011,0.86,1.0,1.0,0.93
PF15902,PF15901:PF06328:PF12772,13,9,9,4,0,1005,1.0,1.0,0.69,0.83,4,4,9,0,1005,1.0,0.99,0.31,0.55
PF03244,PF06890:PF01312:PF15281,0,3,0,0,3,1015,0.0,1.0,0,0,0,0,0,0,1018,0,1.0,0,0
PF05109,PF03729:PF08708:PF10411,0,0,0,0,0,1018,0,1.0,0,0,0,0,0,0,1018,0,1.0,0,0
PF12414,PF08081:PF12220:PF08143,4,5,2,2,3,1011,0.4,1.0,0.5,0.44,1,1,3,0,1014,1.0,1.0,0.25,0.5
PF03578,PF10284:PF10285:PF07276,0,0,0,0,0,1018,0,1.0,0,0,0,0,0,0,1018,0,1.0,0,0
PF12886,PF12884:PF14438:PF12885,3,15,3,0,12,1003,0.2,0.99,1.0,0.44,2,2,1,0,1015,1.0,1.0,0.67,0.82
PF13962,PF00710:PF07693:PF14420,16,29,5,11,24,978,0.17,0.97,0.31,0.22,5,4,12,1,1001,0.8,0.99,0.25,0.44
PF04146,PF03467:PF10453:PF05030,25,22,9,16,13,980,0.41,0.97,0.36,0.37,2,2,23,0,993,1.0,0.98,0.08,0.28
PF08941,PF06803:PF15815:PF16207,8,16,4,4,12,998,0.25,0.98,0.5,0.35,4,1,7,3,1007,0.25,0.99,0.12,0.17
PF08563,PF07710:PF00870:PF11619,2,5,2,0,3,1013,0.4,1.0,1.0,0.63,2,2,0,0,1016,1.0,1.0,1.0,1.0
PF06414,PF10179:PF10672:PF12576,11,7,0,11,7,1000,0.0,0.98,0.0,-0.01,1,0,11,1,1006,0.0,0.99,0.0,-0.0
PF00048,PF13841:PF01294:PF14798,13,6,3,10,3,1002,0.5,0.99,0.23,0.33,1,1,12,0,1005,1.0,0.99,0.08,0.28
PF03856,PF00473:PF02576:PF14279,8,5,1,7,4,1006,0.2,0.99,0.12,0.15,0,0,8,0,1010,0,0.99,0.0,0
PF10157,PF01221:PF06039:PF10454,10,18,5,5,13,995,0.28,0.98,0.5,0.36,1,0,10,1,1007,0.0,0.99,0.0,-0.0
PF01783,PF08583:PF06645:PF00159,8,22,3,5,19,991,0.14,0.98,0.38,0.22,2,1,7,1,1009,0.5,0.99,0.12,0.25
PF06080,PF05811:PF14713:PF01158,10,13,2,8,11,997,0.15,0.98,0.2,0.17,2,2,8,0,1008,1.0,0.99,0.2,0.45
PF00752,PF12246:PF00867:PF12247,30,39,30,0,9,979,0.77,0.99,1.0,0.87,2,1,29,1,987,0.5,0.97,0.03,0.12
PF15621,PF04370:PF15062:PF11771,0,0,0,0,0,1018,0,1.0,0,0,0,0,0,0,1018,0,1.0,0,0
PF05507,PF08768:PF01549:PF05086,7,43,3,4,40,971,0.07,0.96,0.43,0.16,3,0,7,3,1008,0.0,0.99,0.0,-0.0
PF05529,PF07933:PF10208:PF10520,11,20,5,6,15,992,0.25,0.98,0.45,0.33,2,2,9,0,1007,1.0,0.99,0.18,0.42
PF12470,PF05076:PF16173:PF17187,4,4,3,1,1,1013,0.75,1.0,0.75,0.75,1,1,3,0,1014,1.0,1.0,0.25,0.5
PF01413,PF06339:PF08553:PF11693,10,10,0,10,10,998,0.0,0.98,0.0,-0.01,0,0,10,0,1008,0,0.99,0.0,0
PF16594,PF08656:PF15055:PF13933,1,2,0,1,2,1015,0.0,1.0,0.0,-0.0,0,0,1,0,1017,0,1.0,0.0,0
PF08238,PF07720:PF13374:PF01152,42,57,17,25,40,936,0.3,0.94,0.4,0.31,6,5,37,1,975,0.83,0.96,0.12,0.31
PF00248,PF00701:PF01042:PF11807,76,42,24,52,18,924,0.57,0.93,0.32,0.39,11,10,66,1,941,0.91,0.93,0.13,0.33
PF02554,PF01580:PF13722:PF04610,0,6,0,0,6,1012,0.0,0.99,0,0,2,0,0,2,1016,0.0,1.0,0,0
PF04506,PF14953:PF12465:PF16672,9,11,4,5,7,1002,0.36,0.99,0.44,0.4,1,1,8,0,1009,1.0,0.99,0.11,0.33
PF06366,PF08997:PF12578:PF06440,0,13,0,0,13,1005,0.0,0.99,0,0,1,0,0,1,1017,0.0,1.0,0,0
PF00907,PF11078:PF00853:PF12598,19,5,4,15,1,998,0.8,0.98,0.21,0.41,1,1,18,0,999,1.0,0.98,0.05,0.23
PF05046,PF10211:PF05361:PF08231,8,18,2,6,16,994,0.11,0.98,0.25,0.16,3,2,6,1,1009,0.67,0.99,0.25,0.41
PF13545,PF10137:PF16526:PF00325,3,8,1,2,7,1008,0.12,0.99,0.33,0.2,0,0,3,0,1015,0,1.0,0.0,0
PF11738,PF02217:PF06798:PF04076,0,3,0,0,3,1015,0.0,1.0,0,0,0,0,0,0,1018,0,1.0,0,0
PF16172,PF14429:PF06920:PF11878,2,21,2,0,19,997,0.1,0.98,1.0,0.31,8,2,0,6,1010,0.25,0.99,1.0,0.5
PF02151,PF02577:PF13474:PF10431,17,28,8,9,20,981,0.29,0.97,0.47,0.35,2,2,15,0,1001,1.0,0.99,0.12,0.34
PF08325,PF12057:PF09668:PF16764,7,20,5,2,15,996,0.25,0.98,0.71,0.42,2,2,5,0,1011,1.0,1.0,0.29,0.53
PF04363,PF03869:PF07505:PF06505,2,3,2,0,1,1015,0.67,1.0,1.0,0.82,0,0,2,0,1016,0,1.0,0.0,0
PF10912,PF15847:PF11341:PF14539,1,5,0,1,5,1012,0.0,0.99,0.0,-0.0,0,0,1,0,1017,0,1.0,0.0,0
PF08815,PF16279:PF08832:PF07469,6,6,6,0,0,1012,1.0,1.0,1.0,1.0,6,6,0,0,1012,1.0,1.0,1.0,1.0
PF15494,PF09272:PF02983:PF16030,10,13,3,7,10,998,0.23,0.98,0.3,0.25,1,1,9,0,1008,1.0,0.99,0.1,0.31
PF03171,PF14226:PF01066:PF13344,49,74,42,7,32,937,0.57,0.96,0.86,0.68,20,13,36,7,962,0.65,0.96,0.27,0.4
PF00650,PF03765:PF04707:PF00635,67,57,36,31,21,930,0.63,0.95,0.54,0.56,14,13,54,1,950,0.93,0.95,0.19,0.41
PF10450,PF17206:PF17193:PF10106,0,2,0,0,2,1016,0.0,1.0,0,0,0,0,0,0,1018,0,1.0,0,0
PF13664,PF09769:PF06127:PF09754,9,12,2,7,10,999,0.17,0.98,0.22,0.18,1,1,8,0,1009,1.0,0.99,0.11,0.33
PF10003,PF07584:PF05103:PF04361,0,2,0,0,2,1016,0.0,1.0,0,0,0,0,0,0,1018,0,1.0,0,0
PF08591,PF07961:PF05754:PF04691,0,1,0,0,1,1017,0.0,1.0,0,0,0,0,0,0,1018,0,1.0,0,0
PF08335,PF03710:PF01807:PF04865,3,8,3,0,5,1010,0.38,1.0,1.0,0.61,1,1,2,0,1015,1.0,1.0,0.33,0.58
PF07519,PF04479:PF11807:PF14027,19,35,10,9,25,974,0.29,0.97,0.53,0.37,13,5,14,8,991,0.38,0.98,0.26,0.31
PF07927,PF08453:PF04559:PF03241,2,2,0,2,2,1014,0.0,1.0,0.0,-0.0,0,0,2,0,1016,0,1.0,0.0,0
PF12801,PF02074:PF02551:PF12729,4,2,0,4,2,1012,0.0,0.99,0.0,-0.0,0,0,4,0,1014,0,1.0,0.0,0
PF04083,PF08386:PF06441:PF09822,28,31,6,22,25,965,0.19,0.95,0.21,0.18,5,3,25,2,988,0.6,0.97,0.11,0.25
PF08193,PF07544:PF10161:PF10340,1,7,0,1,7,1010,0.0,0.99,0.0,-0.0,0,0,1,0,1017,0,1.0,0.0,0
PF01418,PF01380:PF00585:PF06835,2,17,2,0,15,1001,0.12,0.99,1.0,0.34,2,1,1,1,1015,0.5,1.0,0.5,0.5
PF16796,PF16540:PF13931:PF14739,8,13,5,3,8,1002,0.38,0.99,0.62,0.49,3,3,5,0,1010,1.0,1.0,0.38,0.61
PF00954,PF08276:PF01453:PF04833,26,42,24,2,18,974,0.57,0.98,0.92,0.72,18,17,9,1,991,0.94,0.99,0.65,0.78
PF15069,PF15060:PF15231:PF15685,0,0,0,0,0,1018,0,1.0,0,0,0,0,0,0,1018,0,1.0,0,0
PF01591,PF00300:PF10419:PF09741,19,74,18,1,56,943,0.24,0.94,0.95,0.46,5,5,14,0,999,1.0,0.99,0.26,0.51
PF14799,PF06232:PF10244:PF14935,6,12,1,5,11,1001,0.08,0.98,0.17,0.11,2,1,5,1,1011,0.5,0.99,0.17,0.29
PF12610,PF09267:PF02864:PF12162,0,4,0,0,4,1014,0.0,1.0,0,0,2,0,0,2,1016,0.0,1.0,0,0
PF13530,PF08479:PF08411:PF11019,2,1,0,2,1,1015,0.0,1.0,0.0,-0.0,0,0,2,0,1016,0,1.0,0.0,0
PF08638,PF04048:PF14649:PF12372,9,18,2,7,16,993,0.11,0.98,0.22,0.15,3,1,8,2,1007,0.33,0.99,0.11,0.19
PF01219,PF06277:PF05999:PF05445,1,2,0,1,2,1015,0.0,1.0,0.0,-0.0,0,0,1,0,1017,0,1.0,0.0,0
PF00031,PF16845:PF00112:PF15371,9,63,7,2,56,953,0.11,0.94,0.78,0.28,4,2,7,2,1007,0.5,0.99,0.22,0.33
PF08577,PF10573:PF01080:PF04300,3,20,0,3,20,995,0.0,0.98,0.0,-0.01,2,0,3,2,1013,0.0,1.0,0.0,-0.0
PF06485,PF17078:PF11652:PF08653,4,3,0,4,3,1011,0.0,0.99,0.0,-0.0,0,0,4,0,1014,0,1.0,0.0,0
PF03094,PF00244:PF03759:PF11955,11,32,7,4,25,982,0.22,0.97,0.64,0.36,5,4,7,1,1006,0.8,0.99,0.36,0.54
PF03718,PF07080:PF08189:PF15725,1,3,0,1,3,1014,0.0,1.0,0.0,-0.0,0,0,1,0,1017,0,1.0,0.0,0
PF16187,PF08367:PF00675:PF05193,20,64,20,0,44,954,0.31,0.96,1.0,0.55,53,18,2,35,963,0.34,0.96,0.9,0.54
PF16568,PF16551:PF16544:PF09005,1,12,1,0,11,1006,0.08,0.99,1.0,0.29,2,1,0,1,1016,0.5,1.0,1.0,0.71
PF00837,PF02106:PF05238:PF15302,3,0,0,3,0,1015,0,1.0,0.0,0,0,0,3,0,1015,0,1.0,0.0,0
PF09117,PF11630:PF14672:PF12046,0,0,0,0,0,1018,0,1.0,0,0,0,0,0,0,1018,0,1.0,0,0
PF01552,PF12080:PF00947:PF07476,12,12,12,0,0,1006,1.0,1.0,1.0,1.0,0,0,12,0,1006,0,0.99,0.0,0
PF11556,PF12361:PF12377:PF15445,1,1,1,0,0,1017,1.0,1.0,1.0,1.0,1,1,0,0,1017,1.0,1.0,1.0,1.0
PF04350,PF11794:PF12241:PF04351,0,1,0,0,1,1017,0.0,1.0,0,0,0,0,0,0,1018,0,1.0,0,0
PF05733,PF02087:PF09461:PF12158,1,2,0,1,2,1015,0.0,1.0,0.0,-0.0,0,0,1,0,1017,0,1.0,0.0,0
PF02140,PF01301:PF10102:PF10435,31,32,14,17,18,969,0.44,0.97,0.45,0.43,6,4,27,2,985,0.67,0.97,0.13,0.29
PF14318,PF00946:PF03929:PF08762,4,11,4,0,7,1007,0.36,0.99,1.0,0.6,1,1,3,0,1014,1.0,1.0,0.25,0.5
PF05175,PF00155:PF13847:PF01040,27,135,14,13,121,870,0.1,0.87,0.52,0.19,31,10,17,21,970,0.32,0.96,0.37,0.33
PF12869,PF04122:PF09397:PF10043,3,5,2,1,3,1012,0.4,1.0,0.67,0.51,0,0,3,0,1015,0,1.0,0.0,0
PF11971,PF08683:PF17095:PF16523,11,9,8,3,1,1006,0.89,1.0,0.73,0.8,6,6,5,0,1007,1.0,1.0,0.55,0.74
PF07692,PF15872:PF10856:PF00603,2,2,0,2,2,1014,0.0,1.0,0.0,-0.0,0,0,2,0,1016,0,1.0,0.0,0
PF14853,PF14852:PF00101:PF16205,5,18,4,1,14,999,0.22,0.99,0.8,0.42,3,1,4,2,1011,0.33,0.99,0.2,0.26
PF11705,PF12131:PF08127:PF08660,8,11,1,7,10,1000,0.09,0.98,0.12,0.1,2,0,8,2,1008,0.0,0.99,0.0,-0.0
PF01124,PF00210:PF02284:PF07947,12,20,5,7,15,991,0.25,0.98,0.42,0.31,4,3,9,1,1005,0.75,0.99,0.25,0.43
PF10284,PF10285:PF05295:PF02057,0,1,0,0,1,1017,0.0,1.0,0,0,0,0,0,0,1018,0,1.0,0,0
PF03645,PF03358:PF04420:PF04176,20,29,7,13,22,976,0.24,0.97,0.35,0.27,3,3,17,0,998,1.0,0.98,0.15,0.38
PF11873,PF04466:PF01514:PF03592,0,0,0,0,0,1018,0,1.0,0,0,0,0,0,0,1018,0,1.0,0,0
PF01502,PF01503:PF00815:PF11597,15,26,11,4,15,988,0.42,0.98,0.73,0.55,8,8,7,0,1003,1.0,0.99,0.53,0.73
PF01980,PF04706:PF12240:PF13870,1,10,1,0,9,1008,0.1,0.99,1.0,0.31,1,1,0,0,1017,1.0,1.0,1.0,1.0
PF14926,PF15504:PF15130:PF12264,1,6,1,0,5,1012,0.17,1.0,1.0,0.41,0,0,1,0,1017,0,1.0,0.0,0
PF03859,PF00710:PF16553:PF07693,7,20,4,3,16,995,0.2,0.98,0.57,0.33,3,3,4,0,1011,1.0,1.0,0.43,0.65
PF02634,PF12931:PF00335:PF08614,1,58,0,1,58,959,0.0,0.94,0.0,-0.01,11,0,1,11,1006,0.0,0.99,0.0,-0.0
PF13402,PF02368:PF15627:PF12036,3,7,0,3,7,1008,0.0,0.99,0.0,-0.0,1,0,3,1,1014,0.0,1.0,0.0,-0.0
PF08453,PF01752:PF00669:PF01514,2,3,2,0,1,1015,0.67,1.0,1.0,0.82,0,0,2,0,1016,0,1.0,0.0,0
PF12160,PF08702:PF00147:PF05889,3,51,3,0,48,967,0.06,0.95,1.0,0.24,4,3,0,1,1014,0.75,1.0,1.0,0.87
PF02754,PF02589:PF11870:PF02652,7,9,7,0,2,1009,0.78,1.0,1.0,0.88,1,1,6,0,1011,1.0,0.99,0.14,0.38
PF00969,PF00993:PF16196:PF10420,3,1,0,3,1,1014,0.0,1.0,0.0,-0.0,0,0,3,0,1015,0,1.0,0.0,0
PF14571,PF05605:PF03868:PF03986,2,29,2,0,27,989,0.07,0.97,1.0,0.26,6,1,1,5,1011,0.17,0.99,0.5,0.29
PF08691,PF06681:PF08708:PF06745,0,0,0,0,0,1018,0,1.0,0,0,0,0,0,0,1018,0,1.0,0,0
PF02233,PF12769:PF05222:PF01262,7,20,7,0,13,998,0.35,0.99,1.0,0.59,9,7,0,2,1009,0.78,1.0,1.0,0.88
PF03348,PF05251:PF07745:PF00148,16,9,5,11,4,998,0.56,0.99,0.31,0.41,1,0,16,1,1001,0.0,0.98,0.0,-0.0
PF12366,PF15927:PF08166:PF11597,2,10,2,0,8,1008,0.2,0.99,1.0,0.45,3,1,1,2,1014,0.33,1.0,0.5,0.41
PF01475,PF15483:PF15976:PF13247,4,1,0,4,1,1013,0.0,1.0,0.0,-0.0,0,0,4,0,1014,0,1.0,0.0,0
PF06752,PF04126:PF16756:PF00114,3,3,0,3,3,1012,0.0,0.99,0.0,-0.0,0,0,3,0,1015,0,1.0,0.0,0
PF04365,PF10335:PF02556:PF14334,0,7,0,0,7,1011,0.0,0.99,0,0,0,0,0,0,1018,0,1.0,0,0
PF04962,PF02653:PF13732:PF08402,5,15,5,0,10,1003,0.33,0.99,1.0,0.57,5,3,2,2,1011,0.6,1.0,0.6,0.6
PF03351,PF10517:PF01082:PF03188,19,43,18,1,25,974,0.42,0.97,0.95,0.62,8,6,13,2,997,0.75,0.99,0.32,0.48
PF00390,PF03949:PF04515:PF16401,19,28,14,5,14,985,0.5,0.98,0.74,0.6,4,3,16,1,998,0.75,0.98,0.16,0.34
PF03110,PF08313:PF05182:PF08729,5,27,2,3,25,988,0.07,0.97,0.4,0.16,6,2,3,4,1009,0.33,0.99,0.4,0.36
PF03188,PF04526:PF03351:PF16010,28,30,12,16,18,972,0.4,0.97,0.43,0.4,8,4,24,4,986,0.5,0.97,0.14,0.26
PF05663,PF07757:PF10360:PF10394,0,23,0,0,23,995,0.0,0.98,0,0,5,0,0,5,1013,0.0,1.0,0,0
PF09418,PF12126:PF15451:PF03915,3,8,1,2,7,1008,0.12,0.99,0.33,0.2,3,1,2,2,1013,0.33,1.0,0.33,0.33
PF06024,PF09087:PF05400:PF10438,1,1,1,0,0,1017,1.0,1.0,1.0,1.0,1,1,0,0,1017,1.0,1.0,1.0,1.0
PF13732,PF12399:PF08352:PF08402,5,13,3,2,10,1003,0.23,0.99,0.6,0.37,5,3,2,2,1011,0.6,1.0,0.6,0.6
PF10305,PF10359:PF10293:PF10344,4,5,4,0,1,1013,0.8,1.0,1.0,0.89,4,4,0,0,1014,1.0,1.0,1.0,1.0
PF00925,PF00926:PF12471:PF08704,10,15,7,3,8,1000,0.47,0.99,0.7,0.57,4,3,7,1,1007,0.75,0.99,0.3,0.47
PF00196,PF00486:PF04397:PF06580,8,14,4,4,10,1000,0.29,0.99,0.5,0.37,6,2,6,4,1006,0.33,0.99,0.25,0.28
PF15576,PF15829:PF15120:PF03823,1,3,0,1,3,1014,0.0,1.0,0.0,-0.0,1,0,1,1,1016,0.0,1.0,0.0,-0.0
PF11881,PF08573:PF09740:PF10495,2,9,1,1,8,1008,0.11,0.99,0.5,0.23,1,1,1,0,1016,1.0,1.0,0.5,0.71
PF10419,PF02234:PF04908:PF07200,7,26,2,5,24,987,0.08,0.97,0.29,0.14,5,1,6,4,1007,0.2,0.99,0.14,0.16
PF15118,PF06056:PF06608:PF15050,3,4,1,2,3,1012,0.25,1.0,0.33,0.29,0,0,3,0,1015,0,1.0,0.0,0
PF05524,PF02896:PF00391:PF00358,7,22,6,1,16,995,0.27,0.98,0.86,0.48,13,6,1,7,1004,0.46,0.99,0.86,0.63
PF10856,PF04624:PF08964:PF15709,0,1,0,0,1,1017,0.0,1.0,0,0,0,0,0,0,1018,0,1.0,0,0
PF03388,PF08114:PF10501:PF10147,15,6,2,13,4,999,0.33,0.98,0.13,0.2,0,0,15,0,1003,0,0.99,0.0,0
PF02178,PF12165:PF15285:PF03172,14,7,4,10,3,1001,0.57,0.99,0.29,0.4,1,1,13,0,1004,1.0,0.99,0.07,0.27
PF13722,PF07157:PF07409:PF03090,0,0,0,0,0,1018,0,1.0,0,0,0,0,0,0,1018,0,1.0,0,0
PF02010,PF01477:PF08016:PF00801,14,50,10,4,40,964,0.2,0.96,0.71,0.36,17,8,6,9,995,0.47,0.99,0.57,0.51
PF00283,PF00421:PF00101:PF00124,1,20,1,0,19,998,0.05,0.98,1.0,0.22,4,0,1,4,1013,0.0,1.0,0.0,-0.0
PF05180,PF05019:PF08698:PF05510,6,22,5,1,17,995,0.23,0.98,0.83,0.43,3,3,3,0,1012,1.0,1.0,0.5,0.71
PF08021,PF14882:PF04954:PF03831,0,0,0,0,0,1018,0,1.0,0,0,0,0,0,0,1018,0,1.0,0,0
PF04906,PF15396:PF14857:PF15388,7,8,5,2,3,1008,0.62,1.0,0.71,0.67,1,1,6,0,1011,1.0,0.99,0.14,0.38
PF14438,PF06741:PF12886:PF12884,13,14,10,3,4,1001,0.71,0.99,0.77,0.74,2,1,12,1,1004,0.5,0.99,0.08,0.19
PF14817,PF17167:PF15995:PF00073,3,15,0,3,15,1000,0.0,0.98,0.0,-0.01,0,0,3,0,1015,0,1.0,0.0,0
PF06248,PF11989:PF14844:PF05731,9,24,4,5,20,989,0.17,0.98,0.44,0.26,2,1,8,1,1008,0.5,0.99,0.11,0.23
PF15997,PF02200:PF15923:PF09038,0,2,0,0,2,1016,0.0,1.0,0,0,0,0,0,0,1018,0,1.0,0,0
PF07676,PF02897:PF00930:PF00326,23,47,13,10,34,961,0.28,0.96,0.57,0.38,24,8,15,16,979,0.33,0.97,0.35,0.32
PF07815,PF09431:PF11555:PF12026,8,13,3,5,10,1000,0.23,0.99,0.38,0.29,3,2,6,1,1009,0.67,0.99,0.25,0.41
PF02742,PF02277:PF12019:PF00419,3,5,0,3,5,1010,0.0,0.99,0.0,-0.0,0,0,3,0,1015,0,1.0,0.0,0
PF10330,PF06420:PF11489:PF03596,2,1,0,2,1,1015,0.0,1.0,0.0,-0.0,0,0,2,0,1016,0,1.0,0.0,0
PF07469,PF16279:PF08832:PF08815,3,6,3,0,3,1012,0.5,1.0,1.0,0.71,6,3,0,3,1012,0.5,1.0,1.0,0.71
PF08763,PF16885:PF16905:PF11404,8,6,4,4,2,1008,0.67,0.99,0.5,0.57,2,2,6,0,1010,1.0,0.99,0.25,0.5
PF16193,PF12002:PF05496:PF16565,14,20,14,0,6,998,0.7,0.99,1.0,0.83,5,5,9,0,1004,1.0,0.99,0.36,0.59
PF00976,PF16102:PF08035:PF08384,0,0,0,0,0,1018,0,1.0,0,0,0,0,0,0,1018,0,1.0,0,0
PF13401,PF14630:PF09079:PF00437,14,27,8,6,19,985,0.3,0.98,0.57,0.4,5,3,11,2,1002,0.6,0.99,0.21,0.35
PF03737,PF04148:PF06884:PF10455,12,13,3,9,10,996,0.23,0.98,0.25,0.23,1,0,12,1,1005,0.0,0.99,0.0,-0.0
PF15845,PF15483:PF14328:PF11211,0,1,0,0,1,1017,0.0,1.0,0,0,0,0,0,0,1018,0,1.0,0,0
PF11654,PF03379:PF15055:PF17032,1,1,0,1,1,1016,0.0,1.0,0.0,-0.0,0,0,1,0,1017,0,1.0,0.0,0
PF10537,PF15612:PF15613:PF02791,11,25,11,0,14,993,0.44,0.99,1.0,0.66,20,11,0,9,998,0.55,0.99,1.0,0.74
PF08805,PF04917:PF11751:PF08411,1,2,1,0,1,1016,0.5,1.0,1.0,0.71,0,0,1,0,1017,0,1.0,0.0,0
PF00285,PF08442:PF02629:PF00549,24,32,12,12,20,974,0.38,0.97,0.5,0.42,24,9,15,15,979,0.38,0.97,0.38,0.36
PF10994,PF15555:PF17010:PF15162,0,1,0,0,1,1017,0.0,1.0,0,0,0,0,0,0,1018,0,1.0,0,0
PF08093,PF05962:PF09365:PF12840,1,3,0,1,3,1014,0.0,1.0,0.0,-0.0,0,0,1,0,1017,0,1.0,0.0,0
PF09008,PF15518:PF11304:PF09327,0,1,0,0,1,1017,0.0,1.0,0,0,0,0,0,0,1018,0,1.0,0,0
PF10554,PF11751:PF13722:PF15518,0,1,0,0,1,1017,0.0,1.0,0,0,0,0,0,0,1018,0,1.0,0,0
PF12752,PF13902:PF17219:PF13002,12,13,3,9,10,996,0.23,0.98,0.25,0.23,1,1,11,0,1006,1.0,0.99,0.08,0.29
PF00841,PF04892:PF15775:PF03739,1,5,0,1,5,1012,0.0,0.99,0.0,-0.0,0,0,1,0,1017,0,1.0,0.0,0
PF00683,PF06816:PF00066:PF12661,7,45,7,0,38,973,0.16,0.96,1.0,0.39,9,3,4,6,1005,0.33,0.99,0.43,0.37
PF08572,PF06544:PF09186:PF01205,4,27,4,0,23,991,0.15,0.98,1.0,0.38,4,2,2,2,1012,0.5,1.0,0.5,0.5
PF03789,PF12731:PF05722:PF12737,2,1,1,1,0,1016,1.0,1.0,0.5,0.71,1,1,1,0,1016,1.0,1.0,0.5,0.71
PF04005,PF08423:PF07847:PF03932,11,51,3,8,48,959,0.06,0.94,0.27,0.11,9,2,9,7,1000,0.22,0.98,0.18,0.19
PF02862,PF02121:PF09246:PF14360,16,21,6,10,15,987,0.29,0.98,0.38,0.32,2,2,14,0,1002,1.0,0.99,0.12,0.35
PF16780,PF02798:PF00647:PF13417,1,82,1,0,81,936,0.01,0.92,1.0,0.11,24,0,1,24,993,0.0,0.98,0.0,-0.0
PF13270,PF11460:PF06989:PF11255,3,0,0,3,0,1015,0,1.0,0.0,0,0,0,3,0,1015,0,1.0,0.0,0
PF10313,PF08145:PF04494:PF12931,4,20,3,1,17,997,0.15,0.98,0.75,0.33,4,1,3,3,1011,0.25,0.99,0.25,0.25
PF04140,PF01632:PF10218:PF10252,17,6,1,16,5,996,0.17,0.98,0.06,0.09,0,0,17,0,1001,0,0.98,0.0,0
PF11413,PF08778:PF16279:PF08832,6,7,2,4,5,1007,0.29,0.99,0.33,0.3,6,2,4,4,1008,0.33,0.99,0.33,0.33
PF15496,PF17078:PF11652:PF15621,1,2,1,0,1,1016,0.5,1.0,1.0,0.71,0,0,1,0,1017,0,1.0,0.0,0
PF15196,PF07227:PF10591:PF13417,0,57,0,0,57,961,0.0,0.94,0,0,5,0,0,5,1013,0.0,1.0,0,0
PF05680,PF14542:PF14935:PF07114,5,6,1,4,5,1008,0.17,0.99,0.2,0.18,1,0,5,1,1012,0.0,0.99,0.0,-0.0
PF00401,PF16886:PF12338:PF09323,1,18,1,0,17,1000,0.06,0.98,1.0,0.23,2,1,0,1,1016,0.5,1.0,1.0,0.71
PF10717,PF03265:PF01659:PF00327,0,29,0,0,29,989,0.0,0.97,0,0,5,0,0,5,1013,0.0,1.0,0,0
PF02940,PF11538:PF03919:PF09713,8,23,2,6,21,989,0.09,0.97,0.25,0.14,4,1,7,3,1007,0.25,0.99,0.12,0.17
PF05431,PF11975:PF09678:PF12753,0,10,0,0,10,1008,0.0,0.99,0,0,0,0,0,0,1018,0,1.0,0,0
PF13724,PF14364:PF05508:PF14909,1,6,0,1,6,1011,0.0,0.99,0.0,-0.0,0,0,1,0,1017,0,1.0,0.0,0
PF05117,PF02217:PF05840:PF11124,0,3,0,0,3,1015,0.0,1.0,0,0,0,0,0,0,1018,0,1.0,0,0
PF09268,PF01394:PF10143:PF04340,5,13,3,2,10,1003,0.23,0.99,0.6,0.37,0,0,5,0,1013,0,1.0,0.0,0
PF10317,PF10319:PF02118:PF10318,9,17,2,7,15,994,0.12,0.98,0.22,0.15,2,2,7,0,1009,1.0,0.99,0.22,0.47
PF00147,PF07546:PF05889:PF12160,51,8,7,44,1,966,0.88,0.96,0.14,0.34,1,1,50,0,967,1.0,0.95,0.02,0.14
PF04928,PF04926:PF16979:PF00178,19,46,17,2,29,970,0.37,0.97,0.89,0.56,10,7,12,3,996,0.7,0.99,0.37,0.5
PF10412,PF12615:PF15281:PF06805,0,3,0,0,3,1015,0.0,1.0,0,0,0,0,0,0,1018,0,1.0,0,0
PF09962,PF09428:PF17078:PF05448,1,4,0,1,4,1013,0.0,1.0,0.0,-0.0,0,0,1,0,1017,0,1.0,0.0,0
PF04554,PF03466:PF02948:PF12933,1,12,0,1,12,1005,0.0,0.99,0.0,-0.0,1,0,1,1,1016,0.0,1.0,0.0,-0.0
PF02195,PF04736:PF16089:PF09057,8,1,0,8,1,1009,0.0,0.99,0.0,-0.0,0,0,8,0,1010,0,0.99,0.0,0
PF01632,PF10218:PF04716:PF08561,5,16,0,5,16,997,0.0,0.98,0.0,-0.01,2,0,5,2,1011,0.0,0.99,0.0,-0.0
PF15855,PF16590:PF12412:PF15758,0,1,0,0,1,1017,0.0,1.0,0,0,0,0,0,0,1018,0,1.0,0,0
PF15996,PF05041:PF00924:PF04087,8,22,5,3,17,993,0.23,0.98,0.62,0.37,0,0,8,0,1010,0,0.99,0.0,0
PF16706,PF11244:PF14047:PF11235,1,2,0,1,2,1015,0.0,1.0,0.0,-0.0,0,0,1,0,1017,0,1.0,0.0,0
PF04901,PF12020:PF02372:PF05039,2,1,0,2,1,1015,0.0,1.0,0.0,-0.0,0,0,2,0,1016,0,1.0,0.0,0
PF02679,PF10703:PF02160:PF13326,5,4,2,3,2,1011,0.5,1.0,0.4,0.44,0,0,5,0,1013,0,1.0,0.0,0
PF09458,PF14200:PF00754:PF12248,12,55,5,7,50,956,0.09,0.94,0.42,0.18,11,2,10,9,997,0.18,0.98,0.17,0.16
PF15131,PF09699:PF11123:PF06197,0,0,0,0,0,1018,0,1.0,0,0,0,0,0,0,1018,0,1.0,0,0
PF00782,PF14671:PF05631:PF01416,74,31,19,55,12,932,0.61,0.93,0.26,0.37,6,5,69,1,943,0.83,0.93,0.07,0.23
PF07428,PF03553:PF15555:PF15756,0,3,0,0,3,1015,0.0,1.0,0,0,0,0,0,0,1018,0,1.0,0,0
PF01706,PF06834:PF14841:PF14842,1,1,1,0,0,1017,1.0,1.0,1.0,1.0,0,0,1,0,1017,0,1.0,0.0,0
PF02040,PF13945:PF15624:PF00649,9,12,3,6,9,1000,0.25,0.99,0.33,0.28,1,0,9,1,1008,0.0,0.99,0.0,-0.0
PF02588,PF10035:PF09327:PF13612,2,5,2,0,3,1013,0.4,1.0,1.0,0.63,0,0,2,0,1016,0,1.0,0.0,0
PF00482,PF07963:PF06864:PF04612,1,2,1,0,1,1016,0.5,1.0,1.0,0.71,1,1,0,0,1017,1.0,1.0,1.0,1.0
PF02283,PF16586:PF11245:PF14489,2,1,0,2,1,1015,0.0,1.0,0.0,-0.0,0,0,2,0,1016,0,1.0,0.0,0
PF01078,PF00243:PF15266:PF02083,0,11,0,0,11,1007,0.0,0.99,0,0,0,0,0,0,1018,0,1.0,0,0
PF10634,PF10080:PF08021:PF15143,0,0,0,0,0,1018,0,1.0,0,0,0,0,0,0,1018,0,1.0,0,0
PF05512,PF03386:PF15003:PF06825,3,5,0,3,5,1010,0.0,0.99,0.0,-0.0,0,0,3,0,1015,0,1.0,0.0,0
PF10598,PF08082:PF10597:PF10596,13,18,13,0,5,1000,0.72,1.0,1.0,0.85,15,13,0,2,1003,0.87,1.0,1.0,0.93
PF02423,PF03619:PF02015:PF08613,5,46,3,2,43,970,0.07,0.96,0.6,0.19,8,2,3,6,1007,0.25,0.99,0.4,0.31
PF12719,PF13890:PF08514:PF15249,7,21,1,6,20,991,0.05,0.97,0.14,0.07,4,0,7,4,1007,0.0,0.99,0.0,-0.01
PF14825,PF06541:PF15109:PF11032,8,3,0,8,3,1007,0.0,0.99,0.0,-0.0,0,0,8,0,1010,0,0.99,0.0,0
PF07261,PF15771:PF15207:PF03203,0,1,0,0,1,1017,0.0,1.0,0,0,0,0,0,0,1018,0,1.0,0,0
PF01270,PF05448:PF03745:PF03238,1,2,0,1,2,1015,0.0,1.0,0.0,-0.0,0,0,1,0,1017,0,1.0,0.0,0
PF12016,PF10574:PF09786:PF01217,0,49,0,0,49,969,0.0,0.95,0,0,3,0,0,3,1015,0.0,1.0,0,0
PF06637,PF16043:PF10506:PF07557,0,13,0,0,13,1005,0.0,0.99,0,0,0,0,0,0,1018,0,1.0,0,0
PF09778,PF00277:PF00272:PF14935,2,2,0,2,2,1014,0.0,1.0,0.0,-0.0,0,0,2,0,1016,0,1.0,0.0,0
PF08755,PF13369:PF09346:PF04379,11,16,10,1,6,1001,0.62,0.99,0.91,0.75,2,2,9,0,1007,1.0,0.99,0.18,0.42
PF15675,PF16007:PF03823:PF03883,1,6,0,1,6,1011,0.0,0.99,0.0,-0.0,0,0,1,0,1017,0,1.0,0.0,0
PF04712,PF04064:PF03074:PF06534,4,7,1,3,6,1008,0.14,0.99,0.25,0.18,1,0,4,1,1013,0.0,1.0,0.0,-0.0
PF14091,PF10220:PF05212:PF01644,0,32,0,0,32,986,0.0,0.97,0,0,3,0,0,3,1015,0.0,1.0,0,0
PF14978,PF04307:PF00972:PF09498,8,6,2,6,4,1006,0.33,0.99,0.25,0.28,1,1,7,0,1010,1.0,0.99,0.12,0.35
PF06100,PF14519:PF15770:PF07327,2,1,0,2,1,1015,0.0,1.0,0.0,-0.0,0,0,2,0,1016,0,1.0,0.0,0
PF03241,PF11794:PF06798:PF02277,0,3,0,0,3,1015,0.0,1.0,0,0,0,0,0,0,1018,0,1.0,0,0
PF00157,PF03792:PF16878:PF12284,8,16,6,2,10,1000,0.38,0.99,0.75,0.53,2,2,6,0,1010,1.0,0.99,0.25,0.5
PF00510,PF00146:PF05405:PF00421,9,33,8,1,25,984,0.24,0.97,0.89,0.46,12,4,5,8,1001,0.33,0.99,0.44,0.38
PF15359,PF05039:PF15370:PF02285,2,6,0,2,6,1010,0.0,0.99,0.0,-0.0,1,0,2,1,1015,0.0,1.0,0.0,-0.0
PF03947,PF07985:PF00181:PF08294,18,30,15,3,15,985,0.5,0.98,0.83,0.64,6,5,13,1,999,0.83,0.99,0.28,0.48
PF04982,PF02033:PF06271:PF02683,7,11,0,7,11,1000,0.0,0.98,0.0,-0.01,0,0,7,0,1011,0,0.99,0.0,0
PF09344,PF01303:PF14251:PF05962,0,3,0,0,3,1015,0.0,1.0,0,0,0,0,0,0,1018,0,1.0,0,0
PF10550,PF15186:PF15224:PF06876,0,1,0,0,1,1017,0.0,1.0,0,0,0,0,0,0,1018,0,1.0,0,0
PF08466,PF01007:PF09463:PF10446,1,14,1,0,13,1004,0.07,0.99,1.0,0.27,1,0,1,1,1016,0.0,1.0,0.0,-0.0
PF10203,PF10310:PF13564:PF08649,5,10,1,4,9,1004,0.1,0.99,0.2,0.14,3,1,4,2,1011,0.33,0.99,0.2,0.26
PF00210,PF02284:PF05047:PF04176,13,18,6,7,12,993,0.33,0.98,0.46,0.38,6,3,10,3,1002,0.5,0.99,0.23,0.33
PF01764,PF04577:PF07810:PF03109,55,56,28,27,28,935,0.5,0.95,0.51,0.48,16,15,40,1,962,0.94,0.96,0.27,0.49
PF05036,PF02603:PF07475:PF03668,7,5,4,3,1,1010,0.8,1.0,0.57,0.67,4,4,3,0,1011,1.0,1.0,0.57,0.75
PF01192,PF10780:PF00159:PF06127,5,6,0,5,6,1007,0.0,0.99,0.0,-0.01,0,0,5,0,1013,0,1.0,0.0,0
PF13543,PF09128:PF09469:PF16018,2,7,0,2,7,1009,0.0,0.99,0.0,-0.0,1,0,2,1,1015,0.0,1.0,0.0,-0.0
PF10107,PF07327:PF11111:PF08026,0,2,0,0,2,1016,0.0,1.0,0,0,0,0,0,0,1018,0,1.0,0,0
PF05255,PF16839:PF10166:PF03437,10,4,2,8,2,1006,0.5,0.99,0.2,0.31,0,0,10,0,1008,0,0.99,0.0,0
PF14349,PF11593:PF01913:PF07505,2,3,0,2,3,1013,0.0,1.0,0.0,-0.0,0,0,2,0,1016,0,1.0,0.0,0
PF03248,PF06404:PF05216:PF04756,6,19,2,4,17,995,0.11,0.98,0.33,0.18,1,0,6,1,1011,0.0,0.99,0.0,-0.0
PF04632,PF16967:PF07610:PF06745,0,1,0,0,1,1017,0.0,1.0,0,0,0,0,0,0,1018,0,1.0,0,0
PF09543,PF14280:PF13464:PF12835,1,2,1,0,1,1016,0.5,1.0,1.0,0.71,1,1,0,0,1017,1.0,1.0,1.0,1.0
PF05436,PF04648:PF09367:PF01387,1,1,1,0,0,1017,1.0,1.0,1.0,1.0,0,0,1,0,1017,0,1.0,0.0,0
PF13127,PF00892:PF12804:PF00356,1,46,1,0,45,972,0.02,0.96,1.0,0.14,10,0,1,10,1007,0.0,0.99,0.0,-0.0
PF01927,PF08066:PF07750:PF00570,4,31,2,2,29,985,0.06,0.97,0.5,0.17,10,2,2,8,1006,0.2,0.99,0.5,0.31
PF09107,PF09106:PF16658:PF09173,3,7,3,0,4,1011,0.43,1.0,1.0,0.65,1,1,2,0,1015,1.0,1.0,0.33,0.58
PF17066,PF09428:PF15141:PF03548,1,4,0,1,4,1013,0.0,1.0,0.0,-0.0,0,0,1,0,1017,0,1.0,0.0,0
PF09026,PF04236:PF09607:PF04218,5,23,4,1,19,994,0.17,0.98,0.8,0.37,4,2,3,2,1011,0.5,1.0,0.4,0.44
PF04714,PF07052:PF10571:PF15242,3,13,0,3,13,1002,0.0,0.98,0.0,-0.01,0,0,3,0,1015,0,1.0,0.0,0
PF00146,PF00421:PF00507:PF00223,22,24,11,11,13,983,0.46,0.98,0.5,0.47,4,2,20,2,994,0.5,0.98,0.09,0.21
PF14645,PF05399:PF15333:PF15158,2,0,0,2,0,1016,0,1.0,0.0,0,0,0,2,0,1016,0,1.0,0.0,0
PF10231,PF12494:PF06632:PF01702,8,18,3,5,15,995,0.17,0.98,0.38,0.24,3,1,7,2,1008,0.33,0.99,0.12,0.2
PF15726,PF15851:PF06251:PF14690,0,0,0,0,0,1018,0,1.0,0,0,0,0,0,0,1018,0,1.0,0,0
PF09692,PF01878:PF08228:PF15245,1,12,1,0,11,1006,0.08,0.99,1.0,0.29,1,0,1,1,1016,0.0,1.0,0.0,-0.0
PF07958,PF05658:PF17085:PF11975,5,8,0,5,8,1005,0.0,0.99,0.0,-0.01,0,0,5,0,1013,0,1.0,0.0,0
PF02839,PF08329:PF03427:PF06483,8,4,1,7,3,1007,0.25,0.99,0.12,0.17,0,0,8,0,1010,0,0.99,0.0,0
PF14957,PF00568:PF12620:PF05210,6,23,3,3,20,992,0.13,0.98,0.5,0.25,2,2,4,0,1012,1.0,1.0,0.33,0.58
PF06702,PF15051:PF12251:PF04516,11,13,5,6,8,999,0.38,0.99,0.45,0.41,3,2,9,1,1006,0.67,0.99,0.18,0.34
PF10245,PF05219:PF03901:PF09754,8,36,4,4,32,978,0.11,0.96,0.5,0.22,5,2,6,3,1007,0.4,0.99,0.25,0.31
PF05406,PF02877:PF08063:PF00645,23,33,19,4,14,981,0.58,0.98,0.83,0.68,10,10,13,0,995,1.0,0.99,0.43,0.66
PF08609,PF10179:PF05334:PF04087,5,4,0,5,4,1009,0.0,0.99,0.0,-0.0,0,0,5,0,1013,0,1.0,0.0,0
PF07406,PF15038:PF10248:PF12926,2,4,0,2,4,1012,0.0,0.99,0.0,-0.0,0,0,2,0,1016,0,1.0,0.0,0
PF00830,PF10218:PF01632:PF10252,3,6,1,2,5,1010,0.17,0.99,0.33,0.23,0,0,3,0,1015,0,1.0,0.0,0
PF12615,PF05939:PF06890:PF10412,0,0,0,0,0,1018,0,1.0,0,0,0,0,0,0,1018,0,1.0,0,0
PF01826,PF08742:PF00094:PF09206,40,39,28,12,11,967,0.72,0.98,0.7,0.7,28,26,14,2,976,0.93,0.98,0.65,0.77
PF12020,PF04901:PF10244:PF00143,0,11,0,0,11,1007,0.0,0.99,0,0,0,0,0,0,1018,0,1.0,0,0
PF09728,PF10595:PF10234:PF15264,10,9,4,6,5,1003,0.44,0.99,0.4,0.42,0,0,10,0,1008,0,0.99,0.0,0
PF14317,PF12608:PF00066:PF11936,0,15,0,0,15,1003,0.0,0.99,0,0,3,0,0,3,1015,0.0,1.0,0,0
PF01761,PF00275:PF01202:PF01487,14,19,11,3,8,996,0.58,0.99,0.79,0.67,11,10,4,1,1003,0.91,1.0,0.71,0.8
PF10209,PF17053:PF17050:PF14290,1,1,0,1,1,1016,0.0,1.0,0.0,-0.0,0,0,1,0,1017,0,1.0,0.0,0
PF04057,PF16900:PF08646:PF01336,11,59,10,1,49,958,0.17,0.95,0.91,0.38,17,8,3,9,998,0.47,0.99,0.73,0.58
PF16953,PF17177:PF02297:PF12921,13,47,7,6,40,965,0.15,0.95,0.54,0.27,7,4,9,3,1002,0.57,0.99,0.31,0.41
PF14875,PF14382:PF14921:PF12260,2,19,2,0,17,999,0.11,0.98,1.0,0.32,2,1,1,1,1015,0.5,1.0,0.5,0.5
PF01593,PF02353:PF04433:PF02027,63,28,17,46,11,944,0.61,0.94,0.27,0.38,8,7,56,1,954,0.88,0.94,0.11,0.3
PF12264,PF08762:PF01660:PF00915,4,8,4,0,4,1010,0.5,1.0,1.0,0.71,3,3,1,0,1014,1.0,1.0,0.75,0.87
PF12899,PF14159:PF03350:PF11833,2,5,1,1,4,1012,0.2,1.0,0.5,0.31,0,0,2,0,1016,0,1.0,0.0,0
PF15733,PF12068:PF11830:PF00566,0,84,0,0,84,934,0.0,0.92,0,0,11,0,0,11,1007,0.0,0.99,0,0
PF04248,PF12853:PF10785:PF01259,4,16,0,4,16,998,0.0,0.98,0.0,-0.01,3,0,4,3,1011,0.0,0.99,0.0,-0.0
PF01205,PF06544:PF16543:PF08572,18,29,7,11,22,978,0.24,0.97,0.39,0.29,5,3,15,2,998,0.6,0.98,0.17,0.31
PF04403,PF15395:PF12381:PF16473,3,5,0,3,5,1010,0.0,0.99,0.0,-0.0,0,0,3,0,1015,0,1.0,0.0,0
PF13148,PF06805:PF09818:PF02917,0,3,0,0,3,1015,0.0,1.0,0,0,0,0,0,0,1018,0,1.0,0,0
PF15751,PF02955:PF03930:PF15518,1,5,0,1,5,1012,0.0,0.99,0.0,-0.0,0,0,1,0,1017,0,1.0,0.0,0
PF04504,PF01868:PF13864:PF15311,8,18,2,6,16,994,0.11,0.98,0.25,0.16,3,1,7,2,1008,0.33,0.99,0.12,0.2
PF02441,PF13462:PF08660:PF08584,21,22,4,17,18,979,0.18,0.97,0.19,0.17,1,1,20,0,997,1.0,0.98,0.05,0.22
PF04100,PF16854:PF06662:PF04031,6,15,4,2,11,1001,0.27,0.99,0.67,0.42,1,1,5,0,1012,1.0,1.0,0.17,0.41
PF08734,PF15175:PF15208:PF05155,1,1,1,0,0,1017,1.0,1.0,1.0,1.0,0,0,1,0,1017,0,1.0,0.0,0
PF00787,PF09325:PF12825:PF00794,78,39,29,49,10,930,0.74,0.94,0.37,0.5,9,9,69,0,940,1.0,0.93,0.12,0.33
PF10618,PF10109:PF04392:PF01580,0,7,0,0,7,1011,0.0,0.99,0,0,0,0,0,0,1018,0,1.0,0,0
PF02979,PF02277:PF06890:PF17188,3,3,0,3,3,1012,0.0,0.99,0.0,-0.0,0,0,3,0,1015,0,1.0,0.0,0
PF09829,PF08411:PF16449:PF06890,0,1,0,0,1,1017,0.0,1.0,0,0,0,0,0,0,1018,0,1.0,0,0
PF03025,PF14121:PF10335:PF06252,0,2,0,0,2,1016,0.0,1.0,0,0,0,0,0,0,1018,0,1.0,0,0
PF10114,PF05939:PF03739:PF06131,0,7,0,0,7,1011,0.0,0.99,0,0,0,0,0,0,1018,0,1.0,0,0
PF09820,PF07444:PF15109:PF07368,4,0,0,4,0,1014,0,1.0,0.0,0,0,0,4,0,1014,0,1.0,0.0,0
PF08403,PF03522:PF00324:PF07875,1,51,1,0,50,967,0.02,0.95,1.0,0.14,16,1,0,15,1002,0.06,0.99,1.0,0.25
PF10924,PF08744:PF15471:PF12479,0,0,0,0,0,1018,0,1.0,0,0,0,0,0,0,1018,0,1.0,0,0
PF02751,PF02268:PF02965:PF02607,14,17,12,2,5,999,0.71,0.99,0.86,0.77,5,1,13,4,1000,0.2,0.98,0.07,0.11
PF16200,PF15975:PF16503:PF10637,7,19,3,4,16,995,0.16,0.98,0.43,0.25,1,1,6,0,1011,1.0,0.99,0.14,0.38
PF08125,PF01232:PF07831:PF06863,7,8,6,1,2,1009,0.75,1.0,0.86,0.8,0,0,7,0,1011,0,0.99,0.0,0
PF10191,PF15964:PF00680:PF00073,7,12,2,5,10,1001,0.17,0.99,0.29,0.21,12,2,5,10,1001,0.17,0.99,0.29,0.21
PF03976,PF15817:PF08730:PF16586,0,1,0,0,1,1017,0.0,1.0,0,0,0,0,0,0,1018,0,1.0,0,0
PF15390,PF14822:PF15388:PF14798,0,5,0,0,5,1013,0.0,1.0,0,0,1,0,0,1,1017,0.0,1.0,0,0
PF09382,PF08072:PF16202:PF00570,17,31,17,0,14,987,0.55,0.99,1.0,0.74,7,7,10,0,1001,1.0,0.99,0.41,0.64
PF12077,PF12628:PF01051:PF15032,0,1,0,0,1,1017,0.0,1.0,0,0,0,0,0,0,1018,0,1.0,0,0
PF14919,PF14918:PF14920:PF09050,0,0,0,0,0,1018,0,1.0,0,0,0,0,0,0,1018,0,1.0,0,0
PF17086,PF11227:PF07719:PF08097,0,38,0,0,38,980,0.0,0.96,0,0,0,0,0,0,1018,0,1.0,0,0
PF09787,PF11831:PF15934:PF16026,7,17,2,5,15,996,0.12,0.98,0.29,0.17,0,0,7,0,1011,0,0.99,0.0,0
PF15966,PF15965:PF12366:PF05454,4,8,4,0,4,1010,0.5,1.0,1.0,0.71,2,2,2,0,1014,1.0,1.0,0.5,0.71
PF06629,PF12192:PF15355:PF10429,0,0,0,0,0,1018,0,1.0,0,0,0,0,0,0,1018,0,1.0,0,0
PF02637,PF02934:PF14687:PF16709,9,21,9,0,12,997,0.43,0.99,1.0,0.65,1,0,9,1,1008,0.0,0.99,0.0,-0.0
PF11775,PF03090:PF06798:PF03241,0,0,0,0,0,1018,0,1.0,0,0,0,0,0,0,1018,0,1.0,0,0
PF01977,PF12973:PF07543:PF03576,6,7,0,6,7,1005,0.0,0.99,0.0,-0.01,2,0,6,2,1010,0.0,0.99,0.0,-0.0
PF15216,PF15555:PF15107:PF14985,1,3,0,1,3,1014,0.0,1.0,0.0,-0.0,0,0,1,0,1017,0,1.0,0.0,0
PF05485,PF12017:PF12596:PF07776,59,63,28,31,35,924,0.44,0.94,0.47,0.42,12,11,48,1,958,0.92,0.95,0.19,0.4
PF02234,PF08209:PF11250:PF15991,8,11,0,8,11,999,0.0,0.98,0.0,-0.01,1,0,8,1,1009,0.0,0.99,0.0,-0.0
PF04577,PF02517:PF13344:PF02701,21,40,13,8,27,970,0.33,0.97,0.62,0.43,8,5,16,3,994,0.62,0.98,0.24,0.38
PF09304,PF15147:PF14564:PF07055,1,2,1,0,1,1016,0.5,1.0,1.0,0.71,1,1,0,0,1017,1.0,1.0,1.0,1.0
PF03644,PF02449:PF12308:PF07034,13,18,2,11,16,989,0.11,0.97,0.15,0.12,0,0,13,0,1005,0,0.99,0.0,0
PF14106,PF11002:PF02151:PF14782,0,22,0,0,22,996,0.0,0.98,0,0,3,0,0,3,1015,0.0,1.0,0,0
PF07203,PF15760:PF15085:PF03379,1,3,0,1,3,1014,0.0,1.0,0.0,-0.0,0,0,1,0,1017,0,1.0,0.0,0
PF12843,PF09951:PF08744:PF07209,0,1,0,0,1,1017,0.0,1.0,0,0,0,0,0,0,1018,0,1.0,0,0
PF08687,PF08688:PF15737:PF02208,4,6,2,2,4,1010,0.33,0.99,0.5,0.41,1,1,3,0,1014,1.0,1.0,0.25,0.5
PF07140,PF09294:PF01108:PF14161,2,6,2,0,4,1012,0.33,1.0,1.0,0.58,1,1,1,0,1016,1.0,1.0,0.5,0.71
PF05218,PF06007:PF12477:PF15204,2,2,0,2,2,1014,0.0,1.0,0.0,-0.0,0,0,2,0,1016,0,1.0,0.0,0
PF09635,PF13603:PF10458:PF09334,3,39,3,0,36,979,0.08,0.96,1.0,0.27,11,3,0,8,1007,0.27,0.99,1.0,0.52
PF11693,PF06276:PF08657:PF06449,2,8,0,2,8,1008,0.0,0.99,0.0,-0.0,0,0,2,0,1016,0,1.0,0.0,0
PF07445,PF04489:PF14400:PF04473,0,0,0,0,0,1018,0,1.0,0,0,0,0,0,0,1018,0,1.0,0,0
PF05990,PF04632:PF15235:PF15337,1,3,1,0,2,1015,0.33,1.0,1.0,0.58,1,1,0,0,1017,1.0,1.0,1.0,1.0
PF11612,PF02501:PF04612:PF10908,2,2,2,0,0,1016,1.0,1.0,1.0,1.0,1,1,1,0,1016,1.0,1.0,0.5,0.71
PF02526,PF05594:PF14232:PF01228,0,2,0,0,2,1016,0.0,1.0,0,0,0,0,0,0,1018,0,1.0,0,0
PF15396,PF07797:PF15778:PF15369,3,8,0,3,8,1007,0.0,0.99,0.0,-0.0,1,0,3,1,1014,0.0,1.0,0.0,-0.0
PF02077,PF09778:PF16860:PF02175,6,7,2,4,5,1007,0.29,0.99,0.33,0.3,0,0,6,0,1012,0,0.99,0.0,0
PF10503,PF00457:PF01083:PF03664,10,18,3,7,15,993,0.17,0.98,0.3,0.21,7,3,7,4,1004,0.43,0.99,0.3,0.35
PF09246,PF16533:PF17208:PF10534,2,5,1,1,4,1012,0.2,1.0,0.5,0.31,1,1,1,0,1016,1.0,1.0,0.5,0.71
PF02810,PF13373:PF10302:PF14023,6,9,2,4,7,1005,0.22,0.99,0.33,0.27,3,0,6,3,1009,0.0,0.99,0.0,-0.0
PF06167,PF13986:PF11304:PF12081,1,1,1,0,0,1017,1.0,1.0,1.0,1.0,0,0,1,0,1017,0,1.0,0.0,0
PF03786,PF14882:PF07476:PF04865,1,0,0,1,0,1017,0,1.0,0.0,0,0,0,1,0,1017,0,1.0,0.0,0
PF12202,PF11629:PF14593:PF12063,11,10,4,7,6,1001,0.4,0.99,0.36,0.37,4,4,7,0,1007,1.0,0.99,0.36,0.6
PF11720,PF09183:PF03243:PF08040,1,5,1,0,4,1013,0.2,1.0,1.0,0.45,0,0,1,0,1017,0,1.0,0.0,0
PF06968,PF13597:PF12345:PF16881,8,13,2,6,11,999,0.15,0.98,0.25,0.19,2,2,6,0,1010,1.0,0.99,0.25,0.5
PF08153,PF08701:PF05128:PF10662,6,4,1,5,3,1009,0.25,0.99,0.17,0.2,1,1,5,0,1012,1.0,1.0,0.17,0.41
PF17154,PF10554:PF05016:PF01807,1,6,0,1,6,1011,0.0,0.99,0.0,-0.0,0,0,1,0,1017,0,1.0,0.0,0
PF16186,PF01749:PF16689:PF09863,21,23,16,5,7,990,0.7,0.99,0.76,0.72,1,1,20,0,997,1.0,0.98,0.05,0.22
PF11759,PF15480:PF06954:PF15119,0,3,0,0,3,1015,0.0,1.0,0,0,0,0,0,0,1018,0,1.0,0,0
PF10548,PF17007:PF16991:PF15476,0,0,0,0,0,1018,0,1.0,0,0,0,0,0,0,1018,0,1.0,0,0
PF08525,PF16824:PF07937:PF03525,0,0,0,0,0,1018,0,1.0,0,0,0,0,0,0,1018,0,1.0,0,0
PF03172,PF16737:PF12269:PF14061,4,10,2,2,8,1006,0.2,0.99,0.5,0.31,2,2,2,0,1014,1.0,1.0,0.5,0.71
PF11935,PF15917:PF12166:PF16399,8,19,4,4,15,995,0.21,0.98,0.5,0.32,4,2,6,2,1008,0.5,0.99,0.25,0.35
PF08218,PF15815:PF08625:PF00642,1,73,0,1,73,944,0.0,0.93,0.0,-0.01,5,0,1,5,1012,0.0,0.99,0.0,-0.0
PF04332,PF08333:PF00077:PF16469,0,21,0,0,21,997,0.0,0.98,0,0,3,0,0,3,1015,0.0,1.0,0,0
PF03524,PF10618:PF05797:PF09498,7,0,0,7,0,1011,0,0.99,0.0,0,0,0,7,0,1011,0,0.99,0.0,0
PF16511,PF09141:PF08913:PF01608,17,24,11,6,13,988,0.46,0.98,0.65,0.54,8,8,9,0,1001,1.0,0.99,0.47,0.68
PF14886,PF09232:PF15085:PF02950,4,3,0,4,3,1011,0.0,0.99,0.0,-0.0,0,0,4,0,1014,0,1.0,0.0,0
PF00338,PF10259:PF09696:PF03942,24,32,9,15,23,971,0.28,0.96,0.38,0.31,3,2,22,1,993,0.67,0.98,0.08,0.23
PF12602,PF11751:PF06798:PF08299,0,2,0,0,2,1016,0.0,1.0,0,0,0,0,0,0,1018,0,1.0,0,0
PF15272,PF14842:PF02056:PF08299,0,9,0,0,9,1009,0.0,0.99,0,0,1,0,0,1,1017,0.0,1.0,0,0
PF00265,PF07189:PF05078:PF07386,10,12,4,6,8,1000,0.33,0.99,0.4,0.36,3,2,8,1,1007,0.67,0.99,0.2,0.36
PF01180,PF16020:PF14721:PF00310,22,14,2,20,12,984,0.14,0.97,0.09,0.1,3,1,21,2,994,0.33,0.98,0.05,0.12
PF07735,PF01827:PF07734:PF08268,11,28,7,4,21,986,0.25,0.98,0.64,0.39,9,4,7,5,1002,0.44,0.99,0.36,0.4
PF13919,PF05066:PF13922:PF16563,9,11,7,2,4,1005,0.64,0.99,0.78,0.7,5,4,5,1,1008,0.8,0.99,0.44,0.59
PF01731,PF10420:PF00243:PF07258,4,19,1,3,18,996,0.05,0.98,0.25,0.11,2,1,3,1,1013,0.5,1.0,0.25,0.35
PF00463,PF01274:PF10317:PF08925,10,19,5,5,14,994,0.26,0.98,0.5,0.35,4,0,10,4,1004,0.0,0.99,0.0,-0.01
PF00797,PF12239:PF10455:PF01774,13,19,4,9,15,990,0.21,0.98,0.31,0.24,1,1,12,0,1005,1.0,0.99,0.08,0.28
PF06214,PF11162:PF15089:PF10749,1,0,0,1,0,1017,0,1.0,0.0,0,0,0,1,0,1017,0,1.0,0.0,0
PF11231,PF17028:PF10807:PF03476,0,13,0,0,13,1005,0.0,0.99,0,0,0,0,0,0,1018,0,1.0,0,0
PF10873,PF09461:PF10279:PF09216,0,0,0,0,0,1018,0,1.0,0,0,0,0,0,0,1018,0,1.0,0,0
PF09337,PF07245:PF13276:PF08284,14,27,5,9,22,982,0.19,0.97,0.36,0.24,8,5,9,3,1001,0.62,0.99,0.36,0.47
PF06007,PF06070:PF09611:PF01913,2,2,0,2,2,1014,0.0,1.0,0.0,-0.0,0,0,2,0,1016,0,1.0,0.0,0
PF14160,PF15805:PF15622:PF02750,2,0,0,2,0,1016,0,1.0,0.0,0,0,0,2,0,1016,0,1.0,0.0,0
PF12850,PF01470:PF08561:PF01097,13,18,4,9,14,991,0.22,0.98,0.31,0.25,2,2,11,0,1005,1.0,0.99,0.15,0.39
PF02093,PF00607:PF01140:PF01141,5,12,4,1,8,1005,0.33,0.99,0.8,0.51,4,4,1,0,1013,1.0,1.0,0.8,0.89
PF02259,PF02260:PF08163:PF08064,29,31,22,7,9,980,0.71,0.98,0.76,0.73,9,9,20,0,989,1.0,0.98,0.31,0.55
PF04795,PF04925:PF13959:PF07999,2,26,1,1,25,991,0.04,0.97,0.5,0.13,4,1,1,3,1013,0.25,1.0,0.5,0.35
PF00116,PF02790:PF13116:PF13442,15,15,12,3,3,1000,0.8,0.99,0.8,0.8,10,10,5,0,1003,1.0,1.0,0.67,0.81
PF12812,PF13180:PF06241:PF12844,1,32,1,0,31,986,0.03,0.97,1.0,0.17,3,1,0,2,1015,0.33,1.0,1.0,0.58
PF15400,PF15482:PF05065:PF15312,0,1,0,0,1,1017,0.0,1.0,0,0,0,0,0,0,1018,0,1.0,0,0
PF01762,PF00337:PF04099:PF13334,40,34,17,23,17,961,0.5,0.96,0.42,0.44,10,9,31,1,977,0.9,0.97,0.23,0.44
PF11807,PF04199:PF14027:PF12311,12,30,8,4,22,984,0.27,0.97,0.67,0.41,11,7,5,4,1002,0.64,0.99,0.58,0.6
PF02122,PF07705:PF11138:PF10279,1,0,0,1,0,1017,0,1.0,0.0,0,0,0,1,0,1017,0,1.0,0.0,0
PF01884,PF04488:PF00355:PF00940,1,59,0,1,59,958,0.0,0.94,0.0,-0.01,14,0,1,14,1003,0.0,0.99,0.0,-0.0
PF16829,PF15872:PF15398:PF17085,0,1,0,0,1,1017,0.0,1.0,0,0,0,0,0,0,1018,0,1.0,0,0
PF06975,PF11136:PF10079:PF03613,0,0,0,0,0,1018,0,1.0,0,0,0,0,0,0,1018,0,1.0,0,0
PF03740,PF04539:PF04542:PF04545,6,26,6,0,20,992,0.23,0.98,1.0,0.48,20,6,0,14,998,0.3,0.99,1.0,0.54
PF06608,PF11317:PF03379:PF15055,1,1,0,1,1,1016,0.0,1.0,0.0,-0.0,0,0,1,0,1017,0,1.0,0.0,0
PF14988,PF08227:PF13870:PF15248,3,11,2,1,9,1006,0.18,0.99,0.67,0.34,2,1,2,1,1014,0.5,1.0,0.33,0.41
PF03946,PF02747:PF03989:PF09326,22,29,5,17,24,972,0.17,0.96,0.23,0.18,7,2,20,5,991,0.29,0.98,0.09,0.15
PF07983,PF00332:PF03198:PF00154,13,47,11,2,36,969,0.23,0.96,0.85,0.43,11,6,7,5,1000,0.55,0.99,0.46,0.5
PF07068,PF08401:PF06651:PF05797,0,0,0,0,0,1018,0,1.0,0,0,0,0,0,0,1018,0,1.0,0,0
PF12780,PF12777:PF08393:PF08385,37,46,37,0,9,972,0.8,0.99,1.0,0.89,33,30,7,3,978,0.91,0.99,0.81,0.85
PF11078,PF16176:PF12598:PF00907,2,19,2,0,17,999,0.11,0.98,1.0,0.32,4,1,1,3,1013,0.25,1.0,0.5,0.35
PF01730,PF08286:PF00835:PF14997,2,5,0,2,5,1011,0.0,0.99,0.0,-0.0,0,0,2,0,1016,0,1.0,0.0,0
PF08234,PF16516:PF06211:PF04440,2,6,0,2,6,1010,0.0,0.99,0.0,-0.0,0,0,2,0,1016,0,1.0,0.0,0
PF13876,PF07505:PF04963:PF07523,1,1,0,1,1,1016,0.0,1.0,0.0,-0.0,0,0,1,0,1017,0,1.0,0.0,0
PF16726,PF16776:PF08952:PF09036,1,13,0,1,13,1004,0.0,0.99,0.0,-0.0,1,0,1,1,1016,0.0,1.0,0.0,-0.0
PF09655,PF14094:PF04748:PF04608,0,2,0,0,2,1016,0.0,1.0,0,0,0,0,0,0,1018,0,1.0,0,0
PF11769,PF14233:PF14433:PF10962,0,0,0,0,0,1018,0,1.0,0,0,0,0,0,0,1018,0,1.0,0,0
PF01177,PF01230:PF02540:PF00795,8,72,6,2,66,944,0.08,0.93,0.75,0.24,16,4,4,12,998,0.25,0.98,0.5,0.35
PF03050,PF13007:PF08497:PF11736,0,4,0,0,4,1014,0.0,1.0,0,0,0,0,0,0,1018,0,1.0,0,0
PF16420,PF08825:PF00899:PF10585,11,57,11,0,46,961,0.19,0.95,1.0,0.43,9,2,9,7,1000,0.22,0.98,0.18,0.19
PF16208,PF04732:PF00932:PF00038,4,23,4,0,19,995,0.17,0.98,1.0,0.41,8,2,2,6,1008,0.25,0.99,0.5,0.35
PF09359,PF03600:PF03124:PF12253,15,15,4,11,11,992,0.27,0.98,0.27,0.26,1,0,15,1,1002,0.0,0.98,0.0,-0.0
PF10211,PF16531:PF14846:PF05046,6,12,2,4,10,1002,0.17,0.99,0.33,0.23,2,1,5,1,1011,0.5,0.99,0.17,0.29
PF04084,PF15929:PF10681:PF03085,8,2,0,8,2,1008,0.0,0.99,0.0,-0.0,0,0,8,0,1010,0,0.99,0.0,0
PF04466,PF01580:PF17206:PF03592,0,5,0,0,5,1013,0.0,1.0,0,0,1,0,0,1,1017,0.0,1.0,0,0
PF02361,PF06695:PF17056:PF12046,5,0,0,5,0,1013,0,1.0,0.0,0,0,0,5,0,1013,0,1.0,0.0,0
PF10046,PF11264:PF06521:PF15719,12,5,3,9,2,1004,0.6,0.99,0.25,0.38,0,0,12,0,1006,0,0.99,0.0,0
PF14718,PF15075:PF05280:PF08298,1,5,0,1,5,1012,0.0,0.99,0.0,-0.0,0,0,1,0,1017,0,1.0,0.0,0
PF00708,PF15013:PF02285:PF07114,7,8,0,7,8,1003,0.0,0.99,0.0,-0.01,0,0,7,0,1011,0,0.99,0.0,0
PF03669,PF11336:PF01253:PF12706,7,47,4,3,43,968,0.09,0.95,0.57,0.21,14,3,4,11,1000,0.21,0.99,0.43,0.3
PF04876,PF03178:PF10062:PF04976,0,29,0,0,29,989,0.0,0.97,0,0,0,0,0,0,1018,0,1.0,0,0
PF15836,PF04352:PF12778:PF17092,1,2,0,1,2,1015,0.0,1.0,0.0,-0.0,0,0,1,0,1017,0,1.0,0.0,0
PF14495,PF09057:PF01741:PF01947,2,2,0,2,2,1014,0.0,1.0,0.0,-0.0,0,0,2,0,1016,0,1.0,0.0,0
PF12104,PF09191:PF05790:PF10570,0,3,0,0,3,1015,0.0,1.0,0,0,0,0,0,0,1018,0,1.0,0,0
PF04586,PF07016:PF08274:PF11863,1,0,0,1,0,1017,0,1.0,0.0,0,0,0,1,0,1017,0,1.0,0.0,0
PF03133,PF01975:PF02939:PF03914,31,36,14,17,22,965,0.39,0.96,0.45,0.4,6,4,27,2,985,0.67,0.97,0.13,0.29
PF06827,PF10458:PF13603:PF11551,9,17,3,6,14,995,0.18,0.98,0.33,0.23,3,3,6,0,1009,1.0,0.99,0.33,0.58
PF04359,PF06485:PF12646:PF03907,1,5,0,1,5,1012,0.0,0.99,0.0,-0.0,0,0,1,0,1017,0,1.0,0.0,0
PF14421,PF08762:PF01660:PF14307,0,8,0,0,8,1010,0.0,0.99,0,0,2,0,0,2,1016,0.0,1.0,0,0
PF12759,PF16590:PF02457:PF15214,0,3,0,0,3,1015,0.0,1.0,0,0,0,0,0,0,1018,0,1.0,0,0
PF05400,PF09087:PF06024:PF10438,1,1,1,0,0,1017,1.0,1.0,1.0,1.0,1,1,0,0,1017,1.0,1.0,1.0,1.0
PF14342,PF05547:PF15578:PF08508,4,4,0,4,4,1010,0.0,0.99,0.0,-0.0,0,0,4,0,1014,0,1.0,0.0,0
PF12578,PF00814:PF02893:PF06602,5,73,5,0,68,945,0.07,0.93,1.0,0.25,20,2,3,18,995,0.1,0.98,0.4,0.19
PF06143,PF00752:PF06916:PF14063,0,39,0,0,39,979,0.0,0.96,0,0,1,0,0,1,1017,0.0,1.0,0,0
PF14273,PF10681:PF06108:PF06206,9,8,1,8,7,1002,0.12,0.99,0.11,0.11,1,0,9,1,1008,0.0,0.99,0.0,-0.0
PF02739,PF11671:PF15374:PF14353,5,0,0,5,0,1013,0,1.0,0.0,0,0,0,5,0,1013,0,1.0,0.0,0
PF07516,PF01043:PF15994:PF15995,3,3,3,0,0,1015,1.0,1.0,1.0,1.0,0,0,3,0,1015,0,1.0,0.0,0
PF07339,PF02934:PF16334:PF08760,0,15,0,0,15,1003,0.0,0.99,0,0,1,0,0,1,1017,0.0,1.0,0,0
PF16113,PF00378:PF06522:PF05995,20,68,14,6,54,944,0.21,0.94,0.7,0.36,5,5,15,0,998,1.0,0.99,0.25,0.5
PF02407,PF14113:PF00548:PF08411,5,13,3,2,10,1003,0.23,0.99,0.6,0.37,0,0,5,0,1013,0,1.0,0.0,0
PF01258,PF12465:PF10584:PF04225,6,36,3,3,33,979,0.08,0.96,0.5,0.19,5,2,4,3,1009,0.4,0.99,0.33,0.36
PF08647,PF10375:PF15453:PF08505,9,2,0,9,2,1007,0.0,0.99,0.0,-0.0,0,0,9,0,1009,0,0.99,0.0,0
PF12491,PF06448:PF09172:PF01347,1,19,1,0,18,999,0.05,0.98,1.0,0.23,10,1,0,9,1008,0.1,0.99,1.0,0.31
PF08732,PF07464:PF09057:PF09690,3,1,0,3,1,1014,0.0,1.0,0.0,-0.0,0,0,3,0,1015,0,1.0,0.0,0
PF05569,PF03831:PF17152:PF07499,1,3,0,1,3,1014,0.0,1.0,0.0,-0.0,0,0,1,0,1017,0,1.0,0.0,0
PF10182,PF04740:PF13750:PF15856,3,1,0,3,1,1014,0.0,1.0,0.0,-0.0,0,0,3,0,1015,0,1.0,0.0,0
PF08648,PF01715:PF15990:PF08617,8,23,3,5,20,990,0.13,0.98,0.38,0.21,4,2,6,2,1008,0.5,0.99,0.25,0.35
PF17042,PF07005:PF01116:PF14833,6,36,6,0,30,982,0.17,0.97,1.0,0.4,9,6,0,3,1009,0.67,1.0,1.0,0.82
PF07449,PF15928:PF14283:PF10961,0,7,0,0,7,1011,0.0,0.99,0,0,0,0,0,0,1018,0,1.0,0,0
PF16038,PF04901:PF02285:PF00159,1,8,0,1,8,1009,0.0,0.99,0.0,-0.0,0,0,1,0,1017,0,1.0,0.0,0
PF08667,PF01339:PF04397:PF12431,0,7,0,0,7,1011,0.0,0.99,0,0,0,0,0,0,1018,0,1.0,0,0
PF14798,PF05308:PF05197:PF03298,2,10,2,0,8,1008,0.2,0.99,1.0,0.45,1,1,1,0,1016,1.0,1.0,0.5,0.71
PF11934,PF01857:PF08934:PF01858,2,2,1,1,1,1015,0.5,1.0,0.5,0.5,1,1,1,0,1016,1.0,1.0,0.5,0.71
PF09519,PF00001:PF08320:PF04236,2,137,1,1,136,880,0.01,0.87,0.5,0.05,12,1,1,11,1005,0.08,0.99,0.5,0.2
PF06001,PF08214:PF02135:PF09030,12,28,12,0,16,990,0.43,0.98,1.0,0.65,18,10,2,8,998,0.56,0.99,0.83,0.68
PF01008,PF00293:PF01725:PF09297,29,86,17,12,69,920,0.2,0.92,0.59,0.31,11,7,22,4,985,0.64,0.97,0.24,0.38
PF06652,PF02793:PF01825:PF03827,3,48,2,1,46,969,0.04,0.95,0.67,0.16,6,1,2,5,1010,0.17,0.99,0.33,0.23
PF16752,PF06374:PF08600:PF12043,4,9,0,4,9,1005,0.0,0.99,0.0,-0.01,0,0,4,0,1014,0,1.0,0.0,0
PF12814,PF10650:PF16574:PF15456,9,7,2,7,5,1004,0.29,0.99,0.22,0.25,1,1,8,0,1009,1.0,0.99,0.11,0.33
PF09257,PF15443:PF15482:PF05547,1,2,0,1,2,1015,0.0,1.0,0.0,-0.0,0,0,1,0,1017,0,1.0,0.0,0
PF08846,PF08850:PF04883:PF06187,0,0,0,0,0,1018,0,1.0,0,0,0,0,0,0,1018,0,1.0,0,0
PF14441,PF10155:PF13824:PF01755,4,19,1,3,18,996,0.05,0.98,0.25,0.11,2,0,4,2,1012,0.0,0.99,0.0,-0.0
PF01036,PF01987:PF09769:PF01627,9,13,3,6,10,999,0.23,0.98,0.33,0.27,3,2,7,1,1008,0.67,0.99,0.22,0.38
PF06428,PF15266:PF14922:PF10998,8,9,2,6,7,1003,0.22,0.99,0.25,0.23,1,0,8,1,1009,0.0,0.99,0.0,-0.0
PF08784,PF09170:PF02938:PF10451,14,9,3,11,6,998,0.33,0.98,0.21,0.26,1,1,13,0,1004,1.0,0.99,0.07,0.27
PF15232,PF09047:PF15392:PF09596,0,2,0,0,2,1016,0.0,1.0,0,0,0,0,0,0,1018,0,1.0,0,0
PF04624,PF10856:PF04625:PF03710,1,4,1,0,3,1014,0.25,1.0,1.0,0.5,0,0,1,0,1017,0,1.0,0.0,0
PF10226,PF10998:PF11831:PF14922,3,17,2,1,15,1000,0.12,0.98,0.67,0.28,1,0,3,1,1014,0.0,1.0,0.0,-0.0
PF00557,PF14826:PF01285:PF05195,53,26,24,29,2,963,0.92,0.97,0.45,0.63,6,6,47,0,965,1.0,0.95,0.11,0.33
PF10155,PF14441:PF11698:PF01755,6,25,2,4,23,989,0.08,0.97,0.33,0.15,0,0,6,0,1012,0,0.99,0.0,0
PF00530,PF01186:PF00100:PF01744,39,60,23,16,37,942,0.38,0.95,0.59,0.45,8,8,31,0,979,1.0,0.97,0.21,0.45
PF00070,PF07681:PF01654:PF14163,4,6,2,2,4,1010,0.33,0.99,0.5,0.41,2,1,3,1,1013,0.5,1.0,0.25,0.35
PF05453,PF08093:PF11402:PF15547,1,1,0,1,1,1016,0.0,1.0,0.0,-0.0,0,0,1,0,1017,0,1.0,0.0,0
PF12766,PF12049:PF03193:PF06420,4,6,1,3,5,1009,0.17,0.99,0.25,0.2,0,0,4,0,1014,0,1.0,0.0,0
PF01437,PF01403:PF00059:PF08337,18,92,16,2,76,924,0.17,0.92,0.89,0.37,15,12,6,3,997,0.8,0.99,0.67,0.73
PF01494,PF07976:PF12831:PF08491,90,22,22,68,0,928,1.0,0.93,0.24,0.48,7,7,83,0,928,1.0,0.92,0.08,0.27
PF07678,PF07703:PF01835:PF10569,15,15,13,2,2,1001,0.87,1.0,0.87,0.86,11,11,4,0,1003,1.0,1.0,0.73,0.85
PF15842,PF15097:PF15142:PF16311,2,3,1,1,2,1014,0.33,1.0,0.5,0.41,0,0,2,0,1016,0,1.0,0.0,0
PF02598,PF07137:PF14988:PF15313,11,12,2,9,10,997,0.17,0.98,0.18,0.16,2,1,10,1,1006,0.5,0.99,0.09,0.21
PF00137,PF07687:PF12406:PF04145,23,29,9,14,20,975,0.31,0.97,0.39,0.33,7,3,20,4,991,0.43,0.98,0.13,0.23
PF02149,PF08332:PF12605:PF14593,13,9,5,8,4,1001,0.56,0.99,0.38,0.46,3,3,10,0,1005,1.0,0.99,0.23,0.48
PF04012,PF10868:PF15699:PF06521,0,1,0,0,1,1017,0.0,1.0,0,0,0,0,0,0,1018,0,1.0,0,0
PF16013,PF16061:PF12309:PF08318,4,22,1,3,21,993,0.05,0.98,0.25,0.1,3,1,3,2,1012,0.33,1.0,0.25,0.29
PF17107,PF17100:PF01048:PF17111,25,48,15,10,33,960,0.31,0.96,0.6,0.41,16,13,12,3,990,0.81,0.99,0.52,0.64
PF04958,PF07642:PF01815:PF09311,3,6,0,3,6,1009,0.0,0.99,0.0,-0.0,0,0,3,0,1015,0,1.0,0.0,0
PF04732,PF16208:PF00932:PF00038,4,23,4,0,19,995,0.17,0.98,1.0,0.41,7,1,3,6,1008,0.14,0.99,0.25,0.18
PF15089,PF08795:PF02554:PF02277,0,3,0,0,3,1015,0.0,1.0,0,0,0,0,0,0,1018,0,1.0,0,0
PF15989,PF15325:PF01316:PF06876,0,3,0,0,3,1015,0.0,1.0,0,0,0,0,0,0,1018,0,1.0,0,0
PF10265,PF15008:PF03253:PF10246,2,14,1,1,13,1003,0.07,0.99,0.5,0.19,1,1,1,0,1016,1.0,1.0,0.5,0.71
PF03972,PF14027:PF05995:PF06172,7,22,3,4,19,992,0.14,0.98,0.43,0.23,4,2,5,2,1009,0.5,0.99,0.29,0.37
PF04253,PF09747:PF01133:PF02225,15,51,14,1,37,966,0.27,0.96,0.93,0.5,7,3,12,4,999,0.43,0.98,0.2,0.29
PF09303,PF03185:PF14944:PF09049,2,11,2,0,9,1007,0.18,0.99,1.0,0.42,0,0,2,0,1016,0,1.0,0.0,0
PF01279,PF02044:PF00159:PF15063,2,2,1,1,1,1015,0.5,1.0,0.5,0.5,0,0,2,0,1016,0,1.0,0.0,0
PF00319,PF12346:PF12347:PF02665,20,7,6,14,1,997,0.86,0.99,0.3,0.5,1,0,20,1,997,0.0,0.98,0.0,-0.0
PF05736,PF16325:PF12477:PF08497,0,1,0,0,1,1017,0.0,1.0,0,0,0,0,0,0,1018,0,1.0,0,0
PF01093,PF02267:PF15008:PF01296,0,5,0,0,5,1013,0.0,1.0,0,0,0,0,0,0,1018,0,1.0,0,0
PF03219,PF08643:PF16007:PF10471,5,11,2,3,9,1004,0.18,0.99,0.4,0.26,1,1,4,0,1013,1.0,1.0,0.2,0.45
PF05035,PF00356:PF13735:PF01515,3,22,1,2,21,994,0.05,0.98,0.33,0.12,1,0,3,1,1014,0.0,1.0,0.0,-0.0
PF10363,PF12830:PF12765:PF12397,3,21,1,2,20,995,0.05,0.98,0.33,0.12,10,1,2,9,1006,0.1,0.99,0.33,0.18
PF07723,PF08268:PF07734:PF01167,10,30,7,3,23,985,0.23,0.97,0.7,0.39,7,3,7,4,1004,0.43,0.99,0.3,0.35
PF01793,PF11807:PF03595:PF00793,15,37,4,11,33,970,0.11,0.96,0.27,0.15,8,2,13,6,997,0.25,0.98,0.13,0.17
PF02586,PF03479:PF04139:PF08552,10,22,5,5,17,991,0.23,0.98,0.5,0.33,3,1,9,2,1006,0.33,0.99,0.1,0.18
PF13409,PF02798:PF13417:PF14497,16,91,11,5,80,922,0.12,0.92,0.69,0.26,32,6,10,26,976,0.19,0.96,0.38,0.25
PF11175,PF03553:PF06056:PF15134,1,3,0,1,3,1014,0.0,1.0,0.0,-0.0,0,0,1,0,1017,0,1.0,0.0,0
PF14780,PF14977:PF10198:PF14909,4,13,0,4,13,1001,0.0,0.98,0.0,-0.01,1,0,4,1,1013,0.0,1.0,0.0,-0.0
PF03929,PF02975:PF04196:PF13751,3,6,0,3,6,1009,0.0,0.99,0.0,-0.0,0,0,3,0,1015,0,1.0,0.0,0
PF10446,PF09463:PF10307:PF15918,1,1,0,1,1,1016,0.0,1.0,0.0,-0.0,0,0,1,0,1017,0,1.0,0.0,0
PF16661,PF10996:PF07521:PF13299,30,37,27,3,10,978,0.73,0.99,0.9,0.8,27,22,8,5,983,0.81,0.99,0.73,0.77
PF00935,PF01198:PF12020:PF15260,17,26,8,9,18,983,0.31,0.97,0.47,0.37,0,0,17,0,1001,0,0.98,0.0,0
PF10022,PF16401:PF16692:PF09797,7,14,1,6,13,998,0.07,0.98,0.14,0.09,1,0,7,1,1010,0.0,0.99,0.0,-0.0
PF10782,PF11751:PF06890:PF01312,0,0,0,0,0,1018,0,1.0,0,0,0,0,0,0,1018,0,1.0,0,0
PF11696,PF15463:PF12118:PF10979,5,2,0,5,2,1011,0.0,0.99,0.0,-0.0,0,0,5,0,1013,0,1.0,0.0,0
PF10214,PF08639:PF11489:PF14342,6,8,1,5,7,1005,0.12,0.99,0.17,0.14,0,0,6,0,1012,0,0.99,0.0,0
PF14753,PF15390:PF03298:PF15388,4,5,0,4,5,1009,0.0,0.99,0.0,-0.0,0,0,4,0,1014,0,1.0,0.0,0
PF03539,PF10917:PF05869:PF13780,1,4,0,1,4,1013,0.0,1.0,0.0,-0.0,0,0,1,0,1017,0,1.0,0.0,0
PF01614,PF16416:PF02056:PF10410,10,11,2,8,9,999,0.18,0.98,0.2,0.18,1,1,9,0,1008,1.0,0.99,0.1,0.31
PF01821,PF07677:PF07703:PF01835,6,16,6,0,10,1002,0.38,0.99,1.0,0.61,11,6,0,5,1007,0.55,1.0,1.0,0.74
PF07942,PF01217:PF09786:PF10574,9,49,6,3,43,966,0.12,0.95,0.67,0.27,3,1,8,2,1007,0.33,0.99,0.11,0.19
PF16183,PF12423:PF12473:PF16540,19,24,15,4,9,990,0.62,0.99,0.79,0.7,15,14,5,1,998,0.93,0.99,0.74,0.83
PF06078,PF05100:PF06805:PF13556,1,1,0,1,1,1016,0.0,1.0,0.0,-0.0,0,0,1,0,1017,0,1.0,0.0,0
PF16122,PF00318:PF04161:PF08207,14,35,9,5,26,978,0.26,0.97,0.64,0.39,8,4,10,4,1000,0.5,0.99,0.29,0.37
PF04148,PF11264:PF04402:PF09459,4,8,2,2,6,1008,0.25,0.99,0.5,0.35,0,0,4,0,1014,0,1.0,0.0,0
PF13176,PF13181:PF09295:PF13174,38,108,28,10,80,900,0.26,0.91,0.74,0.4,14,8,30,6,974,0.57,0.96,0.21,0.33
PF13963,PF13960:PF13952:PF02992,10,15,8,2,7,1001,0.53,0.99,0.8,0.65,4,3,7,1,1007,0.75,0.99,0.3,0.47
PF00032,PF03980:PF08561:PF01185,11,11,1,10,10,997,0.09,0.98,0.09,0.08,1,0,11,1,1006,0.0,0.99,0.0,-0.0
PF07971,PF03074:PF01757:PF07162,16,48,5,11,43,959,0.1,0.95,0.31,0.16,5,2,14,3,999,0.4,0.98,0.12,0.22
PF11604,PF11019:PF13742:PF04349,0,2,0,0,2,1016,0.0,1.0,0,0,0,0,0,0,1018,0,1.0,0,0
PF10358,PF12510:PF15949:PF12130,19,12,2,17,10,989,0.17,0.97,0.11,0.12,2,1,18,1,998,0.5,0.98,0.05,0.16
PF16164,PF05587:PF05586:PF06668,2,7,1,1,6,1010,0.14,0.99,0.5,0.26,4,1,1,3,1013,0.25,1.0,0.5,0.35
PF00324,PF03522:PF08403:PF13520,50,83,31,19,52,916,0.37,0.93,0.62,0.45,8,8,42,0,968,1.0,0.96,0.16,0.39
PF07222,PF15093:PF07891:PF15280,2,4,0,2,4,1012,0.0,0.99,0.0,-0.0,1,0,2,1,1015,0.0,1.0,0.0,-0.0
PF09577,PF10399:PF13009:PF04308,0,3,0,0,3,1015,0.0,1.0,0,0,0,0,0,0,1018,0,1.0,0,0
PF12453,PF12567:PF16066:PF05473,2,5,2,0,3,1013,0.4,1.0,1.0,0.63,1,1,1,0,1016,1.0,1.0,0.5,0.71
PF12757,PF11496:PF15368:PF11577,0,12,0,0,12,1006,0.0,0.99,0,0,1,0,0,1,1017,0.0,1.0,0,0
PF00714,PF15559:PF04856:PF00236,1,1,0,1,1,1016,0.0,1.0,0.0,-0.0,0,0,1,0,1017,0,1.0,0.0,0
PF17030,PF11794:PF14842:PF14841,0,1,0,0,1,1017,0.0,1.0,0,0,0,0,0,0,1018,0,1.0,0,0
PF04024,PF07866:PF16058:PF13239,0,4,0,0,4,1014,0.0,1.0,0,0,0,0,0,0,1018,0,1.0,0,0
PF02941,PF06393:PF08092:PF05151,1,3,0,1,3,1014,0.0,1.0,0.0,-0.0,0,0,1,0,1017,0,1.0,0.0,0
PF03087,PF04674:PF03492:PF02519,6,20,3,3,17,995,0.15,0.98,0.5,0.27,6,3,3,3,1009,0.5,0.99,0.5,0.5
PF08086,PF04099:PF13839:PF01967,1,38,0,1,38,979,0.0,0.96,0.0,-0.01,6,0,1,6,1011,0.0,0.99,0.0,-0.0
PF12326,PF13334:PF07061:PF00337,4,30,2,2,28,986,0.07,0.97,0.5,0.17,7,1,3,6,1008,0.14,0.99,0.25,0.18
PF12806,PF08028:PF12418:PF09317,3,3,3,0,0,1015,1.0,1.0,1.0,1.0,3,3,0,0,1015,1.0,1.0,1.0,1.0
PF15662,PF14690:PF05418:PF08497,0,1,0,0,1,1017,0.0,1.0,0,0,0,0,0,0,1018,0,1.0,0,0
PF00801,PF02010:PF08016:PF07632,10,35,5,5,30,978,0.14,0.97,0.5,0.25,8,3,7,5,1003,0.38,0.99,0.3,0.33
PF02896,PF00391:PF01326:PF05524,16,21,13,3,8,994,0.62,0.99,0.81,0.7,11,10,6,1,1001,0.91,0.99,0.62,0.75
PF06449,PF08140:PF11693:PF12139,4,3,0,4,3,1011,0.0,0.99,0.0,-0.0,0,0,4,0,1014,0,1.0,0.0,0
PF13926,PF16501:PF10377:PF10264,4,9,1,3,8,1006,0.11,0.99,0.25,0.16,2,1,3,1,1013,0.5,1.0,0.25,0.35
PF02130,PF02348:PF12409:PF09040,5,18,1,4,17,996,0.06,0.98,0.2,0.1,5,0,5,5,1008,0.0,0.99,0.0,-0.0
PF00150,PF10503:PF01341:PF02013,49,19,11,38,8,961,0.58,0.95,0.22,0.34,3,3,46,0,969,1.0,0.95,0.06,0.24
PF15950,PF11597:PF06333:PF12145,2,13,1,1,12,1004,0.08,0.99,0.5,0.19,5,1,1,4,1012,0.2,1.0,0.5,0.31
PF07014,PF09051:PF09049:PF09050,0,0,0,0,0,1018,0,1.0,0,0,0,0,0,0,1018,0,1.0,0,0
PF00471,PF05912:PF07544:PF08883,4,16,2,2,14,1000,0.12,0.98,0.5,0.24,3,2,2,1,1013,0.67,1.0,0.5,0.58
PF15109,PF15715:PF15559:PF02448,0,0,0,0,0,1018,0,1.0,0,0,0,0,0,0,1018,0,1.0,0,0
PF02815,PF02366:PF16192:PF01365,25,22,22,3,0,993,1.0,1.0,0.88,0.94,13,13,12,0,993,1.0,0.99,0.52,0.72
PF06832,PF04355:PF13995:PF10109,1,0,0,1,0,1017,0,1.0,0.0,0,0,0,1,0,1017,0,1.0,0.0,0
PF03078,PF02337:PF03716:PF02093,1,6,0,1,6,1011,0.0,0.99,0.0,-0.0,4,0,1,4,1013,0.0,1.0,0.0,-0.0
PF00235,PF04177:PF15377:PF05351,12,15,4,8,11,995,0.27,0.98,0.33,0.29,2,2,10,0,1006,1.0,0.99,0.17,0.41
PF04275,PF04030:PF02913:PF09265,9,52,7,2,45,964,0.13,0.95,0.78,0.31,9,4,5,5,1004,0.44,0.99,0.44,0.44
PF17180,PF13696:PF08783:PF14978,3,15,2,1,13,1002,0.13,0.99,0.67,0.29,9,1,2,8,1007,0.11,0.99,0.33,0.19
PF05190,PF05192:PF05188:PF00488,6,46,6,0,40,972,0.13,0.96,1.0,0.35,38,5,1,33,979,0.13,0.97,0.83,0.32
PF03589,PF03831:PF11751:PF05513,1,1,1,0,0,1017,1.0,1.0,1.0,1.0,0,0,1,0,1017,0,1.0,0.0,0
PF12828,PF12825:PF09325:PF03700,4,22,4,0,18,996,0.18,0.98,1.0,0.42,4,2,2,2,1012,0.5,1.0,0.5,0.5
PF00118,PF10247:PF04051:PF01504,51,53,22,29,31,936,0.42,0.94,0.43,0.39,11,10,41,1,966,0.91,0.96,0.2,0.41
PF01774,PF02284:PF06172:PF05995,7,13,1,6,12,999,0.08,0.98,0.14,0.1,3,0,7,3,1008,0.0,0.99,0.0,-0.0
PF13644,PF12477:PF10995:PF04671,1,1,0,1,1,1016,0.0,1.0,0.0,-0.0,0,0,1,0,1017,0,1.0,0.0,0
PF10297,PF12498:PF07777:PF11785,5,3,2,3,1,1012,0.67,1.0,0.4,0.51,2,2,3,0,1013,1.0,1.0,0.4,0.63
PF05344,PF01529:PF03632:PF00132,0,95,0,0,95,923,0.0,0.91,0,0,25,0,0,25,993,0.0,0.98,0,0
PF15612,PF02791:PF10537:PF15613,15,21,11,4,10,993,0.52,0.99,0.73,0.61,20,11,4,9,994,0.55,0.99,0.73,0.63
PF13302,PF11807:PF12311:PF04229,31,17,7,24,10,977,0.41,0.97,0.23,0.29,4,3,28,1,986,0.75,0.97,0.1,0.26
PF14379,PF16495:PF16772:PF08558,7,13,2,5,11,1000,0.15,0.98,0.29,0.2,2,0,7,2,1009,0.0,0.99,0.0,-0.0
PF14934,PF10195:PF15011:PF02453,2,16,2,0,14,1002,0.12,0.99,1.0,0.35,3,0,2,3,1013,0.0,1.0,0.0,-0.0
PF03089,PF13341:PF09778:PF03409,2,5,1,1,4,1012,0.2,1.0,0.5,0.31,0,0,2,0,1016,0,1.0,0.0,0
PF07599,PF07471:PF00493:PF01754,0,52,0,0,52,966,0.0,0.95,0,0,7,0,0,7,1011,0.0,0.99,0,0
PF02095,PF09049:PF09051:PF15689,2,0,0,2,0,1016,0,1.0,0.0,0,0,0,2,0,1016,0,1.0,0.0,0
PF07916,PF12255:PF09327:PF06826,0,1,0,0,1,1017,0.0,1.0,0,0,0,0,0,0,1018,0,1.0,0,0
PF12105,PF17191:PF08032:PF11770,5,7,5,0,2,1011,0.71,1.0,1.0,0.84,2,2,3,0,1013,1.0,1.0,0.4,0.63
PF12965,PF02557:PF09867:PF05887,0,2,0,0,2,1016,0.0,1.0,0,0,0,0,0,0,1018,0,1.0,0,0
PF15187,PF06875:PF15550:PF17124,0,0,0,0,0,1018,0,1.0,0,0,0,0,0,0,1018,0,1.0,0,0
PF07192,PF02557:PF04562:PF05418,0,3,0,0,3,1015,0.0,1.0,0,0,0,0,0,0,1018,0,1.0,0,0
PF01677,PF06311:PF14364:PF05026,0,14,0,0,14,1004,0.0,0.99,0,0,1,0,0,1,1017,0.0,1.0,0,0
PF12042,PF11260:PF16763:PF11466,0,0,0,0,0,1018,0,1.0,0,0,0,0,0,0,1018,0,1.0,0,0
PF13406,PF07409:PF05787:PF01913,1,1,0,1,1,1016,0.0,1.0,0.0,-0.0,0,0,1,0,1017,0,1.0,0.0,0
PF14216,PF11223:PF15337:PF07199,1,4,0,1,4,1013,0.0,1.0,0.0,-0.0,0,0,1,0,1017,0,1.0,0.0,0
PF00047,PF13895:PF03921:PF01403,37,43,24,13,19,962,0.56,0.97,0.65,0.59,8,7,30,1,980,0.88,0.97,0.19,0.4
PF15450,PF14615:PF12376:PF07458,1,7,0,1,7,1010,0.0,0.99,0.0,-0.0,0,0,1,0,1017,0,1.0,0.0,0
PF02123,PF09227:PF13331:PF12488,2,1,0,2,1,1015,0.0,1.0,0.0,-0.0,0,0,2,0,1016,0,1.0,0.0,0
PF03583,PF13092:PF10252:PF07542,1,18,0,1,18,999,0.0,0.98,0.0,-0.0,1,0,1,1,1016,0.0,1.0,0.0,-0.0
PF06373,PF06446:PF01099:PF00537,0,2,0,0,2,1016,0.0,1.0,0,0,0,0,0,0,1018,0,1.0,0,0
PF03846,PF06910:PF15081:PF15217,0,3,0,0,3,1015,0.0,1.0,0,0,0,0,0,0,1018,0,1.0,0,0
PF12604,PF03406:PF06070:PF07494,0,2,0,0,2,1016,0.0,1.0,0,0,0,0,0,0,1018,0,1.0,0,0
PF03092,PF04859:PF07786:PF04833,8,10,2,6,8,1002,0.2,0.99,0.25,0.22,0,0,8,0,1010,0,0.99,0.0,0
PF09259,PF00267:PF10618:PF17006,2,1,0,2,1,1015,0.0,1.0,0.0,-0.0,0,0,2,0,1016,0,1.0,0.0,0
PF01023,PF16166:PF01221:PF00036,10,48,6,4,42,966,0.12,0.95,0.6,0.26,7,4,6,3,1005,0.57,0.99,0.4,0.47
PF12460,PF07035:PF12036:PF04091,6,20,0,6,20,992,0.0,0.97,0.0,-0.01,2,0,6,2,1010,0.0,0.99,0.0,-0.0
PF05817,PF02580:PF09734:PF16720,13,19,7,6,12,993,0.37,0.98,0.54,0.44,4,4,9,0,1005,1.0,0.99,0.31,0.55
PF00636,PF14622:PF03368:PF00035,22,63,20,2,43,953,0.32,0.96,0.91,0.52,18,15,7,3,993,0.83,0.99,0.68,0.75
PF11917,PF09729:PF13434:PF16944,6,23,4,2,19,993,0.17,0.98,0.67,0.33,4,2,4,2,1010,0.5,0.99,0.33,0.41
PF02025,PF14862:PF06868:PF05418,2,1,0,2,1,1015,0.0,1.0,0.0,-0.0,0,0,2,0,1016,0,1.0,0.0,0
PF06807,PF16573:PF16575:PF08622,10,22,10,0,12,996,0.45,0.99,1.0,0.67,8,8,2,0,1008,1.0,1.0,0.8,0.89
PF00864,PF03036:PF03299:PF15390,10,16,2,8,14,994,0.12,0.98,0.2,0.15,2,2,8,0,1008,1.0,0.99,0.2,0.45
PF14973,PF15249:PF14722:PF09429,5,22,1,4,21,992,0.05,0.98,0.2,0.09,3,1,4,2,1011,0.33,0.99,0.2,0.26
PF08806,PF01667:PF01783:PF03942,12,29,7,5,22,984,0.24,0.97,0.58,0.36,3,2,10,1,1005,0.67,0.99,0.17,0.33
PF00748,PF08526:PF08527:PF03068,2,8,0,2,8,1008,0.0,0.99,0.0,-0.0,4,0,2,4,1012,0.0,0.99,0.0,-0.0
PF06165,PF17167:PF08302:PF09511,3,12,3,0,9,1006,0.25,0.99,1.0,0.5,4,1,2,3,1012,0.25,1.0,0.33,0.29
PF08854,PF05939:PF09951:PF08453,0,2,0,0,2,1016,0.0,1.0,0,0,0,0,0,0,1018,0,1.0,0,0
PF16644,PF08619:PF00999:PF02254,2,57,2,0,55,961,0.04,0.95,1.0,0.18,12,1,1,11,1005,0.08,0.99,0.5,0.2
PF01025,PF01871:PF03637:PF04759,15,22,4,11,18,985,0.18,0.97,0.27,0.21,3,2,13,1,1002,0.67,0.99,0.13,0.29
PF08527,PF03068:PF08526:PF02971,4,12,4,0,8,1006,0.33,0.99,1.0,0.58,4,4,0,0,1014,1.0,1.0,1.0,1.0
PF09500,PF11750:PF01361:PF15658,0,1,0,0,1,1017,0.0,1.0,0,0,0,0,0,0,1018,0,1.0,0,0
PF13307,PF06733:PF06777:PF07422,21,22,21,0,1,996,0.95,1.0,1.0,0.98,15,15,6,0,997,1.0,0.99,0.71,0.84
PF00160,PF13879:PF04641:PF15906,73,23,13,60,10,935,0.57,0.93,0.18,0.29,7,6,67,1,944,0.86,0.93,0.08,0.25
PF14959,PF13910:PF15627:PF08168,1,4,0,1,4,1013,0.0,1.0,0.0,-0.0,0,0,1,0,1017,0,1.0,0.0,0
PF10281,PF07543:PF03795:PF00366,8,23,4,4,19,991,0.17,0.98,0.5,0.29,7,4,4,3,1007,0.57,0.99,0.5,0.53
PF06035,PF14715:PF03922:PF04349,0,0,0,0,0,1018,0,1.0,0,0,0,0,0,0,1018,0,1.0,0,0
PF06422,PF08370:PF14510:PF14396,15,18,14,1,4,999,0.78,1.0,0.93,0.85,5,4,11,1,1002,0.8,0.99,0.27,0.46
PF09060,PF09007:PF10608:PF10571,1,2,1,0,1,1016,0.5,1.0,1.0,0.71,1,1,0,0,1017,1.0,1.0,1.0,1.0
PF09296,PF09297:PF15916:PF05026,8,17,6,2,11,999,0.35,0.99,0.75,0.51,4,3,5,1,1009,0.75,0.99,0.38,0.53
PF10721,PF16178:PF02902:PF00145,0,85,0,0,85,933,0.0,0.92,0,0,17,0,0,17,1001,0.0,0.98,0,0
PF00098,PF02093:PF02337:PF07962,101,10,7,94,3,914,0.7,0.9,0.07,0.2,4,4,97,0,917,1.0,0.9,0.04,0.19
PF08391,PF03954:PF09006:PF06023,1,1,0,1,1,1016,0.0,1.0,0.0,-0.0,0,0,1,0,1017,0,1.0,0.0,0
PF15449,PF15302:PF12904:PF01114,1,1,0,1,1,1016,0.0,1.0,0.0,-0.0,0,0,1,0,1017,0,1.0,0.0,0
PF02759,PF00566:PF03456:PF02141,32,103,20,12,83,903,0.19,0.91,0.62,0.31,30,12,20,18,968,0.4,0.96,0.38,0.37
PF11176,PF08649:PF13564:PF04419,7,16,3,4,13,998,0.19,0.98,0.43,0.28,4,2,5,2,1009,0.5,0.99,0.29,0.37
PF08309,PF08622:PF17187:PF11958,1,7,0,1,7,1010,0.0,0.99,0.0,-0.0,2,0,1,2,1015,0.0,1.0,0.0,-0.0
PF15743,PF10452:PF14877:PF15050,0,8,0,0,8,1010,0.0,0.99,0,0,0,0,0,0,1018,0,1.0,0,0
PF08338,PF00908:PF14934:PF11803,8,9,3,5,6,1004,0.33,0.99,0.38,0.35,2,2,6,0,1010,1.0,0.99,0.25,0.5
PF11041,PF09397:PF07391:PF01136,2,6,0,2,6,1010,0.0,0.99,0.0,-0.0,0,0,2,0,1016,0,1.0,0.0,0
PF02098,PF02284:PF04176:PF06658,3,13,1,2,12,1003,0.08,0.99,0.33,0.16,4,0,3,4,1011,0.0,0.99,0.0,-0.0
PF07929,PF13392:PF04194:PF09698,5,15,0,5,15,998,0.0,0.98,0.0,-0.01,2,0,5,2,1011,0.0,0.99,0.0,-0.0
PF10044,PF12585:PF15048:PF04138,0,4,0,0,4,1014,0.0,1.0,0,0,0,0,0,0,1018,0,1.0,0,0
PF14771,PF15057:PF04357:PF15912,4,11,2,2,9,1005,0.18,0.99,0.5,0.3,0,0,4,0,1014,0,1.0,0.0,0
PF16590,PF02951:PF17061:PF03050,1,4,0,1,4,1013,0.0,1.0,0.0,-0.0,0,0,1,0,1017,0,1.0,0.0,0
PF08549,PF09775:PF16485:PF11958,3,6,0,3,6,1009,0.0,0.99,0.0,-0.0,0,0,3,0,1015,0,1.0,0.0,0
PF10320,PF06784:PF05719:PF14778,8,11,2,6,9,1001,0.18,0.99,0.25,0.21,2,1,7,1,1009,0.5,0.99,0.12,0.25
PF05253,PF05206:PF11722:PF05669,13,21,7,6,14,991,0.33,0.98,0.54,0.41,7,5,8,2,1003,0.71,0.99,0.38,0.52
PF05199,PF00732:PF06964:PF16010,62,64,55,7,9,947,0.86,0.98,0.89,0.86,17,16,46,1,955,0.94,0.95,0.26,0.48
PF11543,PF05020:PF05021:PF03880,9,13,8,1,5,1004,0.62,0.99,0.89,0.74,9,7,2,2,1007,0.78,1.0,0.78,0.78
PF05879,PF04091:PF13519:PF03839,13,46,9,4,37,968,0.2,0.96,0.69,0.35,10,6,7,4,1001,0.6,0.99,0.46,0.52
PF04355,PF02565:PF10109:PF17014,0,0,0,0,0,1018,0,1.0,0,0,0,0,0,0,1018,0,1.0,0,0
PF16573,PF06807:PF16575:PF08622,8,22,8,0,14,996,0.36,0.99,1.0,0.6,10,8,0,2,1008,0.8,1.0,1.0,0.89
PF00906,PF08453:PF14690:PF13742,1,4,0,1,4,1013,0.0,1.0,0.0,-0.0,0,0,1,0,1017,0,1.0,0.0,0
PF00221,PF12053:PF01569:PF03417,11,44,2,9,42,965,0.05,0.95,0.18,0.07,6,2,9,4,1003,0.33,0.99,0.18,0.24
PF02278,PF02884:PF08124:PF04425,2,2,2,0,0,1016,1.0,1.0,1.0,1.0,1,1,1,0,1016,1.0,1.0,0.5,0.71
PF08336,PF13640:PF10288:PF04406,10,50,8,2,42,966,0.16,0.96,0.8,0.35,9,3,7,6,1002,0.33,0.99,0.3,0.31
PF00764,PF00988:PF08252:PF00185,12,26,6,6,20,986,0.23,0.97,0.5,0.33,13,3,9,10,996,0.23,0.98,0.25,0.23
PF02743,PF08473:PF13757:PF08399,14,10,4,10,6,998,0.4,0.98,0.29,0.33,5,3,11,2,1002,0.6,0.99,0.21,0.35
PF14911,PF14951:PF14910:PF08526,1,8,1,0,7,1010,0.12,0.99,1.0,0.35,0,0,1,0,1017,0,1.0,0.0,0
PF12825,PF12828:PF09325:PF03700,7,21,6,1,15,996,0.29,0.98,0.86,0.49,2,2,5,0,1011,1.0,1.0,0.29,0.53
PF14868,PF06414:PF10253:PF12018,0,18,0,0,18,1000,0.0,0.98,0,0,4,0,0,4,1014,0.0,1.0,0,0
PF09465,PF01222:PF08504:PF10846,7,27,6,1,21,990,0.22,0.98,0.86,0.43,5,4,3,1,1010,0.8,1.0,0.57,0.67
PF05797,PF01752:PF04451:PF03050,0,3,0,0,3,1015,0.0,1.0,0,0,0,0,0,0,1018,0,1.0,0,0
PF07168,PF07712:PF00197:PF06113,2,5,0,2,5,1011,0.0,0.99,0.0,-0.0,0,0,2,0,1016,0,1.0,0.0,0
PF01515,PF07085:PF00799:PF11958,8,11,5,3,6,1004,0.45,0.99,0.62,0.53,2,2,6,0,1010,1.0,0.99,0.25,0.5
PF03194,PF01733:PF07542:PF06309,10,27,2,8,25,983,0.07,0.97,0.2,0.11,4,2,8,2,1006,0.5,0.99,0.2,0.31
PF15735,PF11502:PF15997:PF15793,5,1,0,5,1,1012,0.0,0.99,0.0,-0.0,0,0,5,0,1013,0,1.0,0.0,0
PF14656,PF14655:PF07919:PF11817,6,17,6,0,11,1001,0.35,0.99,1.0,0.59,3,0,6,3,1009,0.0,0.99,0.0,-0.0
PF13519,PF08487:PF15300:PF14624,35,18,11,24,7,976,0.61,0.97,0.31,0.42,3,2,33,1,982,0.67,0.97,0.06,0.19
PF02662,PF14322:PF02305:PF15049,0,1,0,0,1,1017,0.0,1.0,0,0,0,0,0,0,1018,0,1.0,0,0
PF14662,PF14722:PF10377:PF14738,2,15,1,1,14,1002,0.07,0.99,0.5,0.18,1,1,1,0,1016,1.0,1.0,0.5,0.71
PF01011,PF13570:PF13360:PF07774,9,32,9,0,23,986,0.28,0.98,1.0,0.52,13,4,5,9,1000,0.31,0.99,0.44,0.36
PF03349,PF05736:PF02217:PF12477,0,3,0,0,3,1015,0.0,1.0,0,0,0,0,0,0,1018,0,1.0,0,0
PF07334,PF07292:PF08961:PF08564,1,11,1,0,10,1007,0.09,0.99,1.0,0.3,1,0,1,1,1016,0.0,1.0,0.0,-0.0
PF12856,PF09109:PF03241:PF08497,1,0,0,1,0,1017,0,1.0,0.0,0,0,0,1,0,1017,0,1.0,0.0,0
PF11861,PF07780:PF10691:PF14978,15,17,14,1,3,1000,0.82,1.0,0.93,0.87,5,5,10,0,1003,1.0,0.99,0.33,0.57
PF12108,PF11931:PF16958:PF16837,6,7,6,0,1,1011,0.86,1.0,1.0,0.93,5,5,1,0,1012,1.0,1.0,0.83,0.91
PF01743,PF01144:PF05827:PF10022,12,28,3,9,25,981,0.11,0.97,0.25,0.15,6,1,11,5,1001,0.17,0.98,0.08,0.11
PF00834,PF00197:PF01115:PF03694,19,14,6,13,8,991,0.43,0.98,0.32,0.36,0,0,19,0,999,0,0.98,0.0,0
PF04535,PF06749:PF04720:PF06376,5,14,3,2,11,1002,0.21,0.99,0.6,0.35,2,1,4,1,1012,0.5,1.0,0.2,0.31
PF05824,PF06875:PF06581:PF14653,2,0,0,2,0,1016,0,1.0,0.0,0,0,0,2,0,1016,0,1.0,0.0,0
PF04622,PF07444:PF13095:PF11317,5,2,0,5,2,1011,0.0,0.99,0.0,-0.0,0,0,5,0,1013,0,1.0,0.0,0
PF08127,PF08773:PF12131:PF03301,3,7,2,1,5,1010,0.29,0.99,0.67,0.43,1,1,2,0,1015,1.0,1.0,0.33,0.58
PF14657,PF16055:PF01514:PF07660,1,1,0,1,1,1016,0.0,1.0,0.0,-0.0,0,0,1,0,1017,0,1.0,0.0,0
PF01364,PF15518:PF03090:PF10554,2,1,0,2,1,1015,0.0,1.0,0.0,-0.0,0,0,2,0,1016,0,1.0,0.0,0
PF05686,PF04777:PF06964:PF08239,29,44,13,16,31,958,0.3,0.95,0.45,0.34,3,2,27,1,988,0.67,0.97,0.07,0.21
PF02104,PF02284:PF04176:PF04667,7,17,1,6,16,995,0.06,0.98,0.14,0.08,3,0,7,3,1008,0.0,0.99,0.0,-0.0
PF12525,PF06902:PF08808:PF04076,0,0,0,0,0,1018,0,1.0,0,0,0,0,0,0,1018,0,1.0,0,0
PF07996,PF08808:PF05962:PF09498,3,1,0,3,1,1014,0.0,1.0,0.0,-0.0,0,0,3,0,1015,0,1.0,0.0,0
PF06160,PF01446:PF15144:PF14478,0,3,0,0,3,1015,0.0,1.0,0,0,0,0,0,0,1018,0,1.0,0,0
PF03161,PF00831:PF06645:PF10775,9,15,1,8,14,995,0.07,0.98,0.11,0.08,3,0,9,3,1006,0.0,0.99,0.0,-0.01
PF10441,PF17034:PF12372:PF15027,5,9,1,4,8,1005,0.11,0.99,0.2,0.14,3,1,4,2,1011,0.33,0.99,0.2,0.26
PF01833,PF08337:PF10162:PF03859,37,20,14,23,6,975,0.7,0.97,0.38,0.5,5,5,32,0,981,1.0,0.97,0.14,0.36
PF03951,PF12437:PF04909:PF16952,10,38,3,7,35,973,0.08,0.96,0.3,0.14,3,2,8,1,1007,0.67,0.99,0.2,0.36
PF12437,PF16952:PF03951:PF04909,2,45,2,0,43,973,0.04,0.96,1.0,0.21,4,2,0,2,1014,0.5,1.0,1.0,0.71
PF14226,PF03171:PF01066:PF13344,39,80,38,1,42,937,0.47,0.96,0.97,0.66,23,12,27,11,968,0.52,0.96,0.31,0.38
PF07960,PF05962:PF06681:PF07209,2,2,0,2,2,1014,0.0,1.0,0.0,-0.0,0,0,2,0,1016,0,1.0,0.0,0
PF02882,PF01268:PF00763:PF17135,30,30,24,6,6,982,0.8,0.99,0.8,0.79,13,13,17,0,988,1.0,0.98,0.43,0.65
PF04235,PF10406:PF05119:PF10607,0,30,0,0,30,988,0.0,0.97,0,0,2,0,0,2,1016,0.0,1.0,0,0
PF04186,PF15713:PF03203:PF14862,0,2,0,0,2,1016,0.0,1.0,0,0,0,0,0,0,1018,0,1.0,0,0
PF00475,PF12311:PF01933:PF01687,9,19,2,7,17,992,0.11,0.98,0.22,0.14,2,0,9,2,1007,0.0,0.99,0.0,-0.0
PF15899,PF15021:PF15851:PF10279,2,0,0,2,0,1016,0,1.0,0.0,0,0,0,2,0,1016,0,1.0,0.0,0
PF02217,PF06505:PF01752:PF04740,3,2,0,3,2,1013,0.0,1.0,0.0,-0.0,0,0,3,0,1015,0,1.0,0.0,0
PF11555,PF07815:PF08397:PF09027,3,12,2,1,10,1005,0.17,0.99,0.67,0.33,4,2,1,2,1013,0.5,1.0,0.67,0.58
PF13326,PF09252:PF01809:PF05355,1,3,0,1,3,1014,0.0,1.0,0.0,-0.0,0,0,1,0,1017,0,1.0,0.0,0
PF14755,PF00063:PF08416:PF16735,2,76,2,0,74,942,0.03,0.93,1.0,0.16,11,2,0,9,1007,0.18,0.99,1.0,0.42
PF10134,PF10554:PF07523:PF03428,0,0,0,0,0,1018,0,1.0,0,0,0,0,0,0,1018,0,1.0,0,0
PF06804,PF03412:PF07123:PF00950,4,9,2,2,7,1007,0.22,0.99,0.5,0.33,3,2,2,1,1013,0.67,1.0,0.5,0.58
PF15249,PF12516:PF15778:PF15292,9,3,0,9,3,1006,0.0,0.99,0.0,-0.01,0,0,9,0,1009,0,0.99,0.0,0
PF09113,PF09112:PF02951:PF15661,0,6,0,0,6,1012,0.0,0.99,0,0,0,0,0,0,1018,0,1.0,0,0
PF07244,PF01103:PF02091:PF02092,6,31,6,0,25,987,0.19,0.98,1.0,0.43,8,2,4,6,1006,0.25,0.99,0.33,0.28
PF09439,PF02284:PF05047:PF01774,6,19,3,3,16,996,0.16,0.98,0.5,0.27,4,2,4,2,1010,0.5,0.99,0.33,0.41
PF10674,PF06581:PF11264:PF02943,1,2,0,1,2,1015,0.0,1.0,0.0,-0.0,0,0,1,0,1017,0,1.0,0.0,0
PF08538,PF10705:PF14542:PF04402,5,7,1,4,6,1007,0.14,0.99,0.2,0.16,1,0,5,1,1012,0.0,0.99,0.0,-0.0
PF03520,PF16799:PF11956:PF08412,8,9,4,4,5,1005,0.44,0.99,0.5,0.47,1,1,7,0,1010,1.0,0.99,0.12,0.35
PF12870,PF15712:PF06890:PF04352,0,0,0,0,0,1018,0,1.0,0,0,0,0,0,0,1018,0,1.0,0,0
PF00410,PF09341:PF06842:PF09495,20,15,5,15,10,988,0.33,0.98,0.25,0.28,3,2,18,1,997,0.67,0.98,0.1,0.25
PF03284,PF13366:PF15052:PF11268,0,3,0,0,3,1015,0.0,1.0,0,0,0,0,0,0,1018,0,1.0,0,0
PF05860,PF11245:PF03616:PF06798,0,1,0,0,1,1017,0.0,1.0,0,0,0,0,0,0,1018,0,1.0,0,0
PF14723,PF16756:PF08632:PF15774,1,5,0,1,5,1012,0.0,0.99,0.0,-0.0,0,0,1,0,1017,0,1.0,0.0,0
PF08802,PF02921:PF09165:PF04305,3,20,2,1,18,997,0.1,0.98,0.67,0.25,6,2,1,4,1011,0.33,1.0,0.67,0.47
PF00088,PF16863:PF17137:PF16338,16,23,8,8,15,987,0.35,0.98,0.5,0.41,2,2,14,0,1002,1.0,0.99,0.12,0.35
PF07160,PF10278:PF05612:PF14935,3,8,0,3,8,1007,0.0,0.99,0.0,-0.0,1,0,3,1,1014,0.0,1.0,0.0,-0.0
PF04115,PF03561:PF13411:PF05432,11,11,6,5,5,1002,0.55,0.99,0.55,0.54,3,2,9,1,1006,0.67,0.99,0.18,0.34
PF02110,PF02581:PF08543:PF07364,6,24,3,3,21,991,0.12,0.98,0.5,0.24,3,2,4,1,1011,0.67,1.0,0.33,0.47
PF14904,PF01869:PF10294:PF07109,2,47,2,0,45,971,0.04,0.96,1.0,0.2,7,0,2,7,1009,0.0,0.99,0.0,-0.0
PF13471,PF12883:PF04335:PF04060,4,8,3,1,5,1009,0.38,0.99,0.75,0.53,3,2,2,1,1013,0.67,1.0,0.5,0.58
PF00682,PF02436:PF08502:PF02785,22,39,13,9,26,970,0.33,0.97,0.59,0.43,3,3,19,0,996,1.0,0.98,0.14,0.37
PF06951,PF14954:PF09777:PF00272,11,4,1,10,3,1004,0.25,0.99,0.09,0.15,0,0,11,0,1007,0,0.99,0.0,0
PF01031,PF00350:PF04799:PF02212,47,71,46,1,25,946,0.65,0.97,0.98,0.79,31,29,18,2,969,0.94,0.98,0.62,0.75
PF02841,PF02263:PF04871:PF16013,12,31,12,0,19,987,0.39,0.98,1.0,0.62,6,4,8,2,1004,0.67,0.99,0.33,0.47
PF11794,PF03241:PF12080:PF13722,0,0,0,0,0,1018,0,1.0,0,0,0,0,0,0,1018,0,1.0,0,0
PF08373,PF08368:PF06743:PF15074,16,12,7,9,5,997,0.58,0.99,0.44,0.5,6,6,10,0,1002,1.0,0.99,0.38,0.61
PF06455,PF01010:PF00662:PF13910,2,6,2,0,4,1012,0.33,1.0,1.0,0.58,0,0,2,0,1016,0,1.0,0.0,0
PF15875,PF03033:PF10964:PF12394,0,25,0,0,25,993,0.0,0.98,0,0,0,0,0,0,1018,0,1.0,0,0
PF08506,PF08389:PF03378:PF12755,16,51,14,2,37,965,0.27,0.96,0.88,0.48,7,7,9,0,1002,1.0,0.99,0.44,0.66
PF03380,PF15724:PF06954:PF06875,0,1,0,0,1,1017,0.0,1.0,0,0,0,0,0,0,1018,0,1.0,0,0
PF15728,PF12843:PF12392:PF08453,1,3,0,1,3,1014,0.0,1.0,0.0,-0.0,0,0,1,0,1017,0,1.0,0.0,0
PF08491,PF12831:PF01266:PF01494,4,117,4,0,113,901,0.03,0.89,1.0,0.17,41,4,0,37,977,0.1,0.96,1.0,0.31
PF14887,PF13775:PF09667:PF12336,7,4,2,5,2,1009,0.5,0.99,0.29,0.37,0,0,7,0,1011,0,0.99,0.0,0
PF16541,PF01097:PF05039:PF02488,2,3,0,2,3,1013,0.0,1.0,0.0,-0.0,0,0,2,0,1016,0,1.0,0.0,0
PF05225,PF04218:PF03221:PF03184,27,77,23,4,54,937,0.3,0.94,0.85,0.48,39,16,11,23,968,0.41,0.97,0.59,0.48
PF16042,PF03383:PF10148:PF15254,1,5,0,1,5,1012,0.0,0.99,0.0,-0.0,0,0,1,0,1017,0,1.0,0.0,0
PF00190,PF04859:PF04702:PF07762,17,19,5,12,14,987,0.26,0.97,0.29,0.27,3,3,14,0,1001,1.0,0.99,0.18,0.42
PF05687,PF01373:PF03181:PF06964,6,25,5,1,20,992,0.2,0.98,0.83,0.4,2,1,5,1,1011,0.5,0.99,0.17,0.29
PF12258,PF16892:PF16893:PF09309,0,2,0,0,2,1016,0.0,1.0,0,0,2,0,0,2,1016,0.0,1.0,0,0
PF12031,PF01388:PF08169:PF02257,8,42,6,2,36,974,0.14,0.96,0.75,0.32,10,4,4,6,1004,0.4,0.99,0.5,0.44
PF02264,PF00367:PF10410:PF16416,2,11,2,0,9,1007,0.18,0.99,1.0,0.42,1,0,2,1,1015,0.0,1.0,0.0,-0.0
PF16632,PF16600:PF16553:PF15808,1,4,1,0,3,1014,0.25,1.0,1.0,0.5,1,1,0,0,1017,1.0,1.0,1.0,1.0
PF01737,PF03819:PF05135:PF15207,0,2,0,0,2,1016,0.0,1.0,0,0,0,0,0,0,1018,0,1.0,0,0
PF15917,PF09743:PF12166:PF08638,2,19,2,0,17,999,0.11,0.98,1.0,0.32,2,0,2,2,1014,0.0,1.0,0.0,-0.0
PF06725,PF13753:PF12081:PF12477,1,0,0,1,0,1017,0,1.0,0.0,0,0,0,1,0,1017,0,1.0,0.0,0
PF07892,PF16350:PF04324:PF16901,1,27,1,0,26,991,0.04,0.97,1.0,0.19,2,1,0,1,1016,0.5,1.0,1.0,0.71
PF01365,PF08709:PF02026:PF08454,9,18,9,0,9,1000,0.5,0.99,1.0,0.7,11,8,1,3,1006,0.73,1.0,0.89,0.8
PF01397,PF03936:PF05827:PF16401,16,29,16,0,13,989,0.55,0.99,1.0,0.74,2,1,15,1,1001,0.5,0.98,0.06,0.17
PF01195,PF04690:PF04720:PF06749,8,14,2,6,12,998,0.14,0.98,0.25,0.18,3,2,6,1,1009,0.67,0.99,0.25,0.41
PF01272,PF06429:PF03963:PF07963,10,4,1,9,3,1005,0.25,0.99,0.1,0.15,1,0,10,1,1007,0.0,0.99,0.0,-0.0
PF03475,PF11591:PF03473:PF03450,6,32,6,0,26,986,0.19,0.97,1.0,0.43,6,3,3,3,1009,0.5,0.99,0.5,0.5
PF11528,PF16011:PF03562:PF04963,0,3,0,0,3,1015,0.0,1.0,0,0,1,0,0,1,1017,0.0,1.0,0,0
PF04547,PF16178:PF06733:PF09733,18,31,11,7,20,980,0.35,0.97,0.61,0.45,4,4,14,0,1000,1.0,0.99,0.22,0.47
PF16876,PF08235:PF04571:PF12366,9,12,9,0,3,1006,0.75,1.0,1.0,0.86,11,9,0,2,1007,0.82,1.0,1.0,0.9
PF02550,PF13336:PF01273:PF01144,10,38,9,1,29,979,0.24,0.97,0.9,0.45,4,1,9,3,1005,0.25,0.99,0.1,0.15
PF03129,PF02403:PF00458:PF09180,40,40,20,20,20,958,0.5,0.96,0.5,0.48,9,9,31,0,978,1.0,0.97,0.23,0.47
PF00507,PF00499:PF00124:PF01058,5,19,2,3,17,996,0.11,0.98,0.4,0.2,2,1,4,1,1012,0.5,1.0,0.2,0.31
PF09668,PF09280:PF12057:PF08325,19,14,7,12,7,992,0.5,0.98,0.37,0.42,3,3,16,0,999,1.0,0.98,0.16,0.39
PF02431,PF03386:PF01176:PF08536,2,16,1,1,15,1001,0.06,0.98,0.5,0.17,1,0,2,1,1015,0.0,1.0,0.0,-0.0
PF10555,PF02719:PF03726:PF10119,7,12,7,0,5,1006,0.58,1.0,1.0,0.76,1,1,6,0,1011,1.0,0.99,0.14,0.38
PF02932,PF02931:PF04406:PF05450,69,91,65,4,26,923,0.71,0.97,0.94,0.81,11,9,60,2,947,0.82,0.94,0.13,0.31
PF00195,PF02797:PF08545:PF03951,23,28,18,5,10,985,0.64,0.99,0.78,0.7,4,3,20,1,994,0.75,0.98,0.13,0.31
PF16207,PF08941:PF02172:PF03167,11,33,4,7,29,978,0.12,0.96,0.36,0.2,7,3,8,4,1003,0.43,0.99,0.27,0.34
PF05477,PF15552:PF13232:PF08194,7,1,1,6,0,1011,1.0,0.99,0.14,0.38,0,0,7,0,1011,0,0.99,0.0,0
PF02721,PF16900:PF08646:PF01336,12,59,10,2,49,957,0.17,0.95,0.83,0.36,17,9,3,8,998,0.53,0.99,0.75,0.62
PF05699,PF14291:PF02892:PF04937,67,51,30,37,21,930,0.59,0.94,0.45,0.48,17,16,51,1,950,0.94,0.95,0.24,0.46
PF01358,PF03618:PF17078:PF17017,1,3,0,1,3,1014,0.0,1.0,0.0,-0.0,0,0,1,0,1017,0,1.0,0.0,0
PF07565,PF00955:PF00359:PF13020,7,25,7,0,18,993,0.28,0.98,1.0,0.52,2,1,6,1,1010,0.5,0.99,0.14,0.26
PF03441,PF00875:PF10155:PF01755,11,30,10,1,20,987,0.33,0.98,0.91,0.54,3,2,9,1,1006,0.67,0.99,0.18,0.34
PF05277,PF06463:PF04055:PF08600,17,63,8,9,55,946,0.13,0.94,0.47,0.22,11,5,12,6,995,0.45,0.98,0.29,0.36
PF03797,PF14449:PF14793:PF11862,2,1,0,2,1,1015,0.0,1.0,0.0,-0.0,0,0,2,0,1016,0,1.0,0.0,0
PF04966,PF10429:PF03498:PF15114,1,1,0,1,1,1016,0.0,1.0,0.0,-0.0,0,0,1,0,1017,0,1.0,0.0,0
PF04135,PF15014:PF05754:PF02972,6,1,0,6,1,1011,0.0,0.99,0.0,-0.0,0,0,6,0,1012,0,0.99,0.0,0
PF05155,PF12081:PF06082:PF11874,0,0,0,0,0,1018,0,1.0,0,0,0,0,0,0,1018,0,1.0,0,0
PF01340,PF12320:PF02718:PF10092,1,0,0,1,0,1017,0,1.0,0.0,0,0,0,1,0,1017,0,1.0,0.0,0
PF10073,PF04612:PF16055:PF09673,0,1,0,0,1,1017,0.0,1.0,0,0,0,0,0,0,1018,0,1.0,0,0
PF13352,PF14922:PF04880:PF15007,2,6,0,2,6,1010,0.0,0.99,0.0,-0.0,1,0,2,1,1015,0.0,1.0,0.0,-0.0
PF02112,PF11970:PF07217:PF11885,4,15,1,3,14,1000,0.07,0.98,0.25,0.12,2,0,4,2,1012,0.0,0.99,0.0,-0.0
PF01641,PF05047:PF01625:PF01192,9,27,3,6,24,985,0.11,0.97,0.33,0.18,6,1,8,5,1004,0.17,0.99,0.11,0.13
PF00569,PF16577:PF16158:PF09030,43,19,12,31,7,968,0.63,0.96,0.28,0.4,3,3,40,0,975,1.0,0.96,0.07,0.26
PF12406,PF04145:PF07080:PF07823,1,29,1,0,28,989,0.03,0.97,1.0,0.18,3,0,1,3,1014,0.0,1.0,0.0,-0.0
PF12040,PF12679:PF12256:PF04917,0,1,0,0,1,1017,0.0,1.0,0,0,0,0,0,0,1018,0,1.0,0,0
PF08311,PF12202:PF14593:PF12063,8,17,3,5,14,996,0.18,0.98,0.38,0.25,4,3,5,1,1009,0.75,0.99,0.38,0.53
PF12234,PF09453:PF14538:PF07304,7,29,4,3,25,986,0.14,0.97,0.57,0.27,6,1,6,5,1006,0.17,0.99,0.14,0.15
PF13579,PF13439:PF12038:PF04413,2,25,1,1,24,992,0.04,0.98,0.5,0.14,1,0,2,1,1015,0.0,1.0,0.0,-0.0
PF01925,PF04406:PF06237:PF01144,9,30,5,4,25,984,0.17,0.97,0.56,0.29,8,2,7,6,1003,0.25,0.99,0.22,0.23
PF16089,PF15884:PF00727:PF04402,0,9,0,0,9,1009,0.0,0.99,0,0,4,0,0,4,1014,0.0,1.0,0,0
PF12150,PF07956:PF14931:PF05436,2,8,0,2,8,1008,0.0,0.99,0.0,-0.0,1,0,2,1,1015,0.0,1.0,0.0,-0.0
PF04221,PF04170:PF03925:PF13876,1,2,1,0,1,1016,0.5,1.0,1.0,0.71,0,0,1,0,1017,0,1.0,0.0,0
PF14901,PF14308:PF05207:PF00684,2,23,1,1,22,994,0.04,0.98,0.5,0.14,4,0,2,4,1012,0.0,0.99,0.0,-0.0
PF02786,PF00988:PF01808:PF01039,50,55,31,19,24,944,0.56,0.96,0.62,0.57,8,6,44,2,966,0.75,0.95,0.12,0.29
PF05571,PF02792:PF05856:PF14231,5,12,1,4,11,1002,0.08,0.99,0.2,0.12,0,0,5,0,1013,0,1.0,0.0,0
PF02136,PF09162:PF03943:PF14327,19,17,6,13,11,988,0.35,0.98,0.32,0.32,3,3,16,0,999,1.0,0.98,0.16,0.39
PF07572,PF02631:PF11267:PF15379,8,3,1,7,2,1008,0.33,0.99,0.12,0.2,1,1,7,0,1010,1.0,0.99,0.12,0.35
PF01134,PF13932:PF16044:PF03343,18,25,17,1,8,992,0.68,0.99,0.94,0.8,4,4,14,0,1000,1.0,0.99,0.22,0.47
PF07931,PF13810:PF10295:PF05841,3,4,1,2,3,1012,0.25,1.0,0.33,0.29,0,0,3,0,1015,0,1.0,0.0,0
PF14312,PF03382:PF03457:PF03160,2,19,0,2,19,997,0.0,0.98,0.0,-0.01,4,0,2,4,1012,0.0,0.99,0.0,-0.0
PF08484,PF08421:PF02425:PF11967,2,2,2,0,0,1016,1.0,1.0,1.0,1.0,0,0,2,0,1016,0,1.0,0.0,0
PF08519,PF16725:PF09079:PF16193,14,23,5,9,18,986,0.22,0.97,0.36,0.27,2,1,13,1,1003,0.5,0.99,0.07,0.19
PF01237,PF08174:PF01412:PF12430,41,49,16,25,33,944,0.33,0.94,0.39,0.33,6,4,37,2,975,0.67,0.96,0.1,0.25
PF14492,PF16004:PF03764:PF00679,35,51,27,8,24,959,0.53,0.97,0.77,0.62,23,20,15,3,980,0.87,0.98,0.57,0.7
PF08433,PF14712:PF13778:PF09014,13,12,2,11,10,995,0.17,0.98,0.15,0.15,0,0,13,0,1005,0,0.99,0.0,0
PF03962,PF05207:PF09495:PF00684,7,16,2,5,14,997,0.12,0.98,0.29,0.18,1,0,7,1,1010,0.0,0.99,0.0,-0.0
PF13586,PF08737:PF03357:PF00033,0,57,0,0,57,961,0.0,0.94,0,0,6,0,0,6,1012,0.0,0.99,0,0
PF13886,PF10505:PF00924:PF01755,18,27,5,13,22,978,0.19,0.97,0.28,0.21,5,2,16,3,997,0.4,0.98,0.11,0.2
PF06424,PF08163:PF12770:PF17109,2,26,1,1,25,991,0.04,0.97,0.5,0.13,3,1,1,2,1014,0.33,1.0,0.5,0.41
PF08346,PF06745:PF12302:PF07804,0,3,0,0,3,1015,0.0,1.0,0,0,0,0,0,0,1018,0,1.0,0,0
PF07007,PF17119:PF06677:PF01679,0,15,0,0,15,1003,0.0,0.99,0,0,3,0,0,3,1015,0.0,1.0,0,0
PF16925,PF13750:PF13722:PF06798,1,0,0,1,0,1017,0,1.0,0.0,0,0,0,1,0,1017,0,1.0,0.0,0
PF12830,PF05041:PF12422:PF15996,9,15,1,8,14,995,0.07,0.98,0.11,0.08,3,0,9,3,1006,0.0,0.99,0.0,-0.01
PF15177,PF06679:PF14935:PF15260,6,4,1,5,3,1009,0.25,0.99,0.17,0.2,0,0,6,0,1012,0,0.99,0.0,0
PF11493,PF09252:PF07327:PF15119,0,2,0,0,2,1016,0.0,1.0,0,0,0,0,0,0,1018,0,1.0,0,0
PF02682,PF02626:PF00289:PF02785,11,37,11,0,26,981,0.3,0.97,1.0,0.54,33,8,3,25,982,0.24,0.97,0.73,0.41
PF12662,PF07474:PF12661:PF07645,24,73,23,1,50,944,0.32,0.95,0.96,0.53,30,18,6,12,982,0.6,0.98,0.75,0.66
PF13746,PF11614:PF14882:PF07805,4,5,4,0,1,1013,0.8,1.0,1.0,0.89,0,0,4,0,1014,0,1.0,0.0,0
PF12799,PF12819:PF13855:PF15904,42,152,38,4,114,862,0.25,0.88,0.9,0.44,14,7,35,7,969,0.5,0.96,0.17,0.27
PF04924,PF01540:PF01504:PF14399,0,45,0,0,45,973,0.0,0.96,0,0,2,0,0,2,1016,0.0,1.0,0,0
PF15102,PF16649:PF05836:PF08738,3,1,0,3,1,1014,0.0,1.0,0.0,-0.0,0,0,3,0,1015,0,1.0,0.0,0
PF15092,PF11593:PF10106:PF15832,4,3,0,4,3,1011,0.0,0.99,0.0,-0.0,0,0,4,0,1014,0,1.0,0.0,0
PF00664,PF06472:PF02769:PF13304,105,28,17,88,11,902,0.61,0.9,0.16,0.28,4,4,101,0,913,1.0,0.9,0.04,0.19
PF04042,PF00429:PF15072:PF03435,27,31,9,18,22,969,0.29,0.96,0.33,0.29,4,3,24,1,990,0.75,0.98,0.11,0.28
PF16358,PF10554:PF03180:PF15150,0,3,0,0,3,1015,0.0,1.0,0,0,0,0,0,0,1018,0,1.0,0,0
PF01230,PF01177:PF01491:PF00795,28,49,13,15,36,954,0.27,0.95,0.46,0.33,8,6,22,2,988,0.75,0.98,0.21,0.39
PF05258,PF15680:PF13011:PF09232,0,0,0,0,0,1018,0,1.0,0,0,0,0,0,0,1018,0,1.0,0,0
PF14958,PF10253:PF15877:PF15311,0,9,0,0,9,1009,0.0,0.99,0,0,2,0,0,2,1016,0.0,1.0,0,0
PF01208,PF05562:PF01264:PF04690,12,9,2,10,7,999,0.22,0.98,0.17,0.18,1,0,12,1,1005,0.0,0.99,0.0,-0.0
PF14399,PF09260:PF07393:PF11852,7,13,2,5,11,1000,0.15,0.98,0.29,0.2,1,0,7,1,1010,0.0,0.99,0.0,-0.0
PF16165,PF08150:PF08165:PF08151,8,7,5,3,2,1008,0.71,1.0,0.62,0.67,5,3,5,2,1008,0.6,0.99,0.38,0.47
PF10592,PF08103:PF16566:PF12067,0,12,0,0,12,1006,0.0,0.99,0,0,1,0,0,1,1017,0.0,1.0,0,0
PF04613,PF13720:PF06426:PF01050,9,17,2,7,15,994,0.12,0.98,0.22,0.15,1,1,8,0,1009,1.0,0.99,0.11,0.33
PF01412,PF01237:PF08916:PF08174,47,47,19,28,28,943,0.4,0.94,0.4,0.38,3,3,44,0,971,1.0,0.96,0.06,0.25
PF09790,PF15247:PF08209:PF15991,5,17,3,2,14,999,0.18,0.98,0.6,0.32,0,0,5,0,1013,0,1.0,0.0,0
PF14517,PF08535:PF07010:PF02305,1,2,0,1,2,1015,0.0,1.0,0.0,-0.0,0,0,1,0,1017,0,1.0,0.0,0
PF06751,PF08708:PF07805:PF10566,1,1,0,1,1,1016,0.0,1.0,0.0,-0.0,0,0,1,0,1017,0,1.0,0.0,0
PF02595,PF02565:PF11245:PF08497,1,0,0,1,0,1017,0,1.0,0.0,0,0,0,1,0,1017,0,1.0,0.0,0
PF05664,PF01735:PF10540:PF15625,15,24,5,10,19,984,0.21,0.97,0.33,0.25,3,1,14,2,1001,0.33,0.98,0.07,0.14
PF14829,PF16076:PF16094:PF08806,2,29,1,1,28,988,0.03,0.97,0.5,0.13,9,1,1,8,1008,0.11,0.99,0.5,0.23
PF14770,PF15071:PF06232:PF15370,3,7,0,3,7,1008,0.0,0.99,0.0,-0.0,0,0,3,0,1015,0,1.0,0.0,0
PF05926,PF00364:PF01528:PF07105,0,44,0,0,44,974,0.0,0.96,0,0,0,0,0,0,1018,0,1.0,0,0
PF12926,PF08228:PF16007:PF01878,0,12,0,0,12,1006,0.0,0.99,0,0,2,0,0,2,1016,0.0,1.0,0,0
PF02987,PF02919:PF15694:PF01028,0,8,0,0,8,1010,0.0,0.99,0,0,6,0,0,6,1012,0.0,0.99,0,0
PF05839,PF01428:PF02063:PF14342,4,29,2,2,27,987,0.07,0.97,0.5,0.18,4,1,3,3,1011,0.25,0.99,0.25,0.25
PF07962,PF16297:PF10175:PF02093,6,10,3,3,7,1005,0.3,0.99,0.5,0.38,2,2,4,0,1012,1.0,1.0,0.33,0.58
PF16022,PF07178:PF05509:PF05513,0,1,0,0,1,1017,0.0,1.0,0,0,1,0,0,1,1017,0.0,1.0,0,0
PF13166,PF10375:PF11291:PF15453,0,1,0,0,1,1017,0.0,1.0,0,0,0,0,0,0,1018,0,1.0,0,0
PF02513,PF02988:PF06189:PF10265,1,6,0,1,6,1011,0.0,0.99,0.0,-0.0,0,0,1,0,1017,0,1.0,0.0,0
PF03692,PF15062:PF08692:PF13270,1,3,0,1,3,1014,0.0,1.0,0.0,-0.0,0,0,1,0,1017,0,1.0,0.0,0
PF02191,PF02354:PF12308:PF02140,13,32,6,7,26,979,0.19,0.97,0.46,0.28,3,2,11,1,1004,0.67,0.99,0.15,0.32
PF04437,PF08318:PF16061:PF11571,13,23,8,5,15,990,0.35,0.98,0.62,0.45,2,1,12,1,1004,0.5,0.99,0.08,0.19
PF02378,PF09648:PF11870:PF03123,8,2,2,6,0,1010,1.0,0.99,0.25,0.5,0,0,8,0,1010,0,0.99,0.0,0
PF02424,PF02910:PF00890:PF12831,2,51,2,0,49,967,0.04,0.95,1.0,0.19,20,1,1,19,997,0.05,0.98,0.5,0.15
PF13019,PF05508:PF14909:PF12898,5,5,1,4,4,1009,0.2,0.99,0.2,0.2,0,0,5,0,1013,0,1.0,0.0,0
PF11265,PF11232:PF11244:PF11235,4,6,3,1,3,1011,0.5,1.0,0.75,0.61,0,0,4,0,1014,0,1.0,0.0,0
PF15847,PF08291:PF05962:PF14344,3,1,0,3,1,1014,0.0,1.0,0.0,-0.0,0,0,3,0,1015,0,1.0,0.0,0
PF15218,PF15837:PF15100:PF15828,0,2,0,0,2,1016,0.0,1.0,0,0,0,0,0,0,1018,0,1.0,0,0
PF06658,PF04176:PF02284:PF04716,3,22,2,1,20,995,0.09,0.98,0.67,0.24,4,1,2,3,1012,0.25,1.0,0.33,0.29
PF08069,PF05019:PF00312:PF03979,12,32,10,2,22,984,0.31,0.98,0.83,0.5,4,4,8,0,1006,1.0,0.99,0.33,0.58
PF12844,PF03709:PF01355:PF09950,2,4,1,1,3,1013,0.25,1.0,0.5,0.35,0,0,2,0,1016,0,1.0,0.0,0
PF10156,PF04087:PF05334:PF12576,3,3,0,3,3,1012,0.0,0.99,0.0,-0.0,0,0,3,0,1015,0,1.0,0.0,0
PF16799,PF03521:PF11933:PF03520,2,14,1,1,13,1003,0.07,0.99,0.5,0.19,1,1,1,0,1016,1.0,1.0,0.5,0.71
PF06650,PF16909:PF16910:PF12624,21,35,19,2,16,981,0.54,0.98,0.9,0.69,21,14,7,7,990,0.67,0.99,0.67,0.66
PF02099,PF08059:PF05839:PF11891,9,17,4,5,13,996,0.24,0.98,0.44,0.32,2,0,9,2,1007,0.0,0.99,0.0,-0.0
PF11245,PF08497:PF02465:PF03090,0,0,0,0,0,1018,0,1.0,0,0,0,0,0,0,1018,0,1.0,0,0
PF14400,PF01342:PF07445:PF10923,0,10,0,0,10,1008,0.0,0.99,0,0,0,0,0,0,1018,0,1.0,0,0
PF06094,PF02330:PF06884:PF12311,18,17,7,11,10,990,0.41,0.98,0.39,0.39,1,1,17,0,1000,1.0,0.98,0.06,0.23
PF06573,PF15207:PF03050:PF03238,2,1,0,2,1,1015,0.0,1.0,0.0,-0.0,0,0,2,0,1016,0,1.0,0.0,0
PF03824,PF08228:PF15831:PF01878,9,12,3,6,9,1000,0.25,0.99,0.33,0.28,1,0,9,1,1008,0.0,0.99,0.0,-0.0
PF15478,PF14866:PF15680:PF13094,1,1,0,1,1,1016,0.0,1.0,0.0,-0.0,0,0,1,0,1017,0,1.0,0.0,0
PF05919,PF09216:PF15062:PF06695,2,0,0,2,0,1016,0,1.0,0.0,0,0,0,2,0,1016,0,1.0,0.0,0
PF07646,PF06588:PF10102:PF07734,14,19,4,10,15,989,0.21,0.98,0.29,0.23,2,1,13,1,1003,0.5,0.99,0.07,0.19
PF02020,PF04613:PF02847:PF13720,32,28,12,20,16,970,0.43,0.96,0.38,0.38,2,2,30,0,986,1.0,0.97,0.06,0.25
PF13462,PF01097:PF07333:PF05039,10,4,0,10,4,1004,0.0,0.99,0.0,-0.01,0,0,10,0,1008,0,0.99,0.0,0
PF11835,PF13320:PF14613:PF12432,1,4,0,1,4,1013,0.0,1.0,0.0,-0.0,0,0,1,0,1017,0,1.0,0.0,0
PF04863,PF04864:PF03979:PF07014,2,10,2,0,8,1008,0.2,0.99,1.0,0.45,0,0,2,0,1016,0,1.0,0.0,0
PF10572,PF15623:PF16590:PF00997,4,1,0,4,1,1013,0.0,1.0,0.0,-0.0,0,0,4,0,1014,0,1.0,0.0,0
PF10479,PF00680:PF15994:PF15995,8,12,1,7,11,999,0.08,0.98,0.12,0.09,0,0,8,0,1010,0,0.99,0.0,0
PF04426,PF04425:PF08124:PF02884,3,2,0,3,2,1013,0.0,1.0,0.0,-0.0,1,0,3,1,1014,0.0,1.0,0.0,-0.0
PF01808,PF02729:PF00185:PF00988,13,26,2,11,24,981,0.08,0.97,0.15,0.09,20,2,11,18,987,0.1,0.97,0.15,0.11
PF12742,PF07919:PF12584:PF11817,3,14,3,0,11,1004,0.21,0.99,1.0,0.46,4,2,1,2,1013,0.5,1.0,0.67,0.58
PF03079,PF05995:PF01774:PF11779,17,18,6,11,12,989,0.33,0.98,0.35,0.33,4,2,15,2,999,0.5,0.98,0.12,0.24
PF14635,PF14639:PF14641:PF14632,13,14,13,0,1,1004,0.93,1.0,1.0,0.96,13,13,0,0,1005,1.0,1.0,1.0,1.0
PF02321,PF01114:PF07014:PF15302,12,1,0,12,1,1005,0.0,0.99,0.0,-0.0,0,0,12,0,1006,0,0.99,0.0,0
PF02253,PF15750:PF04865:PF02211,1,4,0,1,4,1013,0.0,1.0,0.0,-0.0,0,0,1,0,1017,0,1.0,0.0,0
PF08457,PF10638:PF02916:PF17077,7,2,0,7,2,1009,0.0,0.99,0.0,-0.0,0,0,7,0,1011,0,0.99,0.0,0
PF06235,PF02378:PF12242:PF06942,2,8,1,1,7,1009,0.12,0.99,0.5,0.25,1,1,1,0,1016,1.0,1.0,0.5,0.71
PF12546,PF00875:PF04244:PF03441,0,19,0,0,19,999,0.0,0.98,0,0,10,0,0,10,1008,0.0,0.99,0,0
PF10445,PF15776:PF06890:PF15708,1,2,0,1,2,1015,0.0,1.0,0.0,-0.0,0,0,1,0,1017,0,1.0,0.0,0
PF16871,PF11958:PF07963:PF17085,0,7,0,0,7,1011,0.0,0.99,0,0,0,0,0,0,1018,0,1.0,0,0
PF10484,PF14864:PF14863:PF11718,12,15,3,9,12,994,0.2,0.98,0.25,0.21,4,1,11,3,1003,0.25,0.99,0.08,0.14
PF15337,PF15553:PF11162:PF12628,3,0,0,3,0,1015,0,1.0,0.0,0,0,0,3,0,1015,0,1.0,0.0,0
PF11467,PF10513:PF00855:PF12064,7,47,6,1,41,970,0.13,0.96,0.86,0.32,14,3,4,11,1000,0.21,0.99,0.43,0.3
PF10119,PF17192:PF11130:PF09677,0,0,0,0,0,1018,0,1.0,0,0,0,0,0,0,1018,0,1.0,0,0
PF15323,PF00379:PF01906:PF09348,2,35,1,1,34,982,0.03,0.97,0.5,0.11,1,0,2,1,1015,0.0,1.0,0.0,-0.0
PF01534,PF01392:PF06121:PF06482,8,26,6,2,20,990,0.23,0.98,0.75,0.41,3,2,6,1,1009,0.67,0.99,0.25,0.41
PF04228,PF05509:PF01752:PF13753,0,3,0,0,3,1015,0.0,1.0,0,0,0,0,0,0,1018,0,1.0,0,0
PF04455,PF16653:PF05222:PF02233,3,21,1,2,20,995,0.05,0.98,0.33,0.12,12,1,2,11,1004,0.08,0.99,0.33,0.16
PF08552,PF04934:PF15991:PF04729,9,19,3,6,16,993,0.16,0.98,0.33,0.22,1,0,9,1,1008,0.0,0.99,0.0,-0.0
PF04324,PF13806:PF14721:PF16020,9,17,8,1,9,1000,0.47,0.99,0.89,0.64,2,1,8,1,1008,0.5,0.99,0.11,0.23
PF07671,PF16485:PF01447:PF10404,2,8,0,2,8,1008,0.0,0.99,0.0,-0.0,1,0,2,1,1015,0.0,1.0,0.0,-0.0
PF04493,PF03155:PF01722:PF05719,8,32,3,5,29,981,0.09,0.97,0.38,0.18,7,2,6,5,1005,0.29,0.99,0.25,0.26
PF04380,PF10782:PF13946:PF15214,0,3,0,0,3,1015,0.0,1.0,0,0,0,0,0,0,1018,0,1.0,0,0
PF06163,PF02342:PF14435:PF12399,0,13,0,0,13,1005,0.0,0.99,0,0,0,0,0,0,1018,0,1.0,0,0
PF14688,PF14687:PF04056:PF07488,9,19,8,1,11,998,0.42,0.99,0.89,0.61,2,2,7,0,1009,1.0,0.99,0.22,0.47
PF02205,PF12828:PF12825:PF08776,33,16,10,23,6,979,0.62,0.97,0.3,0.42,4,2,31,2,983,0.5,0.97,0.06,0.17
PF03765,PF13897:PF04707:PF00650,24,71,24,0,47,947,0.34,0.95,1.0,0.57,13,7,17,6,988,0.54,0.98,0.29,0.39
PF11904,PF16553:PF15898:PF09310,9,3,1,8,2,1007,0.33,0.99,0.11,0.19,0,0,9,0,1009,0,0.99,0.0,0
PF15805,PF15803:PF04422:PF14049,0,0,0,0,0,1018,0,1.0,0,0,0,0,0,0,1018,0,1.0,0,0
PF15737,PF10407:PF09322:PF15082,2,3,0,2,3,1013,0.0,1.0,0.0,-0.0,0,0,2,0,1016,0,1.0,0.0,0
PF10683,PF14372:PF04937:PF02892,2,46,2,0,44,972,0.04,0.96,1.0,0.2,18,2,0,16,1000,0.11,0.98,1.0,0.33
PF11915,PF08631:PF16201:PF08146,22,16,8,14,8,988,0.5,0.98,0.36,0.42,3,2,20,1,995,0.67,0.98,0.09,0.24
PF10323,PF02118:PF10326:PF10317,9,27,3,6,24,985,0.11,0.97,0.33,0.18,6,0,9,6,1003,0.0,0.99,0.0,-0.01
PF16893,PF16892:PF12258:PF09309,2,2,2,0,0,1016,1.0,1.0,1.0,1.0,0,0,2,0,1016,0,1.0,0.0,0
PF09269,PF15086:PF05128:PF06780,4,3,1,3,2,1012,0.33,1.0,0.25,0.29,1,1,3,0,1014,1.0,1.0,0.25,0.5
PF11912,PF15333:PF03203:PF15771,0,0,0,0,0,1018,0,1.0,0,0,0,0,0,0,1018,0,1.0,0,0
PF01758,PF07542:PF11735:PF03583,11,21,2,9,19,988,0.1,0.97,0.18,0.12,1,1,10,0,1007,1.0,0.99,0.09,0.3
PF03463,PF03464:PF03465:PF04927,9,10,8,1,2,1007,0.8,1.0,0.89,0.84,8,8,1,0,1009,1.0,1.0,0.89,0.94
PF02538,PF05378:PF01968:PF06032,26,28,26,0,2,990,0.93,1.0,1.0,0.96,28,26,0,2,990,0.93,1.0,1.0,0.96
PF11034,PF04355:PF06798:PF11751,4,0,0,4,0,1014,0,1.0,0.0,0,0,0,4,0,1014,0,1.0,0.0,0
PF12125,PF16856:PF10647:PF04300,6,8,2,4,6,1006,0.25,0.99,0.33,0.28,3,2,4,1,1011,0.67,1.0,0.33,0.47
PF05908,PF15052:PF15355:PF08093,0,4,0,0,4,1014,0.0,1.0,0,0,0,0,0,0,1018,0,1.0,0,0
PF06113,PF15008:PF01327:PF14935,4,9,1,3,8,1006,0.11,0.99,0.25,0.16,1,1,3,0,1014,1.0,1.0,0.25,0.5
PF09414,PF14948:PF11548:PF12567,7,5,1,6,4,1007,0.2,0.99,0.14,0.16,3,1,6,2,1009,0.33,0.99,0.14,0.21
PF08693,PF17056:PF15972:PF03749,1,2,0,1,2,1015,0.0,1.0,0.0,-0.0,0,0,1,0,1017,0,1.0,0.0,0
PF03481,PF10437:PF01184:PF09825,8,22,5,3,17,993,0.23,0.98,0.62,0.37,2,1,7,1,1009,0.5,0.99,0.12,0.25
PF05030,PF08624:PF16944:PF14611,6,10,0,6,10,1002,0.0,0.98,0.0,-0.01,0,0,6,0,1012,0,0.99,0.0,0
PF05460,PF08639:PF15328:PF05859,3,7,1,2,6,1009,0.14,0.99,0.33,0.21,0,0,3,0,1015,0,1.0,0.0,0
PF07245,PF05585:PF09337:PF03564,5,42,5,0,37,976,0.12,0.96,1.0,0.34,23,4,1,19,994,0.17,0.98,0.8,0.37
PF00798,PF15608:PF02211:PF01668,2,5,0,2,5,1011,0.0,0.99,0.0,-0.0,0,0,2,0,1016,0,1.0,0.0,0
PF06423,PF03478:PF05827:PF06237,15,35,9,6,26,977,0.26,0.97,0.6,0.38,4,2,13,2,1001,0.5,0.99,0.13,0.25
PF04410,PF03045:PF08265:PF03162,24,19,7,17,12,982,0.37,0.97,0.29,0.31,3,2,22,1,993,0.67,0.98,0.08,0.23
PF03931,PF01466:PF01725:PF01169,25,36,19,6,17,976,0.53,0.98,0.76,0.62,7,6,19,1,992,0.86,0.98,0.24,0.45
PF11754,PF09729:PF10348:PF04376,11,17,5,6,12,995,0.29,0.98,0.45,0.36,4,2,9,2,1005,0.5,0.99,0.18,0.3
PF11360,PF08653:PF04359:PF17078,1,3,1,0,2,1015,0.33,1.0,1.0,0.58,0,0,1,0,1017,0,1.0,0.0,0
PF06694,PF15060:PF15467:PF15872,3,0,0,3,0,1015,0,1.0,0.0,0,0,0,3,0,1015,0,1.0,0.0,0
PF10338,PF10471:PF11623:PF02044,1,6,0,1,6,1011,0.0,0.99,0.0,-0.0,0,0,1,0,1017,0,1.0,0.0,0
PF00241,PF14724:PF11527:PF04801,26,19,5,21,14,978,0.26,0.97,0.19,0.21,1,1,25,0,992,1.0,0.98,0.04,0.19
PF03390,PF08291:PF07589:PF07804,1,1,0,1,1,1016,0.0,1.0,0.0,-0.0,0,0,1,0,1017,0,1.0,0.0,0
PF01963,PF07896:PF04107:PF03878,10,16,4,6,12,996,0.25,0.98,0.4,0.31,5,3,7,2,1006,0.6,0.99,0.3,0.42
PF17220,PF03914:PF03098:PF16891,0,46,0,0,46,972,0.0,0.95,0,0,12,0,0,12,1006,0.0,0.99,0,0
PF16965,PF02277:PF07805:PF02336,1,6,0,1,6,1011,0.0,0.99,0.0,-0.0,0,0,1,0,1017,0,1.0,0.0,0
PF04333,PF08249:PF08908:PF10546,0,0,0,0,0,1018,0,1.0,0,0,0,0,0,0,1018,0,1.0,0,0
PF05401,PF03428:PF06798:PF07499,1,2,0,1,2,1015,0.0,1.0,0.0,-0.0,0,0,1,0,1017,0,1.0,0.0,0
PF15629,PF15628:PF07394:PF00073,0,19,0,0,19,999,0.0,0.98,0,0,0,0,0,0,1018,0,1.0,0,0
PF14987,PF01330:PF07157:PF06798,3,2,1,2,1,1014,0.5,1.0,0.33,0.41,0,0,3,0,1015,0,1.0,0.0,0
PF12447,PF02873:PF04978:PF02754,3,14,3,0,11,1004,0.21,0.99,1.0,0.46,4,3,0,1,1014,0.75,1.0,1.0,0.87
PF15975,PF16200:PF02036:PF09822,6,26,1,5,25,987,0.04,0.97,0.17,0.07,4,1,5,3,1009,0.25,0.99,0.17,0.2
PF01894,PF08315:PF02970:PF16053,14,29,4,10,25,979,0.14,0.97,0.29,0.18,2,2,12,0,1004,1.0,0.99,0.14,0.38
PF00013,PF16274:PF16544:PF08067,72,8,8,64,0,946,1.0,0.94,0.11,0.32,1,1,71,0,946,1.0,0.93,0.01,0.11
PF00373,PF09379:PF03623:PF00784,53,54,47,6,7,958,0.87,0.99,0.89,0.87,12,11,42,1,964,0.92,0.96,0.21,0.43
PF07310,PF01913:PF07805:PF01752,1,4,0,1,4,1013,0.0,1.0,0.0,-0.0,0,0,1,0,1017,0,1.0,0.0,0
PF11478,PF05084:PF02392:PF09932,0,8,0,0,8,1010,0.0,0.99,0,0,0,0,0,0,1018,0,1.0,0,0
PF14737,PF07929:PF04194:PF13392,10,20,2,8,18,990,0.1,0.97,0.2,0.13,2,2,8,0,1008,1.0,0.99,0.2,0.45
PF04121,PF10226:PF03004:PF14922,13,23,4,9,19,986,0.17,0.97,0.31,0.22,2,2,11,0,1005,1.0,0.99,0.15,0.39
PF15451,PF10631:PF06803:PF12126,2,11,2,0,9,1007,0.18,0.99,1.0,0.42,3,2,0,1,1015,0.67,1.0,1.0,0.82
PF05934,PF15877:PF15313:PF07137,6,11,0,6,11,1001,0.0,0.98,0.0,-0.01,0,0,6,0,1012,0,0.99,0.0,0
PF00804,PF09177:PF11416:PF05739,27,39,21,6,18,973,0.54,0.98,0.78,0.64,7,4,23,3,988,0.57,0.97,0.15,0.28
PF02632,PF01668:PF08497:PF15555,6,3,0,6,3,1009,0.0,0.99,0.0,-0.0,0,0,6,0,1012,0,0.99,0.0,0
PF04677,PF04676:PF08603:PF10443,23,32,23,0,9,986,0.72,0.99,1.0,0.84,6,6,17,0,995,1.0,0.98,0.26,0.51
PF04799,PF01031:PF00350:PF01321,5,76,5,0,71,942,0.07,0.93,1.0,0.25,42,3,2,39,974,0.07,0.96,0.6,0.2
PF12191,PF01752:PF07016:PF01514,0,2,0,0,2,1016,0.0,1.0,0,0,0,0,0,0,1018,0,1.0,0,0
PF00331,PF02018:PF03664:PF16010,12,22,6,6,16,990,0.27,0.98,0.5,0.36,6,2,10,4,1002,0.33,0.99,0.17,0.23
PF14676,PF14680:PF14679:PF14675,1,1,1,0,0,1017,1.0,1.0,1.0,1.0,1,1,0,0,1017,1.0,1.0,1.0,1.0
PF01728,PF07780:PF01585:PF07842,37,75,26,11,49,932,0.35,0.94,0.7,0.47,15,10,27,5,976,0.67,0.97,0.27,0.41
PF14600,PF07382:PF06483:PF02719,0,7,0,0,7,1011,0.0,0.99,0,0,0,0,0,0,1018,0,1.0,0,0
PF09949,PF16401:PF16692:PF03615,9,9,2,7,7,1002,0.22,0.99,0.22,0.22,1,1,8,0,1009,1.0,0.99,0.11,0.33
PF03657,PF01097:PF08641:PF03911,8,14,2,6,12,998,0.14,0.98,0.25,0.18,1,1,7,0,1010,1.0,0.99,0.12,0.35
PF02605,PF09057:PF07464:PF15699,0,1,0,0,1,1017,0.0,1.0,0,0,0,0,0,0,1018,0,1.0,0,0
PF00913,PF13206:PF00835:PF10173,0,6,0,0,6,1012,0.0,0.99,0,0,0,0,0,0,1018,0,1.0,0,0
PF04314,PF09611:PF06007:PF17092,0,3,0,0,3,1015,0.0,1.0,0,0,0,0,0,0,1018,0,1.0,0,0
PF15951,PF11851:PF01056:PF09427,3,13,1,2,12,1003,0.08,0.99,0.33,0.16,1,1,2,0,1015,1.0,1.0,0.33,0.58
PF02613,PF15776:PF15023:PF03592,1,2,0,1,2,1015,0.0,1.0,0.0,-0.0,0,0,1,0,1017,0,1.0,0.0,0
PF15803,PF15805:PF04422:PF07260,0,1,0,0,1,1017,0.0,1.0,0,0,0,0,0,0,1018,0,1.0,0,0
PF09362,PF11790:PF02485:PF12529,10,23,3,7,20,988,0.13,0.97,0.3,0.19,4,1,9,3,1005,0.25,0.99,0.1,0.15
PF13556,PF17007:PF11751:PF04740,1,0,0,1,0,1017,0,1.0,0.0,0,0,0,1,0,1017,0,1.0,0.0,0
PF07950,PF12243:PF10785:PF14232,4,6,0,4,6,1008,0.0,0.99,0.0,-0.0,0,0,4,0,1014,0,1.0,0.0,0
PF01014,PF00731:PF02578:PF04927,3,14,2,1,12,1003,0.14,0.99,0.67,0.3,1,0,3,1,1014,0.0,1.0,0.0,-0.0
PF14239,PF03742:PF03260:PF06672,0,1,0,0,1,1017,0.0,1.0,0,0,0,0,0,0,1018,0,1.0,0,0
PF16608,PF12938:PF10427:PF06495,4,7,1,3,6,1008,0.14,0.99,0.25,0.18,1,1,3,0,1014,1.0,1.0,0.25,0.5
PF10588,PF00384:PF04879:PF09326,17,24,15,2,9,992,0.62,0.99,0.88,0.74,17,14,3,3,998,0.82,0.99,0.82,0.82
PF00074,PF02422:PF05498:PF06404,2,10,1,1,9,1007,0.1,0.99,0.5,0.22,0,0,2,0,1016,0,1.0,0.0,0
PF10685,PF16871:PF02768:PF11958,1,12,0,1,12,1005,0.0,0.99,0.0,-0.0,0,0,1,0,1017,0,1.0,0.0,0
PF06553,PF15171:PF05612:PF07771,4,1,0,4,1,1013,0.0,1.0,0.0,-0.0,0,0,4,0,1014,0,1.0,0.0,0
PF10014,PF02950:PF09428:PF16311,2,2,0,2,2,1014,0.0,1.0,0.0,-0.0,0,0,2,0,1016,0,1.0,0.0,0
PF12347,PF01486:PF00319:PF12346,7,23,7,0,16,995,0.3,0.98,1.0,0.55,8,3,4,5,1006,0.38,0.99,0.43,0.4
PF09804,PF03085:PF14831:PF16019,3,2,2,1,0,1015,1.0,1.0,0.67,0.82,0,0,3,0,1015,0,1.0,0.0,0
PF16463,PF14489:PF12192:PF06745,0,1,0,0,1,1017,0.0,1.0,0,0,0,0,0,0,1018,0,1.0,0,0
PF14474,PF04988:PF07199:PF14877,4,9,0,4,9,1005,0.0,0.99,0.0,-0.01,0,0,4,0,1014,0,1.0,0.0,0
PF12659,PF12461:PF03934:PF15518,0,3,0,0,3,1015,0.0,1.0,0,0,0,0,0,0,1018,0,1.0,0,0
PF13660,PF05161:PF07477:PF07488,12,11,7,5,4,1002,0.64,0.99,0.58,0.6,4,0,12,4,1002,0.0,0.98,0.0,-0.01
PF15231,PF10856:PF15685:PF15060,0,0,0,0,0,1018,0,1.0,0,0,0,0,0,0,1018,0,1.0,0,0
PF04834,PF06381:PF15085:PF13013,0,3,0,0,3,1015,0.0,1.0,0,0,0,0,0,0,1018,0,1.0,0,0
PF07602,PF16977:PF00341:PF16915,1,14,1,0,13,1004,0.07,0.99,1.0,0.27,1,1,0,0,1017,1.0,1.0,1.0,1.0
PF15239,PF11017:PF15377:PF01959,1,3,1,0,2,1015,0.33,1.0,1.0,0.58,0,0,1,0,1017,0,1.0,0.0,0
PF16136,PF07897:PF16135:PF12165,1,16,1,0,15,1002,0.06,0.99,1.0,0.25,3,1,0,2,1015,0.33,1.0,1.0,0.58
PF07173,PF12422:PF10189:PF06662,6,12,3,3,9,1003,0.25,0.99,0.5,0.35,1,1,5,0,1012,1.0,1.0,0.17,0.41
PF11261,PF07001:PF15914:PF15912,6,9,1,5,8,1004,0.11,0.99,0.17,0.13,1,0,6,1,1011,0.0,0.99,0.0,-0.0
PF08429,PF02928:PF02375:PF01388,12,38,10,2,28,978,0.26,0.97,0.83,0.46,12,10,2,2,1004,0.83,1.0,0.83,0.83
PF00583,PF13673:PF05153:PF13380,86,34,22,64,12,920,0.65,0.93,0.26,0.38,7,7,79,0,932,1.0,0.92,0.08,0.27
PF05661,PF13994:PF06476:PF00314,0,22,0,0,22,996,0.0,0.98,0,0,0,0,0,0,1018,0,1.0,0,0
PF01259,PF02222:PF00731:PF04248,10,18,3,7,15,993,0.17,0.98,0.3,0.21,5,1,9,4,1004,0.2,0.99,0.1,0.14
PF15042,PF04308:PF02232:PF15029,0,1,0,0,1,1017,0.0,1.0,0,0,0,0,0,0,1018,0,1.0,0,0
PF09248,PF02727:PF02728:PF01179,3,28,3,0,25,990,0.11,0.98,1.0,0.32,22,3,0,19,996,0.14,0.98,1.0,0.37
PF14616,PF03918:PF07353:PF09365,5,5,1,4,4,1009,0.2,0.99,0.2,0.2,0,0,5,0,1013,0,1.0,0.0,0
PF00287,PF06951:PF05351:PF15065,10,21,4,6,17,991,0.19,0.98,0.4,0.27,4,2,8,2,1006,0.5,0.99,0.2,0.31
PF09759,PF14764:PF09822:PF06662,8,11,3,5,8,1002,0.27,0.99,0.38,0.31,2,2,6,0,1010,1.0,0.99,0.25,0.5
PF00350,PF01031:PF02212:PF04799,66,49,43,23,6,946,0.88,0.97,0.65,0.74,34,29,37,5,947,0.85,0.96,0.44,0.59
PF11465,PF07204:PF03921:PF12355,3,6,1,2,5,1010,0.17,0.99,0.33,0.23,2,1,2,1,1014,0.5,1.0,0.33,0.41
PF10139,PF07520:PF07805:PF08345,0,2,0,0,2,1016,0.0,1.0,0,0,0,0,0,0,1018,0,1.0,0,0
PF14975,PF04142:PF00638:PF08911,5,41,4,1,37,976,0.1,0.96,0.8,0.27,12,3,2,9,1004,0.25,0.99,0.6,0.38
PF03706,PF06744:PF04865:PF14842,1,0,0,1,0,1017,0,1.0,0.0,0,0,0,1,0,1017,0,1.0,0.0,0
PF15957,PF09085:PF03856:PF14279,1,8,1,0,7,1010,0.12,0.99,1.0,0.35,0,0,1,0,1017,0,1.0,0.0,0
PF02919,PF14370:PF01028:PF05392,7,10,6,1,4,1007,0.6,1.0,0.86,0.71,6,6,1,0,1011,1.0,1.0,0.86,0.93
PF02531,PF02427:PF12046:PF08576,2,3,1,1,2,1014,0.33,1.0,0.5,0.41,0,0,2,0,1016,0,1.0,0.0,0
PF02551,PF06798:PF07308:PF06761,0,0,0,0,0,1018,0,1.0,0,0,0,0,0,0,1018,0,1.0,0,0
PF08579,PF15491:PF16014:PF16756,1,0,0,1,0,1017,0,1.0,0.0,0,0,0,1,0,1017,0,1.0,0.0,0
PF07803,PF00822:PF15226:PF02180,0,11,0,0,11,1007,0.0,0.99,0,0,0,0,0,0,1018,0,1.0,0,0
PF02659,PF07376:PF10534:PF15579,0,2,0,0,2,1016,0.0,1.0,0,0,0,0,0,0,1018,0,1.0,0,0
PF00538,PF14379:PF00249:PF14303,19,101,14,5,87,912,0.14,0.91,0.74,0.29,23,9,10,14,985,0.39,0.98,0.47,0.42
PF07666,PF00621:PF00616:PF06920,1,91,0,1,91,926,0.0,0.91,0.0,-0.01,16,0,1,16,1001,0.0,0.98,0.0,-0.0
PF09738,PF02374:PF07137:PF16044,1,16,0,1,16,1001,0.0,0.98,0.0,-0.0,2,0,1,2,1015,0.0,1.0,0.0,-0.0
PF08553,PF07096:PF05512:PF02133,3,28,2,1,26,989,0.07,0.97,0.67,0.21,3,0,3,3,1012,0.0,0.99,0.0,-0.0
PF01804,PF17084:PF07149:PF11369,1,0,0,1,0,1017,0,1.0,0.0,0,0,0,1,0,1017,0,1.0,0.0,0
PF13002,PF04090:PF10332:PF10104,4,9,1,3,8,1006,0.11,0.99,0.25,0.16,1,0,4,1,1013,0.0,1.0,0.0,-0.0
PF13089,PF13090:PF02503:PF03090,1,2,1,0,1,1016,0.5,1.0,1.0,0.71,2,1,0,1,1016,0.5,1.0,1.0,0.71
PF16784,PF04854:PF06588:PF00208,0,23,0,0,23,995,0.0,0.98,0,0,3,0,0,3,1015,0.0,1.0,0,0
PF14768,PF14766:PF14767:PF01386,0,5,0,0,5,1013,0.0,1.0,0,0,0,0,0,0,1018,0,1.0,0,0
PF15752,PF15762:PF04625:PF08258,0,1,0,0,1,1017,0.0,1.0,0,0,0,0,0,0,1018,0,1.0,0,0
PF12278,PF11671:PF15362:PF15374,0,1,0,0,1,1017,0.0,1.0,0,0,0,0,0,0,1018,0,1.0,0,0
PF12382,PF14465:PF16071:PF03235,0,5,0,0,5,1013,0.0,1.0,0,0,1,0,0,1,1017,0.0,1.0,0,0
PF14642,PF05179:PF16050:PF14654,1,8,0,1,8,1009,0.0,0.99,0.0,-0.0,5,0,1,5,1012,0.0,0.99,0.0,-0.0
PF08726,PF13499:PF00036:PF13833,10,143,7,3,136,872,0.05,0.86,0.7,0.16,48,4,6,44,964,0.08,0.95,0.4,0.17
PF12608,PF14317:PF10084:PF01107,0,5,0,0,5,1013,0.0,1.0,0,0,0,0,0,0,1018,0,1.0,0,0
PF15720,PF15441:PF06395:PF12015,1,8,1,0,7,1010,0.12,0.99,1.0,0.35,2,1,0,1,1016,0.5,1.0,1.0,0.71
PF14330,PF07287:PF08635:PF16573,3,18,3,0,15,1000,0.17,0.99,1.0,0.41,2,0,3,2,1013,0.0,1.0,0.0,-0.0
PF05375,PF09206:PF13330:PF09175,7,20,2,5,18,993,0.1,0.98,0.29,0.16,1,1,6,0,1011,1.0,0.99,0.14,0.38
PF11025,PF02915:PF04769:PF13225,0,7,0,0,7,1011,0.0,0.99,0,0,0,0,0,0,1018,0,1.0,0,0
PF05198,PF11567:PF04432:PF14849,10,2,1,9,1,1007,0.5,0.99,0.1,0.22,0,0,10,0,1008,0,0.99,0.0,0
PF12471,PF00926:PF07958:PF00925,2,17,2,0,15,1001,0.12,0.99,1.0,0.34,6,1,1,5,1011,0.17,0.99,0.5,0.29
PF15429,PF07484:PF09818:PF06798,1,1,0,1,1,1016,0.0,1.0,0.0,-0.0,0,0,1,0,1017,0,1.0,0.0,0
PF10283,PF10228:PF16759:PF06087,16,30,11,5,19,983,0.37,0.98,0.69,0.49,6,4,12,2,1000,0.67,0.99,0.25,0.4
PF15794,PF01387:PF14946:PF07354,9,3,1,8,2,1007,0.33,0.99,0.11,0.19,1,1,8,0,1009,1.0,0.99,0.11,0.33
PF12301,PF00272:PF12020:PF06951,1,11,0,1,11,1006,0.0,0.99,0.0,-0.0,0,0,1,0,1017,0,1.0,0.0,0
PF11742,PF08651:PF12236:PF05138,0,1,0,0,1,1017,0.0,1.0,0,0,0,0,0,0,1018,0,1.0,0,0
PF04553,PF13451:PF08922:PF08485,3,4,1,2,3,1012,0.25,1.0,0.33,0.29,0,0,3,0,1015,0,1.0,0.0,0
PF03919,PF02940:PF01331:PF16545,14,27,13,1,14,990,0.48,0.99,0.93,0.66,3,3,11,0,1004,1.0,0.99,0.21,0.46
PF00965,PF08561:PF12020:PF04716,6,16,1,5,15,997,0.06,0.98,0.17,0.09,2,1,5,1,1011,0.5,0.99,0.17,0.29
PF04101,PF06925:PF08660:PF00804,13,31,8,5,23,982,0.26,0.97,0.62,0.39,8,4,9,4,1001,0.5,0.99,0.31,0.39
PF11258,PF08026:PF06868:PF11593,0,2,0,0,2,1016,0.0,1.0,0,0,0,0,0,0,1018,0,1.0,0,0
PF05066,PF13922:PF13919:PF10482,6,10,4,2,6,1006,0.4,0.99,0.67,0.51,4,4,2,0,1012,1.0,1.0,0.67,0.82
PF03015,PF07993:PF01422:PF08690,20,54,19,1,35,963,0.35,0.96,0.95,0.57,6,4,16,2,996,0.67,0.98,0.2,0.36
PF00101,PF12338:PF00283:PF14853,5,10,4,1,6,1007,0.4,0.99,0.8,0.56,0,0,5,0,1013,0,1.0,0.0,0
PF16885,PF08763:PF16905:PF11933,2,11,2,0,9,1007,0.18,0.99,1.0,0.42,5,2,0,3,1013,0.4,1.0,1.0,0.63
PF08147,PF03880:PF07652:PF03461,10,11,3,7,8,1000,0.27,0.99,0.3,0.28,2,2,8,0,1008,1.0,0.99,0.2,0.45
PF00508,PF15052:PF02511:PF07881,2,6,1,1,5,1011,0.17,0.99,0.5,0.29,0,0,2,0,1016,0,1.0,0.0,0
PF10240,PF03455:PF03456:PF02141,14,36,4,10,32,972,0.11,0.96,0.29,0.16,31,3,11,28,976,0.1,0.96,0.21,0.13
PF06980,PF01514:PF04738:PF15190,0,1,0,0,1,1017,0.0,1.0,0,0,0,0,0,0,1018,0,1.0,0,0
PF08372,PF16165:PF08151:PF08150,9,10,1,8,9,1000,0.1,0.98,0.11,0.1,7,1,8,6,1003,0.14,0.99,0.11,0.12
PF01715,PF01745:PF08648:PF12171,15,47,10,5,37,966,0.21,0.96,0.67,0.36,5,3,12,2,1001,0.6,0.99,0.2,0.34
PF17188,PF03888:PF01752:PF01514,0,2,0,0,2,1016,0.0,1.0,0,0,0,0,0,0,1018,0,1.0,0,0
PF03312,PF03888:PF06493:PF03241,1,0,0,1,0,1017,0,1.0,0.0,0,0,0,1,0,1017,0,1.0,0.0,0
PF02817,PF00198:PF10937:PF00364,15,48,15,0,33,970,0.31,0.97,1.0,0.55,19,15,0,4,999,0.79,1.0,1.0,0.89
PF00996,PF08295:PF02671:PF16879,26,30,10,16,20,972,0.33,0.96,0.38,0.34,16,8,18,8,984,0.5,0.97,0.31,0.38
PF14340,PF06936:PF04205:PF00462,2,52,2,0,50,966,0.04,0.95,1.0,0.19,4,2,0,2,1014,0.5,1.0,1.0,0.71
PF07804,PF08404:PF17006:PF07494,1,1,0,1,1,1016,0.0,1.0,0.0,-0.0,0,0,1,0,1017,0,1.0,0.0,0
PF00329,PF01058:PF00507:PF00499,17,21,8,9,13,988,0.38,0.98,0.47,0.41,2,2,15,0,1001,1.0,0.99,0.12,0.34
PF01400,PF05821:PF08768:PF00431,46,74,29,17,45,927,0.39,0.94,0.63,0.47,7,5,41,2,970,0.71,0.96,0.11,0.27
PF17102,PF17101:PF11380:PF17103,8,8,7,1,1,1009,0.88,1.0,0.88,0.87,5,4,4,1,1009,0.8,1.0,0.5,0.63
PF05556,PF14877:PF11360:PF03203,5,5,1,4,4,1009,0.2,0.99,0.2,0.2,0,0,5,0,1013,0,1.0,0.0,0
PF03291,PF05719:PF05839:PF02245,8,13,3,5,10,1000,0.23,0.99,0.38,0.29,0,0,8,0,1010,0,0.99,0.0,0
PF01582,PF07725:PF00931:PF15627,40,84,29,11,55,923,0.35,0.94,0.72,0.47,14,13,27,1,977,0.93,0.97,0.33,0.54
PF07462,PF12946:PF01723:PF14956,0,4,0,0,4,1014,0.0,1.0,0,0,1,0,0,1,1017,0.0,1.0,0,0
PF05278,PF10226:PF15558:PF15742,2,6,2,0,4,1012,0.33,1.0,1.0,0.58,0,0,2,0,1016,0,1.0,0.0,0
PF09808,PF09816:PF07814:PF05182,5,30,3,2,27,986,0.1,0.97,0.6,0.24,4,1,4,3,1010,0.25,0.99,0.2,0.22
PF01496,PF05742:PF10266:PF04922,16,15,6,10,9,993,0.4,0.98,0.38,0.38,2,1,15,1,1001,0.5,0.98,0.06,0.17
PF09346,PF11566:PF08755:PF03048,2,17,2,0,15,1001,0.12,0.99,1.0,0.34,1,1,1,0,1016,1.0,1.0,0.5,0.71
PF13806,PF04324:PF16020:PF14721,14,12,8,6,4,1000,0.67,0.99,0.57,0.61,2,1,13,1,1003,0.5,0.99,0.07,0.19
PF08028,PF12806:PF09317:PF12418,3,3,3,0,0,1015,1.0,1.0,1.0,1.0,3,3,0,0,1015,1.0,1.0,1.0,1.0
PF16020,PF14721:PF14962:PF01180,2,25,2,0,23,993,0.08,0.98,1.0,0.28,2,2,0,0,1016,1.0,1.0,1.0,1.0
PF08436,PF13288:PF02670:PF00674,12,12,12,0,0,1006,1.0,1.0,1.0,1.0,4,4,8,0,1006,1.0,0.99,0.33,0.58
PF00182,PF00187:PF00967:PF00704,14,58,10,4,48,956,0.17,0.95,0.71,0.33,13,6,8,7,997,0.46,0.99,0.43,0.44
PF08033,PF04815:PF04811:PF04810,24,29,24,0,5,989,0.83,1.0,1.0,0.91,27,24,0,3,991,0.89,1.0,1.0,0.94
PF11288,PF00519:PF09666:PF13013,0,5,0,0,5,1013,0.0,1.0,0,0,1,0,0,1,1017,0.0,1.0,0,0
PF01642,PF02310:PF02965:PF02607,5,7,5,0,2,1011,0.71,1.0,1.0,0.84,5,3,2,2,1011,0.6,1.0,0.6,0.6
PF02194,PF08628:PF16646:PF12828,19,18,15,4,3,996,0.83,0.99,0.79,0.81,1,1,18,0,999,1.0,0.98,0.05,0.23
PF08583,PF00159:PF07106:PF00142,14,10,2,12,8,996,0.2,0.98,0.14,0.16,1,1,13,0,1004,1.0,0.99,0.07,0.27
PF02374,PF09738:PF07137:PF07047,11,13,3,8,10,997,0.23,0.98,0.27,0.24,1,0,11,1,1006,0.0,0.99,0.0,-0.0
PF12999,PF13015:PF14923:PF08976,16,16,11,5,5,997,0.69,0.99,0.69,0.68,2,2,14,0,1002,1.0,0.99,0.12,0.35
PF08853,PF08651:PF10664:PF15050,0,4,0,0,4,1014,0.0,1.0,0,0,0,0,0,0,1018,0,1.0,0,0
PF01266,PF16901:PF01571:PF08491,67,36,27,40,9,942,0.75,0.95,0.4,0.53,2,2,65,0,951,1.0,0.94,0.03,0.17
PF04346,PF03244:PF17066:PF08258,2,1,0,2,1,1015,0.0,1.0,0.0,-0.0,0,0,2,0,1016,0,1.0,0.0,0
PF10013,PF10707:PF15727:PF13698,0,0,0,0,0,1018,0,1.0,0,0,0,0,0,0,1018,0,1.0,0,0
PF10307,PF10198:PF10446:PF05508,1,5,0,1,5,1012,0.0,0.99,0.0,-0.0,1,0,1,1,1016,0.0,1.0,0.0,-0.0
PF09065,PF02788:PF00016:PF00330,0,40,0,0,40,978,0.0,0.96,0,0,3,0,0,3,1015,0.0,1.0,0,0
PF11800,PF08479:PF04865:PF04552,0,1,0,0,1,1017,0.0,1.0,0,0,0,0,0,0,1018,0,1.0,0,0
PF01684,PF16709:PF16711:PF07975,0,7,0,0,7,1011,0.0,0.99,0,0,1,0,0,1,1017,0.0,1.0,0,0
PF16367,PF16366:PF16368:PF10267,13,17,11,2,6,999,0.65,0.99,0.85,0.74,5,5,8,0,1005,1.0,0.99,0.38,0.62
PF11338,PF09510:PF08331:PF06681,4,0,0,4,0,1014,0,1.0,0.0,0,0,0,4,0,1014,0,1.0,0.0,0
PF08534,PF04667:PF12734:PF02284,25,13,4,21,9,984,0.31,0.97,0.16,0.21,0,0,25,0,993,0,0.98,0.0,0
PF10102,PF06588:PF02676:PF02140,3,39,2,1,37,978,0.05,0.96,0.67,0.18,4,1,2,3,1012,0.25,1.0,0.33,0.29
PF12128,PF01630:PF02485:PF08441,0,34,0,0,34,984,0.0,0.97,0,0,5,0,0,5,1013,0.0,1.0,0,0
PF01965,PF06628:PF00199:PF01578,35,24,11,24,13,970,0.46,0.96,0.31,0.36,17,8,27,9,974,0.47,0.96,0.23,0.31
PF12344,PF16783:PF03461:PF03880,5,9,4,1,5,1008,0.44,0.99,0.8,0.59,2,2,3,0,1013,1.0,1.0,0.4,0.63
PF01387,PF15252:PF01415:PF14931,0,3,0,0,3,1015,0.0,1.0,0,0,0,0,0,0,1018,0,1.0,0,0
PF08650,PF16799:PF15318:PF03521,1,5,1,0,4,1013,0.2,1.0,1.0,0.45,1,1,0,0,1017,1.0,1.0,1.0,1.0
PF12401,PF00791:PF12313:PF00093,0,35,0,0,35,983,0.0,0.97,0,0,5,0,0,5,1013,0.0,1.0,0,0
PF09128,PF02196:PF06395:PF13543,5,17,2,3,15,998,0.12,0.98,0.4,0.21,4,2,3,2,1011,0.5,1.0,0.4,0.44
PF16197,PF00698:PF00975:PF02801,36,63,36,0,27,955,0.57,0.97,1.0,0.75,44,36,0,8,974,0.82,0.99,1.0,0.9
PF02769,PF00586:PF02844:PF02843,16,18,11,5,7,995,0.61,0.99,0.69,0.64,13,7,9,6,996,0.54,0.99,0.44,0.48
PF04654,PF03386:PF03242:PF05512,5,3,0,5,3,1010,0.0,0.99,0.0,-0.0,0,0,5,0,1013,0,1.0,0.0,0
PF15772,PF15119:PF06729:PF15340,0,3,0,0,3,1015,0.0,1.0,0,0,0,0,0,0,1018,0,1.0,0,0
PF15713,PF03203:PF08792:PF15047,2,0,0,2,0,1016,0,1.0,0.0,0,0,0,2,0,1016,0,1.0,0.0,0
PF03691,PF12843:PF07927:PF05425,0,2,0,0,2,1016,0.0,1.0,0,0,0,0,0,0,1018,0,1.0,0,0
PF04464,PF17164:PF14573:PF03925,1,1,0,1,1,1016,0.0,1.0,0.0,-0.0,0,0,1,0,1017,0,1.0,0.0,0
PF08850,PF08096:PF09485:PF08803,0,1,0,0,1,1017,0.0,1.0,0,0,0,0,0,0,1018,0,1.0,0,0
PF12242,PF12241:PF15529:PF04350,1,1,1,0,0,1017,1.0,1.0,1.0,1.0,0,0,1,0,1017,0,1.0,0.0,0
PF08356,PF08355:PF10149:PF00071,12,146,12,0,134,872,0.08,0.87,1.0,0.27,16,12,0,4,1002,0.75,1.0,1.0,0.86
PF16188,PF01321:PF14826:PF05195,6,33,6,0,27,985,0.18,0.97,1.0,0.42,5,2,4,3,1009,0.4,0.99,0.33,0.36
PF02822,PF02961:PF09307:PF08831,12,6,2,10,4,1002,0.33,0.99,0.17,0.23,3,0,12,3,1003,0.0,0.99,0.0,-0.01
PF04871,PF01782:PF02841:PF03470,15,15,3,12,12,991,0.2,0.98,0.2,0.19,3,1,14,2,1001,0.33,0.98,0.07,0.14
PF04583,PF07927:PF11862:PF05947,1,3,0,1,3,1014,0.0,1.0,0.0,-0.0,0,0,1,0,1017,0,1.0,0.0,0
PF00575,PF09371:PF14633:PF14878,34,14,11,23,3,981,0.79,0.97,0.32,0.49,13,11,23,2,982,0.85,0.98,0.32,0.51
PF10743,PF12790:PF02742:PF14290,0,3,0,0,3,1015,0.0,1.0,0,0,0,0,0,0,1018,0,1.0,0,0
PF01234,PF05497:PF11937:PF07160,5,12,3,2,9,1004,0.25,0.99,0.6,0.38,0,0,5,0,1013,0,1.0,0.0,0
PF00780,PF08826:PF09128:PF13281,38,12,8,30,4,976,0.67,0.97,0.21,0.36,4,3,35,1,979,0.75,0.96,0.08,0.24
PF08398,PF15085:PF13013:PF15680,1,3,0,1,3,1014,0.0,1.0,0.0,-0.0,0,0,1,0,1017,0,1.0,0.0,0
PF09166,PF08635:PF02894:PF01041,3,27,1,2,26,989,0.04,0.97,0.33,0.1,4,1,2,3,1012,0.25,1.0,0.33,0.29
PF06693,PF09296:PF04008:PF16656,0,25,0,0,25,993,0.0,0.98,0,0,7,0,0,7,1011,0.0,0.99,0,0
PF09127,PF11940:PF11838:PF01433,7,54,7,0,47,964,0.13,0.95,1.0,0.35,37,3,4,34,977,0.08,0.96,0.43,0.17
PF00106,PF15011:PF01575:PF02036,187,44,32,155,12,819,0.73,0.84,0.17,0.3,12,11,176,1,830,0.92,0.83,0.06,0.21
PF02535,PF04592:PF07561:PF01184,57,21,10,47,11,950,0.48,0.94,0.18,0.27,1,1,56,0,961,1.0,0.94,0.02,0.13
PF02067,PF15175:PF17015:PF17062,1,0,0,1,0,1017,0,1.0,0.0,0,0,0,1,0,1017,0,1.0,0.0,0
PF13705,PF06547:PF13441:PF15419,6,3,2,4,1,1011,0.67,1.0,0.33,0.47,2,2,4,0,1012,1.0,1.0,0.33,0.58
PF01559,PF03331:PF03032:PF00103,1,8,0,1,8,1009,0.0,0.99,0.0,-0.0,0,0,1,0,1017,0,1.0,0.0,0
PF00692,PF00077:PF00607:PF02093,14,18,6,8,12,992,0.33,0.98,0.43,0.37,7,6,8,1,1003,0.86,0.99,0.43,0.6
PF09364,PF09363:PF03894:PF08369,2,3,2,0,1,1015,0.67,1.0,1.0,0.82,2,2,0,0,1016,1.0,1.0,1.0,1.0
PF14818,PF07558:PF07001:PF15557,7,8,2,5,6,1005,0.25,0.99,0.29,0.26,0,0,7,0,1011,0,0.99,0.0,0
PF12142,PF12143:PF14830:PF00264,2,38,2,0,36,980,0.05,0.96,1.0,0.23,2,2,0,0,1016,1.0,1.0,1.0,1.0
PF14993,PF01668:PF15204:PF15190,0,3,0,0,3,1015,0.0,1.0,0,0,0,0,0,0,1018,0,1.0,0,0
PF09779,PF06972:PF12129:PF07001,2,11,1,1,10,1006,0.09,0.99,0.5,0.21,0,0,2,0,1016,0,1.0,0.0,0
PF16863,PF00088:PF16338:PF13802,19,29,13,6,16,983,0.45,0.98,0.68,0.54,8,8,11,0,999,1.0,0.99,0.42,0.65
PF02943,PF15109:PF12046:PF06581,1,0,0,1,0,1017,0,1.0,0.0,0,0,0,1,0,1017,0,1.0,0.0,0
PF00990,PF00563:PF00672:PF00015,13,26,10,3,16,989,0.38,0.98,0.77,0.54,13,10,3,3,1002,0.77,0.99,0.77,0.77
PF12421,PF09327:PF03428:PF06864,0,1,0,0,1,1017,0.0,1.0,0,0,0,0,0,0,1018,0,1.0,0,0
PF03422,PF06439:PF04616:PF08531,14,40,9,5,31,973,0.23,0.96,0.64,0.37,8,5,9,3,1001,0.62,0.99,0.36,0.47
PF15045,PF10104:PF04090:PF06989,0,9,0,0,9,1009,0.0,0.99,0,0,1,0,0,1,1017,0.0,1.0,0,0
PF05791,PF05164:PF10375:PF11291,0,1,0,0,1,1017,0.0,1.0,0,0,0,0,0,0,1018,0,1.0,0,0
PF14759,PF14962:PF14721:PF04224,7,6,1,6,5,1006,0.17,0.99,0.14,0.15,2,1,6,1,1010,0.5,0.99,0.14,0.26
PF03209,PF05336:PF06718:PF06028,0,5,0,0,5,1013,0.0,1.0,0,0,0,0,0,0,1018,0,1.0,0,0
PF16915,PF05837:PF13096:PF07502,1,3,1,0,2,1015,0.33,1.0,1.0,0.58,0,0,1,0,1017,0,1.0,0.0,0
PF17207,PF00493:PF14551:PF04117,48,71,47,1,24,946,0.66,0.98,0.98,0.79,46,45,3,1,969,0.98,1.0,0.94,0.96
PF10335,PF05103:PF08437:PF00909,2,33,2,0,31,985,0.06,0.97,1.0,0.24,0,0,2,0,1016,0,1.0,0.0,0
PF10110,PF03925:PF05913:PF03831,1,2,0,1,2,1015,0.0,1.0,0.0,-0.0,0,0,1,0,1017,0,1.0,0.0,0
PF14289,PF05421:PF12897:PF00455,2,7,2,0,5,1011,0.29,1.0,1.0,0.53,0,0,2,0,1016,0,1.0,0.0,0
PF11277,PF10479:PF10221:PF15489,7,14,4,3,10,1001,0.29,0.99,0.57,0.4,4,3,4,1,1010,0.75,1.0,0.43,0.56
PF15789,PF11765:PF16047:PF04680,0,2,0,0,2,1016,0.0,1.0,0,0,0,0,0,0,1018,0,1.0,0,0
PF14968,PF05238:PF15691:PF01387,2,1,0,2,1,1015,0.0,1.0,0.0,-0.0,0,0,2,0,1016,0,1.0,0.0,0
PF03637,PF01025:PF10190:PF00213,17,31,9,8,22,979,0.29,0.97,0.53,0.38,6,4,13,2,999,0.67,0.99,0.24,0.39
PF12276,PF08260:PF05929:PF12087,0,0,0,0,0,1018,0,1.0,0,0,0,0,0,0,1018,0,1.0,0,0
PF16380,PF04994:PF11034:PF11650,0,4,0,0,4,1014,0.0,1.0,0,0,0,0,0,0,1018,0,1.0,0,0
PF07998,PF07282:PF16692:PF05337,5,7,0,5,7,1006,0.0,0.99,0.0,-0.01,1,0,5,1,1012,0.0,0.99,0.0,-0.0
PF06777,PF06733:PF13307:PF00273,15,22,15,0,7,996,0.68,0.99,1.0,0.82,21,15,0,6,997,0.71,0.99,1.0,0.84
PF00443,PF06337:PF14836:PF14533,115,23,21,94,2,901,0.91,0.91,0.18,0.38,7,7,108,0,903,1.0,0.89,0.06,0.23
PF03378,PF08767:PF08506:PF08389,12,48,12,0,36,970,0.25,0.96,1.0,0.49,15,7,5,8,998,0.47,0.99,0.58,0.52
PF01076,PF10979:PF15400:PF04354,1,1,0,1,1,1016,0.0,1.0,0.0,-0.0,0,0,1,0,1017,0,1.0,0.0,0
PF05016,PF03831:PF14841:PF14842,0,1,0,0,1,1017,0.0,1.0,0,0,0,0,0,0,1018,0,1.0,0,0
PF12845,PF13870:PF15934:PF06211,7,4,0,7,4,1007,0.0,0.99,0.0,-0.01,0,0,7,0,1011,0,0.99,0.0,0
PF16499,PF09072:PF13813:PF00150,20,59,14,6,45,953,0.24,0.95,0.7,0.39,10,6,14,4,994,0.6,0.98,0.3,0.42
PF16099,PF08585:PF13888:PF14438,1,29,1,0,28,989,0.03,0.97,1.0,0.18,2,0,1,2,1015,0.0,1.0,0.0,-0.0
PF03533,PF09664:PF09983:PF02875,3,18,3,0,15,1000,0.17,0.99,1.0,0.41,3,3,0,0,1015,1.0,1.0,1.0,1.0
PF05207,PF14901:PF00684:PF14308,14,15,5,9,10,994,0.33,0.98,0.36,0.34,0,0,14,0,1004,0,0.99,0.0,0
PF08376,PF04940:PF16214:PF07700,4,25,4,0,21,993,0.16,0.98,1.0,0.4,1,1,3,0,1014,1.0,1.0,0.25,0.5
PF09202,PF12169:PF15862:PF11331,10,6,3,7,3,1005,0.5,0.99,0.3,0.38,0,0,10,0,1008,0,0.99,0.0,0
PF09431,PF07815:PF08397:PF03983,10,18,2,8,16,992,0.11,0.98,0.2,0.14,3,2,8,1,1007,0.67,0.99,0.2,0.36
PF14538,PF08232:PF12234:PF09453,18,25,7,11,18,982,0.28,0.97,0.39,0.32,2,2,16,0,1000,1.0,0.98,0.11,0.33
PF06609,PF11700:PF00296:PF04479,12,39,9,3,30,976,0.23,0.97,0.75,0.4,8,3,9,5,1001,0.38,0.99,0.25,0.3
PF16131,PF04098:PF08081:PF12220,17,12,5,12,7,994,0.42,0.98,0.29,0.34,2,2,15,0,1001,1.0,0.99,0.12,0.34
PF14638,PF14636:PF14637:PF11597,6,9,6,0,3,1009,0.67,1.0,1.0,0.82,6,6,0,0,1012,1.0,1.0,1.0,1.0
PF03772,PF13567:PF04247:PF09648,4,4,4,0,0,1014,1.0,1.0,1.0,1.0,0,0,4,0,1014,0,1.0,0.0,0
PF14066,PF03742:PF06505:PF07753,0,1,0,0,1,1017,0.0,1.0,0,0,0,0,0,0,1018,0,1.0,0,0
PF07157,PF07409:PF13722:PF11751,0,0,0,0,0,1018,0,1.0,0,0,0,0,0,0,1018,0,1.0,0,0
PF14329,PF05119:PF10417:PF07413,0,32,0,0,32,986,0.0,0.97,0,0,0,0,0,0,1018,0,1.0,0,0
PF09931,PF09444:PF09967:PF10407,1,3,0,1,3,1014,0.0,1.0,0.0,-0.0,0,0,1,0,1017,0,1.0,0.0,0
PF00918,PF03745:PF06681:PF14290,1,0,0,1,0,1017,0,1.0,0.0,0,0,0,1,0,1017,0,1.0,0.0,0
PF13367,PF11341:PF06695:PF09690,3,2,0,3,2,1013,0.0,1.0,0.0,-0.0,0,0,3,0,1015,0,1.0,0.0,0
PF15276,PF13325:PF16508:PF15308,1,15,1,0,14,1003,0.07,0.99,1.0,0.26,3,1,0,2,1015,0.33,1.0,1.0,0.58
PF03067,PF05335:PF13695:PF01551,19,19,6,13,13,986,0.32,0.97,0.32,0.3,1,1,18,0,999,1.0,0.98,0.05,0.23
PF10111,PF13477:PF12038:PF05159,0,2,0,0,2,1016,0.0,1.0,0,0,0,0,0,0,1018,0,1.0,0,0
PF12225,PF15608:PF08485:PF08298,2,1,0,2,1,1015,0.0,1.0,0.0,-0.0,0,0,2,0,1016,0,1.0,0.0,0
PF04751,PF06217:PF11677:PF10674,3,1,0,3,1,1014,0.0,1.0,0.0,-0.0,0,0,3,0,1015,0,1.0,0.0,0
PF08213,PF02780:PF15328:PF10104,5,33,0,5,33,980,0.0,0.96,0.0,-0.01,7,0,5,7,1006,0.0,0.99,0.0,-0.01
PF10304,PF12765:PF08620:PF10363,2,19,2,0,17,999,0.11,0.98,1.0,0.32,1,1,1,0,1016,1.0,1.0,0.5,0.71
PF14015,PF15856:PF08744:PF01668,0,3,0,0,3,1015,0.0,1.0,0,0,0,0,0,0,1018,0,1.0,0,0
PF13330,PF10162:PF09175:PF09206,16,13,4,12,9,993,0.31,0.98,0.25,0.27,2,1,15,1,1001,0.5,0.98,0.06,0.17
PF00162,PF02390:PF15473:PF00228,21,22,10,11,12,985,0.45,0.98,0.48,0.45,4,4,17,0,997,1.0,0.98,0.19,0.43
PF10100,PF01108:PF14603:PF09794,0,14,0,0,14,1004,0.0,0.99,0,0,2,0,0,2,1016,0.0,1.0,0,0
PF06821,PF15088:PF08843:PF00519,2,5,0,2,5,1011,0.0,0.99,0.0,-0.0,0,0,2,0,1016,0,1.0,0.0,0
PF01968,PF05378:PF02538:PF06032,28,28,28,0,0,990,1.0,1.0,1.0,1.0,28,28,0,0,990,1.0,1.0,1.0,1.0
PF09514,PF12417:PF02023:PF09607,3,24,2,1,22,993,0.08,0.98,0.67,0.23,5,1,2,4,1011,0.2,0.99,0.33,0.26
PF01220,PF06070:PF06131:PF00555,3,5,0,3,5,1010,0.0,0.99,0.0,-0.0,0,0,3,0,1015,0,1.0,0.0,0
PF17151,PF07004:PF00109:PF01266,0,106,0,0,106,912,0.0,0.9,0,0,31,0,0,31,987,0.0,0.97,0,0
PF11558,PF17046:PF17106:PF07367,0,8,0,0,8,1010,0.0,0.99,0,0,2,0,0,2,1016,0.0,1.0,0,0
PF02514,PF11965:PF14763:PF06746,1,2,1,0,1,1016,0.5,1.0,1.0,0.71,0,0,1,0,1017,0,1.0,0.0,0
PF15608,PF12081:PF06082:PF08886,0,0,0,0,0,1018,0,1.0,0,0,0,0,0,0,1018,0,1.0,0,0
PF08682,PF01721:PF16489:PF07305,0,17,0,0,17,1001,0.0,0.98,0,0,0,0,0,0,1018,0,1.0,0,0
PF07818,PF14610:PF07052:PF07051,10,15,2,8,13,995,0.13,0.98,0.2,0.15,1,0,10,1,1007,0.0,0.99,0.0,-0.0
PF10328,PF10323:PF02118:PF10316,16,18,6,10,12,990,0.33,0.98,0.38,0.34,2,1,15,1,1001,0.5,0.98,0.06,0.17
PF11392,PF04895:PF09986:PF02458,0,33,0,0,33,985,0.0,0.97,0,0,0,0,0,0,1018,0,1.0,0,0
PF13953,PF13954:PF00345:PF00577,5,5,5,0,0,1013,1.0,1.0,1.0,1.0,3,3,2,0,1013,1.0,1.0,0.6,0.77
PF07175,PF11510:PF04988:PF15337,0,10,0,0,10,1008,0.0,0.99,0,0,3,0,0,3,1015,0.0,1.0,0,0
PF09722,PF04451:PF00669:PF08453,0,3,0,0,3,1015,0.0,1.0,0,0,1,0,0,1,1017,0.0,1.0,0,0
PF02197,PF13178:PF13545:PF10137,21,8,3,18,5,992,0.38,0.98,0.14,0.22,1,0,21,1,996,0.0,0.98,0.0,-0.0
PF09287,PF01337:PF03883:PF07804,0,3,0,0,3,1015,0.0,1.0,0,0,0,0,0,0,1018,0,1.0,0,0
PF09184,PF09302:PF09816:PF09808,9,13,0,9,13,996,0.0,0.98,0.0,-0.01,2,0,9,2,1007,0.0,0.99,0.0,-0.0
PF12320,PF01340:PF14077:PF01797,0,6,0,0,6,1012,0.0,0.99,0,0,1,0,0,1,1017,0.0,1.0,0,0
PF01786,PF00301:PF04759:PF01871,12,10,3,9,7,999,0.3,0.98,0.25,0.27,0,0,12,0,1006,0,0.99,0.0,0
PF08926,PF14593:PF12063:PF11629,10,10,5,5,5,1003,0.5,0.99,0.5,0.5,4,4,6,0,1008,1.0,0.99,0.4,0.63
PF12831,PF07976:PF06314:PF08491,9,26,7,2,19,990,0.27,0.98,0.78,0.45,5,4,5,1,1008,0.8,0.99,0.44,0.59
PF04106,PF08561:PF00143:PF04520,16,6,1,15,5,997,0.17,0.98,0.06,0.09,0,0,16,0,1002,0,0.98,0.0,0
PF13559,PF15460:PF08795:PF03601,1,1,0,1,1,1016,0.0,1.0,0.0,-0.0,0,0,1,0,1017,0,1.0,0.0,0
PF10574,PF09786:PF12016:PF15321,0,7,0,0,7,1011,0.0,0.99,0,0,0,0,0,0,1018,0,1.0,0,0
PF12329,PF10377:PF07765:PF11500,11,11,2,9,9,998,0.18,0.98,0.18,0.17,3,1,10,2,1005,0.33,0.99,0.09,0.17
PF12827,PF00796:PF05836:PF17049,0,1,0,0,1,1017,0.0,1.0,0,0,0,0,0,0,1018,0,1.0,0,0
PF01951,PF09174:PF15054:PF10574,4,7,2,2,5,1009,0.29,0.99,0.5,0.37,0,0,4,0,1014,0,1.0,0.0,0
PF00680,PF00910:PF00073:PF12381,12,14,12,0,2,1004,0.86,1.0,1.0,0.92,12,12,0,0,1006,1.0,1.0,1.0,1.0
PF00214,PF14473:PF00236:PF15063,1,1,1,0,0,1017,1.0,1.0,1.0,1.0,0,0,1,0,1017,0,1.0,0.0,0
PF04905,PF04902:PF04904:PF10488,4,3,2,2,1,1013,0.67,1.0,0.5,0.58,0,0,4,0,1014,0,1.0,0.0,0
PF10166,PF15252:PF01387:PF03842,2,0,0,2,0,1016,0,1.0,0.0,0,0,0,2,0,1016,0,1.0,0.0,0
PF00219,PF00007:PF00050:PF09289,8,27,5,3,22,988,0.19,0.98,0.62,0.33,4,3,5,1,1009,0.75,0.99,0.38,0.53
PF04831,PF09756:PF07809:PF02291,4,10,2,2,8,1006,0.2,0.99,0.5,0.31,1,1,3,0,1014,1.0,1.0,0.25,0.5
PF13417,PF02798:PF13409:PF13679,53,68,25,28,43,922,0.37,0.93,0.47,0.38,15,11,42,4,961,0.73,0.95,0.21,0.38
PF15927,PF12366:PF11597:PF14665,6,6,4,2,2,1010,0.67,1.0,0.67,0.66,1,1,5,0,1012,1.0,1.0,0.17,0.41
PF04180,PF07093:PF00864:PF09803,8,20,2,6,18,992,0.1,0.98,0.25,0.15,3,2,6,1,1009,0.67,0.99,0.25,0.41
PF04487,PF16036:PF15621:PF11652,3,5,0,3,5,1010,0.0,0.99,0.0,-0.0,0,0,3,0,1015,0,1.0,0.0,0
PF00950,PF05936:PF06808:PF12837,4,8,3,1,5,1009,0.38,0.99,0.75,0.53,2,2,2,0,1014,1.0,1.0,0.5,0.71
PF16350,PF01571:PF10170:PF07892,12,27,12,0,15,991,0.44,0.99,1.0,0.66,2,2,10,0,1006,1.0,0.99,0.17,0.41
PF06278,PF16869:PF16858:PF02404,4,6,4,0,2,1012,0.67,1.0,1.0,0.82,0,0,4,0,1014,0,1.0,0.0,0
PF10613,PF00497:PF00060:PF10565,33,63,31,2,32,953,0.49,0.97,0.94,0.67,12,11,22,1,984,0.92,0.98,0.33,0.55
PF03416,PF04831:PF04729:PF07798,21,16,4,17,12,985,0.25,0.97,0.19,0.2,2,1,20,1,996,0.5,0.98,0.05,0.15
PF05011,PF04152:PF16891:PF10360,14,26,7,7,19,985,0.27,0.97,0.5,0.36,5,3,11,2,1002,0.6,0.99,0.21,0.35
PF10235,PF02950:PF15160:PF17022,3,1,0,3,1,1014,0.0,1.0,0.0,-0.0,0,0,3,0,1015,0,1.0,0.0,0
PF00231,PF05497:PF02284:PF01775,17,17,5,12,12,989,0.29,0.98,0.29,0.28,3,2,15,1,1000,0.67,0.98,0.12,0.28
PF05380,PF05585:PF07245:PF03564,28,38,14,14,24,966,0.37,0.96,0.5,0.41,22,12,16,10,980,0.55,0.97,0.43,0.47
PF15213,PF05830:PF02654:PF02283,0,6,0,0,6,1012,0.0,0.99,0,0,0,0,0,0,1018,0,1.0,0,0
PF15223,PF08782:PF02437:PF16566,0,19,0,0,19,999,0.0,0.98,0,0,10,0,0,10,1008,0.0,0.99,0,0
PF02990,PF00197:PF02330:PF01625,29,24,7,22,17,972,0.29,0.96,0.24,0.25,4,4,25,0,989,1.0,0.98,0.14,0.37
PF00724,PF00756:PF00180:PF07110,35,56,13,22,43,940,0.23,0.94,0.37,0.26,9,4,31,5,978,0.44,0.96,0.11,0.21
PF07324,PF02126:PF10251:PF15087,3,11,1,2,10,1005,0.09,0.99,0.33,0.17,1,0,3,1,1014,0.0,1.0,0.0,-0.0
PF08243,PF12169:PF08578:PF08161,12,10,2,10,8,998,0.2,0.98,0.17,0.17,1,1,11,0,1006,1.0,0.99,0.08,0.29
PF07740,PF06446:PF16716:PF00537,1,1,1,0,0,1017,1.0,1.0,1.0,1.0,0,0,1,0,1017,0,1.0,0.0,0
PF01849,PF01279:PF00159:PF07911,13,5,1,12,4,1001,0.2,0.98,0.08,0.12,1,0,13,1,1004,0.0,0.99,0.0,-0.0
PF07914,PF16088:PF02958:PF10321,8,33,3,5,30,980,0.09,0.97,0.38,0.17,3,1,7,2,1008,0.33,0.99,0.12,0.2
PF04107,PF00468:PF07298:PF03350,5,8,0,5,8,1005,0.0,0.99,0.0,-0.01,0,0,5,0,1013,0,1.0,0.0,0
PF05547,PF15553:PF17017:PF15379,1,0,0,1,0,1017,0,1.0,0.0,0,0,0,1,0,1017,0,1.0,0.0,0
PF07767,PF09751:PF03239:PF16969,12,20,6,6,14,992,0.3,0.98,0.5,0.38,4,4,8,0,1006,1.0,0.99,0.33,0.58
PF14159,PF03350:PF04759:PF14249,0,7,0,0,7,1011,0.0,0.99,0,0,0,0,0,0,1018,0,1.0,0,0
PF11331,PF14611:PF15862:PF00649,3,14,0,3,14,1001,0.0,0.98,0.0,-0.01,0,0,3,0,1015,0,1.0,0.0,0
PF12362,PF15182:PF10106:PF09498,1,1,0,1,1,1016,0.0,1.0,0.0,-0.0,0,0,1,0,1017,0,1.0,0.0,0
PF11039,PF06347:PF14344:PF08808,0,5,0,0,5,1013,0.0,1.0,0,0,0,0,0,0,1018,0,1.0,0,0
PF15764,PF15553:PF06485:PF15379,1,4,0,1,4,1013,0.0,1.0,0.0,-0.0,0,0,1,0,1017,0,1.0,0.0,0
PF04054,PF16417:PF16418:PF12842,11,12,9,2,3,1004,0.75,1.0,0.82,0.78,10,9,2,1,1006,0.9,1.0,0.82,0.86
PF07974,PF02333:PF08725:PF01457,34,21,11,23,10,974,0.52,0.97,0.32,0.4,2,2,32,0,984,1.0,0.97,0.06,0.24
PF01146,PF14802:PF08286:PF04089,10,7,1,9,6,1002,0.14,0.99,0.1,0.11,0,0,10,0,1008,0,0.99,0.0,0
PF09470,PF10856:PF02951:PF15367,0,6,0,0,6,1012,0.0,0.99,0,0,0,0,0,0,1018,0,1.0,0,0
PF10385,PF04561:PF06883:PF04560,4,19,4,0,15,999,0.21,0.99,1.0,0.46,6,2,2,4,1010,0.33,0.99,0.5,0.41
PF05056,PF04758:PF01020:PF10421,11,24,5,6,19,988,0.21,0.98,0.45,0.3,2,1,10,1,1006,0.5,0.99,0.09,0.21
PF08597,PF10166:PF14931:PF14713,8,5,1,7,4,1006,0.2,0.99,0.12,0.15,0,0,8,0,1010,0,0.99,0.0,0
PF15199,PF00519:PF17049:PF08026,0,6,0,0,6,1012,0.0,0.99,0,0,0,0,0,0,1018,0,1.0,0,0
PF08286,PF12240:PF08227:PF11291,0,7,0,0,7,1011,0.0,0.99,0,0,0,0,0,0,1018,0,1.0,0,0
PF17189,PF02055:PF08934:PF16757,13,23,13,0,10,995,0.57,0.99,1.0,0.75,0,0,13,0,1005,0,0.99,0.0,0
PF11926,PF00684:PF14308:PF11875,2,17,2,0,15,1001,0.12,0.99,1.0,0.34,1,0,2,1,1015,0.0,1.0,0.0,-0.0
PF02865,PF01017:PF02864:PF14596,4,4,3,1,1,1013,0.75,1.0,0.75,0.75,2,2,2,0,1014,1.0,1.0,0.5,0.71
PF03404,PF00174:PF01070:PF00970,20,71,20,0,51,947,0.28,0.95,1.0,0.52,23,18,2,5,993,0.78,0.99,0.9,0.84
PF13813,PF04646:PF01066:PF08652,14,39,7,7,32,972,0.18,0.96,0.5,0.28,7,2,12,5,999,0.29,0.98,0.14,0.19
PF12862,PF05183:PF11701:PF13374,15,70,11,4,59,944,0.16,0.94,0.73,0.32,17,5,10,12,991,0.29,0.98,0.33,0.3
PF00381,PF12477:PF06798:PF03241,0,0,0,0,0,1018,0,1.0,0,0,0,0,0,0,1018,0,1.0,0,0
PF13350,PF13026:PF12146:PF04083,7,66,4,3,62,949,0.06,0.94,0.57,0.17,13,1,6,12,999,0.08,0.98,0.14,0.1
PF01644,PF06165:PF12449:PF14663,15,17,4,11,13,990,0.24,0.98,0.27,0.24,1,1,14,0,1003,1.0,0.99,0.07,0.26
PF05495,PF13441:PF13705:PF06547,11,7,4,7,3,1004,0.57,0.99,0.36,0.45,2,2,9,0,1007,1.0,0.99,0.18,0.42
PF15602,PF16108:PF00527:PF04973,0,3,0,0,3,1015,0.0,1.0,0,0,0,0,0,0,1018,0,1.0,0,0
PF09781,PF09057:PF06679:PF03488,1,1,0,1,1,1016,0.0,1.0,0.0,-0.0,0,0,1,0,1017,0,1.0,0.0,0
PF08417,PF04305:PF00848:PF08802,9,18,3,6,15,994,0.17,0.98,0.33,0.23,5,3,6,2,1007,0.6,0.99,0.33,0.44
PF08903,PF05138:PF10429:PF14715,0,0,0,0,0,1018,0,1.0,0,0,0,0,0,0,1018,0,1.0,0,0
PF02916,PF11604:PF09093:PF07916,1,1,0,1,1,1016,0.0,1.0,0.0,-0.0,0,0,1,0,1017,0,1.0,0.0,0
PF16072,PF15669:PF15264:PF04004,1,12,1,0,11,1006,0.08,0.99,1.0,0.29,1,0,1,1,1016,0.0,1.0,0.0,-0.0
PF13269,PF15518:PF04552:PF08479,0,2,0,0,2,1016,0.0,1.0,0,0,0,0,0,0,1018,0,1.0,0,0
PF08743,PF10253:PF14970:PF14784,10,8,1,9,7,1001,0.12,0.98,0.1,0.1,1,0,10,1,1007,0.0,0.99,0.0,-0.0
PF08907,PF11767:PF04073:PF01927,3,19,3,0,16,999,0.16,0.98,1.0,0.39,4,3,0,1,1014,0.75,1.0,1.0,0.87
PF11730,PF09069:PF09068:PF12738,0,29,0,0,29,989,0.0,0.97,0,0,6,0,0,6,1012,0.0,0.99,0,0
PF08782,PF15223:PF04818:PF02040,10,34,6,4,28,980,0.18,0.97,0.6,0.31,4,0,10,4,1004,0.0,0.99,0.0,-0.01
PF06870,PF05995:PF04176:PF02284,9,18,2,7,16,993,0.11,0.98,0.22,0.15,5,1,8,4,1005,0.2,0.99,0.11,0.14
PF07857,PF08140:PF12853:PF03769,9,7,0,9,7,1002,0.0,0.98,0.0,-0.01,0,0,9,0,1009,0,0.99,0.0,0
PF00034,PF08752:PF16381:PF06375,17,7,2,15,5,996,0.29,0.98,0.12,0.17,5,1,16,4,997,0.2,0.98,0.06,0.1
PF06812,PF15050:PF17062:PF10664,0,3,0,0,3,1015,0.0,1.0,0,0,0,0,0,0,1018,0,1.0,0,0
PF10435,PF13363:PF13364:PF01301,5,31,5,0,26,987,0.16,0.97,1.0,0.4,10,5,0,5,1008,0.5,1.0,1.0,0.71
PF08041,PF05419:PF12046:PF02427,4,0,0,4,0,1014,0,1.0,0.0,0,0,0,4,0,1014,0,1.0,0.0,0
PF03588,PF17078:PF15052:PF15553,1,4,0,1,4,1013,0.0,1.0,0.0,-0.0,0,0,1,0,1017,0,1.0,0.0,0
PF01329,PF01097:PF10244:PF08561,16,15,3,13,12,990,0.2,0.98,0.19,0.18,1,0,16,1,1001,0.0,0.98,0.0,-0.0
PF00593,PF00950:PF12837:PF07123,4,8,2,2,6,1008,0.25,0.99,0.5,0.35,2,2,2,0,1014,1.0,1.0,0.5,0.71
PF04222,PF17206:PF15529:PF11751,0,1,0,0,1,1017,0.0,1.0,0,0,0,0,0,0,1018,0,1.0,0,0
PF06723,PF10712:PF00012:PF09259,5,70,2,3,68,945,0.03,0.93,0.4,0.09,6,2,3,4,1009,0.33,0.99,0.4,0.36
PF08198,PF03020:PF09402:PF11560,1,17,1,0,16,1001,0.06,0.98,1.0,0.24,3,1,0,2,1015,0.33,1.0,1.0,0.58
PF14094,PF09655:PF10474:PF08086,0,2,0,0,2,1016,0.0,1.0,0,0,0,0,0,0,1018,0,1.0,0,0
PF06614,PF10580:PF13178:PF15157,1,7,1,0,6,1011,0.14,0.99,1.0,0.38,1,1,0,0,1017,1.0,1.0,1.0,1.0
PF08473,PF06668:PF08399:PF02743,5,21,5,0,16,997,0.24,0.98,1.0,0.48,5,3,2,2,1011,0.6,1.0,0.6,0.6
PF09904,PF07409:PF11751:PF07157,0,0,0,0,0,1018,0,1.0,0,0,0,0,0,0,1018,0,1.0,0,0
PF12879,PF12887:PF12878:PF15253,0,3,0,0,3,1015,0.0,1.0,0,0,0,0,0,0,1018,0,1.0,0,0
PF10853,PF10244:PF04716:PF15370,4,20,3,1,17,997,0.15,0.98,0.75,0.33,4,1,3,3,1011,0.25,0.99,0.25,0.25
PF11217,PF08021:PF13751:PF10974,2,2,1,1,1,1015,0.5,1.0,0.5,0.5,0,0,2,0,1016,0,1.0,0.0,0
PF02581,PF02110:PF01288:PF03070,6,27,3,3,24,988,0.11,0.97,0.5,0.23,3,0,6,3,1009,0.0,0.99,0.0,-0.0
PF02381,PF17060:PF04963:PF14841,2,3,0,2,3,1013,0.0,1.0,0.0,-0.0,0,0,2,0,1016,0,1.0,0.0,0
PF11430,PF10994:PF15169:PF15825,0,0,0,0,0,1018,0,1.0,0,0,0,0,0,0,1018,0,1.0,0,0
PF01059,PF06444:PF04241:PF12155,0,13,0,0,13,1005,0.0,0.99,0,0,0,0,0,0,1018,0,1.0,0,0
PF14974,PF00467:PF01238:PF01929,10,34,8,2,26,982,0.24,0.97,0.8,0.42,13,7,3,6,1002,0.54,0.99,0.7,0.61
PF01484,PF09006:PF03523:PF15067,37,5,0,37,5,976,0.0,0.96,0.0,-0.01,0,0,37,0,981,0,0.96,0.0,0
PF10058,PF10217:PF11282:PF07052,7,14,0,7,14,997,0.0,0.98,0.0,-0.01,1,0,7,1,1010,0.0,0.99,0.0,-0.0
PF02562,PF17020:PF07547:PF12443,2,5,0,2,5,1011,0.0,0.99,0.0,-0.0,0,0,2,0,1016,0,1.0,0.0,0
PF08738,PF03576:PF01947:PF09056,0,4,0,0,4,1014,0.0,1.0,0,0,0,0,0,0,1018,0,1.0,0,0
PF13466,PF05494:PF07520:PF14805,1,4,0,1,4,1013,0.0,1.0,0.0,-0.0,0,0,1,0,1017,0,1.0,0.0,0
PF08911,PF00638:PF04065:PF08604,6,37,5,1,32,980,0.14,0.97,0.83,0.33,4,2,4,2,1010,0.5,0.99,0.33,0.41
PF07421,PF10974:PF03944:PF01514,1,2,0,1,2,1015,0.0,1.0,0.0,-0.0,0,0,1,0,1017,0,1.0,0.0,0
PF04097,PF03074:PF07778:PF04833,17,13,5,12,8,993,0.38,0.98,0.29,0.33,1,1,16,0,1001,1.0,0.98,0.06,0.24
PF04769,PF11025:PF09687:PF01160,2,1,0,2,1,1015,0.0,1.0,0.0,-0.0,0,0,2,0,1016,0,1.0,0.0,0
PF12745,PF12063:PF13281:PF16797,7,15,3,4,12,999,0.2,0.98,0.43,0.29,2,2,5,0,1011,1.0,1.0,0.29,0.53
PF02486,PF04451:PF04355:PF08707,2,2,0,2,2,1014,0.0,1.0,0.0,-0.0,0,0,2,0,1016,0,1.0,0.0,0
PF01948,PF03428:PF01312:PF01913,0,1,0,0,1,1017,0.0,1.0,0,0,0,0,0,0,1018,0,1.0,0,0
PF08518,PF16559:PF12205:PF03259,8,13,3,5,10,1000,0.23,0.99,0.38,0.29,3,3,5,0,1010,1.0,1.0,0.38,0.61
PF04559,PF03865:PF08411:PF05939,0,1,0,0,1,1017,0.0,1.0,0,0,0,0,0,0,1018,0,1.0,0,0
PF14837,PF14838:PF16875:PF06165,2,8,2,0,6,1010,0.25,0.99,1.0,0.5,0,0,2,0,1016,0,1.0,0.0,0
PF12215,PF04685:PF04840:PF04841,8,17,5,3,12,998,0.29,0.99,0.62,0.42,9,2,6,7,1003,0.22,0.99,0.25,0.23
PF00734,PF02013:PF16990:PF03442,39,13,10,29,3,976,0.77,0.97,0.26,0.43,4,4,35,0,979,1.0,0.97,0.1,0.31
PF06522,PF04110:PF01828:PF10853,3,16,2,1,14,1001,0.12,0.99,0.67,0.28,3,1,2,2,1013,0.33,1.0,0.33,0.33
PF11871,PF17058:PF16980:PF07645,0,60,0,0,60,958,0.0,0.94,0,0,0,0,0,0,1018,0,1.0,0,0
PF09989,PF06050:PF02056:PF09134,0,8,0,0,8,1010,0.0,0.99,0,0,0,0,0,0,1018,0,1.0,0,0
PF01408,PF17132:PF03118:PF08652,40,16,7,33,9,969,0.44,0.96,0.17,0.26,1,0,40,1,977,0.0,0.96,0.0,-0.01
PF07977,PF15888:PF04417:PF11502,15,3,0,15,3,1000,0.0,0.98,0.0,-0.01,0,0,15,0,1003,0,0.99,0.0,0
PF15754,PF14862:PF15333:PF15838,0,0,0,0,0,1018,0,1.0,0,0,0,0,0,0,1018,0,1.0,0,0
PF05163,PF09798:PF11214:PF04196,0,1,0,0,1,1017,0.0,1.0,0,0,0,0,0,0,1018,0,1.0,0,0
PF01640,PF13505:PF00700:PF06744,1,1,0,1,1,1016,0.0,1.0,0.0,-0.0,0,0,1,0,1017,0,1.0,0.0,0
PF02933,PF02359:PF05362:PF01749,10,40,8,2,32,976,0.2,0.97,0.8,0.39,9,6,4,3,1005,0.67,0.99,0.6,0.63
PF10798,PF03550:PF05103:PF10335,0,4,0,0,4,1014,0.0,1.0,0,0,0,0,0,0,1018,0,1.0,0,0
PF01179,PF02728:PF02727:PF09248,28,22,22,6,0,990,1.0,0.99,0.79,0.88,13,13,15,0,990,1.0,0.99,0.46,0.68
PF03462,PF00472:PF04095:PF02744,21,52,21,0,31,966,0.4,0.97,1.0,0.63,5,4,17,1,996,0.8,0.98,0.19,0.39
PF07976,PF06314:PF12831:PF01494,18,90,18,0,72,928,0.2,0.93,1.0,0.43,16,6,12,10,990,0.38,0.98,0.33,0.34
PF12547,PF15923:PF10198:PF09038,2,5,1,1,4,1012,0.2,1.0,0.5,0.31,0,0,2,0,1016,0,1.0,0.0,0
PF07189,PF05612:PF06217:PF02605,7,0,0,7,0,1011,0,0.99,0.0,0,0,0,7,0,1011,0,0.99,0.0,0
PF07795,PF04536:PF08536:PF08656,2,10,2,0,8,1008,0.2,0.99,1.0,0.45,0,0,2,0,1016,0,1.0,0.0,0
PF17026,PF11057:PF15119:PF05728,0,5,0,0,5,1013,0.0,1.0,0,0,0,0,0,0,1018,0,1.0,0,0
PF01871,PF03350:PF07816:PF04367,4,3,0,4,3,1011,0.0,0.99,0.0,-0.0,0,0,4,0,1014,0,1.0,0.0,0
PF15829,PF15576:PF15120:PF03823,1,4,1,0,3,1014,0.25,1.0,1.0,0.5,1,1,0,0,1017,1.0,1.0,1.0,1.0
PF00791,PF00531:PF09034:PF17217,14,39,10,4,29,975,0.26,0.97,0.71,0.42,4,3,11,1,1003,0.75,0.99,0.21,0.4
PF00119,PF00124:PF00115:PF00499,9,19,7,2,12,997,0.37,0.99,0.78,0.53,2,0,9,2,1007,0.0,0.99,0.0,-0.0
PF01091,PF05196:PF06540:PF01296,2,2,1,1,1,1015,0.5,1.0,0.5,0.5,1,0,2,1,1015,0.0,1.0,0.0,-0.0
PF03195,PF05678:PF02325:PF01245,8,18,5,3,13,997,0.28,0.98,0.62,0.41,3,3,5,0,1010,1.0,1.0,0.38,0.61
PF07584,PF01208:PF03962:PF01280,0,27,0,0,27,991,0.0,0.97,0,0,5,0,0,5,1013,0.0,1.0,0,0
PF13490,PF15750:PF02369:PF11614,3,5,0,3,5,1010,0.0,0.99,0.0,-0.0,0,0,3,0,1015,0,1.0,0.0,0
PF01997,PF01680:PF02284:PF16906,9,23,3,6,20,989,0.13,0.97,0.33,0.2,3,1,8,2,1007,0.33,0.99,0.11,0.19
PF15848,PF03238:PF03745:PF12724,0,0,0,0,0,1018,0,1.0,0,0,0,0,0,0,1018,0,1.0,0,0
PF02163,PF15019:PF13908:PF04769,10,5,0,10,5,1003,0.0,0.99,0.0,-0.01,0,0,10,0,1008,0,0.99,0.0,0
PF12533,PF01586:PF09427:PF15372,3,5,1,2,4,1011,0.2,0.99,0.33,0.26,1,1,2,0,1015,1.0,1.0,0.33,0.58
PF08035,PF16102:PF08384:PF00976,0,0,0,0,0,1018,0,1.0,0,0,0,0,0,0,1018,0,1.0,0,0
PF04081,PF09459:PF07544:PF09348,8,8,0,8,8,1002,0.0,0.98,0.0,-0.01,0,0,8,0,1010,0,0.99,0.0,0
PF10263,PF05770:PF00194:PF04906,22,42,13,9,29,967,0.31,0.96,0.59,0.41,3,2,20,1,995,0.67,0.98,0.09,0.24
PF07782,PF13890:PF07810:PF09733,12,17,3,9,14,992,0.18,0.98,0.25,0.2,2,1,11,1,1005,0.5,0.99,0.08,0.2
PF15814,PF06729:PF02977:PF15825,0,0,0,0,0,1018,0,1.0,0,0,0,0,0,0,1018,0,1.0,0,0
PF00662,PF06455:PF01010:PF10350,3,12,1,2,11,1004,0.08,0.99,0.33,0.16,1,0,3,1,1014,0.0,1.0,0.0,-0.0
PF04232,PF07963:PF00345:PF15750,3,6,1,2,5,1010,0.17,0.99,0.33,0.23,0,0,3,0,1015,0,1.0,0.0,0
PF15788,PF02740:PF00323:PF04643,0,3,0,0,3,1015,0.0,1.0,0,0,0,0,0,0,1018,0,1.0,0,0
PF16923,PF03200:PF16350:PF08302,8,20,8,0,12,998,0.4,0.99,1.0,0.63,6,6,2,0,1010,1.0,1.0,0.75,0.87
PF04116,PF04765:PF04819:PF00487,31,46,12,19,34,953,0.26,0.95,0.39,0.29,6,4,27,2,985,0.67,0.97,0.13,0.29
PF00512,PF08446:PF08448:PF00672,45,27,21,24,6,967,0.78,0.97,0.47,0.59,12,10,35,2,971,0.83,0.96,0.22,0.42
PF07055,PF12241:PF15726:PF02561,1,1,1,0,0,1017,1.0,1.0,1.0,1.0,0,0,1,0,1017,0,1.0,0.0,0
PF15407,PF15082:PF09322:PF10407,0,3,0,0,3,1015,0.0,1.0,0,0,0,0,0,0,1018,0,1.0,0,0
PF08149,PF08145:PF04003:PF10313,7,17,2,5,15,996,0.12,0.98,0.29,0.17,3,1,6,2,1009,0.33,0.99,0.14,0.21
PF16683,PF15314:PF04359:PF06485,3,5,0,3,5,1010,0.0,0.99,0.0,-0.0,0,0,3,0,1015,0,1.0,0.0,0
PF08521,PF00672:PF00990:PF02518,3,78,3,0,75,940,0.04,0.93,1.0,0.19,21,2,1,19,996,0.1,0.98,0.67,0.25
PF12041,PF03514:PF13922:PF05066,3,24,0,3,24,991,0.0,0.97,0.0,-0.01,4,0,3,4,1011,0.0,0.99,0.0,-0.0
PF15248,PF12240:PF15866:PF08227,5,11,4,1,7,1006,0.36,0.99,0.8,0.54,1,1,4,0,1013,1.0,1.0,0.2,0.45
PF01241,PF06351:PF00537:PF00236,0,4,0,0,4,1014,0.0,1.0,0,0,0,0,0,0,1018,0,1.0,0,0
PF07347,PF11029:PF15884:PF04736,9,5,0,9,5,1004,0.0,0.99,0.0,-0.01,1,0,9,1,1008,0.0,0.99,0.0,-0.0
PF00347,PF03719:PF00166:PF00861,23,37,13,10,24,971,0.35,0.97,0.57,0.43,10,8,15,2,993,0.8,0.98,0.35,0.52
PF04709,PF00688:PF09771:PF09157,1,18,1,0,17,1000,0.06,0.98,1.0,0.23,4,1,0,3,1014,0.25,1.0,1.0,0.5
PF03055,PF15219:PF10157:PF00154,22,22,6,16,16,980,0.27,0.97,0.27,0.26,5,3,19,2,994,0.6,0.98,0.14,0.28
PF16211,PF00125:PF01170:PF01661,24,66,21,3,45,949,0.32,0.95,0.88,0.51,20,12,12,8,986,0.6,0.98,0.5,0.54
PF02325,PF14610:PF15810:PF11282,1,5,0,1,5,1012,0.0,0.99,0.0,-0.0,1,0,1,1,1016,0.0,1.0,0.0,-0.0
PF01474,PF07168:PF07993:PF10195,17,51,7,10,44,957,0.14,0.95,0.41,0.22,0,0,17,0,1001,0,0.98,0.0,0
PF15880,PF00737:PF07281:PF00537,3,6,0,3,6,1009,0.0,0.99,0.0,-0.0,0,0,3,0,1015,0,1.0,0.0,0
PF05427,PF10254:PF05587:PF01484,6,46,5,1,41,971,0.11,0.96,0.83,0.29,1,1,5,0,1012,1.0,1.0,0.17,0.41
PF11669,PF12527:PF10361:PF08528,3,5,0,3,5,1010,0.0,0.99,0.0,-0.0,0,0,3,0,1015,0,1.0,0.0,0
PF01457,PF09992:PF07974:PF02333,10,40,5,5,35,973,0.12,0.96,0.5,0.24,1,0,10,1,1007,0.0,0.99,0.0,-0.0
PF16029,PF11029:PF15884:PF06351,6,5,1,5,4,1008,0.2,0.99,0.17,0.18,1,1,5,0,1012,1.0,1.0,0.17,0.41
PF09329,PF12253:PF16944:PF15871,6,6,0,6,6,1006,0.0,0.99,0.0,-0.01,0,0,6,0,1012,0,0.99,0.0,0
PF16797,PF12063:PF11629:PF08311,3,15,2,1,13,1002,0.13,0.99,0.67,0.29,4,2,1,2,1013,0.5,1.0,0.67,0.58
PF08418,PF12213:PF16002:PF16653,5,18,2,3,16,997,0.11,0.98,0.4,0.2,4,2,3,2,1011,0.5,1.0,0.4,0.44
PF15440,PF07260:PF07139:PF09755,3,8,2,1,6,1009,0.25,0.99,0.67,0.41,1,1,2,0,1015,1.0,1.0,0.33,0.58
PF01158,PF07074:PF15551:PF15139,9,9,3,6,6,1003,0.33,0.99,0.33,0.33,0,0,9,0,1009,0,0.99,0.0,0
PF07156,PF08911:PF00638:PF00343,14,46,6,8,40,964,0.13,0.95,0.43,0.22,9,5,9,4,1000,0.56,0.99,0.36,0.44
PF00828,PF10218:PF01632:PF01185,26,8,3,23,5,987,0.38,0.97,0.12,0.2,1,1,25,0,992,1.0,0.98,0.04,0.19
PF09764,PF03727:PF00349:PF08714,6,24,5,1,19,993,0.21,0.98,0.83,0.41,20,5,1,15,997,0.25,0.98,0.83,0.45
PF04476,PF10412:PF11037:PF06945,0,0,0,0,0,1018,0,1.0,0,0,0,0,0,0,1018,0,1.0,0,0
PF04505,PF06083:PF07896:PF02915,15,9,3,12,6,997,0.33,0.98,0.2,0.25,1,0,15,1,1002,0.0,0.98,0.0,-0.0
PF08826,PF12179:PF14593:PF12202,5,12,4,1,8,1005,0.33,0.99,0.8,0.51,3,3,2,0,1013,1.0,1.0,0.6,0.77
PF00266,PF03476:PF03473:PF01171,49,32,14,35,18,951,0.44,0.95,0.29,0.33,14,7,42,7,962,0.5,0.95,0.14,0.25
PF00413,PF01471:PF08924:PF00045,35,36,28,7,8,975,0.78,0.99,0.8,0.78,22,22,13,0,983,1.0,0.99,0.63,0.79
PF01834,PF08605:PF00649:PF07535,6,14,1,5,13,999,0.07,0.98,0.17,0.1,1,0,6,1,1011,0.0,0.99,0.0,-0.0
PF03729,PF03090:PF04717:PF11751,0,0,0,0,0,1018,0,1.0,0,0,0,0,0,0,1018,0,1.0,0,0
PF10469,PF10470:PF16568:PF16544,17,4,2,15,2,999,0.5,0.98,0.12,0.24,1,1,16,0,1001,1.0,0.98,0.06,0.24
PF05299,PF05707:PF11245:PF08744,0,0,0,0,0,1018,0,1.0,0,0,0,0,0,0,1018,0,1.0,0,0
PF02957,PF04472:PF02611:PF13875,0,3,0,0,3,1015,0.0,1.0,0,0,0,0,0,0,1018,0,1.0,0,0
PF16791,PF03509:PF03508:PF00029,0,8,0,0,8,1010,0.0,0.99,0,0,0,0,0,0,1018,0,1.0,0,0
PF01637,PF17008:PF15485:PF14573,2,0,0,2,0,1016,0,1.0,0.0,0,0,0,2,0,1016,0,1.0,0.0,0
PF03031,PF10213:PF08511:PF07535,43,17,7,36,10,965,0.41,0.95,0.16,0.24,3,3,40,0,975,1.0,0.96,0.07,0.26
PF01754,PF01428:PF05839:PF02338,10,59,7,3,52,956,0.12,0.95,0.7,0.27,11,4,6,7,1001,0.36,0.99,0.4,0.37
PF05368,PF11807:PF04199:PF14027,46,32,17,29,15,957,0.53,0.96,0.37,0.42,12,12,34,0,972,1.0,0.97,0.26,0.5
PF02929,PF16353:PF02837:PF02836,5,22,5,0,17,996,0.23,0.98,1.0,0.47,12,5,0,7,1006,0.42,0.99,1.0,0.64
PF08503,PF07530:PF15299:PF16012,1,19,0,1,19,998,0.0,0.98,0.0,-0.0,2,0,1,2,1015,0.0,1.0,0.0,-0.0
PF13631,PF00033:PF04140:PF06159,2,27,2,0,25,991,0.07,0.98,1.0,0.27,3,1,1,2,1014,0.33,1.0,0.5,0.41
PF01719,PF10694:PF10962:PF02591,2,3,1,1,2,1014,0.33,1.0,0.5,0.41,0,0,2,0,1016,0,1.0,0.0,0
PF09377,PF01172:PF13506:PF12243,8,20,7,1,13,997,0.35,0.99,0.88,0.55,0,0,8,0,1010,0,0.99,0.0,0
PF14630,PF09079:PF13401:PF14532,9,20,4,5,16,993,0.2,0.98,0.44,0.29,6,3,6,3,1006,0.5,0.99,0.33,0.4
PF01710,PF01022:PF12760:PF09339,1,13,0,1,13,1004,0.0,0.99,0.0,-0.0,0,0,1,0,1017,0,1.0,0.0,0
PF15807,PF15046:PF15754:PF07458,2,3,0,2,3,1013,0.0,1.0,0.0,-0.0,0,0,2,0,1016,0,1.0,0.0,0
PF05456,PF15325:PF06876:PF06729,3,1,1,2,0,1015,1.0,1.0,0.33,0.58,0,0,3,0,1015,0,1.0,0.0,0
PF14196,PF10566:PF07157:PF04355,0,0,0,0,0,1018,0,1.0,0,0,0,0,0,0,1018,0,1.0,0,0
PF17152,PF01752:PF11751:PF00669,1,3,0,1,3,1014,0.0,1.0,0.0,-0.0,0,0,1,0,1017,0,1.0,0.0,0
PF14783,PF14782:PF14781:PF14944,6,11,6,0,5,1007,0.55,1.0,1.0,0.74,4,4,2,0,1012,1.0,1.0,0.67,0.82
PF11731,PF16064:PF01510:PF14360,0,22,0,0,22,996,0.0,0.98,0,0,1,0,0,1,1017,0.0,1.0,0,0
PF00458,PF09180:PF03950:PF03129,18,52,15,3,37,963,0.29,0.96,0.83,0.48,13,8,10,5,995,0.62,0.99,0.44,0.52
PF12121,PF08023:PF16048:PF08018,0,0,0,0,0,1018,0,1.0,0,0,0,0,0,0,1018,0,1.0,0,0
PF14856,PF03427:PF08329:PF00704,10,59,10,0,49,959,0.17,0.95,1.0,0.4,3,1,9,2,1006,0.33,0.99,0.1,0.18
PF04902,PF04904:PF04905:PF14763,0,4,0,0,4,1014,0.0,1.0,0,0,2,0,0,2,1016,0.0,1.0,0,0
PF02375,PF02928:PF08429:PF10497,19,22,12,7,10,989,0.55,0.98,0.63,0.58,9,9,10,0,999,1.0,0.99,0.47,0.68
PF01553,PF00924:PF01699:PF02536,63,67,27,36,40,915,0.4,0.93,0.43,0.38,20,13,50,7,948,0.65,0.94,0.21,0.35
PF13281,PF14593:PF12202:PF11629,7,11,3,4,8,1003,0.27,0.99,0.43,0.34,4,3,4,1,1010,0.75,1.0,0.43,0.56
PF06031,PF07545:PF01868:PF09816,5,15,2,3,13,1000,0.13,0.98,0.4,0.22,2,0,5,2,1011,0.0,0.99,0.0,-0.0
PF12399,PF13732:PF08402:PF08352,9,11,5,4,6,1003,0.45,0.99,0.56,0.5,3,3,6,0,1009,1.0,0.99,0.33,0.58
PF08736,PF04382:PF09380:PF09379,15,42,15,0,27,976,0.36,0.97,1.0,0.59,31,15,0,16,987,0.48,0.98,1.0,0.69
PF08008,PF02217:PF08093:PF11039,0,4,0,0,4,1014,0.0,1.0,0,0,0,0,0,0,1018,0,1.0,0,0
PF16124,PF09382:PF08072:PF00570,30,31,20,10,11,977,0.65,0.98,0.67,0.65,17,17,13,0,988,1.0,0.99,0.57,0.75
PF15979,PF10350:PF12612:PF07539,12,27,7,5,20,986,0.26,0.98,0.58,0.38,6,4,8,2,1004,0.67,0.99,0.33,0.47
PF10543,PF14791:PF14792:PF10391,0,20,0,0,20,998,0.0,0.98,0,0,18,0,0,18,1000,0.0,0.98,0,0
PF05842,PF07679:PF15210:PF04847,1,94,0,1,94,923,0.0,0.91,0.0,-0.01,5,0,1,5,1012,0.0,0.99,0.0,-0.0
PF00230,PF04535:PF06749:PF12296,40,15,6,34,9,969,0.4,0.96,0.15,0.23,2,2,38,0,978,1.0,0.96,0.05,0.22
PF09037,PF15775:PF02595:PF04350,0,1,0,0,1,1017,0.0,1.0,0,0,0,0,0,0,1018,0,1.0,0,0
PF03755,PF13005:PF10375:PF10490,0,5,0,0,5,1013,0.0,1.0,0,0,0,0,0,0,1018,0,1.0,0,0
PF09058,PF10600:PF10608:PF04629,3,7,1,2,6,1009,0.14,0.99,0.33,0.21,1,1,2,0,1015,1.0,1.0,0.33,0.58
PF03948,PF17221:PF01386:PF05173,6,8,1,5,7,1005,0.12,0.99,0.17,0.14,0,0,6,0,1012,0,0.99,0.0,0
PF14782,PF14781:PF14783:PF10267,8,13,6,2,7,1003,0.46,0.99,0.75,0.58,5,5,3,0,1010,1.0,1.0,0.62,0.79
PF00499,PF00507:PF00124:PF00119,2,13,1,1,12,1004,0.08,0.99,0.5,0.19,3,0,2,3,1013,0.0,1.0,0.0,-0.0
PF15839,PF07259:PF15829:PF15576,1,3,0,1,3,1014,0.0,1.0,0.0,-0.0,0,0,1,0,1017,0,1.0,0.0,0
PF08463,PF03146:PF02667:PF03291,2,9,1,1,8,1008,0.11,0.99,0.5,0.23,1,0,2,1,1015,0.0,1.0,0.0,-0.0
PF14946,PF15252:PF01415:PF15551,2,2,0,2,2,1014,0.0,1.0,0.0,-0.0,0,0,2,0,1016,0,1.0,0.0,0
PF13885,PF05287:PF01500:PF14735,1,5,0,1,5,1012,0.0,0.99,0.0,-0.0,0,0,1,0,1017,0,1.0,0.0,0
PF00345,PF13954:PF02056:PF08461,3,10,3,0,7,1008,0.3,0.99,1.0,0.55,1,1,2,0,1015,1.0,1.0,0.33,0.58
PF13477,PF05159:PF11997:PF10111,0,0,0,0,0,1018,0,1.0,0,0,0,0,0,0,1018,0,1.0,0,0
PF13102,PF08037:PF05928:PF15844,0,1,0,0,1,1017,0.0,1.0,0,0,0,0,0,0,1018,0,1.0,0,0
PF01395,PF05405:PF06083:PF06159,18,12,2,16,10,990,0.17,0.97,0.11,0.12,1,0,18,1,999,0.0,0.98,0.0,-0.0
PF15380,PF05418:PF06393:PF15186,0,3,0,0,3,1015,0.0,1.0,0,0,1,0,0,1,1017,0.0,1.0,0,0
PF09361,PF16967:PF02601:PF15976,0,2,0,0,2,1016,0.0,1.0,0,0,0,0,0,0,1018,0,1.0,0,0
PF04508,PF12384:PF12596:PF05869,2,9,2,0,7,1009,0.22,0.99,1.0,0.47,1,1,1,0,1016,1.0,1.0,0.5,0.71
PF10405,PF10403:PF10404:PF03835,10,12,10,0,2,1006,0.83,1.0,1.0,0.91,10,10,0,0,1008,1.0,1.0,1.0,1.0
PF16832,PF09108:PF13929:PF15518,0,1,0,0,1,1017,0.0,1.0,0,0,0,0,0,0,1018,0,1.0,0,0
PF07744,PF07533:PF03159:PF02337,15,34,7,8,27,976,0.21,0.97,0.47,0.29,5,3,12,2,1001,0.6,0.99,0.2,0.34
PF01435,PF16491:PF04833:PF08652,24,21,15,9,6,988,0.71,0.99,0.62,0.66,3,3,21,0,994,1.0,0.98,0.12,0.35
PF05388,PF00450:PF04252:PF09478,2,61,2,0,59,957,0.03,0.94,1.0,0.18,5,1,1,4,1012,0.2,1.0,0.5,0.31
PF13193,PF16177:PF13360:PF00668,85,59,42,43,17,916,0.71,0.94,0.49,0.56,13,13,72,0,933,1.0,0.93,0.15,0.38
PF10580,PF06614:PF13178:PF15157,1,7,1,0,6,1011,0.14,0.99,1.0,0.38,1,1,0,0,1017,1.0,1.0,1.0,1.0
PF15706,PF15705:PF16070:PF00963,3,11,3,0,8,1007,0.27,0.99,1.0,0.52,8,2,1,6,1009,0.25,0.99,0.67,0.41
PF11035,PF15302:PF07085:PF10630,2,6,1,1,5,1011,0.17,0.99,0.5,0.29,0,0,2,0,1016,0,1.0,0.0,0
PF04500,PF15423:PF16064:PF10551,23,58,14,9,44,951,0.24,0.95,0.61,0.36,5,5,18,0,995,1.0,0.98,0.22,0.46
PF09289,PF00050:PF10591:PF01469,4,26,4,0,22,992,0.15,0.98,1.0,0.39,5,3,1,2,1012,0.6,1.0,0.75,0.67
PF04241,PF02284:PF08561:PF00321,12,10,2,10,8,998,0.2,0.98,0.17,0.17,1,1,11,0,1006,1.0,0.99,0.08,0.29
PF12949,PF09402:PF16944:PF05640,12,17,11,1,6,1000,0.65,0.99,0.92,0.77,1,1,11,0,1006,1.0,0.99,0.08,0.29
PF16861,PF03090:PF07157:PF11751,3,0,0,3,0,1015,0,1.0,0.0,0,0,0,3,0,1015,0,1.0,0.0,0
PF03798,PF03826:PF02183:PF16878,36,21,8,28,13,969,0.38,0.96,0.22,0.27,4,4,32,0,982,1.0,0.97,0.11,0.33
PF03591,PF14903:PF09690:PF12602,0,0,0,0,0,1018,0,1.0,0,0,0,0,0,0,1018,0,1.0,0,0
PF16978,PF05422:PF16979:PF10348,13,17,10,3,7,998,0.59,0.99,0.77,0.67,4,2,11,2,1003,0.5,0.99,0.15,0.27
PF11785,PF11786:PF11787:PF12498,3,4,3,0,1,1014,0.75,1.0,1.0,0.87,4,3,0,1,1014,0.75,1.0,1.0,0.87
PF02834,PF14573:PF17017:PF06868,0,0,0,0,0,1018,0,1.0,0,0,0,0,0,0,1018,0,1.0,0,0
PF15846,PF07117:PF03548:PF15856,3,4,0,3,4,1011,0.0,0.99,0.0,-0.0,0,0,3,0,1015,0,1.0,0.0,0
PF07846,PF12904:PF15302:PF16829,1,0,0,1,0,1017,0,1.0,0.0,0,0,0,1,0,1017,0,1.0,0.0,0
PF08315,PF01279:PF00159:PF05676,16,9,3,13,6,996,0.33,0.98,0.19,0.24,2,1,15,1,1001,0.5,0.98,0.06,0.17
PF03017,PF03004:PF12180:PF13870,3,24,2,1,22,993,0.08,0.98,0.67,0.23,0,0,3,0,1015,0,1.0,0.0,0
PF15521,PF09011:PF09815:PF00195,0,45,0,0,45,973,0.0,0.96,0,0,11,0,0,11,1007,0.0,0.99,0,0
PF16576,PF02074:PF15834:PF17085,1,1,0,1,1,1016,0.0,1.0,0.0,-0.0,0,0,1,0,1017,0,1.0,0.0,0
PF13094,PF05728:PF15485:PF15478,1,5,0,1,5,1012,0.0,0.99,0.0,-0.0,0,0,1,0,1017,0,1.0,0.0,0
PF01565,PF04030:PF08031:PF09265,105,63,61,44,2,911,0.97,0.95,0.58,0.73,10,10,95,0,913,1.0,0.91,0.1,0.29
PF04865,PF08479:PF07409:PF06890,0,0,0,0,0,1018,0,1.0,0,0,0,0,0,0,1018,0,1.0,0,0
PF08259,PF11751:PF06798:PF01312,0,0,0,0,0,1018,0,1.0,0,0,0,0,0,0,1018,0,1.0,0,0
PF12849,PF13458:PF07701:PF08376,11,23,5,6,18,989,0.22,0.98,0.45,0.3,5,3,8,2,1005,0.6,0.99,0.27,0.4
PF12920,PF09374:PF17013:PF01640,0,1,0,0,1,1017,0.0,1.0,0,0,0,0,0,0,1018,0,1.0,0,0
PF17148,PF15082:PF10933:PF08291,0,3,0,0,3,1015,0.0,1.0,0,0,0,0,0,0,1018,0,1.0,0,0
PF06721,PF13689:PF14600:PF15100,2,0,0,2,0,1016,0,1.0,0.0,0,0,0,2,0,1016,0,1.0,0.0,0
PF15037,PF16556:PF16742:PF08357,1,9,1,0,8,1009,0.11,0.99,1.0,0.33,1,0,1,1,1016,0.0,1.0,0.0,-0.0
PF04961,PF02971:PF07837:PF08527,4,11,4,0,7,1007,0.36,0.99,1.0,0.6,4,4,0,0,1014,1.0,1.0,1.0,1.0
PF08101,PF09441:PF09047:PF15407,1,2,1,0,1,1016,0.5,1.0,1.0,0.71,0,0,1,0,1017,0,1.0,0.0,0
PF00972,PF05857:PF15518:PF05513,6,2,1,5,1,1011,0.5,0.99,0.17,0.29,0,0,6,0,1012,0,0.99,0.0,0
PF07750,PF01927:PF06882:PF08066,2,13,2,0,11,1005,0.15,0.99,1.0,0.39,2,2,0,0,1016,1.0,1.0,1.0,1.0
PF07652,PF10927:PF14229:PF12137,6,5,2,4,3,1009,0.4,0.99,0.33,0.36,1,1,5,0,1012,1.0,1.0,0.17,0.41
PF15094,PF15914:PF15082:PF09322,0,6,0,0,6,1012,0.0,0.99,0,0,0,0,0,0,1018,0,1.0,0,0
PF12356,PF09247:PF09288:PF07202,5,9,1,4,8,1005,0.11,0.99,0.2,0.14,1,1,4,0,1013,1.0,1.0,0.2,0.45
PF07475,PF09432:PF10279:PF03729,4,0,0,4,0,1014,0,1.0,0.0,0,0,0,4,0,1014,0,1.0,0.0,0
PF01902,PF01042:PF01497:PF01593,7,79,6,1,73,938,0.08,0.93,0.86,0.24,15,4,3,11,1000,0.27,0.99,0.57,0.38
PF09528,PF04954:PF11751:PF04917,0,1,0,0,1,1017,0.0,1.0,0,0,0,0,0,0,1018,0,1.0,0,0
PF03808,PF17049:PF04738:PF01514,0,1,0,0,1,1017,0.0,1.0,0,0,0,0,0,0,1018,0,1.0,0,0
PF17110,PF15664:PF08591:PF09428,0,1,0,0,1,1017,0.0,1.0,0,0,0,0,0,0,1018,0,1.0,0,0
PF11700,PF06609:PF00296:PF06884,3,29,0,3,29,986,0.0,0.97,0.0,-0.01,9,0,3,9,1006,0.0,0.99,0.0,-0.01
PF03605,PF06890:PF09829:PF08479,1,0,0,1,0,1017,0,1.0,0.0,0,0,0,1,0,1017,0,1.0,0.0,0
PF12439,PF01660:PF15823:PF04625,0,7,0,0,7,1011,0.0,0.99,0,0,0,0,0,0,1018,0,1.0,0,0
PF02643,PF16903:PF05943:PF06745,0,1,0,0,1,1017,0.0,1.0,0,0,0,0,0,0,1018,0,1.0,0,0
PF09430,PF08315:PF04418:PF10280,7,25,2,5,23,988,0.08,0.97,0.29,0.14,3,1,6,2,1009,0.33,0.99,0.14,0.21
PF08778,PF11413:PF16279:PF08629,3,11,2,1,9,1006,0.18,0.99,0.67,0.34,2,2,1,0,1015,1.0,1.0,0.67,0.82
PF16204,PF08072:PF09382:PF16202,7,17,7,0,10,1001,0.41,0.99,1.0,0.64,7,7,0,0,1011,1.0,1.0,1.0,1.0
PF09234,PF03268:PF16851:PF15556,2,0,0,2,0,1016,0,1.0,0.0,0,0,0,2,0,1016,0,1.0,0.0,0
PF08283,PF00799:PF14232:PF08275,1,6,1,0,5,1012,0.17,1.0,1.0,0.41,0,0,1,0,1017,0,1.0,0.0,0
PF00545,PF09056:PF11029:PF01741,3,7,1,2,6,1009,0.14,0.99,0.33,0.21,1,0,3,1,1014,0.0,1.0,0.0,-0.0
PF00379,PF15323:PF06417:PF04923,32,12,5,27,7,979,0.42,0.97,0.16,0.24,2,2,30,0,986,1.0,0.97,0.06,0.25
PF03490,PF15471:PF05229:PF13929,1,0,0,1,0,1017,0,1.0,0.0,0,0,0,1,0,1017,0,1.0,0.0,0
PF03250,PF10189:PF15996:PF06830,4,15,1,3,14,1000,0.07,0.98,0.25,0.12,1,0,4,1,1013,0.0,1.0,0.0,-0.0
PF02776,PF02775:PF00205:PF16582,27,29,26,1,3,988,0.9,1.0,0.96,0.93,22,22,5,0,991,1.0,1.0,0.81,0.9
PF11998,PF03661:PF16546:PF00515,5,65,3,2,62,951,0.05,0.94,0.6,0.15,12,2,3,10,1003,0.17,0.99,0.4,0.25
PF00388,PF00387:PF09279:PF06631,23,18,17,6,1,994,0.94,0.99,0.74,0.83,9,9,14,0,995,1.0,0.99,0.39,0.62
PF05347,PF04281:PF07491:PF10270,29,17,6,23,11,978,0.35,0.97,0.21,0.25,0,0,29,0,989,0,0.97,0.0,0
PF08264,PF00133:PF06827:PF09334,41,71,37,4,34,943,0.52,0.96,0.9,0.67,19,17,24,2,975,0.89,0.97,0.41,0.6
PF10145,PF15186:PF01303:PF12194,0,2,0,0,2,1016,0.0,1.0,0,0,0,0,0,0,1018,0,1.0,0,0
PF15801,PF05195:PF01321:PF16188,6,29,5,1,24,988,0.17,0.98,0.83,0.37,6,2,4,4,1008,0.33,0.99,0.33,0.33
PF03725,PF01138:PF07541:PF10469,29,67,29,0,38,951,0.43,0.96,1.0,0.65,14,7,22,7,982,0.5,0.97,0.24,0.33
PF05287,PF01500:PF13885:PF04579,0,4,0,0,4,1014,0.0,1.0,0,0,1,0,0,1,1017,0.0,1.0,0,0
PF03521,PF16799:PF11933:PF03520,4,12,1,3,11,1003,0.08,0.99,0.25,0.14,1,1,3,0,1014,1.0,1.0,0.25,0.5
PF17205,PF07965:PF00362:PF08725,5,10,4,1,6,1007,0.4,0.99,0.8,0.56,9,4,1,5,1008,0.44,0.99,0.8,0.59
PF04972,PF13580:PF11739:PF00908,5,8,2,3,6,1007,0.25,0.99,0.4,0.31,1,1,4,0,1013,1.0,1.0,0.2,0.45
PF06853,PF12147:PF08321:PF04152,1,21,1,0,20,997,0.05,0.98,1.0,0.22,4,1,0,3,1014,0.25,1.0,1.0,0.5
PF01111,PF10203:PF10471:PF02044,7,10,3,4,7,1004,0.3,0.99,0.43,0.35,1,1,6,0,1011,1.0,0.99,0.14,0.38
PF14348,PF03135:PF05591:PF13722,1,5,1,0,4,1013,0.2,1.0,1.0,0.45,0,0,1,0,1017,0,1.0,0.0,0
PF15204,PF01668:PF15023:PF05418,0,3,0,0,3,1015,0.0,1.0,0,0,0,0,0,0,1018,0,1.0,0,0
PF12353,PF12220:PF08081:PF12196,18,5,4,14,1,999,0.8,0.99,0.22,0.42,1,1,17,0,1000,1.0,0.98,0.06,0.23
PF01434,PF09336:PF12037:PF14363,38,21,9,29,12,968,0.43,0.96,0.24,0.3,3,3,35,0,980,1.0,0.97,0.08,0.28
PF12188,PF14596:PF12162:PF06286,1,2,1,0,1,1016,0.5,1.0,1.0,0.71,1,1,0,0,1017,1.0,1.0,1.0,1.0
PF06134,PF08117:PF06412:PF07373,2,1,0,2,1,1015,0.0,1.0,0.0,-0.0,0,0,2,0,1016,0,1.0,0.0,0
PF04934,PF03479:PF15991:PF04714,13,8,1,12,7,998,0.12,0.98,0.08,0.09,1,1,12,0,1005,1.0,0.99,0.08,0.28
PF09782,PF15377:PF07464:PF15139,6,2,1,5,1,1011,0.5,0.99,0.17,0.29,0,0,6,0,1012,0,0.99,0.0,0
PF05018,PF02586:PF08232:PF03920,15,17,6,9,11,992,0.35,0.98,0.4,0.37,2,2,13,0,1003,1.0,0.99,0.13,0.36
PF02583,PF02348:PF15928:PF00403,4,33,4,0,29,985,0.12,0.97,1.0,0.34,3,0,4,3,1011,0.0,0.99,0.0,-0.0
PF08881,PF11807:PF03972:PF00797,8,20,1,7,19,991,0.05,0.97,0.12,0.07,8,0,8,8,1002,0.0,0.98,0.0,-0.01
PF00155,PF05175:PF13847:PF09029,102,57,22,80,35,881,0.39,0.89,0.22,0.23,10,8,94,2,914,0.8,0.91,0.08,0.23
PF08163,PF15785:PF11640:PF08064,11,17,3,8,14,993,0.18,0.98,0.27,0.21,4,2,9,2,1005,0.5,0.99,0.18,0.3
PF10259,PF03980:PF09631:PF03657,10,18,5,5,13,995,0.28,0.98,0.5,0.36,3,2,8,1,1007,0.67,0.99,0.2,0.36
PF04209,PF03386:PF06825:PF04006,12,14,6,6,8,998,0.43,0.99,0.5,0.46,0,0,12,0,1006,0,0.99,0.0,0
PF12495,PF04489:PF08336:PF01812,0,22,0,0,22,996,0.0,0.98,0,0,1,0,0,1,1017,0.0,1.0,0,0
PF12678,PF12861:PF17175:PF09745,17,26,5,12,21,980,0.19,0.97,0.29,0.22,4,3,14,1,1000,0.75,0.99,0.18,0.36
PF09765,PF11793:PF00874:PF08564,6,18,6,0,12,1000,0.33,0.99,1.0,0.57,2,1,5,1,1011,0.5,0.99,0.17,0.29
PF02638,PF13406:PF17049:PF15312,4,2,0,4,2,1012,0.0,0.99,0.0,-0.0,0,0,4,0,1014,0,1.0,0.0,0
PF15040,PF11351:PF03886:PF14400,0,1,0,0,1,1017,0.0,1.0,0,0,0,0,0,0,1018,0,1.0,0,0
PF03911,PF01097:PF03657:PF10244,8,17,3,5,14,996,0.18,0.98,0.38,0.25,2,2,6,0,1010,1.0,0.99,0.25,0.5
PF09666,PF08744:PF14251:PF10445,0,3,0,0,3,1015,0.0,1.0,0,0,0,0,0,0,1018,0,1.0,0,0
PF14649,PF04048:PF08638:PF10441,4,23,0,4,23,991,0.0,0.97,0.0,-0.01,2,0,4,2,1012,0.0,0.99,0.0,-0.0
PF04868,PF13247:PF05167:PF17206,2,2,0,2,2,1014,0.0,1.0,0.0,-0.0,0,0,2,0,1016,0,1.0,0.0,0
PF08602,PF17062:PF03275:PF15175,0,1,0,0,1,1017,0.0,1.0,0,0,0,0,0,0,1018,0,1.0,0,0
PF04412,PF01989:PF00680:PF00073,1,13,1,0,12,1005,0.08,0.99,1.0,0.28,12,0,1,12,1005,0.0,0.99,0.0,-0.0
PF08889,PF11862:PF10908:PF13742,0,3,0,0,3,1015,0.0,1.0,0,0,0,0,0,0,1018,0,1.0,0,0
PF00542,PF16320:PF14768:PF17119,10,11,9,1,2,1006,0.82,1.0,0.9,0.86,2,2,8,0,1008,1.0,0.99,0.2,0.45
PF13815,PF07926:PF07989:PF14846,6,21,1,5,20,992,0.05,0.98,0.17,0.08,4,0,6,4,1008,0.0,0.99,0.0,-0.0
PF11718,PF07521:PF13299:PF10484,12,39,11,1,28,978,0.28,0.97,0.92,0.5,9,3,9,6,1000,0.33,0.99,0.25,0.28
PF14806,PF07718:PF09066:PF16381,12,15,8,4,7,999,0.53,0.99,0.67,0.59,5,5,7,0,1006,1.0,0.99,0.42,0.64
PF07396,PF01484:PF03209:PF04784,0,47,0,0,47,971,0.0,0.95,0,0,6,0,0,6,1012,0.0,0.99,0,0
PF11842,PF06962:PF10105:PF11230,2,2,2,0,0,1016,1.0,1.0,1.0,1.0,2,2,0,0,1016,1.0,1.0,1.0,1.0
PF15499,PF15255:PF08630:PF10522,5,8,0,5,8,1005,0.0,0.99,0.0,-0.01,0,0,5,0,1013,0,1.0,0.0,0
PF13879,PF04641:PF08231:PF00160,10,88,7,3,81,927,0.08,0.92,0.7,0.22,8,3,7,5,1003,0.38,0.99,0.3,0.33
PF08681,PF01580:PF08708:PF02413,1,5,0,1,5,1012,0.0,0.99,0.0,-0.0,0,0,1,0,1017,0,1.0,0.0,0
PF03631,PF17206:PF05797:PF08894,0,2,0,0,2,1016,0.0,1.0,0,0,0,0,0,0,1018,0,1.0,0,0
PF16471,PF04388:PF01465:PF10377,2,23,1,1,22,994,0.04,0.98,0.5,0.14,3,1,1,2,1014,0.33,1.0,0.5,0.41
PF10533,PF03106:PF14364:PF08731,3,20,3,0,17,998,0.15,0.98,1.0,0.38,0,0,3,0,1015,0,1.0,0.0,0
PF07632,PF00305:PF01477:PF02010,1,41,0,1,41,976,0.0,0.96,0.0,-0.01,21,0,1,21,996,0.0,0.98,0.0,-0.0
PF06239,PF14784:PF12243:PF10444,4,9,0,4,9,1005,0.0,0.99,0.0,-0.01,0,0,4,0,1014,0,1.0,0.0,0
PF15810,PF14610:PF11282:PF12855,1,7,1,0,6,1011,0.14,0.99,1.0,0.38,0,0,1,0,1017,0,1.0,0.0,0
PF02366,PF16192:PF02815:PF15012,13,26,13,0,13,992,0.5,0.99,1.0,0.7,14,13,0,1,1004,0.93,1.0,1.0,0.96
PF07001,PF15624:PF10482:PF15557,5,5,0,5,5,1008,0.0,0.99,0.0,-0.0,0,0,5,0,1013,0,1.0,0.0,0
PF15219,PF03243:PF01337:PF08193,1,4,0,1,4,1013,0.0,1.0,0.0,-0.0,0,0,1,0,1017,0,1.0,0.0,0
PF07171,PF07364:PF06742:PF03315,3,10,3,0,7,1008,0.3,0.99,1.0,0.55,0,0,3,0,1015,0,1.0,0.0,0
PF06103,PF09986:PF09545:PF16330,0,2,0,0,2,1016,0.0,1.0,0,0,0,0,0,0,1018,0,1.0,0,0
PF12572,PF09350:PF09320:PF05099,11,14,3,8,11,996,0.21,0.98,0.27,0.23,1,0,11,1,1006,0.0,0.99,0.0,-0.0
PF10546,PF00970:PF12030:PF04333,0,39,0,0,39,979,0.0,0.96,0,0,2,0,0,2,1016,0.0,1.0,0,0
PF09855,PF06877:PF05751:PF06115,0,0,0,0,0,1018,0,1.0,0,0,0,0,0,0,1018,0,1.0,0,0
PF09731,PF08704:PF05871:PF10275,10,20,5,5,15,993,0.25,0.98,0.5,0.34,4,1,9,3,1005,0.25,0.99,0.1,0.15
PF15141,PF15212:PF17049:PF15114,0,1,0,0,1,1017,0.0,1.0,0,0,0,0,0,0,1018,0,1.0,0,0
PF12732,PF03865:PF13530:PF05974,0,2,0,0,2,1016,0.0,1.0,0,0,0,0,0,0,1018,0,1.0,0,0
PF03008,PF15471:PF12477:PF05309,1,1,0,1,1,1016,0.0,1.0,0.0,-0.0,0,0,1,0,1017,0,1.0,0.0,0
PF03540,PF12597:PF06500:PF10780,6,11,1,5,10,1002,0.09,0.99,0.17,0.12,0,0,6,0,1012,0,0.99,0.0,0
PF14305,PF11057:PF03548:PF01943,0,3,0,0,3,1015,0.0,1.0,0,0,0,0,0,0,1018,0,1.0,0,0
PF05276,PF09808:PF04139:PF09302,5,16,2,3,14,999,0.12,0.98,0.4,0.22,4,1,4,3,1010,0.25,0.99,0.2,0.22
PF17217,PF09034:PF10461:PF00791,3,15,3,0,12,1003,0.2,0.99,1.0,0.44,1,1,2,0,1015,1.0,1.0,0.33,0.58
PF06764,PF00737:PF15109:PF14986,0,1,0,0,1,1017,0.0,1.0,0,0,0,0,0,0,1018,0,1.0,0,0
PF02159,PF11825:PF12743:PF02155,10,8,6,4,2,1006,0.75,0.99,0.6,0.67,5,5,5,0,1008,1.0,1.0,0.5,0.71
PF14309,PF14383:PF12552:PF04118,10,13,7,3,6,1002,0.54,0.99,0.7,0.61,1,1,9,0,1008,1.0,0.99,0.1,0.31
PF11028,PF15627:PF10395:PF13320,1,3,0,1,3,1014,0.0,1.0,0.0,-0.0,0,0,1,0,1017,0,1.0,0.0,0
PF06530,PF05947:PF06798:PF03888,1,0,0,1,0,1017,0,1.0,0.0,0,0,0,1,0,1017,0,1.0,0.0,0
PF04244,PF14814:PF07494:PF13721,0,4,0,0,4,1014,0.0,1.0,0,0,0,0,0,0,1018,0,1.0,0,0
PF05433,PF08881:PF03883:PF05512,3,11,0,3,11,1004,0.0,0.99,0.0,-0.01,2,0,3,2,1013,0.0,1.0,0.0,-0.0
PF15430,PF02098:PF04176:PF01327,5,19,3,2,16,997,0.16,0.98,0.6,0.3,1,1,4,0,1013,1.0,1.0,0.2,0.45
PF10165,PF05719:PF05742:PF03091,9,19,4,5,15,994,0.21,0.98,0.44,0.3,4,1,8,3,1006,0.25,0.99,0.11,0.16
PF07279,PF15302:PF17085:PF16576,1,1,0,1,1,1016,0.0,1.0,0.0,-0.0,0,0,1,0,1017,0,1.0,0.0,0
PF02318,PF04698:PF16056:PF15625,8,7,4,4,3,1007,0.57,0.99,0.5,0.53,2,1,7,1,1009,0.5,0.99,0.12,0.25
PF08561,PF04716:PF01632:PF03980,5,20,2,3,18,995,0.1,0.98,0.4,0.19,2,1,4,1,1012,0.5,1.0,0.2,0.31
PF14377,PF16727:PF11626:PF13438,7,9,3,4,6,1005,0.33,0.99,0.43,0.37,1,1,6,0,1011,1.0,0.99,0.14,0.38
PF07409,PF07157:PF13722:PF11751,0,0,0,0,0,1018,0,1.0,0,0,0,0,0,0,1018,0,1.0,0,0
PF13867,PF04422:PF16740:PF10581,6,4,1,5,3,1009,0.25,0.99,0.17,0.2,0,0,6,0,1012,0,0.99,0.0,0
PF07807,PF07808:PF05391:PF07504,5,10,5,0,5,1008,0.5,1.0,1.0,0.71,3,1,4,2,1011,0.33,0.99,0.2,0.26
PF07148,PF09996:PF01609:PF06559,0,4,0,0,4,1014,0.0,1.0,0,0,0,0,0,0,1018,0,1.0,0,0
PF10637,PF10369:PF00351:PF01842,7,46,6,1,40,971,0.13,0.96,0.86,0.33,7,2,5,5,1006,0.29,0.99,0.29,0.28
PF15143,PF07805:PF07308:PF12241,0,2,0,0,2,1016,0.0,1.0,0,0,0,0,0,0,1018,0,1.0,0,0
PF07853,PF03922:PF01752:PF17188,0,2,0,0,2,1016,0.0,1.0,0,0,0,0,0,0,1018,0,1.0,0,0
PF12701,PF09532:PF12949:PF04376,15,29,13,2,16,987,0.45,0.98,0.87,0.62,6,2,13,4,999,0.33,0.98,0.13,0.2
PF04674,PF04398:PF04525:PF07712,5,11,1,4,10,1003,0.09,0.99,0.2,0.13,2,1,4,1,1012,0.5,1.0,0.2,0.31
PF02251,PF02252:PF01132:PF13332,6,15,6,0,9,1003,0.4,0.99,1.0,0.63,3,2,4,1,1011,0.67,1.0,0.33,0.47
PF17122,PF12451:PF12816:PF00637,6,31,6,0,25,987,0.19,0.98,1.0,0.43,9,6,0,3,1009,0.67,1.0,1.0,0.82
PF14558,PF11597:PF06011:PF14636,5,12,4,1,8,1005,0.33,0.99,0.8,0.51,4,3,2,1,1012,0.75,1.0,0.6,0.67
PF07866,PF04024:PF12738:PF12207,0,24,0,0,24,994,0.0,0.98,0,0,0,0,0,0,1018,0,1.0,0,0
PF06716,PF14539:PF15340:PF08026,0,2,0,0,2,1016,0.0,1.0,0,0,0,0,0,0,1018,0,1.0,0,0
PF09370,PF02091:PF06792:PF15622,2,8,1,1,7,1009,0.12,0.99,0.5,0.25,0,0,2,0,1016,0,1.0,0.0,0
PF06395,PF15720:PF09128:PF09036,8,12,4,4,8,1002,0.33,0.99,0.5,0.4,2,2,6,0,1010,1.0,0.99,0.25,0.5
PF01556,PF14308:PF09350:PF12572,42,23,12,30,11,965,0.52,0.96,0.29,0.37,2,2,40,0,976,1.0,0.96,0.05,0.21
PF16321,PF02482:PF07014:PF01228,4,4,4,0,0,1014,1.0,1.0,1.0,1.0,0,0,4,0,1014,0,1.0,0.0,0
PF07883,PF05899:PF02502:PF06249,30,11,5,25,6,982,0.45,0.97,0.17,0.26,3,1,29,2,986,0.33,0.97,0.03,0.1
PF13603,PF10458:PF09635:PF06827,13,13,3,10,10,995,0.23,0.98,0.23,0.22,3,3,10,0,1005,1.0,0.99,0.23,0.48
PF13945,PF15624:PF09441:PF07001,1,10,0,1,10,1007,0.0,0.99,0.0,-0.0,0,0,1,0,1017,0,1.0,0.0,0
PF03147,PF02912:PF10354:PF01409,19,31,19,0,12,987,0.61,0.99,1.0,0.78,8,7,12,1,998,0.88,0.99,0.37,0.56
PF14231,PF00345:PF14232:PF09367,0,3,0,0,3,1015,0.0,1.0,0,0,0,0,0,0,1018,0,1.0,0,0
PF06501,PF14685:PF04160:PF10118,1,5,0,1,5,1012,0.0,0.99,0.0,-0.0,0,0,1,0,1017,0,1.0,0.0,0
PF02082,PF12242:PF06780:PF09614,1,2,1,0,1,1016,0.5,1.0,1.0,0.71,0,0,1,0,1017,0,1.0,0.0,0
PF05624,PF14909:PF10198:PF05508,1,8,0,1,8,1009,0.0,0.99,0.0,-0.0,1,0,1,1,1016,0.0,1.0,0.0,-0.0
PF05136,PF01312:PF04355:PF02979,3,3,0,3,3,1012,0.0,0.99,0.0,-0.0,0,0,3,0,1015,0,1.0,0.0,0
PF08523,PF09363:PF03894:PF09364,6,2,0,6,2,1010,0.0,0.99,0.0,-0.0,2,0,6,2,1010,0.0,0.99,0.0,-0.0
PF08207,PF09285:PF01132:PF13241,8,16,6,2,10,1000,0.38,0.99,0.75,0.53,6,6,2,0,1010,1.0,1.0,0.75,0.87
PF03923,PF16210:PF16524:PF16448,2,3,1,1,2,1014,0.33,1.0,0.5,0.41,1,0,2,1,1015,0.0,1.0,0.0,-0.0
PF12311,PF07350:PF04667:PF12296,4,13,1,3,12,1002,0.08,0.99,0.25,0.13,0,0,4,0,1014,0,1.0,0.0,0
PF08400,PF15068:PF13542:PF05591,0,1,0,0,1,1017,0.0,1.0,0,0,0,0,0,0,1018,0,1.0,0,0
PF16684,PF16457:PF01661:PF10923,0,36,0,0,36,982,0.0,0.96,0,0,9,0,0,9,1009,0.0,0.99,0,0
PF08991,PF14777:PF08398:PF15141,5,5,3,2,2,1011,0.6,1.0,0.6,0.6,0,0,5,0,1013,0,1.0,0.0,0
PF07080,PF09056:PF07464:PF09057,3,5,1,2,4,1011,0.2,0.99,0.33,0.26,0,0,3,0,1015,0,1.0,0.0,0
PF10017,PF12867:PF03781:PF03074,8,17,4,4,13,997,0.24,0.98,0.5,0.34,6,3,5,3,1007,0.5,0.99,0.38,0.43
PF13673,PF13508:PF07470:PF00583,23,94,16,7,78,917,0.17,0.92,0.7,0.32,18,9,14,9,986,0.5,0.98,0.39,0.43
PF07002,PF16056:PF08151:PF16165,24,12,4,20,8,986,0.33,0.97,0.17,0.22,4,3,21,1,993,0.75,0.98,0.12,0.3
PF02807,PF00217:PF14868:PF03143,18,37,18,0,19,981,0.49,0.98,1.0,0.69,7,7,11,0,1000,1.0,0.99,0.39,0.62
PF12820,PF01594:PF15627:PF09733,1,11,0,1,11,1006,0.0,0.99,0.0,-0.0,1,0,1,1,1016,0.0,1.0,0.0,-0.0
PF10368,PF14512:PF14251:PF15334,0,2,0,0,2,1016,0.0,1.0,0,0,0,0,0,0,1018,0,1.0,0,0
PF02029,PF15388:PF05693:PF05091,7,25,2,5,23,988,0.08,0.97,0.29,0.14,4,2,5,2,1009,0.5,0.99,0.29,0.37
PF08704,PF05871:PF07798:PF03095,8,24,4,4,20,990,0.17,0.98,0.5,0.28,5,2,6,3,1007,0.4,0.99,0.25,0.31
PF07808,PF07807:PF05391:PF02128,9,8,7,2,1,1008,0.88,1.0,0.78,0.82,1,1,8,0,1009,1.0,0.99,0.11,0.33
PF07964,PF08479:PF15518:PF08411,1,2,0,1,2,1015,0.0,1.0,0.0,-0.0,0,0,1,0,1017,0,1.0,0.0,0
PF11102,PF06105:PF00637:PF00578,0,66,0,0,66,952,0.0,0.94,0,0,16,0,0,16,1002,0.0,0.98,0,0
PF12452,PF05683:PF03385:PF02885,1,13,0,1,13,1004,0.0,0.99,0.0,-0.0,0,0,1,0,1017,0,1.0,0.0,0
PF12166,PF15917:PF16399:PF11935,9,20,6,3,14,995,0.3,0.98,0.67,0.44,3,3,6,0,1009,1.0,0.99,0.33,0.58
PF03703,PF16060:PF02620:PF05991,1,15,1,0,14,1003,0.07,0.99,1.0,0.26,1,0,1,1,1016,0.0,1.0,0.0,-0.0
PF15667,PF03244:PF15340:PF14534,0,2,0,0,2,1016,0.0,1.0,0,0,0,0,0,0,1018,0,1.0,0,0
PF15623,PF06890:PF06798:PF06403,0,1,0,0,1,1017,0.0,1.0,0,0,0,0,0,0,1018,0,1.0,0,0
PF12141,PF09775:PF08600:PF14831,1,7,0,1,7,1010,0.0,0.99,0.0,-0.0,0,0,1,0,1017,0,1.0,0.0,0
PF11437,PF15281:PF10412:PF13390,0,3,0,0,3,1015,0.0,1.0,0,0,0,0,0,0,1018,0,1.0,0,0
PF12295,PF11935:PF12166:PF08101,6,13,6,0,7,1005,0.46,0.99,1.0,0.68,4,4,2,0,1012,1.0,1.0,0.67,0.82
PF15840,PF00025:PF06357:PF05326,1,66,1,0,65,952,0.02,0.94,1.0,0.12,0,0,1,0,1017,0,1.0,0.0,0
PF10434,PF05466:PF06724:PF10906,0,2,0,0,2,1016,0.0,1.0,0,0,0,0,0,0,1018,0,1.0,0,0
PF05132,PF15311:PF11727:PF10332,13,6,4,9,2,1003,0.67,0.99,0.31,0.45,0,0,13,0,1005,0,0.99,0.0,0
PF13934,PF10699:PF10177:PF03615,8,6,2,6,4,1006,0.33,0.99,0.25,0.28,1,1,7,0,1010,1.0,0.99,0.12,0.35
PF16045,PF14775:PF15456:PF06637,7,6,2,5,4,1007,0.33,0.99,0.29,0.3,1,1,6,0,1011,1.0,0.99,0.14,0.38
PF15757,PF15776:PF03553:PF06056,0,4,0,0,4,1014,0.0,1.0,0,0,0,0,0,0,1018,0,1.0,0,0
PF13204,PF12904:PF01114:PF15710,0,1,0,0,1,1017,0.0,1.0,0,0,0,0,0,0,1018,0,1.0,0,0
PF17021,PF10380:PF10368:PF15169,0,1,0,0,1,1017,0.0,1.0,0,0,0,0,0,0,1018,0,1.0,0,0
PF07081,PF03576:PF08738:PF07444,4,0,0,4,0,1014,0,1.0,0.0,0,0,0,4,0,1014,0,1.0,0.0,0
PF01497,PF01902:PF02027:PF01042,10,26,3,7,23,985,0.12,0.97,0.3,0.17,5,1,9,4,1004,0.2,0.99,0.1,0.14
PF08840,PF04775:PF00674:PF12470,4,6,2,2,4,1010,0.33,0.99,0.5,0.41,1,1,3,0,1014,1.0,1.0,0.25,0.5
PF02781,PF00479:PF01182:PF02812,14,33,14,0,19,985,0.42,0.98,1.0,0.65,12,9,5,3,1001,0.75,0.99,0.64,0.69
PF16470,PF01483:PF09286:PF12583,14,31,10,4,21,983,0.32,0.98,0.71,0.47,5,5,9,0,1004,1.0,0.99,0.36,0.59
PF17009,PF11068:PF05130:PF05125,0,1,0,0,1,1017,0.0,1.0,0,0,0,0,0,0,1018,0,1.0,0,0
PF17177,PF16953:PF13812:PF12921,35,65,28,7,37,946,0.43,0.96,0.8,0.57,6,5,30,1,982,0.83,0.97,0.14,0.34
PF11855,PF10467:PF07905:PF09827,2,1,0,2,1,1015,0.0,1.0,0.0,-0.0,0,0,2,0,1016,0,1.0,0.0,0
PF11529,PF17206:PF06651:PF15482,0,1,0,0,1,1017,0.0,1.0,0,0,0,0,0,0,1018,0,1.0,0,0
PF02790,PF06481:PF00116:PF13442,12,17,12,0,5,1001,0.71,1.0,1.0,0.84,8,7,5,1,1005,0.88,0.99,0.58,0.71
PF01659,PF06412:PF10717:PF03531,0,10,0,0,10,1008,0.0,0.99,0,0,0,0,0,0,1018,0,1.0,0,0
PF05694,PF08229:PF06624:PF01022,6,10,1,5,9,1003,0.1,0.99,0.17,0.12,1,1,5,0,1012,1.0,1.0,0.17,0.41
PF07101,PF03917:PF05084:PF03199,0,8,0,0,8,1010,0.0,0.99,0,0,2,0,0,2,1016,0.0,1.0,0,0
PF07286,PF00220:PF04643:PF04644,3,4,0,3,4,1011,0.0,0.99,0.0,-0.0,1,0,3,1,1014,0.0,1.0,0.0,-0.0
PF14255,PF03244:PF17076:PF15281,0,3,0,0,3,1015,0.0,1.0,0,0,0,0,0,0,1018,0,1.0,0,0
PF16026,PF15821:PF09787:PF13166,5,7,1,4,6,1007,0.14,0.99,0.2,0.16,0,0,5,0,1013,0,1.0,0.0,0
PF00277,PF00272:PF06679:PF06373,0,0,0,0,0,1018,0,1.0,0,0,0,0,0,0,1018,0,1.0,0,0
PF17051,PF15046:PF17062:PF03203,0,3,0,0,3,1015,0.0,1.0,0,0,0,0,0,0,1018,0,1.0,0,0
PF08411,PF08461:PF16449:PF15518,1,1,0,1,1,1016,0.0,1.0,0.0,-0.0,0,0,1,0,1017,0,1.0,0.0,0
PF04145,PF12406:PF01299:PF03248,24,24,10,14,14,980,0.42,0.97,0.42,0.4,3,3,21,0,994,1.0,0.98,0.12,0.35
PF09247,PF15557:PF15624:PF07001,2,9,1,1,8,1008,0.11,0.99,0.5,0.23,0,0,2,0,1016,0,1.0,0.0,0
PF12323,PF07282:PF08297:PF02477,1,3,1,0,2,1015,0.33,1.0,1.0,0.58,0,0,1,0,1017,0,1.0,0.0,0
PF04991,PF07782:PF07162:PF07773,9,30,3,6,27,982,0.1,0.97,0.33,0.17,4,1,8,3,1006,0.25,0.99,0.11,0.16
PF04822,PF04423:PF06294:PF07989,1,21,1,0,20,997,0.05,0.98,1.0,0.22,1,0,1,1,1016,0.0,1.0,0.0,-0.0
PF03398,PF14075:PF08313:PF10033,21,16,3,18,13,984,0.19,0.97,0.14,0.15,1,1,20,0,997,1.0,0.98,0.05,0.22
PF12772,PF09067:PF12453:PF16066,1,3,1,0,2,1015,0.33,1.0,1.0,0.58,1,1,0,0,1017,1.0,1.0,1.0,1.0
PF06090,PF05757:PF04690:PF07911,12,6,2,10,4,1002,0.33,0.99,0.17,0.23,0,0,12,0,1006,0,0.99,0.0,0
PF07528,PF16482:PF14622:PF00035,9,60,7,2,53,956,0.12,0.95,0.78,0.29,19,4,5,15,994,0.21,0.98,0.44,0.3
PF08032,PF12105:PF00588:PF17191,4,25,4,0,21,993,0.16,0.98,1.0,0.4,5,2,2,3,1011,0.4,1.0,0.5,0.44
PF13098,PF08497:PF13746:PF16822,5,4,0,5,4,1009,0.0,0.99,0.0,-0.0,0,0,5,0,1013,0,1.0,0.0,0
PF01648,PF01974:PF02778:PF04140,29,30,10,19,20,969,0.33,0.96,0.34,0.32,15,7,22,8,981,0.47,0.97,0.24,0.32
PF16824,PF16822:PF08497:PF09498,0,0,0,0,0,1018,0,1.0,0,0,0,0,0,0,1018,0,1.0,0,0
PF01569,PF04769:PF03556:PF04819,40,18,10,30,8,970,0.56,0.96,0.25,0.36,4,3,37,1,977,0.75,0.96,0.07,0.23
PF09106,PF09107:PF16658:PF09173,3,7,3,0,4,1011,0.43,1.0,1.0,0.65,1,1,2,0,1015,1.0,1.0,0.33,0.58
PF11374,PF08216:PF14649:PF15627,15,11,4,11,7,996,0.36,0.98,0.27,0.3,0,0,15,0,1003,0,0.99,0.0,0
PF01167,PF07734:PF10442:PF08268,12,23,3,9,20,986,0.13,0.97,0.25,0.17,7,3,9,4,1002,0.43,0.99,0.25,0.32
PF01799,PF02738:PF01315:PF03450,21,24,21,0,3,994,0.88,1.0,1.0,0.93,23,21,0,2,995,0.91,1.0,1.0,0.95
PF15101,PF03050:PF10974:PF11638,1,2,0,1,2,1015,0.0,1.0,0.0,-0.0,0,0,1,0,1017,0,1.0,0.0,0
PF00268,PF02284:PF04176:PF01470,15,21,3,12,18,985,0.14,0.97,0.2,0.15,5,3,12,2,1001,0.6,0.99,0.2,0.34
PF15235,PF07891:PF12178:PF01057,1,4,1,0,3,1014,0.25,1.0,1.0,0.5,1,0,1,1,1016,0.0,1.0,0.0,-0.0
PF05526,PF06868:PF15547:PF14573,0,0,0,0,0,1018,0,1.0,0,0,0,0,0,0,1018,0,1.0,0,0
PF08186,PF06070:PF14052:PF10995,1,1,0,1,1,1016,0.0,1.0,0.0,-0.0,0,0,1,0,1017,0,1.0,0.0,0
PF08223,PF08093:PF02425:PF09365,0,3,0,0,3,1015,0.0,1.0,0,0,0,0,0,0,1018,0,1.0,0,0
PF13182,PF15182:PF13753:PF03324,0,0,0,0,0,1018,0,1.0,0,0,0,0,0,0,1018,0,1.0,0,0
PF12877,PF16019:PF07535:PF15275,5,10,1,4,9,1004,0.1,0.99,0.2,0.14,1,1,4,0,1013,1.0,1.0,0.2,0.45
PF10164,PF15071:PF15715:PF10839,2,0,0,2,0,1016,0,1.0,0.0,0,0,0,2,0,1016,0,1.0,0.0,0
PF05239,PF03468:PF15905:PF17045,2,7,0,2,7,1009,0.0,0.99,0.0,-0.0,0,0,2,0,1016,0,1.0,0.0,0
PF04059,PF12196:PF08143:PF08081,6,1,1,5,0,1012,1.0,1.0,0.17,0.41,1,1,5,0,1012,1.0,1.0,0.17,0.41
PF11837,PF08244:PF16352:PF00251,2,16,2,0,14,1002,0.12,0.99,1.0,0.35,13,2,0,11,1005,0.15,0.99,1.0,0.39
PF15827,PF08504:PF13866:PF04432,1,3,1,0,2,1015,0.33,1.0,1.0,0.58,0,0,1,0,1017,0,1.0,0.0,0
PF06290,PF14882:PF06744:PF08708,0,0,0,0,0,1018,0,1.0,0,0,0,0,0,0,1018,0,1.0,0,0
PF03800,PF15066:PF17045:PF11496,3,9,0,3,9,1006,0.0,0.99,0.0,-0.01,0,0,3,0,1015,0,1.0,0.0,0
PF01063,PF12311:PF03358:PF04140,20,31,8,12,23,975,0.26,0.97,0.4,0.3,5,3,17,2,996,0.6,0.98,0.15,0.29
PF17083,PF03038:PF07755:PF01585,0,63,0,0,63,955,0.0,0.94,0,0,0,0,0,0,1018,0,1.0,0,0
PF14233,PF11769:PF06479:PF12605,0,12,0,0,12,1006,0.0,0.99,0,0,2,0,0,2,1016,0.0,1.0,0,0
PF01017,PF02865:PF02864:PF14596,2,5,2,0,3,1013,0.4,1.0,1.0,0.63,3,2,0,1,1015,0.67,1.0,1.0,0.82
PF01617,PF01228:PF02901:PF10105,12,7,2,10,5,1001,0.29,0.99,0.17,0.21,2,2,10,0,1006,1.0,0.99,0.17,0.41
PF16527,PF12729:PF05231:PF08805,2,4,2,0,2,1014,0.5,1.0,1.0,0.71,0,0,2,0,1016,0,1.0,0.0,0
PF16116,PF16173:PF08283:PF14232,0,1,0,0,1,1017,0.0,1.0,0,0,0,0,0,0,1018,0,1.0,0,0
PF11629,PF14593:PF12063:PF12202,4,17,4,0,13,1001,0.24,0.99,1.0,0.48,4,4,0,0,1014,1.0,1.0,1.0,1.0
PF02660,PF12398:PF11465:PF06760,1,7,0,1,7,1010,0.0,0.99,0.0,-0.0,2,0,1,2,1015,0.0,1.0,0.0,-0.0
PF11233,PF15046:PF03319:PF09256,0,3,0,0,3,1015,0.0,1.0,0,0,0,0,0,0,1018,0,1.0,0,0
PF04952,PF01114:PF02057:PF12904,3,2,0,3,2,1013,0.0,1.0,0.0,-0.0,0,0,3,0,1015,0,1.0,0.0,0
PF00006,PF00128:PF04389:PF02874,46,93,42,4,51,921,0.45,0.95,0.91,0.62,24,14,32,10,962,0.58,0.96,0.3,0.4
PF14357,PF03901:PF10996:PF14833,0,66,0,0,66,952,0.0,0.94,0,0,17,0,0,17,1001,0.0,0.98,0,0
PF10312,PF10998:PF05334:PF04000,12,19,4,8,15,991,0.21,0.98,0.33,0.25,1,0,12,1,1005,0.0,0.99,0.0,-0.0
PF10326,PF10319:PF10318:PF10317,20,22,6,14,16,982,0.27,0.97,0.3,0.27,2,0,20,2,996,0.0,0.98,0.0,-0.01
PF13580,PF08345:PF11794:PF14376,2,4,1,1,3,1013,0.25,1.0,0.5,0.35,0,0,2,0,1016,0,1.0,0.0,0
PF01721,PF09095:PF07105:PF08682,0,2,0,0,2,1016,0.0,1.0,0,0,0,0,0,0,1018,0,1.0,0,0
PF05996,PF03652:PF07333:PF14770,3,8,0,3,8,1007,0.0,0.99,0.0,-0.0,1,0,3,1,1014,0.0,1.0,0.0,-0.0
PF01576,PF02736:PF00063:PF12460,21,79,15,6,64,933,0.19,0.93,0.71,0.35,23,11,10,12,985,0.48,0.98,0.52,0.49
PF12360,PF04812:PF03867:PF12045,3,3,1,2,2,1013,0.33,1.0,0.33,0.33,1,1,2,0,1015,1.0,1.0,0.33,0.58
PF04764,PF12241:PF14882:PF15143,0,1,0,0,1,1017,0.0,1.0,0,0,0,0,0,0,1018,0,1.0,0,0
PF02295,PF16797:PF12474:PF08587,11,19,2,9,17,990,0.11,0.97,0.18,0.13,3,2,9,1,1006,0.67,0.99,0.18,0.34
PF15861,PF13643:PF12220:PF11627,3,6,1,2,5,1010,0.17,0.99,0.33,0.23,1,1,2,0,1015,1.0,1.0,0.33,0.58
PF07693,PF00710:PF15898:PF09310,7,18,3,4,15,996,0.17,0.98,0.43,0.26,0,0,7,0,1011,0,0.99,0.0,0
PF15052,PF02425:PF03588:PF15553,3,1,0,3,1,1014,0.0,1.0,0.0,-0.0,0,0,3,0,1015,0,1.0,0.0,0
PF09419,PF07939:PF10018:PF04367,11,17,2,9,15,992,0.12,0.98,0.18,0.13,2,0,11,2,1005,0.0,0.99,0.0,-0.0
PF12074,PF13251:PF12755:PF13001,6,24,4,2,20,992,0.17,0.98,0.67,0.33,4,1,5,3,1009,0.25,0.99,0.17,0.2
PF05494,PF16216:PF02056:PF05662,1,10,0,1,10,1007,0.0,0.99,0.0,-0.0,1,0,1,1,1016,0.0,1.0,0.0,-0.0
PF08511,PF10213:PF12148:PF09280,5,21,3,2,18,995,0.14,0.98,0.6,0.29,2,2,3,0,1013,1.0,1.0,0.4,0.63
PF04593,PF07561:PF15095:PF15752,0,2,0,0,2,1016,0.0,1.0,0,0,0,0,0,0,1018,0,1.0,0,0
PF13366,PF15547:PF17112:PF14539,0,0,0,0,0,1018,0,1.0,0,0,0,0,0,0,1018,0,1.0,0,0
PF03650,PF06093:PF04178:PF05995,15,20,4,11,16,987,0.2,0.97,0.27,0.22,4,2,13,2,1001,0.5,0.99,0.13,0.25
PF04278,PF15311:PF14922:PF11727,5,7,0,5,7,1006,0.0,0.99,0.0,-0.01,3,0,5,3,1010,0.0,0.99,0.0,-0.0
PF01809,PF15550:PF07936:PF11317,0,1,0,0,1,1017,0.0,1.0,0,0,0,0,0,0,1018,0,1.0,0,0
PF15237,PF10217:PF15242:PF09728,2,11,2,0,9,1007,0.18,0.99,1.0,0.42,1,1,1,0,1016,1.0,1.0,0.5,0.71
PF14814,PF06798:PF00381:PF07157,0,0,0,0,0,1018,0,1.0,0,0,0,0,0,0,1018,0,1.0,0,0
PF00108,PF02803:PF02036:PF05768,43,54,38,5,16,959,0.7,0.98,0.88,0.78,9,9,34,0,975,1.0,0.97,0.21,0.45
PF16472,PF00058:PF00057:PF00683,5,80,5,0,75,938,0.06,0.93,1.0,0.24,19,5,0,14,999,0.26,0.99,1.0,0.51
PF05151,PF09252:PF14866:PF15838,0,0,0,0,0,1018,0,1.0,0,0,0,0,0,0,1018,0,1.0,0,0
PF08658,PF13892:PF12054:PF09110,10,26,5,5,21,987,0.19,0.97,0.5,0.3,11,4,6,7,1001,0.36,0.99,0.4,0.37
PF12842,PF16415:PF16417:PF04054,11,15,11,0,4,1003,0.73,1.0,1.0,0.85,11,10,1,1,1006,0.91,1.0,0.91,0.91
PF08639,PF02116:PF10330:PF06485,4,8,2,2,6,1008,0.25,0.99,0.5,0.35,0,0,4,0,1014,0,1.0,0.0,0
PF04296,PF14690:PF13751:PF11245,0,2,0,0,2,1016,0.0,1.0,0,0,0,0,0,0,1018,0,1.0,0,0
PF07298,PF09991:PF14279:PF02620,2,8,0,2,8,1008,0.0,0.99,0.0,-0.0,0,0,2,0,1016,0,1.0,0.0,0
PF03960,PF15114:PF10567:PF05838,1,1,0,1,1,1016,0.0,1.0,0.0,-0.0,0,0,1,0,1017,0,1.0,0.0,0
PF09353,PF06376:PF04520:PF12734,4,4,1,3,3,1011,0.25,0.99,0.25,0.25,0,0,4,0,1014,0,1.0,0.0,0
PF15548,PF04610:PF10618:PF11751,2,3,0,2,3,1013,0.0,1.0,0.0,-0.0,0,0,2,0,1016,0,1.0,0.0,0
PF16411,PF09498:PF13753:PF05167,1,1,0,1,1,1016,0.0,1.0,0.0,-0.0,0,0,1,0,1017,0,1.0,0.0,0
PF12697,PF00561:PF12146:PF13378,65,109,41,24,68,885,0.38,0.91,0.63,0.44,41,29,36,12,941,0.71,0.95,0.45,0.54
PF05605,PF14571:PF01715:PF15451,13,16,6,7,10,995,0.38,0.98,0.46,0.41,2,2,11,0,1005,1.0,0.99,0.15,0.39
PF14791,PF14792:PF10391:PF14716,15,24,14,1,10,993,0.58,0.99,0.93,0.73,18,13,2,5,998,0.72,0.99,0.87,0.79
PF16563,PF13919:PF08313:PF05066,6,21,4,2,17,995,0.19,0.98,0.67,0.35,6,2,4,4,1008,0.33,0.99,0.33,0.33
PF15991,PF06420:PF07052:PF07051,0,14,0,0,14,1004,0.0,0.99,0,0,0,0,0,0,1018,0,1.0,0,0
PF13373,PF10302:PF16843:PF01020,5,15,4,1,11,1002,0.27,0.99,0.8,0.46,2,2,3,0,1013,1.0,1.0,0.4,0.63
PF04095,PF00472:PF03462:PF11635,11,43,3,8,40,967,0.07,0.95,0.27,0.12,21,3,8,18,989,0.14,0.97,0.27,0.19
PF12340,PF12359:PF12449:PF15994,8,12,8,0,4,1006,0.67,1.0,1.0,0.81,0,0,8,0,1010,0,0.99,0.0,0
PF15321,PF06403:PF14690:PF06082,0,1,0,0,1,1017,0.0,1.0,0,0,0,0,0,0,1018,0,1.0,0,0
PF08340,PF04222:PF08345:PF08299,0,2,0,0,2,1016,0.0,1.0,0,0,1,0,0,1,1017,0.0,1.0,0,0
PF05405,PF02284:PF04716:PF15860,8,21,3,5,18,992,0.14,0.98,0.38,0.22,4,1,7,3,1007,0.25,0.99,0.12,0.17
PF04927,PF01132:PF14577:PF09285,2,7,1,1,6,1010,0.14,0.99,0.5,0.26,6,1,1,5,1011,0.17,0.99,0.5,0.29
PF15033,PF10514:PF08026:PF15085,2,2,0,2,2,1014,0.0,1.0,0.0,-0.0,0,0,2,0,1016,0,1.0,0.0,0
PF12474,PF16797:PF13281:PF08587,10,16,5,5,11,997,0.31,0.98,0.5,0.39,3,2,8,1,1007,0.67,0.99,0.2,0.36
PF15559,PF02448:PF15109:PF00714,0,1,0,0,1,1017,0.0,1.0,0,0,0,0,0,0,1018,0,1.0,0,0
PF10293,PF10305:PF10344:PF10359,5,4,4,1,0,1013,1.0,1.0,0.8,0.89,4,4,1,0,1013,1.0,1.0,0.8,0.89
PF13520,PF13906:PF00154:PF07969,74,39,26,48,13,931,0.67,0.94,0.35,0.46,10,10,64,0,944,1.0,0.94,0.14,0.36
PF08414,PF08022:PF01794:PF03807,10,51,9,1,42,966,0.18,0.96,0.9,0.39,39,9,1,30,978,0.23,0.97,0.9,0.45
PF04672,PF09479:PF02495:PF08827,0,1,0,0,1,1017,0.0,1.0,0,0,0,0,0,0,1018,0,1.0,0,0
PF06744,PF01752:PF11863:PF07494,0,3,0,0,3,1015,0.0,1.0,0,0,0,0,0,0,1018,0,1.0,0,0
PF16720,PF03784:PF08027:PF12904,1,1,1,0,0,1017,1.0,1.0,1.0,1.0,0,0,1,0,1017,0,1.0,0.0,0
PF11936,PF16553:PF07684:PF15898,5,9,2,3,7,1006,0.22,0.99,0.4,0.29,1,1,4,0,1013,1.0,1.0,0.2,0.45
PF02541,PF01966:PF06237:PF06880,6,27,5,1,22,990,0.19,0.98,0.83,0.39,3,0,6,3,1009,0.0,0.99,0.0,-0.0
PF05144,PF16888:PF15029:PF17206,0,1,0,0,1,1017,0.0,1.0,0,0,0,0,0,0,1018,0,1.0,0,0
PF15955,PF15868:PF04527:PF11018,1,7,0,1,7,1010,0.0,0.99,0.0,-0.0,0,0,1,0,1017,0,1.0,0.0,0
PF07905,PF11855:PF03426:PF05284,0,2,0,0,2,1016,0.0,1.0,0,0,0,0,0,0,1018,0,1.0,0,0
PF13448,PF05894:PF15082:PF07610,0,4,0,0,4,1014,0.0,1.0,0,0,0,0,0,0,1018,0,1.0,0,0
PF05145,PF04046:PF16837:PF09359,0,23,0,0,23,995,0.0,0.98,0,0,5,0,0,5,1013,0.0,1.0,0,0
PF10306,PF12716:PF06912:PF09056,3,7,1,2,6,1009,0.14,0.99,0.33,0.21,0,0,3,0,1015,0,1.0,0.0,0
PF02022,PF13276:PF00552:PF01141,5,12,5,0,7,1006,0.42,0.99,1.0,0.64,4,4,1,0,1013,1.0,1.0,0.8,0.89
PF10264,PF04182:PF14545:PF13945,6,9,2,4,7,1005,0.22,0.99,0.33,0.27,0,0,6,0,1012,0,0.99,0.0,0
PF10707,PF15727:PF10618:PF15756,0,1,0,0,1,1017,0.0,1.0,0,0,0,0,0,0,1018,0,1.0,0,0
PF06670,PF01254:PF15150:PF04223,0,2,0,0,2,1016,0.0,1.0,0,0,0,0,0,0,1018,0,1.0,0,0
PF09108,PF03090:PF15032:PF02277,0,3,0,0,3,1015,0.0,1.0,0,0,0,0,0,0,1018,0,1.0,0,0
PF09396,PF09272:PF02983:PF15494,2,13,1,1,12,1004,0.08,0.99,0.5,0.19,2,1,1,1,1015,0.5,1.0,0.5,0.5
PF00007,PF00219:PF00093:PF07452,9,25,7,2,18,991,0.28,0.98,0.78,0.46,7,4,5,3,1006,0.57,0.99,0.44,0.5
PF00296,PF06609:PF13577:PF11700,19,18,6,13,12,987,0.33,0.98,0.32,0.31,4,2,17,2,997,0.5,0.98,0.11,0.22
PF02627,PF12311:PF11807:PF07110,17,22,5,12,17,984,0.23,0.97,0.29,0.24,5,1,16,4,997,0.2,0.98,0.06,0.1
PF01541,PF07460:PF07453:PF05192,24,43,16,8,27,967,0.37,0.97,0.67,0.48,8,8,16,0,994,1.0,0.98,0.33,0.57
PF16510,PF12388:PF15207:PF17015,0,1,0,0,1,1017,0.0,1.0,0,0,0,0,0,0,1018,0,1.0,0,0
PF01850,PF12604:PF05474:PF06719,0,2,0,0,2,1016,0.0,1.0,0,0,0,0,0,0,1018,0,1.0,0,0
PF07706,PF09029:PF00392:PF10797,2,20,1,1,19,997,0.05,0.98,0.5,0.15,1,1,1,0,1016,1.0,1.0,0.5,0.71
PF10843,PF13750:PF05294:PF04076,0,0,0,0,0,1018,0,1.0,0,0,0,0,0,0,1018,0,1.0,0,0
PF03382,PF11260:PF11765:PF12499,3,2,0,3,2,1013,0.0,1.0,0.0,-0.0,0,0,3,0,1015,0,1.0,0.0,0
PF09741,PF01513:PF14953:PF10419,6,20,2,4,18,994,0.1,0.98,0.33,0.17,3,0,6,3,1009,0.0,0.99,0.0,-0.0
PF09597,PF08641:PF06108:PF01632,1,15,0,1,15,1002,0.0,0.98,0.0,-0.0,0,0,1,0,1017,0,1.0,0.0,0
PF08231,PF05046:PF15456:PF08507,11,15,0,11,15,992,0.0,0.97,0.0,-0.01,2,0,11,2,1005,0.0,0.99,0.0,-0.0
PF08260,PF12276:PF13796:PF09675,0,0,0,0,0,1018,0,1.0,0,0,0,0,0,0,1018,0,1.0,0,0
PF12004,PF08165:PF00616:PF16056,1,22,1,0,21,996,0.05,0.98,1.0,0.21,2,1,0,1,1016,0.5,1.0,1.0,0.71
PF01498,PF13936:PF02517:PF13813,48,26,12,36,14,956,0.46,0.95,0.25,0.32,6,4,44,2,968,0.67,0.95,0.08,0.23
PF16516,PF04440:PF12180:PF08234,5,3,0,5,3,1010,0.0,0.99,0.0,-0.0,0,0,5,0,1013,0,1.0,0.0,0
PF15909,PF03703:PF15045:PF04359,4,2,0,4,2,1012,0.0,0.99,0.0,-0.0,0,0,4,0,1014,0,1.0,0.0,0
PF12727,PF02522:PF07505:PF03063,0,3,0,0,3,1015,0.0,1.0,0,0,0,0,0,0,1018,0,1.0,0,0
PF00465,PF00171:PF04199:PF07110,24,109,19,5,90,904,0.17,0.91,0.79,0.34,26,14,10,12,982,0.54,0.98,0.58,0.55
PF15305,PF02427:PF06271:PF06581,2,2,0,2,2,1014,0.0,1.0,0.0,-0.0,0,0,2,0,1016,0,1.0,0.0,0
PF00378,PF00725:PF02737:PF16113,62,36,21,41,15,941,0.58,0.94,0.34,0.42,27,19,43,8,948,0.7,0.95,0.31,0.44
PF16508,PF15276:PF13325:PF08605,7,6,2,5,4,1007,0.33,0.99,0.29,0.3,1,1,6,0,1011,1.0,0.99,0.14,0.38
PF12455,PF07989:PF04423:PF16034,7,18,2,5,16,995,0.11,0.98,0.29,0.17,1,1,6,0,1011,1.0,0.99,0.14,0.38
PF00244,PF05091:PF03386:PF05129,24,27,9,15,18,976,0.33,0.97,0.38,0.34,2,2,22,0,994,1.0,0.98,0.08,0.29
PF13801,PF11316:PF15856:PF15199,0,1,0,0,1,1017,0.0,1.0,0,0,0,0,0,0,1018,0,1.0,0,0
PF14700,PF00940:PF01858:PF11934,10,12,8,2,4,1004,0.67,0.99,0.8,0.73,1,0,10,1,1007,0.0,0.99,0.0,-0.0
PF01000,PF03118:PF13656:PF00411,7,32,6,1,26,985,0.19,0.97,0.86,0.39,9,4,3,5,1006,0.44,0.99,0.57,0.5
PF07946,PF02186:PF04939:PF04934,9,32,6,3,26,983,0.19,0.97,0.67,0.34,3,2,7,1,1008,0.67,0.99,0.22,0.38
PF12243,PF12350:PF05390:PF07950,2,8,2,0,6,1010,0.25,0.99,1.0,0.5,1,0,2,1,1015,0.0,1.0,0.0,-0.0
PF08546,PF02558:PF02492:PF03439,20,51,20,0,31,967,0.39,0.97,1.0,0.62,8,6,14,2,996,0.75,0.98,0.3,0.47
PF15152,PF15107:PF15173:PF17124,1,0,0,1,0,1017,0,1.0,0.0,0,0,0,1,0,1017,0,1.0,0.0,0
PF02844,PF02843:PF01071:PF00586,13,21,13,0,8,997,0.62,0.99,1.0,0.78,13,13,0,0,1005,1.0,1.0,1.0,1.0
PF14864,PF14863:PF16123:PF00874,4,18,4,0,14,1000,0.22,0.99,1.0,0.47,3,2,2,1,1013,0.67,1.0,0.5,0.58
PF15976,PF07434:PF16967:PF06798,0,0,0,0,0,1018,0,1.0,0,0,0,0,0,0,1018,0,1.0,0,0
PF14945,PF00770:PF15041:PF15809,1,2,0,1,2,1015,0.0,1.0,0.0,-0.0,0,0,1,0,1017,0,1.0,0.0,0
PF02785,PF00289:PF08326:PF02436,33,34,33,0,1,984,0.97,1.0,1.0,0.98,14,14,19,0,985,1.0,0.98,0.42,0.65
PF00365,PF12036:PF00854:PF12460,16,37,6,10,31,971,0.16,0.96,0.38,0.23,1,1,15,0,1002,1.0,0.99,0.06,0.25
PF15021,PF15518:PF04196:PF08411,0,2,0,0,2,1016,0.0,1.0,0,0,1,0,0,1,1017,0.0,1.0,0,0
PF14989,PF10195:PF15011:PF14832,2,9,0,2,9,1007,0.0,0.99,0.0,-0.0,1,0,2,1,1015,0.0,1.0,0.0,-0.0
PF11956,PF03520:PF03521:PF11404,3,11,3,0,8,1007,0.27,0.99,1.0,0.52,1,1,2,0,1015,1.0,1.0,0.33,0.58
PF01673,PF04355:PF10109:PF10566,0,0,0,0,0,1018,0,1.0,0,0,0,0,0,0,1018,0,1.0,0,0
PF11408,PF09382:PF14493:PF16202,3,18,3,0,15,1000,0.17,0.99,1.0,0.41,7,3,0,4,1011,0.43,1.0,1.0,0.65
PF14610,PF11282:PF02325:PF15810,3,4,1,2,3,1012,0.25,1.0,0.33,0.29,0,0,3,0,1015,0,1.0,0.0,0
PF02161,PF12577:PF02155:PF12743,6,7,5,1,2,1010,0.71,1.0,0.83,0.77,5,5,1,0,1012,1.0,1.0,0.83,0.91
PF14807,PF06375:PF14796:PF14797,0,7,0,0,7,1011,0.0,0.99,0,0,3,0,0,3,1015,0.0,1.0,0,0
PF03345,PF04756:PF04527:PF02284,13,15,6,7,9,996,0.4,0.98,0.46,0.42,2,2,11,0,1005,1.0,0.99,0.15,0.39
PF01801,PF12246:PF05145:PF12247,0,2,0,0,2,1016,0.0,1.0,0,0,2,0,0,2,1016,0.0,1.0,0,0
PF12627,PF10521:PF13735:PF06414,9,20,4,5,16,993,0.2,0.98,0.44,0.29,3,2,7,1,1008,0.67,0.99,0.22,0.38
PF03939,PF00525:PF08674:PF02751,15,16,4,11,12,991,0.25,0.98,0.27,0.25,1,1,14,0,1003,1.0,0.99,0.07,0.26
PF04941,PF12477:PF09611:PF07610,2,1,0,2,1,1015,0.0,1.0,0.0,-0.0,0,0,2,0,1016,0,1.0,0.0,0
PF08305,PF16403:PF03815:PF08709,4,26,2,2,24,990,0.08,0.97,0.5,0.19,4,1,3,3,1011,0.25,0.99,0.25,0.25
PF10118,PF04225:PF08437:PF14685,4,9,0,4,9,1005,0.0,0.99,0.0,-0.01,0,0,4,0,1014,0,1.0,0.0,0
PF07683,PF02492:PF02317:PF03454,12,37,11,1,26,980,0.3,0.97,0.92,0.51,4,3,9,1,1005,0.75,0.99,0.25,0.43
PF06994,PF10583:PF00865:PF03458,0,1,0,0,1,1017,0.0,1.0,0,0,0,0,0,0,1018,0,1.0,0,0
PF10442,PF12014:PF04300:PF08495,3,11,3,0,8,1007,0.27,0.99,1.0,0.52,2,1,2,1,1014,0.5,1.0,0.33,0.41
PF07987,PF09278:PF01455:PF00376,2,2,1,1,1,1015,0.5,1.0,0.5,0.5,2,1,1,1,1015,0.5,1.0,0.5,0.5
PF10170,PF08669:PF01571:PF16350,2,29,1,1,28,988,0.03,0.97,0.5,0.13,24,1,1,23,993,0.04,0.98,0.5,0.14
PF10649,PF11418:PF00233:PF08446,0,32,0,0,32,986,0.0,0.97,0,0,2,0,0,2,1016,0.0,1.0,0,0
PF00337,PF13334:PF01762:PF12326,26,41,17,9,24,968,0.41,0.97,0.65,0.51,5,4,22,1,991,0.8,0.98,0.15,0.34
PF05711,PF08848:PF06681:PF09818,0,1,0,0,1,1017,0.0,1.0,0,0,0,0,0,0,1018,0,1.0,0,0
PF13186,PF13597:PF12345:PF06969,13,4,2,11,2,1003,0.5,0.99,0.15,0.27,2,2,11,0,1005,1.0,0.99,0.15,0.39
PF11587,PF11466:PF01620:PF15973,0,0,0,0,0,1018,0,1.0,0,0,0,0,0,0,1018,0,1.0,0,0
PF10020,PF09365:PF02217:PF10567,0,6,0,0,6,1012,0.0,0.99,0,0,0,0,0,0,1018,0,1.0,0,0
PF04821,PF09743:PF15917:PF06972,5,8,0,5,8,1005,0.0,0.99,0.0,-0.01,0,0,5,0,1013,0,1.0,0.0,0
PF10563,PF03203:PF11371:PF15754,1,0,0,1,0,1017,0,1.0,0.0,0,0,0,1,0,1017,0,1.0,0.0,0
PF04122,PF08310:PF10139:PF07520,0,1,0,0,1,1017,0.0,1.0,0,0,0,0,0,0,1018,0,1.0,0,0
PF02436,PF08502:PF00682:PF02785,3,48,3,0,45,970,0.06,0.96,1.0,0.24,13,3,0,10,1005,0.23,0.99,1.0,0.48
PF00397,PF09445:PF16562:PF12237,83,15,11,72,4,931,0.73,0.93,0.13,0.29,3,3,80,0,935,1.0,0.92,0.04,0.18
PF04693,PF14862:PF15224:PF05448,0,2,0,0,2,1016,0.0,1.0,0,0,0,0,0,0,1018,0,1.0,0,0
PF08156,PF09785:PF07001:PF06972,25,11,2,23,9,984,0.18,0.97,0.08,0.11,1,0,25,1,992,0.0,0.97,0.0,-0.0
PF12044,PF01419:PF03945:PF03018,4,25,0,4,25,989,0.0,0.97,0.0,-0.01,5,0,4,5,1009,0.0,0.99,0.0,-0.0
PF06971,PF00549:PF05353:PF08714,1,33,1,0,32,985,0.03,0.97,1.0,0.17,0,0,1,0,1017,0,1.0,0.0,0
PF04510,PF08124:PF07171:PF02092,1,14,1,0,13,1004,0.07,0.99,1.0,0.27,2,1,0,1,1016,0.5,1.0,1.0,0.71
PF02740,PF01114:PF00323:PF15722,1,1,1,0,0,1017,1.0,1.0,1.0,1.0,0,0,1,0,1017,0,1.0,0.0,0
PF05746,PF03485:PF00750:PF13243,30,41,27,3,14,974,0.66,0.98,0.9,0.76,17,17,13,0,988,1.0,0.99,0.57,0.75
PF15140,PF07248:PF08524:PF14991,6,6,1,5,5,1007,0.17,0.99,0.17,0.16,0,0,6,0,1012,0,0.99,0.0,0
PF02813,PF14216:PF12898:PF04988,3,6,1,2,5,1010,0.17,0.99,0.33,0.23,0,0,3,0,1015,0,1.0,0.0,0
PF08797,PF12054:PF13892:PF15790,20,23,9,11,14,984,0.39,0.98,0.45,0.41,3,3,17,0,998,1.0,0.98,0.15,0.38
PF05192,PF05190:PF00488:PF05188,38,46,38,0,8,972,0.83,0.99,1.0,0.91,26,25,13,1,979,0.96,0.99,0.66,0.79
PF00568,PF14957:PF08776:PF05210,22,15,12,10,3,993,0.8,0.99,0.55,0.65,2,2,20,0,996,1.0,0.98,0.09,0.3
PF05264,PF11529:PF08223:PF06224,0,0,0,0,0,1018,0,1.0,0,0,0,0,0,0,1018,0,1.0,0,0
PF04978,PF02873:PF02913:PF04275,7,35,5,2,30,981,0.14,0.97,0.71,0.31,6,3,4,3,1008,0.5,0.99,0.43,0.46
PF09452,PF04370:PF01303:PF15754,1,0,0,1,0,1017,0,1.0,0.0,0,0,0,1,0,1017,0,1.0,0.0,0
PF06565,PF00334:PF16901:PF13833,6,70,5,1,65,947,0.07,0.94,0.83,0.23,15,3,3,12,1000,0.2,0.99,0.5,0.31
PF01490,PF00657:PF03659:PF08216,61,52,27,34,25,932,0.52,0.94,0.44,0.45,10,8,53,2,955,0.8,0.95,0.13,0.31
PF10834,PF13844:PF14821:PF01566,0,37,0,0,37,981,0.0,0.96,0,0,3,0,0,3,1015,0.0,1.0,0,0
PF15919,PF00351:PF03417:PF03022,0,31,0,0,31,987,0.0,0.97,0,0,3,0,0,3,1015,0.0,1.0,0,0
PF11979,PF11409:PF16696:PF11464,5,12,2,3,10,1003,0.17,0.99,0.4,0.25,1,1,4,0,1013,1.0,1.0,0.2,0.45
PF05390,PF12243:PF14232:PF07950,2,6,0,2,6,1010,0.0,0.99,0.0,-0.0,0,0,2,0,1016,0,1.0,0.0,0
PF09689,PF03979:PF04546:PF13332,0,6,0,0,6,1012,0.0,0.99,0,0,4,0,0,4,1014,0.0,1.0,0,0
PF15104,PF07327:PF03379:PF11493,0,2,0,0,2,1016,0.0,1.0,0,0,0,0,0,0,1018,0,1.0,0,0
PF00838,PF04628:PF12680:PF14388,14,27,6,8,21,983,0.22,0.97,0.43,0.3,3,2,12,1,1003,0.67,0.99,0.14,0.3
PF00316,PF04666:PF07542:PF01731,27,25,7,20,18,973,0.28,0.96,0.26,0.25,1,0,27,1,990,0.0,0.97,0.0,-0.01
PF12704,PF08352:PF08402:PF12399,6,13,3,3,10,1002,0.23,0.99,0.5,0.33,5,3,3,2,1010,0.6,1.0,0.5,0.55
PF13188,PF08448:PF00990:PF00672,5,27,5,0,22,991,0.19,0.98,1.0,0.43,12,5,0,7,1006,0.42,0.99,1.0,0.64
PF06232,PF07333:PF00321:PF01716,4,2,0,4,2,1012,0.0,0.99,0.0,-0.0,0,0,4,0,1014,0,1.0,0.0,0
PF12413,PF10525:PF04617:PF13293,1,4,1,0,3,1014,0.25,1.0,1.0,0.5,1,1,0,0,1017,1.0,1.0,1.0,1.0
PF06543,PF00062:PF07093:PF12675,0,11,0,0,11,1007,0.0,0.99,0,0,1,0,0,1,1017,0.0,1.0,0,0
PF14727,PF14728:PF06382:PF14674,7,5,5,2,0,1011,1.0,1.0,0.71,0.84,1,1,6,0,1011,1.0,0.99,0.14,0.38
PF00516,PF08497:PF06834:PF05939,0,0,0,0,0,1018,0,1.0,0,0,0,0,0,0,1018,0,1.0,0,0
PF06448,PF09172:PF01347:PF09175,4,19,4,0,15,999,0.21,0.99,1.0,0.46,11,4,0,7,1007,0.36,0.99,1.0,0.6
PF01992,PF08061:PF02559:PF03880,10,6,2,8,4,1004,0.33,0.99,0.2,0.25,2,2,8,0,1008,1.0,0.99,0.2,0.45
PF01336,PF00152:PF16900:PF10451,50,78,43,7,35,933,0.55,0.96,0.86,0.67,8,8,42,0,968,1.0,0.96,0.16,0.39
PF09994,PF01018:PF08701:PF08153,17,15,6,11,9,992,0.4,0.98,0.35,0.37,3,3,14,0,1001,1.0,0.99,0.18,0.42
PF15708,PF06890:PF07499:PF11019,0,2,0,0,2,1016,0.0,1.0,0,0,0,0,0,0,1018,0,1.0,0,0
PF16727,PF11626:PF08914:PF14377,2,20,2,0,18,998,0.1,0.98,1.0,0.31,7,0,2,7,1009,0.0,0.99,0.0,-0.0
PF08595,PF15400:PF06210:PF12628,7,0,0,7,0,1011,0,0.99,0.0,0,0,0,7,0,1011,0,0.99,0.0,0
PF03336,PF04014:PF15703:PF15672,0,1,0,0,1,1017,0.0,1.0,0,0,0,0,0,0,1018,0,1.0,0,0
PF03040,PF02392:PF08840:PF05023,6,19,6,0,13,999,0.32,0.99,1.0,0.56,2,2,4,0,1012,1.0,1.0,0.33,0.58
PF00866,PF06995:PF06445:PF09677,7,5,1,6,4,1007,0.2,0.99,0.14,0.16,0,0,7,0,1011,0,0.99,0.0,0
PF03288,PF03745:PF11581:PF15312,0,0,0,0,0,1018,0,1.0,0,0,0,0,0,0,1018,0,1.0,0,0
PF13198,PF01283:PF07046:PF01491,0,21,0,0,21,997,0.0,0.98,0,0,2,0,0,2,1016,0.0,1.0,0,0
PF13426,PF08447:PF00027:PF13188,33,92,23,10,69,916,0.25,0.92,0.7,0.39,18,12,21,6,979,0.67,0.97,0.36,0.48
PF00745,PF05201:PF01488:PF08501,9,24,8,1,16,993,0.33,0.98,0.89,0.54,17,8,1,9,1000,0.47,0.99,0.89,0.64
PF04625,PF06890:PF02277:PF03963,1,4,0,1,4,1013,0.0,1.0,0.0,-0.0,0,0,1,0,1017,0,1.0,0.0,0
PF16910,PF12624:PF06650:PF09333,14,38,14,0,24,980,0.37,0.98,1.0,0.6,22,9,5,13,991,0.41,0.98,0.64,0.5
PF11561,PF15727:PF15482:PF13767,1,0,0,1,0,1017,0,1.0,0.0,0,0,0,1,0,1017,0,1.0,0.0,0
PF03483,PF03484:PF01409:PF00984,18,30,15,3,15,985,0.5,0.98,0.83,0.64,11,11,7,0,1000,1.0,0.99,0.61,0.78
PF10661,PF01696:PF15821:PF15453,0,0,0,0,0,1018,0,1.0,0,0,0,0,0,0,1018,0,1.0,0,0
PF00364,PF00289:PF00198:PF01039,44,60,39,5,21,953,0.65,0.97,0.89,0.75,21,21,23,0,974,1.0,0.98,0.48,0.68
PF16866,PF02008:PF12269:PF16987,7,27,6,1,21,990,0.22,0.98,0.86,0.43,7,4,3,3,1008,0.57,0.99,0.57,0.57
PF00478,PF04739:PF00571:PF03471,20,60,11,9,49,949,0.18,0.94,0.55,0.3,10,5,15,5,993,0.5,0.98,0.25,0.34
PF02225,PF04258:PF01532:PF04389,47,79,36,11,43,928,0.46,0.95,0.77,0.57,23,17,30,6,965,0.74,0.96,0.36,0.5
PF03875,PF06042:PF15555:PF15681,1,5,0,1,5,1012,0.0,0.99,0.0,-0.0,0,0,1,0,1017,0,1.0,0.0,0
PF01872,PF08211:PF08719:PF00383,15,58,10,5,48,955,0.17,0.95,0.67,0.32,14,5,10,9,994,0.36,0.98,0.33,0.34
PF14816,PF05604:PF04988:PF05841,6,5,1,5,4,1008,0.2,0.99,0.17,0.18,1,1,5,0,1012,1.0,1.0,0.17,0.41
PF09310,PF15898:PF09372:PF15487,0,5,0,0,5,1013,0.0,1.0,0,0,1,0,0,1,1017,0.0,1.0,0,0
PF01409,PF03147:PF10354:PF03484,21,31,19,2,12,985,0.61,0.99,0.9,0.74,14,10,11,4,993,0.71,0.99,0.48,0.58
PF10487,PF12530:PF11229:PF08427,7,12,1,6,11,1000,0.08,0.98,0.14,0.1,1,0,7,1,1010,0.0,0.99,0.0,-0.0
PF00486,PF00196:PF04397:PF06580,10,16,8,2,8,1000,0.5,0.99,0.8,0.63,2,2,8,0,1008,1.0,0.99,0.2,0.45
PF03941,PF13836:PF14661:PF06972,11,3,0,11,3,1004,0.0,0.99,0.0,-0.01,0,0,11,0,1007,0,0.99,0.0,0
PF15297,PF15893:PF15064:PF16829,4,2,0,4,2,1012,0.0,0.99,0.0,-0.0,0,0,4,0,1014,0,1.0,0.0,0
PF12932,PF12931:PF11549:PF12935,11,12,10,1,2,1005,0.83,1.0,0.91,0.87,1,1,10,0,1007,1.0,0.99,0.09,0.3
PF03671,PF14825:PF04691:PF13326,8,10,2,6,8,1002,0.2,0.99,0.25,0.22,0,0,8,0,1010,0,0.99,0.0,0
PF14828,PF14799:PF14473:PF06446,4,6,1,3,5,1009,0.17,0.99,0.25,0.2,0,0,4,0,1014,0,1.0,0.0,0
PF14457,PF01323:PF03860:PF14634,0,32,0,0,32,986,0.0,0.97,0,0,6,0,0,6,1012,0.0,0.99,0,0
PF10468,PF10079:PF15117:PF14489,1,1,0,1,1,1016,0.0,1.0,0.0,-0.0,0,0,1,0,1017,0,1.0,0.0,0
PF08014,PF05841:PF15696:PF15257,1,2,1,0,1,1016,0.5,1.0,1.0,0.71,0,0,1,0,1017,0,1.0,0.0,0
PF14085,PF16953:PF02297:PF12832,0,34,0,0,34,984,0.0,0.97,0,0,8,0,0,8,1010,0.0,0.99,0,0
PF03950,PF04558:PF00749:PF04557,23,35,23,0,12,983,0.66,0.99,1.0,0.81,12,12,11,0,995,1.0,0.99,0.52,0.72
PF00816,PF07476:PF07149:PF08310,1,1,0,1,1,1016,0.0,1.0,0.0,-0.0,0,0,1,0,1017,0,1.0,0.0,0
PF15168,PF05947:PF10279:PF03729,3,0,0,3,0,1015,0,1.0,0.0,0,0,0,3,0,1015,0,1.0,0.0,0
PF05553,PF02701:PF10188:PF06886,7,13,3,4,10,1001,0.23,0.99,0.43,0.31,2,0,7,2,1009,0.0,0.99,0.0,-0.0
PF14526,PF00183:PF13493:PF06957,4,40,1,3,39,975,0.03,0.96,0.25,0.07,4,0,4,4,1010,0.0,0.99,0.0,-0.0
PF04676,PF04677:PF10443:PF02607,23,29,23,0,6,989,0.79,0.99,1.0,0.89,4,4,19,0,995,1.0,0.98,0.17,0.41
PF07557,PF06637:PF10506:PF12606,8,6,0,8,6,1004,0.0,0.99,0.0,-0.01,0,0,8,0,1010,0,0.99,0.0,0
PF01238,PF01775:PF06172:PF00810,19,18,9,10,9,990,0.5,0.98,0.47,0.48,4,3,16,1,998,0.75,0.98,0.16,0.34
PF10718,PF01303:PF06725:PF09187,0,1,0,0,1,1017,0.0,1.0,0,0,0,0,0,0,1018,0,1.0,0,0
PF15442,PF08014:PF15670:PF15275,2,6,1,1,5,1011,0.17,0.99,0.5,0.29,1,1,1,0,1016,1.0,1.0,0.5,0.71
PF12273,PF06912:PF12716:PF10224,10,7,1,9,6,1002,0.14,0.99,0.1,0.11,0,0,10,0,1008,0,0.99,0.0,0
PF11774,PF10991:PF15243:PF08122,0,4,0,0,4,1014,0.0,1.0,0,0,0,0,0,0,1018,0,1.0,0,0
PF03454,PF03453:PF06844:PF00994,16,39,15,1,24,978,0.38,0.98,0.94,0.59,20,13,3,7,995,0.65,0.99,0.81,0.72
PF02666,PF12588:PF00648:PF01067,17,52,10,7,42,959,0.19,0.95,0.59,0.32,32,8,9,24,977,0.25,0.97,0.47,0.33
PF06762,PF16027:PF07298:PF05859,3,5,0,3,5,1010,0.0,0.99,0.0,-0.0,0,0,3,0,1015,0,1.0,0.0,0
PF12931,PF12932:PF09453:PF03920,12,19,11,1,8,998,0.58,0.99,0.92,0.72,5,5,7,0,1006,1.0,0.99,0.42,0.64
PF08184,PF10692:PF09922:PF06936,1,5,0,1,5,1012,0.0,0.99,0.0,-0.0,0,0,1,0,1017,0,1.0,0.0,0
PF04523,PF06450:PF04352:PF00114,0,1,0,0,1,1017,0.0,1.0,0,0,0,0,0,0,1018,0,1.0,0,0
PF00832,PF06388:PF08883:PF14087,11,15,7,4,8,999,0.47,0.99,0.64,0.54,6,5,6,1,1006,0.83,0.99,0.45,0.61
PF00988,PF00185:PF02729:PF01808,18,32,13,5,19,981,0.41,0.98,0.72,0.53,20,13,5,7,993,0.65,0.99,0.72,0.68
PF07525,PF00710:PF07693:PF12610,30,20,8,22,12,976,0.4,0.97,0.27,0.31,3,3,27,0,988,1.0,0.97,0.1,0.31
PF09791,PF01613:PF02898:PF00175,7,69,4,3,65,946,0.06,0.93,0.57,0.17,15,1,6,14,997,0.07,0.98,0.14,0.09
PF03562,PF08479:PF11304:PF05857,1,0,0,1,0,1017,0,1.0,0.0,0,0,0,1,0,1017,0,1.0,0.0,0
PF13451,PF07195:PF10951:PF13753,2,0,0,2,0,1016,0,1.0,0.0,0,0,0,2,0,1016,0,1.0,0.0,0
PF13291,PF06780:PF10662:PF15086,2,4,0,2,4,1012,0.0,0.99,0.0,-0.0,1,0,2,1,1015,0.0,1.0,0.0,-0.0
PF15192,PF15680:PF15119:PF07327,0,2,0,0,2,1016,0.0,1.0,0,0,0,0,0,0,1018,0,1.0,0,0
