ID,Closest,No. True,No. Prediction,TP,FN,FP,TN,Precision,Accuracy,Hit Rate,MCC,No. Consensus Prediction,Consensus TP,Consensus FN,Consensus FP,Consensus TN,Consensus Precision,Consensus Accuracy,Consensus Hit Rate,Consensus MCC
PF06110,PF03079:PF04377:PF06212:PF04376:PF05219,10,28,6,4,22,986,0.21,0.97,0.6,0.35,0,0,10,0,1008,0,0.99,0.0,0
PF07610,PF15082:PF04632:PF04001:PF15392:PF08183,1,3,0,1,3,1014,0.0,1.0,0.0,-0.0,0,0,1,0,1017,0,1.0,0.0,0
PF08856,PF10951:PF06934:PF15355:PF01913:PF07505,0,1,0,0,1,1017,0.0,1.0,0,0,0,0,0,0,1018,0,1.0,0,0
PF09183,PF11720:PF09648:PF04466:PF12571:PF06356,1,1,1,0,0,1017,1.0,1.0,1.0,1.0,0,0,1,0,1017,0,1.0,0.0,0
PF08696,PF08427:PF10350:PF07539:PF17034:PF07035,9,34,4,5,30,979,0.12,0.97,0.44,0.22,3,2,7,1,1008,0.67,0.99,0.22,0.38
PF01185,PF06127:PF11779:PF08561:PF09631:PF10780,4,21,2,2,19,995,0.1,0.98,0.5,0.21,1,1,3,0,1014,1.0,1.0,0.25,0.5
PF03488,PF10705:PF14972:PF00727:PF00714:PF15715,1,7,0,1,7,1010,0.0,0.99,0.0,-0.0,0,0,1,0,1017,0,1.0,0.0,0
PF11403,PF08546:PF01996:PF10409:PF01331:PF01852,2,66,1,1,65,951,0.02,0.94,0.5,0.08,6,0,2,6,1010,0.0,0.99,0.0,-0.0
PF01087,PF02744:PF12243:PF01729:PF14768:PF02749,8,20,8,0,12,998,0.4,0.99,1.0,0.63,1,0,8,1,1009,0.0,0.99,0.0,-0.0
PF06621,PF12114:PF09427:PF11413:PF08778:PF11851,4,12,3,1,9,1005,0.25,0.99,0.75,0.43,2,2,2,0,1014,1.0,1.0,0.5,0.71
PF16001,PF08730:PF17061:PF02951:PF08002:PF07359,1,4,0,1,4,1013,0.0,1.0,0.0,-0.0,0,0,1,0,1017,0,1.0,0.0,0
PF13538,PF02689:PF12014:PF05970:PF14214:PF10442,5,49,5,0,44,969,0.1,0.96,1.0,0.31,7,3,2,4,1009,0.43,0.99,0.6,0.5
PF02608,PF01547:PF07562:PF03247:PF01094:PF10565,4,80,3,1,77,937,0.04,0.92,0.75,0.16,6,2,2,4,1010,0.33,0.99,0.5,0.41
PF08987,PF15775:PF03845:PF15340:PF13390:PF17015,0,10,0,0,10,1008,0.0,0.99,0,0,0,0,0,0,1018,0,1.0,0,0
PF11976,PF01150:PF06179:PF08511:PF04574:PF09280,23,37,8,15,29,966,0.22,0.96,0.35,0.25,4,2,21,2,993,0.5,0.98,0.09,0.2
PF03949,PF00390:PF04515:PF00456:PF02780:PF10022,16,54,15,1,39,963,0.28,0.96,0.94,0.5,7,4,12,3,999,0.57,0.99,0.25,0.37
PF08505,PF10490:PF10375:PF05164:PF02108:PF08647,1,14,0,1,14,1003,0.0,0.99,0.0,-0.0,0,0,1,0,1017,0,1.0,0.0,0
PF02354,PF02191:PF02140:PF12308:PF01825:PF12129,2,59,2,0,57,959,0.03,0.94,1.0,0.18,6,2,0,4,1012,0.33,1.0,1.0,0.58
PF05564,PF11317:PF15550:PF02427:PF08576:PF15559,1,3,0,1,3,1014,0.0,1.0,0.0,-0.0,0,0,1,0,1017,0,1.0,0.0,0
PF01930,PF11229:PF08696:PF00680:PF17167:PF15149,1,23,1,0,22,995,0.04,0.98,1.0,0.21,0,0,1,0,1017,0,1.0,0.0,0
PF07521,PF11718:PF13299:PF16661:PF10996:PF07289,24,40,21,3,19,975,0.53,0.98,0.88,0.67,16,10,14,6,988,0.62,0.98,0.42,0.5
PF01393,PF17218:PF06781:PF00385:PF03716:PF10021,11,71,10,1,61,946,0.14,0.94,0.91,0.34,1,1,10,0,1007,1.0,0.99,0.09,0.3
PF16217,PF13722:PF07409:PF03090:PF07157:PF14323,0,0,0,0,0,1018,0,1.0,0,0,0,0,0,0,1018,0,1.0,0,0
PF11470,PF09429:PF09041:PF08605:PF07001:PF15624,6,19,2,4,17,995,0.11,0.98,0.33,0.18,0,0,6,0,1012,0,0.99,0.0,0
PF11556,PF12361:PF12377:PF15445:PF03011:PF15447,1,1,1,0,0,1017,1.0,1.0,1.0,1.0,1,1,0,0,1017,1.0,1.0,1.0,1.0
PF12121,PF08023:PF16048:PF08018:PF16047:PF07440,0,0,0,0,0,1018,0,1.0,0,0,0,0,0,0,1018,0,1.0,0,0
PF00335,PF15320:PF04893:PF05347:PF08583:PF01192,53,50,19,34,31,934,0.38,0.94,0.36,0.34,4,4,49,0,965,1.0,0.95,0.08,0.27
PF14475,PF08528:PF10332:PF10361:PF10104:PF02631,0,14,0,0,14,1004,0.0,0.99,0,0,0,0,0,0,1018,0,1.0,0,0
PF06819,PF05565:PF01967:PF01938:PF16678:PF10938,0,27,0,0,27,991,0.0,0.97,0,0,1,0,0,1,1017,0.0,1.0,0,0
PF16403,PF08305:PF08919:PF13402:PF05345:PF15273,8,16,4,4,12,998,0.25,0.98,0.5,0.35,2,2,6,0,1010,1.0,0.99,0.25,0.5
PF01668,PF17010:PF01316:PF08404:PF08497:PF15023,2,2,0,2,2,1014,0.0,1.0,0.0,-0.0,0,0,2,0,1016,0,1.0,0.0,0
PF05353,PF10645:PF15367:PF15667:PF09663:PF06056,1,7,0,1,7,1010,0.0,0.99,0.0,-0.0,0,0,1,0,1017,0,1.0,0.0,0
PF15912,PF11526:PF07001:PF15624:PF13945:PF04357,2,16,0,2,16,1000,0.0,0.98,0.0,-0.01,0,0,2,0,1016,0,1.0,0.0,0
PF12343,PF04892:PF03974:PF14980:PF03544:PF15578,1,5,0,1,5,1012,0.0,0.99,0.0,-0.0,0,0,1,0,1017,0,1.0,0.0,0
PF06729,PF15119:PF02977:PF15041:PF15772:PF09252,0,2,0,0,2,1016,0.0,1.0,0,0,0,0,0,0,1018,0,1.0,0,0
PF08499,PF08629:PF00233:PF00158:PF13188:PF08778,2,34,2,0,32,984,0.06,0.97,1.0,0.24,1,1,1,0,1016,1.0,1.0,0.5,0.71
PF04328,PF12081:PF04355:PF08479:PF08334:PF11751,0,1,0,0,1,1017,0.0,1.0,0,0,0,0,0,0,1018,0,1.0,0,0
PF16338,PF17137:PF16863:PF00088:PF03423:PF15181,1,31,1,0,30,987,0.03,0.97,1.0,0.18,3,1,0,2,1015,0.33,1.0,1.0,0.58
PF03829,PF03608:PF08220:PF03612:PF00455:PF09677,2,5,2,0,3,1013,0.4,1.0,1.0,0.63,2,2,0,0,1016,1.0,1.0,1.0,1.0
PF15455,PF10912:PF17006:PF12840:PF02601:PF09365,1,5,1,0,4,1013,0.2,1.0,1.0,0.45,0,0,1,0,1017,0,1.0,0.0,0
PF01277,PF07172:PF00468:PF16009:PF04839:PF10542,1,7,0,1,7,1010,0.0,0.99,0.0,-0.0,0,0,1,0,1017,0,1.0,0.0,0
PF11721,PF12819:PF08917:PF12799:PF14786:PF00139,18,66,12,6,54,946,0.18,0.94,0.67,0.33,5,4,14,1,999,0.8,0.99,0.22,0.42
PF05157,PF03922:PF05466:PF03888:PF10566:PF10908,1,0,0,1,0,1017,0,1.0,0.0,0,0,0,1,0,1017,0,1.0,0.0,0
PF00989,PF08447:PF16279:PF12114:PF08832:PF08446,37,32,19,18,13,968,0.59,0.97,0.51,0.54,6,6,31,0,981,1.0,0.97,0.16,0.4
PF07890,PF15063:PF06271:PF15364:PF10280:PF01279,5,10,1,4,9,1004,0.1,0.99,0.2,0.14,0,0,5,0,1013,0,1.0,0.0,0
PF12708,PF06964:PF14498:PF11915:PF00295:PF09286,13,56,10,3,46,959,0.18,0.95,0.77,0.36,10,3,10,7,998,0.3,0.98,0.23,0.25
PF01418,PF01380:PF00585:PF06835:PF08220:PF07831,2,20,2,0,18,998,0.1,0.98,1.0,0.31,1,1,1,0,1016,1.0,1.0,0.5,0.71
PF09008,PF15518:PF11304:PF09327:PF04865:PF04453,0,1,0,0,1,1017,0.0,1.0,0,0,0,0,0,0,1018,0,1.0,0,0
PF15190,PF01668:PF06573:PF03050:PF15776:PF01706,1,7,1,0,6,1011,0.14,0.99,1.0,0.38,0,0,1,0,1017,0,1.0,0.0,0
PF00828,PF10218:PF01632:PF01185:PF07896:PF09754,26,17,6,20,11,981,0.35,0.97,0.23,0.27,1,1,25,0,992,1.0,0.98,0.04,0.19
PF02209,PF16182:PF04810:PF06165:PF16923:PF04815,13,39,6,7,33,972,0.15,0.96,0.46,0.25,4,3,10,1,1004,0.75,0.99,0.23,0.41
PF14238,PF13390:PF03845:PF09829:PF12615:PF12602,0,8,0,0,8,1010,0.0,0.99,0,0,0,0,0,0,1018,0,1.0,0,0
PF01119,PF10699:PF10257:PF15996:PF03250:PF09239,24,23,5,19,18,976,0.22,0.96,0.21,0.19,0,0,24,0,994,0,0.98,0.0,0
PF07815,PF09431:PF11555:PF12026:PF08824:PF08397,8,18,4,4,14,996,0.22,0.98,0.5,0.33,2,2,6,0,1010,1.0,0.99,0.25,0.5
PF02873,PF02913:PF04030:PF09265:PF09129:PF09330,6,54,3,3,51,961,0.06,0.95,0.5,0.15,4,3,3,1,1011,0.75,1.0,0.5,0.61
PF15823,PF07157:PF11751:PF06403:PF16861:PF15150,0,4,0,0,4,1014,0.0,1.0,0,0,0,0,0,0,1018,0,1.0,0,0
PF01397,PF03936:PF05827:PF16401:PF04043:PF06974,16,41,16,0,25,977,0.39,0.98,1.0,0.62,4,0,16,4,998,0.0,0.98,0.0,-0.01
PF00573,PF14374:PF03386:PF04063:PF01176:PF01922,18,29,13,5,16,984,0.45,0.98,0.72,0.56,2,2,16,0,1000,1.0,0.98,0.11,0.33
PF12376,PF15120:PF15046:PF15576:PF07458:PF04360,0,5,0,0,5,1013,0.0,1.0,0,0,0,0,0,0,1018,0,1.0,0,0
PF01627,PF06376:PF04520:PF04716:PF01987:PF06127,8,23,3,5,20,990,0.13,0.98,0.38,0.21,1,1,7,0,1010,1.0,0.99,0.12,0.35
PF08535,PF02305:PF06890:PF04687:PF09829:PF03814,1,2,0,1,2,1015,0.0,1.0,0.0,-0.0,0,0,1,0,1017,0,1.0,0.0,0
PF12602,PF11751:PF06798:PF08299:PF06890:PF03428,0,2,0,0,2,1016,0.0,1.0,0,0,0,0,0,0,1018,0,1.0,0,0
PF05135,PF04860:PF02565:PF10974:PF17049:PF01312,0,2,0,0,2,1016,0.0,1.0,0,0,0,0,0,0,1018,0,1.0,0,0
PF12827,PF00796:PF05836:PF17049:PF15207:PF15186,0,3,0,0,3,1015,0.0,1.0,0,0,0,0,0,0,1018,0,1.0,0,0
PF01410,PF01391:PF00386:PF02210:PF00054:PF12287,15,96,11,4,85,918,0.11,0.91,0.73,0.27,15,6,9,9,994,0.4,0.98,0.4,0.39
PF06980,PF01514:PF04738:PF15190:PF14251:PF08002,0,3,0,0,3,1015,0.0,1.0,0,0,0,0,0,0,1018,0,1.0,0,0
PF03641,PF00436:PF03358:PF04667:PF01261:PF04520,10,55,4,6,51,957,0.07,0.94,0.4,0.15,2,1,9,1,1007,0.5,0.99,0.1,0.22
PF06827,PF10458:PF13603:PF11551:PF08264:PF00133,9,57,5,4,52,957,0.09,0.94,0.56,0.21,13,3,6,10,999,0.23,0.98,0.33,0.27
PF12418,PF12806:PF08028:PF09317:PF14749:PF06331,3,21,3,0,18,997,0.14,0.98,1.0,0.37,3,3,0,0,1015,1.0,1.0,1.0,1.0
PF13825,PF16500:PF07655:PF02097:PF12897:PF01455,0,4,0,0,4,1014,0.0,1.0,0,0,0,0,0,0,1018,0,1.0,0,0
PF12235,PF16098:PF16096:PF16097:PF16551:PF05266,7,5,5,2,0,1011,1.0,1.0,0.71,0.84,1,1,6,0,1011,1.0,0.99,0.14,0.38
PF16759,PF01660:PF15392:PF09247:PF07916:PF08605,7,9,1,6,8,1003,0.11,0.99,0.14,0.12,0,0,7,0,1011,0,0.99,0.0,0
PF08649,PF11093:PF03823:PF15003:PF02202:PF05387,2,4,1,1,3,1013,0.25,1.0,0.5,0.35,0,0,2,0,1016,0,1.0,0.0,0
PF10523,PF03131:PF09494:PF02731:PF08383:PF09789,10,33,4,6,29,979,0.12,0.97,0.4,0.21,2,1,9,1,1007,0.5,0.99,0.1,0.22
PF01679,PF04729:PF10276:PF03095:PF06487:PF01250,12,34,5,7,29,977,0.15,0.96,0.42,0.23,0,0,12,0,1006,0,0.99,0.0,0
PF04979,PF09696:PF01185:PF04667:PF07896:PF08561,21,24,11,10,13,984,0.46,0.98,0.52,0.48,1,1,20,0,997,1.0,0.98,0.05,0.22
PF02800,PF00044:PF02672:PF00121:PF01066:PF00120,28,68,24,4,44,946,0.35,0.95,0.86,0.53,9,9,19,0,990,1.0,0.98,0.32,0.56
PF06757,PF10325:PF16984:PF01147:PF10327:PF08925,2,13,0,2,13,1003,0.0,0.99,0.0,-0.01,0,0,2,0,1016,0,1.0,0.0,0
PF01644,PF06165:PF12449:PF14663:PF17167:PF05285,15,29,8,7,21,982,0.28,0.97,0.53,0.37,1,1,14,0,1003,1.0,0.99,0.07,0.26
PF13933,PF15831:PF06907:PF16594:PF11093:PF03760,0,4,0,0,4,1014,0.0,1.0,0,0,0,0,0,0,1018,0,1.0,0,0
PF04135,PF15014:PF05754:PF02972:PF02087:PF08591,6,3,0,6,3,1009,0.0,0.99,0.0,-0.0,0,0,6,0,1012,0,0.99,0.0,0
PF13656,PF00411:PF01121:PF10256:PF10780:PF01467,15,67,11,4,56,947,0.16,0.94,0.73,0.33,7,6,9,1,1002,0.86,0.99,0.4,0.58
PF00790,PF12210:PF03127:PF04366:PF11464:PF09311,28,34,16,12,18,972,0.47,0.97,0.57,0.5,3,3,25,0,990,1.0,0.98,0.11,0.32
PF01822,PF11790:PF09362:PF02485:PF12529:PF07250,50,33,19,31,14,954,0.58,0.96,0.38,0.45,3,3,47,0,968,1.0,0.95,0.06,0.24
PF00318,PF16122:PF04161:PF01866:PF13774:PF02183,25,48,16,9,32,961,0.33,0.96,0.64,0.44,4,4,21,0,993,1.0,0.98,0.16,0.4
PF01783,PF08583:PF06645:PF00159:PF03501:PF01279,8,28,4,4,24,986,0.14,0.97,0.5,0.26,2,1,7,1,1009,0.5,0.99,0.12,0.25
PF03383,PF11581:PF01739:PF06681:PF06852:PF14494,0,4,0,0,4,1014,0.0,1.0,0,0,0,0,0,0,1018,0,1.0,0,0
PF13000,PF01227:PF13334:PF12260:PF00852:PF07262,7,32,2,5,30,981,0.06,0.97,0.29,0.12,3,1,6,2,1009,0.33,0.99,0.14,0.21
PF04199,PF11807:PF14027:PF12296:PF12680:PF12311,22,31,14,8,17,979,0.45,0.98,0.64,0.52,3,3,19,0,996,1.0,0.98,0.14,0.37
PF10583,PF06994:PF00904:PF15362:PF03032:PF00879,0,4,0,0,4,1014,0.0,1.0,0,0,0,0,0,0,1018,0,1.0,0,0
PF07052,PF11623:PF11282:PF10217:PF16007:PF10273,12,8,3,9,5,1001,0.38,0.99,0.25,0.3,0,0,12,0,1006,0,0.99,0.0,0
PF15888,PF12478:PF08291:PF04417:PF05894:PF15082,0,9,0,0,9,1009,0.0,0.99,0,0,0,0,0,0,1018,0,1.0,0,0
PF08268,PF07734:PF10442:PF12014:PF03478:PF07723,12,44,10,2,34,972,0.23,0.96,0.83,0.42,3,3,9,0,1006,1.0,0.99,0.25,0.5
PF11380,PF17101:PF17103:PF17102:PF00066:PF05572,7,26,7,0,19,992,0.27,0.98,1.0,0.51,4,4,3,0,1011,1.0,1.0,0.57,0.75
PF01758,PF07542:PF11735:PF03583:PF15019:PF02915,11,22,2,9,20,987,0.09,0.97,0.18,0.12,0,0,11,0,1007,0,0.99,0.0,0
PF13339,PF13864:PF11489:PF10330:PF15929:PF04090,15,8,5,10,3,1000,0.62,0.99,0.33,0.45,0,0,15,0,1003,0,0.99,0.0,0
PF08100,PF00891:PF16864:PF02545:PF14365:PF06414,7,49,7,0,42,969,0.14,0.96,1.0,0.37,4,1,6,3,1008,0.25,0.99,0.14,0.18
PF11460,PF06989:PF13270:PF11255:PF12855:PF06485,0,8,0,0,8,1010,0.0,0.99,0,0,0,0,0,0,1018,0,1.0,0,0
PF02457,PF15212:PF15117:PF16824:PF01455:PF02530,0,1,0,0,1,1017,0.0,1.0,0,0,0,0,0,0,1018,0,1.0,0,0
PF01933,PF11264:PF12900:PF15370:PF08787:PF06912,5,14,3,2,11,1002,0.21,0.99,0.6,0.35,0,0,5,0,1013,0,1.0,0.0,0
PF15030,PF03344:PF06513:PF05715:PF09444:PF05762,1,8,0,1,8,1009,0.0,0.99,0.0,-0.0,0,0,1,0,1017,0,1.0,0.0,0
PF01766,PF04099:PF07672:PF09445:PF15011:PF14934,1,29,0,1,29,988,0.0,0.97,0.0,-0.01,1,0,1,1,1016,0.0,1.0,0.0,-0.0
PF04999,PF03865:PF04559:PF06506:PF02951:PF07499,1,7,0,1,7,1010,0.0,0.99,0.0,-0.0,1,0,1,1,1016,0.0,1.0,0.0,-0.0
PF04607,PF13328:PF13291:PF02824:PF14923:PF02187,10,41,7,3,34,974,0.17,0.96,0.7,0.33,4,4,6,0,1008,1.0,0.99,0.4,0.63
PF13423,PF15870:PF00929:PF02878:PF00476:PF13355,16,77,12,4,65,937,0.16,0.93,0.75,0.32,10,3,13,7,995,0.3,0.98,0.19,0.23
PF10393,PF16754:PF12034:PF06668:PF05587:PF13757,3,7,2,1,5,1010,0.29,0.99,0.67,0.43,0,0,3,0,1015,0,1.0,0.0,0
PF04121,PF10226:PF03004:PF14922:PF05132:PF05090,13,34,5,8,29,976,0.15,0.96,0.38,0.22,4,3,10,1,1004,0.75,0.99,0.23,0.41
PF01710,PF01022:PF12760:PF09339:PF04967:PF11654,1,14,0,1,14,1003,0.0,0.99,0.0,-0.0,0,0,1,0,1017,0,1.0,0.0,0
PF00807,PF09051:PF09049:PF09050:PF09367:PF15689,0,0,0,0,0,1018,0,1.0,0,0,0,0,0,0,1018,0,1.0,0,0
PF16381,PF08752:PF14806:PF09066:PF02296:PF14797,5,22,5,0,17,996,0.23,0.98,1.0,0.47,1,1,4,0,1013,1.0,1.0,0.2,0.45
PF07068,PF08401:PF06651:PF05797:PF15856:PF17188,0,1,0,0,1,1017,0.0,1.0,0,0,0,0,0,0,1018,0,1.0,0,0
PF01183,PF09631:PF03980:PF07281:PF08787:PF01097,11,23,3,8,20,987,0.13,0.97,0.27,0.18,0,0,11,0,1007,0,0.99,0.0,0
PF01346,PF03704:PF16546:PF07219:PF15867:PF14280,4,17,2,2,15,999,0.12,0.98,0.5,0.24,1,1,3,0,1014,1.0,1.0,0.25,0.5
PF15715,PF15109:PF06541:PF15364:PF04856:PF14986,0,0,0,0,0,1018,0,1.0,0,0,0,0,0,0,1018,0,1.0,0,0
PF14990,PF04816:PF15766:PF16039:PF16842:PF01813,0,9,0,0,9,1009,0.0,0.99,0,0,0,0,0,0,1018,0,1.0,0,0
PF12505,PF07173:PF10355:PF10348:PF10644:PF06662,5,23,2,3,21,992,0.09,0.98,0.4,0.18,1,1,4,0,1013,1.0,1.0,0.2,0.45
PF01484,PF09006:PF03523:PF15067:PF14616:PF08209,37,20,4,33,16,965,0.2,0.95,0.11,0.12,0,0,37,0,981,0,0.96,0.0,0
PF07517,PF01043:PF08216:PF10350:PF03190:PF10441,5,25,3,2,22,991,0.12,0.98,0.6,0.26,2,2,3,0,1013,1.0,1.0,0.4,0.63
PF03126,PF02201:PF08766:PF10360:PF02213:PF02229,16,53,12,4,41,961,0.23,0.96,0.75,0.4,9,5,11,4,998,0.56,0.99,0.31,0.41
PF10539,PF14738:PF07202:PF02213:PF16768:PF14662,9,25,3,6,22,987,0.12,0.97,0.33,0.19,1,1,8,0,1009,1.0,0.99,0.11,0.33
PF09860,PF02217:PF08093:PF08744:PF05939:PF01430,0,5,0,0,5,1013,0.0,1.0,0,0,0,0,0,0,1018,0,1.0,0,0
PF14783,PF14782:PF14781:PF14944:PF09303:PF05110,6,17,6,0,11,1001,0.35,0.99,1.0,0.59,1,1,5,0,1012,1.0,1.0,0.17,0.41
PF07896,PF07816:PF04716:PF01097:PF05915:PF10218,5,17,1,4,16,997,0.06,0.98,0.2,0.1,0,0,5,0,1013,0,1.0,0.0,0
PF11378,PF03913:PF15080:PF14987:PF15208:PF02530,0,6,0,0,6,1012,0.0,0.99,0,0,0,0,0,0,1018,0,1.0,0,0
PF10343,PF01509:PF01472:PF11720:PF03091:PF13508,15,40,9,6,31,972,0.23,0.96,0.6,0.35,4,3,12,1,1002,0.75,0.99,0.2,0.38
PF01426,PF01448:PF12047:PF00145:PF00320:PF13919,40,70,23,17,47,931,0.33,0.94,0.57,0.4,9,9,31,0,978,1.0,0.97,0.23,0.47
PF03965,PF05024:PF14076:PF12862:PF03420:PF00211,1,72,1,0,71,946,0.01,0.93,1.0,0.11,2,0,1,2,1015,0.0,1.0,0.0,-0.0
PF03906,PF08278:PF11387:PF09867:PF11363:PF10459,0,6,0,0,6,1012,0.0,0.99,0,0,0,0,0,0,1018,0,1.0,0,0
PF16869,PF16858:PF06278:PF00926:PF01228:PF01643,0,16,0,0,16,1002,0.0,0.98,0,0,1,0,0,1,1017,0.0,1.0,0,0
PF03929,PF02975:PF04196:PF13751:PF16586:PF16967,3,6,0,3,6,1009,0.0,0.99,0.0,-0.0,0,0,3,0,1015,0,1.0,0.0,0
PF02203,PF00015:PF00563:PF08918:PF02768:PF17154,4,23,4,0,19,995,0.17,0.98,1.0,0.41,2,1,3,1,1013,0.5,1.0,0.25,0.35
PF02907,PF10801:PF02121:PF02862:PF07516:PF12166,1,28,0,1,28,989,0.0,0.97,0.0,-0.01,3,0,1,3,1014,0.0,1.0,0.0,-0.0
PF12230,PF09750:PF01805:PF16566:PF12057:PF08312,13,53,13,0,40,965,0.25,0.96,1.0,0.49,5,3,10,2,1003,0.6,0.99,0.23,0.37
PF05452,PF06853:PF07905:PF04353:PF15943:PF03719,0,23,0,0,23,995,0.0,0.98,0,0,0,0,0,0,1018,0,1.0,0,0
PF06250,PF12161:PF06122:PF16325:PF02253:PF11019,2,4,2,0,2,1014,0.5,1.0,1.0,0.71,0,0,2,0,1016,0,1.0,0.0,0
PF10184,PF04832:PF12400:PF15998:PF04800:PF11315,11,28,5,6,23,984,0.18,0.97,0.45,0.27,2,2,9,0,1007,1.0,0.99,0.18,0.42
PF13395,PF13635:PF03845:PF13390:PF11070:PF03336,0,8,0,0,8,1010,0.0,0.99,0,0,0,0,0,0,1018,0,1.0,0,0
PF08017,PF15485:PF14251:PF03525:PF08744:PF01668,7,4,1,6,3,1008,0.25,0.99,0.14,0.18,0,0,7,0,1011,0,0.99,0.0,0
PF03625,PF14519:PF08092:PF08843:PF07464:PF14866,1,2,0,1,2,1015,0.0,1.0,0.0,-0.0,0,0,1,0,1017,0,1.0,0.0,0
PF11728,PF10559:PF05608:PF03492:PF16065:PF08819,0,21,0,0,21,997,0.0,0.98,0,0,2,0,0,2,1016,0.0,1.0,0,0
PF08106,PF06684:PF04062:PF07059:PF13966:PF14111,0,117,0,0,117,901,0.0,0.89,0,0,9,0,0,9,1009,0.0,0.99,0,0
PF15758,PF00796:PF06681:PF01312:PF15141:PF17049,0,1,0,0,1,1017,0.0,1.0,0,0,0,0,0,0,1018,0,1.0,0,0
PF05345,PF12509:PF15912:PF15273:PF15326:PF11597,3,11,0,3,11,1004,0.0,0.99,0.0,-0.01,0,0,3,0,1015,0,1.0,0.0,0
PF06485,PF17078:PF11652:PF08653:PF03618:PF15863,4,5,1,3,4,1010,0.2,0.99,0.25,0.22,0,0,4,0,1014,0,1.0,0.0,0
PF00391,PF02896:PF01326:PF05524:PF02738:PF04898,12,41,8,4,33,973,0.2,0.96,0.67,0.35,7,2,10,5,1001,0.29,0.99,0.17,0.21
PF08018,PF16048:PF08023:PF16047:PF12121:PF07440,0,0,0,0,0,1018,0,1.0,0,0,0,0,0,0,1018,0,1.0,0,0
PF15169,PF03745:PF09461:PF14290:PF17061:PF15750,0,1,0,0,1,1017,0.0,1.0,0,0,0,0,0,0,1018,0,1.0,0,0
PF03650,PF06093:PF04178:PF05995:PF05724:PF00810,15,32,4,11,28,975,0.12,0.96,0.27,0.16,2,1,14,1,1002,0.5,0.99,0.07,0.18
PF08143,PF11627:PF12196:PF08081:PF12220:PF08080,1,6,1,0,5,1012,0.17,1.0,1.0,0.41,1,1,0,0,1017,1.0,1.0,1.0,1.0
PF00469,PF11697:PF04868:PF14512:PF13247:PF02973,1,3,0,1,3,1014,0.0,1.0,0.0,-0.0,0,0,1,0,1017,0,1.0,0.0,0
PF00764,PF00988:PF08252:PF00185:PF01808:PF15473,12,42,7,5,35,971,0.17,0.96,0.58,0.3,2,2,10,0,1006,1.0,0.99,0.17,0.41
PF03605,PF06890:PF09829:PF08479:PF14251:PF03994,1,3,0,1,3,1014,0.0,1.0,0.0,-0.0,0,0,1,0,1017,0,1.0,0.0,0
PF06109,PF17062:PF08591:PF14986:PF15055:PF15036,0,1,0,0,1,1017,0.0,1.0,0,0,0,0,0,0,1018,0,1.0,0,0
PF07044,PF15633:PF04693:PF09253:PF13700:PF16647,0,2,0,0,2,1016,0.0,1.0,0,0,0,0,0,0,1018,0,1.0,0,0
PF08252,PF06508:PF06418:PF00697:PF00218:PF00977,0,36,0,0,36,982,0.0,0.96,0,0,2,0,0,2,1016,0.0,1.0,0,0
PF03079,PF05995:PF01774:PF11779:PF07350:PF01674,17,25,7,10,18,983,0.28,0.97,0.41,0.33,3,2,15,1,1000,0.67,0.98,0.12,0.28
PF04316,PF08404:PF17193:PF08021:PF01668:PF04754,0,3,0,0,3,1015,0.0,1.0,0,0,0,0,0,0,1018,0,1.0,0,0
PF12537,PF12430:PF14958:PF01237:PF13851:PF04437,1,50,1,0,49,968,0.02,0.95,1.0,0.14,0,0,1,0,1017,0,1.0,0.0,0
PF17024,PF08873:PF03457:PF00377:PF08247:PF02907,0,8,0,0,8,1010,0.0,0.99,0,0,0,0,0,0,1018,0,1.0,0,0
PF09422,PF09305:PF01447:PF09772:PF15397:PF05045,0,12,0,0,12,1006,0.0,0.99,0,0,0,0,0,0,1018,0,1.0,0,0
PF13627,PF09257:PF10079:PF01110:PF08856:PF07243,0,2,0,0,2,1016,0.0,1.0,0,0,0,0,0,0,1018,0,1.0,0,0
PF07923,PF11882:PF16742:PF14022:PF16794:PF14421,7,14,7,0,7,1004,0.5,0.99,1.0,0.7,0,0,7,0,1011,0,0.99,0.0,0
PF16487,PF16488:PF02171:PF16486:PF05831:PF08699,23,55,23,0,32,963,0.42,0.97,1.0,0.64,33,23,0,10,985,0.7,0.99,1.0,0.83
PF14467,PF08299:PF14882:PF07411:PF07157:PF11775,0,2,0,0,2,1016,0.0,1.0,0,0,0,0,0,0,1018,0,1.0,0,0
PF02820,PF17208:PF12140:PF12618:PF01530:PF14949,22,22,14,8,8,988,0.64,0.98,0.64,0.63,2,2,20,0,996,1.0,0.98,0.09,0.3
PF10458,PF06827:PF13603:PF09334:PF09635:PF08264,7,64,7,0,57,954,0.11,0.94,1.0,0.32,10,3,4,7,1004,0.3,0.99,0.43,0.35
PF04086,PF00448:PF02881:PF02978:PF13442:PF14853,11,47,10,1,37,970,0.21,0.96,0.91,0.43,25,5,6,20,987,0.2,0.97,0.45,0.29
PF12236,PF06122:PF05065:PF10099:PF06651:PF11742,0,1,0,0,1,1017,0.0,1.0,0,0,0,0,0,0,1018,0,1.0,0,0
PF10358,PF12510:PF15949:PF12130:PF15147:PF17095,19,17,2,17,15,984,0.12,0.97,0.11,0.1,1,1,18,0,999,1.0,0.98,0.05,0.23
PF15124,PF11863:PF16325:PF04228:PF05509:PF02465,0,2,0,0,2,1016,0.0,1.0,0,0,0,0,0,0,1018,0,1.0,0,0
PF03036,PF15388:PF14822:PF03299:PF04906:PF02076,8,22,3,5,19,991,0.14,0.98,0.38,0.22,1,1,7,0,1010,1.0,0.99,0.12,0.35
PF09238,PF15914:PF14726:PF11261:PF13836:PF14545,2,13,1,1,12,1004,0.08,0.99,0.5,0.19,0,0,2,0,1016,0,1.0,0.0,0
PF13713,PF16696:PF11464:PF08381:PF11409:PF09311,7,22,7,0,15,996,0.32,0.99,1.0,0.56,2,2,5,0,1011,1.0,1.0,0.29,0.53
PF03381,PF07896:PF04176:PF02104:PF05047:PF05915,18,24,7,11,17,983,0.29,0.97,0.39,0.32,1,1,17,0,1000,1.0,0.98,0.06,0.23
PF17052,PF16265:PF11217:PF15039:PF06681:PF15195,0,3,0,0,3,1015,0.0,1.0,0,0,0,0,0,0,1018,0,1.0,0,0
PF05084,PF01300:PF07101:PF11478:PF03040:PF09412,0,33,0,0,33,985,0.0,0.97,0,0,0,0,0,0,1018,0,1.0,0,0
PF04910,PF15929:PF09816:PF15279:PF04087:PF09808,8,10,4,4,6,1004,0.4,0.99,0.5,0.44,0,0,8,0,1010,0,0.99,0.0,0
PF02261,PF07499:PF04355:PF01312:PF12477:PF17188,2,2,0,2,2,1014,0.0,1.0,0.0,-0.0,0,0,2,0,1016,0,1.0,0.0,0
PF08347,PF13775:PF08517:PF09011:PF12444:PF12067,1,21,0,1,21,996,0.0,0.98,0.0,-0.0,0,0,1,0,1017,0,1.0,0.0,0
PF11603,PF04428:PF09093:PF14307:PF13749:PF01660,2,14,1,1,13,1003,0.07,0.99,0.5,0.19,0,0,2,0,1016,0,1.0,0.0,0
PF07991,PF01450:PF08622:PF17187:PF06401:PF06807,8,24,8,0,16,994,0.33,0.98,1.0,0.57,1,0,8,1,1009,0.0,0.99,0.0,-0.0
PF13889,PF15557:PF04118:PF12129:PF04825:PF14665,5,25,4,1,21,992,0.16,0.98,0.8,0.35,0,0,5,0,1013,0,1.0,0.0,0
PF08839,PF16679:PF05224:PF16019:PF05508:PF01873,7,28,6,1,22,989,0.21,0.98,0.86,0.42,1,1,6,0,1011,1.0,0.99,0.14,0.38
PF04958,PF07642:PF01815:PF09311:PF15740:PF16504,3,7,0,3,7,1008,0.0,0.99,0.0,-0.0,0,0,3,0,1015,0,1.0,0.0,0
PF01107,PF03732:PF03159:PF02337:PF14893:PF12384,5,70,4,1,66,947,0.06,0.93,0.8,0.2,3,2,3,1,1012,0.67,1.0,0.4,0.51
PF07386,PF06581:PF11317:PF10716:PF05419:PF09459,5,2,0,5,2,1011,0.0,0.99,0.0,-0.0,0,0,5,0,1013,0,1.0,0.0,0
PF17048,PF04734:PF02268:PF12590:PF02929:PF16353,8,25,8,0,17,993,0.32,0.98,1.0,0.56,1,0,8,1,1009,0.0,0.99,0.0,-0.0
PF03524,PF10618:PF05797:PF09498:PF14842:PF13296,7,1,0,7,1,1010,0.0,0.99,0.0,-0.0,0,0,7,0,1011,0,0.99,0.0,0
PF00211,PF07701:PF16214:PF08376:PF07700:PF06327,59,25,24,35,1,958,0.96,0.96,0.41,0.61,4,4,55,0,959,1.0,0.95,0.07,0.25
PF05971,PF16019:PF09804:PF04189:PF02112:PF12877,10,19,3,7,16,992,0.16,0.98,0.3,0.21,1,1,9,0,1008,1.0,0.99,0.1,0.31
PF12926,PF08228:PF16007:PF01878:PF08034:PF04852,0,14,0,0,14,1004,0.0,0.99,0,0,0,0,0,0,1018,0,1.0,0,0
PF08526,PF03068:PF08527:PF02971:PF04961:PF14911,4,13,4,0,9,1005,0.31,0.99,1.0,0.55,0,0,4,0,1014,0,1.0,0.0,0
PF06364,PF02952:PF16011:PF07021:PF07016:PF03406,2,4,0,2,4,1012,0.0,0.99,0.0,-0.0,0,0,2,0,1016,0,1.0,0.0,0
PF11357,PF02186:PF06420:PF10173:PF07809:PF08692,10,18,3,7,15,993,0.17,0.98,0.3,0.21,0,0,10,0,1008,0,0.99,0.0,0
PF13019,PF05508:PF14909:PF12898:PF06365:PF15007,5,9,2,3,7,1006,0.22,0.99,0.4,0.29,0,0,5,0,1013,0,1.0,0.0,0
PF06324,PF17056:PF15972:PF14866:PF02531:PF07444,1,2,0,1,2,1015,0.0,1.0,0.0,-0.0,0,0,1,0,1017,0,1.0,0.0,0
PF03619,PF05653:PF02423:PF14719:PF10178:PF08613,27,45,10,17,35,956,0.22,0.95,0.37,0.26,3,3,24,0,991,1.0,0.98,0.11,0.33
PF03105,PF00939:PF03124:PF03009:PF16387:PF02656,31,61,24,7,37,950,0.39,0.96,0.77,0.53,4,4,27,0,987,1.0,0.97,0.13,0.35
PF00716,PF01314:PF09798:PF15482:PF04559:PF10999,1,4,0,1,4,1013,0.0,1.0,0.0,-0.0,0,0,1,0,1017,0,1.0,0.0,0
PF01432,PF05652:PF03074:PF08439:PF16061:PF05450,25,27,11,14,16,977,0.41,0.97,0.44,0.41,0,0,25,0,993,0,0.98,0.0,0
PF08880,PF08879:PF07529:PF14619:PF10497:PF07533,10,35,10,0,25,983,0.29,0.98,1.0,0.53,8,8,2,0,1008,1.0,1.0,0.8,0.89
PF13181,PF13176:PF07719:PF05279:PF13174:PF16669,108,64,46,62,18,892,0.72,0.92,0.43,0.52,10,10,98,0,910,1.0,0.9,0.09,0.29
PF06543,PF00062:PF07093:PF12675:PF04237:PF14295,0,44,0,0,44,974,0.0,0.96,0,0,1,0,0,1,1017,0.0,1.0,0,0
PF07024,PF11026:PF12603:PF17007:PF06505:PF03831,0,1,0,0,1,1017,0.0,1.0,0,0,0,0,0,0,1018,0,1.0,0,0
PF08702,PF12160:PF05889:PF00147:PF12287:PF16164,3,52,3,0,49,966,0.06,0.95,1.0,0.23,1,1,2,0,1015,1.0,1.0,0.33,0.58
PF02271,PF12680:PF06330:PF07366:PF12273:PF12328,11,20,5,6,15,992,0.25,0.98,0.45,0.33,1,1,10,0,1007,1.0,0.99,0.09,0.3
PF17188,PF03888:PF01752:PF01514:PF11874:PF17164,0,2,0,0,2,1016,0.0,1.0,0,0,0,0,0,0,1018,0,1.0,0,0
PF07453,PF07460:PF14528:PF01541:PF11793:PF00961,3,30,3,0,27,988,0.1,0.97,1.0,0.31,10,2,1,8,1007,0.2,0.99,0.67,0.36
PF02738,PF01315:PF01799:PF03450:PF00941:PF00111,23,43,23,0,20,975,0.53,0.98,1.0,0.72,22,21,2,1,994,0.95,1.0,0.91,0.93
PF03099,PF09825:PF10210:PF01578:PF05257:PF04483,17,12,3,14,9,992,0.25,0.98,0.18,0.2,0,0,17,0,1001,0,0.98,0.0,0
PF04230,PF03151:PF15078:PF14616:PF07207:PF10419,2,37,1,1,36,980,0.03,0.96,0.5,0.11,2,0,2,2,1014,0.0,1.0,0.0,-0.0
PF11799,PF00817:PF11798:PF13438:PF16589:PF06732,25,46,25,0,21,972,0.54,0.98,1.0,0.73,3,3,22,0,993,1.0,0.98,0.12,0.34
PF15955,PF15868:PF04527:PF11018:PF14935:PF05497,1,14,0,1,14,1003,0.0,0.99,0.0,-0.0,0,0,1,0,1017,0,1.0,0.0,0
PF07700,PF16214:PF06327:PF04940:PF08376:PF07701,14,28,14,0,14,990,0.5,0.99,1.0,0.7,3,1,13,2,1002,0.33,0.99,0.07,0.15
PF13994,PF17029:PF16923:PF05661:PF05709:PF05817,0,18,0,0,18,1000,0.0,0.98,0,0,0,0,0,0,1018,0,1.0,0,0
PF15373,PF15748:PF16647:PF08026:PF06868:PF14886,0,5,0,0,5,1013,0.0,1.0,0,0,0,0,0,0,1018,0,1.0,0,0
PF00206,PF10397:PF10415:PF14698:PF08328:PF02310,44,38,35,9,3,971,0.92,0.99,0.8,0.85,4,4,40,0,974,1.0,0.96,0.09,0.3
PF02515,PF07491:PF07287:PF04828:PF07247:PF03357,32,69,17,15,52,934,0.25,0.93,0.53,0.33,9,9,23,0,986,1.0,0.98,0.28,0.52
PF07556,PF01136:PF05857:PF11751:PF09108:PF03241,0,1,0,0,1,1017,0.0,1.0,0,0,0,0,0,0,1018,0,1.0,0,0
PF14213,PF08881:PF00172:PF12943:PF08214:PF05613,0,154,0,0,154,864,0.0,0.85,0,0,4,0,0,4,1014,0.0,1.0,0,0
PF10964,PF05125:PF00370:PF15875:PF03552:PF00989,0,71,0,0,71,947,0.0,0.93,0,0,5,0,0,5,1013,0.0,1.0,0,0
PF13742,PF11751:PF03090:PF03241:PF05974:PF14251,2,2,0,2,2,1014,0.0,1.0,0.0,-0.0,0,0,2,0,1016,0,1.0,0.0,0
PF15394,PF08432:PF07149:PF02748:PF08805:PF11356,2,4,0,2,4,1012,0.0,0.99,0.0,-0.0,0,0,2,0,1016,0,1.0,0.0,0
PF13519,PF08487:PF15300:PF14624:PF08473:PF06668,35,19,12,23,7,976,0.63,0.97,0.34,0.45,2,2,33,0,983,1.0,0.97,0.06,0.24
PF13667,PF16838:PF15319:PF05352:PF05491:PF02322,1,6,0,1,6,1011,0.0,0.99,0.0,-0.0,0,0,1,0,1017,0,1.0,0.0,0
PF16507,PF11919:PF16547:PF13001:PF12530:PF12755,9,30,8,1,22,987,0.27,0.98,0.89,0.48,1,1,8,0,1009,1.0,0.99,0.11,0.33
PF01740,PF00916:PF12036:PF16748:PF15098:PF04091,35,47,31,4,16,967,0.66,0.98,0.89,0.75,0,0,35,0,983,0,0.97,0.0,0
PF01122,PF14478:PF12934:PF09230:PF00591:PF12933,5,10,2,3,8,1005,0.2,0.99,0.4,0.28,0,0,5,0,1013,0,1.0,0.0,0
PF13464,PF04375:PF12835:PF09684:PF02217:PF06745,1,5,0,1,5,1012,0.0,0.99,0.0,-0.0,1,0,1,1,1016,0.0,1.0,0.0,-0.0
PF04703,PF11751:PF05100:PF02413:PF05974:PF08805,0,1,0,0,1,1017,0.0,1.0,0,0,0,0,0,0,1018,0,1.0,0,0
PF08670,PF02563:PF10481:PF04813:PF04812:PF07926,6,17,2,4,15,997,0.12,0.98,0.33,0.19,0,0,6,0,1012,0,0.99,0.0,0
PF04963,PF04552:PF08479:PF07805:PF08274:PF09826,1,3,1,0,2,1015,0.33,1.0,1.0,0.58,0,0,1,0,1017,0,1.0,0.0,0
PF04871,PF01782:PF02841:PF03470:PF10212:PF15908,15,19,3,12,16,987,0.16,0.97,0.2,0.16,2,2,13,0,1003,1.0,0.99,0.13,0.36
PF07073,PF02500:PF01888:PF05552:PF04472:PF05229,0,1,0,0,1,1017,0.0,1.0,0,0,0,0,0,0,1018,0,1.0,0,0
PF16783,PF10927:PF07652:PF03461:PF11719:PF12344,5,15,4,1,11,1002,0.27,0.99,0.8,0.46,2,2,3,0,1013,1.0,1.0,0.4,0.63
PF09028,PF11162:PF09510:PF03525:PF08795:PF04569,1,0,0,1,0,1017,0,1.0,0.0,0,0,0,1,0,1017,0,1.0,0.0,0
PF05060,PF04088:PF15383:PF08397:PF02759:PF16317,3,47,2,1,45,970,0.04,0.95,0.67,0.16,1,1,2,0,1015,1.0,1.0,0.33,0.58
PF03489,PF02199:PF05184:PF03227:PF00657:PF08395,7,67,6,1,61,950,0.09,0.94,0.86,0.27,4,3,4,1,1010,0.75,1.0,0.43,0.56
PF02151,PF02577:PF13474:PF10431:PF08755:PF02861,17,35,9,8,26,975,0.26,0.97,0.53,0.35,2,2,15,0,1001,1.0,0.99,0.12,0.34
PF05290,PF08873:PF03120:PF06753:PF03119:PF12258,0,7,0,0,7,1011,0.0,0.99,0,0,0,0,0,0,1018,0,1.0,0,0
PF01969,PF07411:PF14882:PF05326:PF15424:PF02951,0,4,0,0,4,1014,0.0,1.0,0,0,0,0,0,0,1018,0,1.0,0,0
PF16772,PF08558:PF14379:PF16495:PF16498:PF07988,2,20,2,0,18,998,0.1,0.98,1.0,0.31,1,0,2,1,1015,0.0,1.0,0.0,-0.0
PF06008,PF06009:PF00055:PF03801:PF03468:PF07926,4,38,3,1,35,979,0.08,0.96,0.75,0.24,3,1,3,2,1012,0.33,1.0,0.25,0.29
PF05023,PF09328:PF06880:PF02670:PF07778:PF01678,9,21,2,7,19,990,0.1,0.97,0.22,0.13,1,0,9,1,1008,0.0,0.99,0.0,-0.0
PF12937,PF00646:PF16862:PF06985:PF08387:PF11540,96,137,55,41,82,840,0.4,0.88,0.57,0.41,15,12,84,3,919,0.8,0.91,0.12,0.3
PF09606,PF06401:PF14654:PF17187:PF05647:PF06239,6,8,1,5,7,1005,0.12,0.99,0.17,0.14,0,0,6,0,1012,0,0.99,0.0,0
PF13949,PF03097:PF02185:PF14948:PF12215:PF11548,22,49,21,1,28,968,0.43,0.97,0.95,0.63,4,3,19,1,995,0.75,0.98,0.14,0.31
PF15053,PF11017:PF15814:PF07464:PF15952:PF12973,2,4,0,2,4,1012,0.0,0.99,0.0,-0.0,0,0,2,0,1016,0,1.0,0.0,0
PF16908,PF12624:PF09333:PF16910:PF13329:PF06650,18,38,18,0,20,980,0.47,0.98,1.0,0.68,15,9,9,6,994,0.6,0.99,0.5,0.54
PF12589,PF08498:PF05093:PF07109:PF13532:PF16803,6,59,3,3,56,956,0.05,0.94,0.5,0.15,3,2,4,1,1011,0.67,1.0,0.33,0.47
PF15918,PF15759:PF10446:PF11223:PF11179:PF01021,0,4,0,0,4,1014,0.0,1.0,0,0,0,0,0,0,1018,0,1.0,0,0
PF07984,PF04831:PF13908:PF09783:PF06083:PF04505,1,29,0,1,29,988,0.0,0.97,0.0,-0.01,3,0,1,3,1014,0.0,1.0,0.0,-0.0
PF04819,PF01896:PF03556:PF03195:PF14811:PF11025,4,27,3,1,24,990,0.11,0.98,0.75,0.28,3,2,2,1,1013,0.67,1.0,0.5,0.58
PF04538,PF14473:PF15370:PF15359:PF15071:PF00727,1,9,0,1,9,1008,0.0,0.99,0.0,-0.0,0,0,1,0,1017,0,1.0,0.0,0
PF15999,PF05841:PF04988:PF15923:PF12382:PF09038,3,6,0,3,6,1009,0.0,0.99,0.0,-0.0,0,0,3,0,1015,0,1.0,0.0,0
PF05253,PF05206:PF11722:PF05669:PF07837:PF04961,13,27,8,5,19,986,0.3,0.98,0.62,0.42,3,2,11,1,1004,0.67,0.99,0.15,0.32
PF01894,PF08315:PF02970:PF16053:PF08695:PF01987,14,34,6,8,28,976,0.18,0.96,0.43,0.26,1,0,14,1,1003,0.0,0.99,0.0,-0.0
PF00149,PF02872:PF14008:PF16656:PF04152:PF03637,122,52,48,74,4,892,0.92,0.92,0.39,0.57,10,10,112,0,896,1.0,0.89,0.08,0.27
PF04978,PF02873:PF02913:PF04275:PF12447:PF09265,7,45,5,2,40,971,0.11,0.96,0.71,0.27,3,3,4,0,1011,1.0,1.0,0.43,0.65
PF14355,PF11363:PF01752:PF15758:PF12170:PF02277,0,6,0,0,6,1012,0.0,0.99,0,0,0,0,0,0,1018,0,1.0,0,0
PF00722,PF15886:PF06955:PF14543:PF07762:PF00182,43,52,17,26,35,940,0.33,0.94,0.4,0.33,6,6,37,0,975,1.0,0.96,0.14,0.37
PF16656,PF14008:PF02872:PF05011:PF07147:PF16891,24,50,22,2,28,966,0.44,0.97,0.92,0.62,5,4,20,1,993,0.8,0.98,0.17,0.36
PF12396,PF03709:PF14831:PF06738:PF04773:PF08327,6,28,1,5,27,985,0.04,0.97,0.17,0.07,1,0,6,1,1011,0.0,0.99,0.0,-0.0
PF09440,PF08375:PF05470:PF10602:PF15975:PF04715,5,44,4,1,40,973,0.09,0.96,0.8,0.26,3,1,4,2,1011,0.33,0.99,0.2,0.26
PF13321,PF01347:PF00080:PF11756:PF09172:PF06448,0,31,0,0,31,987,0.0,0.97,0,0,6,0,0,6,1012,0.0,0.99,0,0
PF12207,PF07226:PF05357:PF07866:PF10101:PF13586,0,0,0,0,0,1018,0,1.0,0,0,0,0,0,0,1018,0,1.0,0,0
PF09945,PF00594:PF14357:PF00211:PF00530:PF14076,0,87,0,0,87,931,0.0,0.91,0,0,4,0,0,4,1014,0.0,1.0,0,0
PF06136,PF03759:PF05301:PF05627:PF03479:PF05097,6,23,3,3,20,992,0.13,0.98,0.5,0.25,1,1,5,0,1012,1.0,1.0,0.17,0.41
PF06078,PF05100:PF06805:PF13556:PF11138:PF14508,1,1,0,1,1,1016,0.0,1.0,0.0,-0.0,0,0,1,0,1017,0,1.0,0.0,0
PF08372,PF16165:PF08151:PF08150:PF07002:PF12357,9,33,4,5,29,980,0.12,0.97,0.44,0.22,4,1,8,3,1006,0.25,0.99,0.11,0.16
PF14815,PF10576:PF07934:PF00633:PF16174:PF03610,7,22,3,4,19,992,0.14,0.98,0.43,0.23,1,1,6,0,1011,1.0,0.99,0.14,0.38
PF16529,PF15246:PF16501:PF10264:PF14738:PF07001,5,12,2,3,10,1003,0.17,0.99,0.4,0.25,1,1,4,0,1013,1.0,1.0,0.2,0.45
PF10378,PF12178:PF02472:PF04234:PF10407:PF09462,5,6,1,4,5,1008,0.17,0.99,0.2,0.18,0,0,5,0,1013,0,1.0,0.0,0
PF03371,PF04000:PF13339:PF11891:PF10234:PF11001,14,35,9,5,26,978,0.26,0.97,0.64,0.39,3,3,11,0,1004,1.0,0.99,0.21,0.46
PF09648,PF07435:PF13876:PF07523:PF04221:PF03925,0,2,0,0,2,1016,0.0,1.0,0,0,0,0,0,0,1018,0,1.0,0,0
PF09614,PF09611:PF04717:PF09498:PF15529:PF02277,0,3,0,0,3,1015,0.0,1.0,0,0,0,0,0,0,1018,0,1.0,0,0
PF16164,PF05587:PF05586:PF06668:PF10393:PF16754,2,8,1,1,7,1009,0.12,0.99,0.5,0.25,2,1,1,1,1015,0.5,1.0,0.5,0.5
PF04478,PF11282:PF15245:PF11623:PF09340:PF08636,3,10,0,3,10,1005,0.0,0.99,0.0,-0.01,0,0,3,0,1015,0,1.0,0.0,0
PF03065,PF06355:PF09614:PF07192:PF15775:PF03888,1,2,0,1,2,1015,0.0,1.0,0.0,-0.0,0,0,1,0,1017,0,1.0,0.0,0
PF03658,PF05934:PF05278:PF16012:PF02037:PF07735,0,70,0,0,70,948,0.0,0.93,0,0,3,0,0,3,1015,0.0,1.0,0,0
PF03255,PF12297:PF07926:PF03801:PF10481:PF07989,12,27,5,7,22,984,0.19,0.97,0.42,0.27,2,1,11,1,1005,0.5,0.99,0.08,0.2
PF04860,PF05135:PF09690:PF01312:PF15776:PF15119,1,3,0,1,3,1014,0.0,1.0,0.0,-0.0,0,0,1,0,1017,0,1.0,0.0,0
PF14721,PF16020:PF14962:PF14759:PF14691:PF01180,4,33,2,2,31,983,0.06,0.97,0.5,0.17,1,1,3,0,1014,1.0,1.0,0.25,0.5
PF11385,PF11081:PF01673:PF10109:PF06789:PF03243,0,5,0,0,5,1013,0.0,1.0,0,0,0,0,0,0,1018,0,1.0,0,0
PF09740,PF15292:PF13320:PF08579:PF01430:PF14613,1,2,0,1,2,1015,0.0,1.0,0.0,-0.0,0,0,1,0,1017,0,1.0,0.0,0
PF00402,PF03271:PF15147:PF12510:PF16796:PF08580,15,19,7,8,12,991,0.37,0.98,0.47,0.4,2,1,14,1,1002,0.5,0.99,0.07,0.18
PF00749,PF03950:PF04557:PF00458:PF04558:PF09180,35,33,25,10,8,975,0.76,0.98,0.71,0.73,12,12,23,0,983,1.0,0.98,0.34,0.58
PF04947,PF07882:PF03775:PF07195:PF02399:PF17193,0,3,0,0,3,1015,0.0,1.0,0,0,0,0,0,0,1018,0,1.0,0,0
PF14655,PF14656:PF16327:PF14837:PF07919:PF11817,13,14,7,6,7,998,0.5,0.99,0.54,0.51,0,0,13,0,1005,0,0.99,0.0,0
PF05035,PF00356:PF13735:PF01515:PF06670:PF12566,3,23,2,1,21,994,0.09,0.98,0.67,0.24,0,0,3,0,1015,0,1.0,0.0,0
PF07075,PF10106:PF14985:PF15832:PF17010:PF03238,2,3,0,2,3,1013,0.0,1.0,0.0,-0.0,0,0,2,0,1016,0,1.0,0.0,0
PF13619,PF11573:PF01392:PF00051:PF01534:PF14844,0,60,0,0,60,958,0.0,0.94,0,0,7,0,0,7,1011,0.0,0.99,0,0
PF14402,PF09685:PF02088:PF07472:PF14026:PF12346,0,1,0,0,1,1017,0.0,1.0,0,0,0,0,0,0,1018,0,1.0,0,0
PF00836,PF03285:PF04597:PF14802:PF04502:PF04440,10,31,7,3,24,984,0.23,0.97,0.7,0.39,0,0,10,0,1008,0,0.99,0.0,0
PF07000,PF14033:PF07096:PF02284:PF06172:PF01198,11,45,5,6,40,967,0.11,0.95,0.45,0.21,3,1,10,2,1005,0.33,0.99,0.09,0.17
PF00129,PF04833:PF07654:PF04859:PF01066:PF02045,6,46,6,0,40,972,0.13,0.96,1.0,0.35,3,3,3,0,1012,1.0,1.0,0.5,0.71
PF06293,PF09812:PF01784:PF01215:PF10183:PF04667,13,26,4,9,22,983,0.15,0.97,0.31,0.2,1,1,12,0,1005,1.0,0.99,0.08,0.28
PF09387,PF07738:PF07202:PF10377:PF16501:PF05715,0,34,0,0,34,984,0.0,0.97,0,0,2,0,0,2,1016,0.0,1.0,0,0
PF00326,PF02897:PF00930:PF07676:PF03059:PF14498,47,42,31,16,11,960,0.74,0.97,0.66,0.68,7,7,40,0,971,1.0,0.96,0.15,0.38
PF05067,PF06651:PF07955:PF09428:PF11179:PF15199,0,4,0,0,4,1014,0.0,1.0,0,0,0,0,0,0,1018,0,1.0,0,0
PF14619,PF07529:PF08073:PF06465:PF08880:PF16783,8,28,7,1,21,989,0.25,0.98,0.88,0.46,5,4,4,1,1009,0.8,1.0,0.5,0.63
PF05596,PF04691:PF15760:PF14986:PF06729:PF14866,0,1,0,0,1,1017,0.0,1.0,0,0,0,0,0,0,1018,0,1.0,0,0
PF09271,PF09270:PF16422:PF16423:PF03859:PF03120,13,22,13,0,9,996,0.59,0.99,1.0,0.77,3,2,11,1,1004,0.67,0.99,0.15,0.32
PF11874,PF17188:PF03888:PF15976:PF06890:PF07157,0,0,0,0,0,1018,0,1.0,0,0,0,0,0,0,1018,0,1.0,0,0
PF06897,PF15281:PF10412:PF15141:PF15212:PF15186,0,4,0,0,4,1014,0.0,1.0,0,0,0,0,0,0,1018,0,1.0,0,0
PF16579,PF08332:PF14593:PF11629:PF12605:PF06479,14,16,6,8,10,994,0.38,0.98,0.43,0.39,3,3,11,0,1004,1.0,0.99,0.21,0.46
PF10479,PF00680:PF15994:PF15995:PF11277:PF03993,8,20,4,4,16,994,0.2,0.98,0.5,0.31,0,0,8,0,1010,0,0.99,0.0,0
PF03490,PF15471:PF05229:PF13929:PF09646:PF04994,1,0,0,1,0,1017,0,1.0,0.0,0,0,0,1,0,1017,0,1.0,0.0,0
PF06969,PF13597:PF12345:PF01967:PF16881:PF13186,2,26,2,0,24,992,0.08,0.98,1.0,0.27,3,2,0,1,1015,0.67,1.0,1.0,0.82
PF12239,PF06172:PF10455:PF01774:PF07350:PF02284,10,17,2,8,15,993,0.12,0.98,0.2,0.14,0,0,10,0,1008,0,0.99,0.0,0
PF00672,PF00990:PF00015:PF08448:PF00563:PF13188,21,26,15,6,11,986,0.58,0.98,0.71,0.63,7,7,14,0,997,1.0,0.99,0.33,0.57
PF04717,PF03729:PF15529:PF01580:PF09826:PF14882,0,6,0,0,6,1012,0.0,0.99,0,0,0,0,0,0,1018,0,1.0,0,0
PF02854,PF02847:PF09088:PF09090:PF04050:PF12152,34,26,22,12,4,980,0.85,0.98,0.65,0.73,6,6,28,0,984,1.0,0.97,0.18,0.41
PF00499,PF00507:PF00124:PF00119:PF00115:PF08561,2,26,2,0,24,992,0.08,0.98,1.0,0.27,3,0,2,3,1013,0.0,1.0,0.0,-0.0
PF00397,PF09445:PF16562:PF12237:PF09068:PF00639,83,31,20,63,11,924,0.65,0.93,0.24,0.37,2,2,81,0,935,1.0,0.92,0.02,0.15
PF07394,PF09462:PF15082:PF01660:PF15548:PF08811,4,16,4,0,12,1002,0.25,0.99,1.0,0.5,0,0,4,0,1014,0,1.0,0.0,0
PF11808,PF06078:PF06114:PF14398:PF02767:PF02645,2,8,0,2,8,1008,0.0,0.99,0.0,-0.0,1,0,2,1,1015,0.0,1.0,0.0,-0.0
PF08516,PF00200:PF16698:PF02333:PF02012:PF01562,24,44,24,0,20,974,0.55,0.98,1.0,0.73,2,1,23,1,993,0.5,0.98,0.04,0.14
PF04754,PF06952:PF01668:PF15023:PF15041:PF03401,1,4,0,1,4,1013,0.0,1.0,0.0,-0.0,0,0,1,0,1017,0,1.0,0.0,0
PF08323,PF00862:PF12038:PF15924:PF13439:PF04413,6,34,3,3,31,981,0.09,0.97,0.5,0.2,1,0,6,1,1011,0.0,0.99,0.0,-0.0
PF11245,PF08497:PF02465:PF03090:PF03831:PF04740,0,0,0,0,0,1018,0,1.0,0,0,0,0,0,0,1018,0,1.0,0,0
PF16974,PF12046:PF06206:PF10674:PF05479:PF06351,0,4,0,0,4,1014,0.0,1.0,0,0,0,0,0,0,1018,0,1.0,0,0
PF01406,PF09190:PF04981:PF05622:PF10998:PF07817,19,21,7,12,14,985,0.33,0.97,0.37,0.34,2,1,18,1,998,0.5,0.98,0.05,0.16
PF10501,PF13664:PF09769:PF02698:PF11527:PF06244,2,26,1,1,25,991,0.04,0.97,0.5,0.13,2,0,2,2,1014,0.0,1.0,0.0,-0.0
PF00380,PF04981:PF08609:PF05334:PF12309:PF06858,16,33,6,10,27,975,0.18,0.96,0.38,0.24,2,1,15,1,1001,0.5,0.98,0.06,0.17
PF15679,PF13422:PF13689:PF14659:PF05013:PF01706,0,12,0,0,12,1006,0.0,0.99,0,0,0,0,0,0,1018,0,1.0,0,0
PF05238,PF02106:PF15302:PF15165:PF15087:PF15467,0,1,0,0,1,1017,0.0,1.0,0,0,0,0,0,0,1018,0,1.0,0,0
PF06719,PF12852:PF05272:PF02113:PF03705:PF07476,2,3,2,0,1,1015,0.67,1.0,1.0,0.82,0,0,2,0,1016,0,1.0,0.0,0
PF10354,PF03147:PF01409:PF02912:PF08279:PF03483,14,35,9,5,26,978,0.26,0.97,0.64,0.39,10,2,12,8,996,0.2,0.98,0.14,0.16
PF00066,PF06816:PF17101:PF17103:PF11380:PF17102,13,12,8,5,4,1001,0.67,0.99,0.62,0.64,4,4,9,0,1005,1.0,0.99,0.31,0.55
PF12736,PF05640:PF10296:PF06741:PF15017:PF04606,8,22,2,6,20,990,0.09,0.97,0.25,0.14,1,1,7,0,1010,1.0,0.99,0.12,0.35
PF17064,PF02448:PF11805:PF14986:PF15055:PF08092,6,1,0,6,1,1011,0.0,0.99,0.0,-0.0,0,0,6,0,1012,0,0.99,0.0,0
PF01778,PF04874:PF02777:PF00081:PF00166:PF13506,16,49,10,6,39,963,0.2,0.96,0.62,0.34,4,2,14,2,1000,0.5,0.98,0.12,0.24
PF00714,PF15559:PF04856:PF00236:PF15173:PF14653,1,1,0,1,1,1016,0.0,1.0,0.0,-0.0,0,0,1,0,1017,0,1.0,0.0,0
PF00078,PF05380:PF00075:PF07245:PF09337:PF13655,218,69,55,163,14,786,0.8,0.83,0.25,0.38,6,6,212,0,800,1.0,0.79,0.03,0.15
PF13270,PF11460:PF06989:PF11255:PF15767:PF15062,3,2,0,3,2,1013,0.0,1.0,0.0,-0.0,0,0,3,0,1015,0,1.0,0.0,0
PF03058,PF15823:PF04764:PF15150:PF07308:PF07157,0,0,0,0,0,1018,0,1.0,0,0,0,0,0,0,1018,0,1.0,0,0
PF09531,PF07574:PF16680:PF09748:PF05693:PF09801,12,36,4,8,32,974,0.11,0.96,0.33,0.18,3,2,10,1,1005,0.67,0.99,0.17,0.33
PF05547,PF15553:PF17017:PF15379:PF09818:PF15052,1,4,0,1,4,1013,0.0,1.0,0.0,-0.0,0,0,1,0,1017,0,1.0,0.0,0
PF02966,PF11221:PF05755:PF04643:PF11362:PF04593,14,9,2,12,7,997,0.22,0.98,0.14,0.17,0,0,14,0,1004,0,0.99,0.0,0
PF15055,PF14986:PF15109:PF04691:PF02448:PF15158,0,1,0,0,1,1017,0.0,1.0,0,0,0,0,0,0,1018,0,1.0,0,0
PF05395,PF15260:PF03488:PF05281:PF02525:PF05361,2,8,0,2,8,1008,0.0,0.99,0.0,-0.0,1,0,2,1,1015,0.0,1.0,0.0,-0.0
PF14031,PF00842:PF01168:PF08661:PF14687:PF14918,7,24,7,0,17,994,0.29,0.98,1.0,0.54,2,0,7,2,1009,0.0,0.99,0.0,-0.0
PF13875,PF01297:PF08894:PF03063:PF02086:PF13247,2,7,1,1,6,1010,0.14,0.99,0.5,0.26,0,0,2,0,1016,0,1.0,0.0,0
PF01050,PF04613:PF13720:PF06426:PF14602:PF12464,6,42,2,4,40,972,0.05,0.96,0.33,0.11,4,0,6,4,1008,0.0,0.99,0.0,-0.0
PF15191,PF14621:PF12012:PF02165:PF08163:PF11522,0,20,0,0,20,998,0.0,0.98,0,0,2,0,0,2,1016,0.0,1.0,0,0
PF00882,PF00357:PF01788:PF08441:PF01839:PF15156,0,19,0,0,19,999,0.0,0.98,0,0,3,0,0,3,1015,0.0,1.0,0,0
PF03508,PF03509:PF16791:PF00029:PF09598:PF16174,0,9,0,0,9,1009,0.0,0.99,0,0,0,0,0,0,1018,0,1.0,0,0
PF14988,PF08227:PF13870:PF15248:PF15313:PF12240,3,18,3,0,15,1000,0.17,0.99,1.0,0.41,2,1,2,1,1014,0.5,1.0,0.33,0.41
PF12256,PF03534:PF12255:PF09327:PF04196:PF11751,0,1,0,0,1,1017,0.0,1.0,0,0,0,0,0,0,1018,0,1.0,0,0
PF07149,PF03963:PF14564:PF14983:PF13588:PF05857,0,6,0,0,6,1012,0.0,0.99,0,0,0,0,0,0,1018,0,1.0,0,0
PF07524,PF04139:PF11945:PF04189:PF06221:PF10406,19,38,15,4,23,976,0.39,0.97,0.79,0.55,4,3,16,1,998,0.75,0.98,0.16,0.34
PF08758,PF08266:PF08374:PF07953:PF11587:PF02041,2,10,1,1,9,1007,0.1,0.99,0.5,0.22,1,1,1,0,1016,1.0,1.0,0.5,0.71
PF15694,PF15693:PF07500:PF06881:PF08711:PF01096,0,40,0,0,40,978,0.0,0.96,0,0,10,0,0,10,1008,0.0,0.99,0,0
PF04892,PF09216:PF17015:PF01668:PF03203:PF03553,0,3,0,0,3,1015,0.0,1.0,0,0,0,0,0,0,1018,0,1.0,0,0
PF02650,PF00008:PF01940:PF00572:PF01462:PF00675,0,119,0,0,119,899,0.0,0.88,0,0,12,0,0,12,1006,0.0,0.99,0,0
PF00527,PF15602:PF09507:PF11503:PF04212:PF10946,2,41,1,1,40,976,0.02,0.96,0.5,0.1,0,0,2,0,1016,0,1.0,0.0,0
PF15475,PF04736:PF11029:PF06875:PF14653:PF15884,1,5,0,1,5,1012,0.0,0.99,0.0,-0.0,0,0,1,0,1017,0,1.0,0.0,0
PF07875,PF17019:PF05552:PF09611:PF06381:PF02830,0,0,0,0,0,1018,0,1.0,0,0,0,0,0,0,1018,0,1.0,0,0
PF08297,PF07282:PF12600:PF01057:PF15073:PF12695,1,6,0,1,6,1011,0.0,0.99,0.0,-0.0,0,0,1,0,1017,0,1.0,0.0,0
PF09490,PF15817:PF06506:PF11751:PF02979:PF10554,0,8,0,0,8,1010,0.0,0.99,0,0,0,0,0,0,1018,0,1.0,0,0
PF04614,PF02681:PF09366:PF09419:PF08137:PF15795,7,19,2,5,17,994,0.11,0.98,0.29,0.16,0,0,7,0,1011,0,0.99,0.0,0
PF16519,PF11404:PF12372:PF07001:PF15912:PF14952,8,15,3,5,12,998,0.2,0.98,0.38,0.27,0,0,8,0,1010,0,0.99,0.0,0
PF16199,PF12345:PF06969:PF13186:PF13597:PF06466,8,22,3,5,19,991,0.14,0.98,0.38,0.22,2,2,6,0,1010,1.0,0.99,0.25,0.5
PF06403,PF11751:PF15128:PF07157:PF07409:PF14512,1,0,0,1,0,1017,0,1.0,0.0,0,0,0,1,0,1017,0,1.0,0.0,0
PF12251,PF09816:PF08634:PF05334:PF04087:PF14922,7,10,4,3,6,1005,0.4,0.99,0.57,0.47,1,1,6,0,1011,1.0,0.99,0.14,0.38
PF09675,PF08503:PF08260:PF09337:PF02188:PF10807,0,23,0,0,23,995,0.0,0.98,0,0,0,0,0,0,1018,0,1.0,0,0
PF01984,PF07080:PF07225:PF09056:PF03718:PF06388,13,12,5,8,7,998,0.42,0.99,0.38,0.39,0,0,13,0,1005,0,0.99,0.0,0
PF06680,PF01161:PF13472:PF00494:PF02801:PF01728,0,128,0,0,128,890,0.0,0.87,0,0,19,0,0,19,999,0.0,0.98,0,0
PF07046,PF00553:PF13198:PF02721:PF16030:PF09342,1,20,1,0,19,998,0.05,0.98,1.0,0.22,1,1,0,0,1017,1.0,1.0,1.0,1.0
PF13687,PF04466:PF04586:PF07016:PF07201:PF13340,2,4,0,2,4,1012,0.0,0.99,0.0,-0.0,0,0,2,0,1016,0,1.0,0.0,0
PF00611,PF09128:PF13543:PF00620:PF10291:PF00617,19,102,15,4,87,912,0.15,0.91,0.79,0.32,9,4,15,5,994,0.44,0.98,0.21,0.3
PF03159,PF01107:PF02337:PF11719:PF07744:PF11923,18,30,6,12,24,976,0.2,0.96,0.33,0.24,3,3,15,0,1000,1.0,0.99,0.17,0.41
PF13057,PF10057:PF08691:PF06403:PF06082:PF08421,0,3,0,0,3,1015,0.0,1.0,0,0,0,0,0,0,1018,0,1.0,0,0
PF06721,PF13689:PF14600:PF15100:PF06483:PF02702,2,2,0,2,2,1014,0.0,1.0,0.0,-0.0,0,0,2,0,1016,0,1.0,0.0,0
PF05138,PF08651:PF06122:PF00602:PF09501:PF11742,0,2,0,0,2,1016,0.0,1.0,0,0,0,0,0,0,1018,0,1.0,0,0
PF09297,PF09296:PF15916:PF14803:PF05026:PF10169,6,21,6,0,15,997,0.29,0.99,1.0,0.53,1,1,5,0,1012,1.0,1.0,0.17,0.41
PF12745,PF12063:PF13281:PF16797:PF08311:PF11629,7,19,4,3,15,996,0.21,0.98,0.57,0.34,3,3,4,0,1011,1.0,1.0,0.43,0.65
PF05287,PF01500:PF13885:PF04579:PF15551:PF11703,0,4,0,0,4,1014,0.0,1.0,0,0,0,0,0,0,1018,0,1.0,0,0
PF00274,PF05617:PF05051:PF07994:PF07096:PF01294,13,18,2,11,16,989,0.11,0.97,0.15,0.12,1,0,13,1,1004,0.0,0.99,0.0,-0.0
PF11898,PF02559:PF12029:PF09369:PF16204:PF07999,3,12,2,1,10,1005,0.17,0.99,0.67,0.33,2,2,1,0,1015,1.0,1.0,0.67,0.82
PF06456,PF09007:PF09058:PF15936:PF04629:PF14138,14,20,7,7,13,991,0.35,0.98,0.5,0.41,1,1,13,0,1004,1.0,0.99,0.07,0.27
PF06267,PF17206:PF04221:PF04569:PF06356:PF04466,0,2,0,0,2,1016,0.0,1.0,0,0,0,0,0,0,1018,0,1.0,0,0
PF06114,PF08805:PF10279:PF04917:PF13722:PF17007,3,1,1,2,0,1015,1.0,1.0,0.33,0.58,0,0,3,0,1015,0,1.0,0.0,0
PF07062,PF05822:PF10681:PF06324:PF10542:PF00127,1,21,0,1,21,996,0.0,0.98,0.0,-0.0,0,0,1,0,1017,0,1.0,0.0,0
PF00706,PF15119:PF02950:PF07327:PF15339:PF14519,0,3,0,0,3,1015,0.0,1.0,0,0,0,0,0,0,1018,0,1.0,0,0
PF12719,PF13890:PF08514:PF15249:PF08159:PF14959,7,29,1,6,28,983,0.03,0.97,0.14,0.06,2,0,7,2,1009,0.0,0.99,0.0,-0.0
PF01303,PF08093:PF15333:PF15212:PF15838:PF08026,0,1,0,0,1,1017,0.0,1.0,0,0,0,0,0,0,1018,0,1.0,0,0
PF01957,PF10726:PF05518:PF07273:PF10394:PF10149,0,20,0,0,20,998,0.0,0.98,0,0,0,0,0,0,1018,0,1.0,0,0
PF05161,PF13660:PF07477:PF03648:PF07488:PF02971,7,18,7,0,11,1000,0.39,0.99,1.0,0.62,3,0,7,3,1008,0.0,0.99,0.0,-0.0
PF05522,PF15343:PF14534:PF15668:PF11124:PF14290,0,2,0,0,2,1016,0.0,1.0,0,0,0,0,0,0,1018,0,1.0,0,0
PF04426,PF04425:PF08124:PF02884:PF02278:PF07171,3,5,2,1,3,1012,0.4,1.0,0.67,0.51,1,0,3,1,1014,0.0,1.0,0.0,-0.0
PF08002,PF14251:PF06573:PF08497:PF03050:PF15775,0,4,0,0,4,1014,0.0,1.0,0,0,0,0,0,0,1018,0,1.0,0,0
PF16804,PF17017:PF13750:PF08093:PF07209:PF15856,0,3,0,0,3,1015,0.0,1.0,0,0,0,0,0,0,1018,0,1.0,0,0
PF13474,PF02577:PF02151:PF09346:PF13369:PF08755,3,26,3,0,23,992,0.12,0.98,1.0,0.34,3,2,1,1,1014,0.67,1.0,0.67,0.67
PF02116,PF10180:PF07904:PF10104:PF08528:PF15264,2,22,1,1,21,995,0.05,0.98,0.5,0.15,0,0,2,0,1016,0,1.0,0.0,0
PF07333,PF11264:PF00537:PF06351:PF06232:PF15071,1,8,0,1,8,1009,0.0,0.99,0.0,-0.0,0,0,1,0,1017,0,1.0,0.0,0
PF02639,PF14467:PF01552:PF05016:PF08299:PF05930,2,14,1,1,13,1003,0.07,0.99,0.5,0.19,0,0,2,0,1016,0,1.0,0.0,0
PF07227,PF16066:PF09240:PF09067:PF06328:PF12453,2,9,1,1,8,1008,0.11,0.99,0.5,0.23,1,1,1,0,1016,1.0,1.0,0.5,0.71
PF01841,PF00868:PF00927:PF04721:PF03835:PF09736,26,22,14,12,8,984,0.64,0.98,0.54,0.58,3,3,23,0,992,1.0,0.98,0.12,0.34
PF10106,PF17206:PF09498:PF03592:PF01316:PF08404,1,3,0,1,3,1014,0.0,1.0,0.0,-0.0,0,0,1,0,1017,0,1.0,0.0,0
PF13249,PF13243:PF16711:PF01645:PF14749:PF16709,16,30,16,0,14,988,0.53,0.99,1.0,0.73,1,1,15,0,1002,1.0,0.99,0.06,0.25
PF16493,PF07526:PF12737:PF05722:PF12731:PF03791,1,6,1,0,5,1012,0.17,1.0,1.0,0.41,1,1,0,0,1017,1.0,1.0,1.0,1.0
PF10995,PF01913:PF03831:PF17206:PF03090:PF15529,0,2,0,0,2,1016,0.0,1.0,0,0,0,0,0,0,1018,0,1.0,0,0
PF10924,PF08744:PF15471:PF12479:PF11363:PF13929,0,0,0,0,0,1018,0,1.0,0,0,0,0,0,0,1018,0,1.0,0,0
PF09551,PF14976:PF09372:PF15487:PF16600:PF16553,0,4,0,0,4,1014,0.0,1.0,0,0,1,0,0,1,1017,0.0,1.0,0,0
PF06582,PF09042:PF06583:PF06789:PF00367:PF03247,4,16,3,1,13,1001,0.19,0.99,0.75,0.37,1,1,3,0,1014,1.0,1.0,0.25,0.5
PF11244,PF11235:PF11232:PF11265:PF16706:PF10488,0,9,0,0,9,1009,0.0,0.99,0,0,0,0,0,0,1018,0,1.0,0,0
PF04337,PF08345:PF12241:PF13502:PF16888:PF17206,1,4,0,1,4,1013,0.0,1.0,0.0,-0.0,0,0,1,0,1017,0,1.0,0.0,0
PF01250,PF10276:PF09805:PF10018:PF01126:PF01871,16,33,7,9,26,976,0.21,0.97,0.44,0.29,1,1,15,0,1002,1.0,0.99,0.06,0.25
PF15355,PF07505:PF08093:PF01913:PF17206:PF05962,0,4,0,0,4,1014,0.0,1.0,0,0,0,0,0,0,1018,0,1.0,0,0
PF00283,PF00421:PF00101:PF00124:PF02284:PF00499,1,26,1,0,25,992,0.04,0.98,1.0,0.19,2,0,1,2,1015,0.0,1.0,0.0,-0.0
PF02342,PF16562:PF08151:PF15625:PF16843:PF16056,4,14,1,3,13,1001,0.07,0.98,0.25,0.13,1,1,3,0,1014,1.0,1.0,0.25,0.5
PF05109,PF03729:PF08708:PF10411:PF06798:PF02572,0,2,0,0,2,1016,0.0,1.0,0,0,0,0,0,0,1018,0,1.0,0,0
PF12444,PF09667:PF16090:PF13775:PF08347:PF09011,0,20,0,0,20,998,0.0,0.98,0,0,0,0,0,0,1018,0,1.0,0,0
PF01906,PF08738:PF09252:PF07955:PF09117:PF03379,3,3,0,3,3,1012,0.0,0.99,0.0,-0.0,0,0,3,0,1015,0,1.0,0.0,0
PF13901,PF08399:PF13768:PF15057:PF09128:PF12335,24,35,12,12,23,971,0.34,0.97,0.5,0.4,5,5,19,0,994,1.0,0.98,0.21,0.45
PF00959,PF14099:PF02361:PF06500:PF07544:PF09056,5,16,2,3,14,999,0.12,0.98,0.4,0.22,1,1,4,0,1013,1.0,1.0,0.2,0.45
PF10606,PF10482:PF07001:PF06972:PF15557:PF12129,1,12,0,1,12,1005,0.0,0.99,0.0,-0.0,0,0,1,0,1017,0,1.0,0.0,0
PF02748,PF03135:PF05100:PF11751:PF16861:PF06506,2,9,0,2,9,1007,0.0,0.99,0.0,-0.0,1,0,2,1,1015,0.0,1.0,0.0,-0.0
PF12453,PF12567:PF16066:PF05473:PF03673:PF12772,2,5,2,0,3,1013,0.4,1.0,1.0,0.63,1,1,1,0,1016,1.0,1.0,0.5,0.71
PF16589,PF11626:PF06732:PF08914:PF11799:PF05406,27,55,23,4,32,959,0.42,0.96,0.85,0.58,5,5,22,0,991,1.0,0.98,0.19,0.43
PF02202,PF15829:PF15576:PF15839:PF07458:PF03823,0,5,0,0,5,1013,0.0,1.0,0,0,0,0,0,0,1018,0,1.0,0,0
PF12898,PF14216:PF10138:PF13810:PF11223:PF10446,0,6,0,0,6,1012,0.0,0.99,0,0,0,0,0,0,1018,0,1.0,0,0
PF03908,PF09496:PF04706:PF05837:PF01980:PF12483,11,12,5,6,7,1000,0.42,0.99,0.45,0.43,1,1,10,0,1007,1.0,0.99,0.09,0.3
PF08216,PF15627:PF08640:PF11374:PF11028:PF15296,5,29,3,2,26,987,0.1,0.97,0.6,0.24,2,2,3,0,1013,1.0,1.0,0.4,0.63
PF16576,PF02074:PF15834:PF17085:PF15703:PF02951,1,5,0,1,5,1012,0.0,0.99,0.0,-0.0,0,0,1,0,1017,0,1.0,0.0,0
PF00496,PF12911:PF12800:PF06808:PF01032:PF03150,14,15,3,11,12,992,0.2,0.98,0.21,0.2,2,2,12,0,1004,1.0,0.99,0.14,0.38
PF08789,PF11515:PF04023:PF00486:PF12889:PF02204,0,45,0,0,45,973,0.0,0.96,0,0,1,0,0,1,1017,0.0,1.0,0,0
PF05111,PF15064:PF15467:PF01114:PF02057:PF05463,1,5,0,1,5,1012,0.0,0.99,0.0,-0.0,0,0,1,0,1017,0,1.0,0.0,0
PF13786,PF07804:PF03613:PF08982:PF07209:PF06832,3,6,0,3,6,1009,0.0,0.99,0.0,-0.0,0,0,3,0,1015,0,1.0,0.0,0
PF12044,PF01419:PF03945:PF03018:PF08655:PF13352,4,31,0,4,31,983,0.0,0.97,0.0,-0.01,1,0,4,1,1013,0.0,1.0,0.0,-0.0
PF02815,PF02366:PF16192:PF01365:PF15012:PF02026,25,26,22,3,4,989,0.85,0.99,0.88,0.86,1,1,24,0,993,1.0,0.98,0.04,0.2
PF05508,PF16944:PF10307:PF08655:PF10446:PF08634,1,11,0,1,11,1006,0.0,0.99,0.0,-0.0,0,0,1,0,1017,0,1.0,0.0,0
PF10220,PF15012:PF07965:PF04916:PF14668:PF14663,10,21,2,8,19,989,0.1,0.97,0.2,0.13,4,2,8,2,1006,0.5,0.99,0.2,0.31
PF00940,PF14700:PF11934:PF01857:PF05645:PF02091,9,18,8,1,10,999,0.44,0.99,0.89,0.62,1,1,8,0,1009,1.0,0.99,0.11,0.33
PF00291,PF00290:PF14821:PF00571:PF01546:PF00585,56,91,31,25,60,902,0.34,0.92,0.55,0.39,3,3,53,0,962,1.0,0.95,0.05,0.23
PF04558,PF04557:PF03950:PF00749:PF00458:PF16313,12,42,12,0,30,976,0.29,0.97,1.0,0.53,16,11,1,5,1001,0.69,0.99,0.92,0.79
PF04588,PF01896:PF09793:PF10280:PF00830:PF00159,13,20,4,9,16,989,0.2,0.98,0.31,0.24,2,2,11,0,1005,1.0,0.99,0.15,0.39
PF10650,PF16574:PF16830:PF14858:PF12325:PF15651,3,11,1,2,10,1005,0.09,0.99,0.33,0.17,0,0,3,0,1015,0,1.0,0.0,0
PF05189,PF01137:PF01523:PF01658:PF13280:PF06249,3,25,3,0,22,993,0.12,0.98,1.0,0.34,1,1,2,0,1015,1.0,1.0,0.33,0.58
PF03031,PF10213:PF08511:PF07535:PF12057:PF01834,43,23,11,32,12,963,0.48,0.96,0.26,0.33,1,1,42,0,975,1.0,0.96,0.02,0.15
PF09421,PF14474:PF15378:PF01358:PF17078:PF06485,4,9,1,3,8,1006,0.11,0.99,0.25,0.16,0,0,4,0,1014,0,1.0,0.0,0
PF06547,PF13441:PF13705:PF15419:PF13436:PF05495,3,13,2,1,11,1004,0.15,0.99,0.67,0.32,2,2,1,0,1015,1.0,1.0,0.67,0.82
PF09835,PF12046:PF08092:PF15173:PF15152:PF15172,3,3,0,3,3,1012,0.0,0.99,0.0,-0.0,0,0,3,0,1015,0,1.0,0.0,0
PF04000,PF08528:PF06886:PF04910:PF04908:PF17098,16,28,6,10,22,980,0.21,0.97,0.38,0.27,1,0,16,1,1001,0.0,0.98,0.0,-0.0
PF06345,PF06346:PF06367:PF10377:PF06371:PF02181,4,44,4,0,40,974,0.09,0.96,1.0,0.3,21,4,0,17,997,0.19,0.98,1.0,0.43
PF00343,PF01896:PF04819:PF07156:PF05007:PF09326,22,37,6,16,31,965,0.16,0.95,0.27,0.19,3,3,19,0,996,1.0,0.98,0.14,0.37
PF08574,PF15247:PF02045:PF13864:PF02234:PF08528,5,25,3,2,22,991,0.12,0.98,0.6,0.26,2,2,3,0,1013,1.0,1.0,0.4,0.63
PF04854,PF16784:PF14541:PF12437:PF05262:PF13271,2,31,1,1,30,986,0.03,0.97,0.5,0.12,1,0,2,1,1015,0.0,1.0,0.0,-0.0
PF02256,PF02906:PF00037:PF12617:PF04836:PF03070,4,36,4,0,32,982,0.11,0.97,1.0,0.33,2,0,4,2,1012,0.0,0.99,0.0,-0.0
PF01682,PF09067:PF12772:PF16066:PF06583:PF09291,12,2,1,11,1,1005,0.5,0.99,0.08,0.2,1,1,11,0,1006,1.0,0.99,0.08,0.29
PF15843,PF15623:PF02277:PF00419:PF06798:PF08964,0,4,0,0,4,1014,0.0,1.0,0,0,0,0,0,0,1018,0,1.0,0,0
PF15116,PF11341:PF15828:PF03238:PF08040:PF08857,0,5,0,0,5,1013,0.0,1.0,0,0,0,0,0,0,1018,0,1.0,0,0
PF07338,PF06798:PF06890:PF15281:PF02277:PF17076,5,6,0,5,6,1007,0.0,0.99,0.0,-0.01,0,0,5,0,1013,0,1.0,0.0,0
PF11102,PF06105:PF00637:PF00578:PF04179:PF01169,0,67,0,0,67,951,0.0,0.93,0,0,4,0,0,4,1014,0.0,1.0,0,0
PF14847,PF16533:PF09246:PF12202:PF14786:PF10534,6,14,4,2,10,1002,0.29,0.99,0.67,0.43,1,1,5,0,1012,1.0,1.0,0.17,0.41
PF01834,PF08605:PF00649:PF07535:PF16892:PF06972,6,18,1,5,17,995,0.06,0.98,0.17,0.09,0,0,6,0,1012,0,0.99,0.0,0
PF06418,PF00697:PF08252:PF00977:PF00218:PF04715,19,31,7,12,24,975,0.23,0.96,0.37,0.27,1,1,18,0,999,1.0,0.98,0.05,0.23
PF16051,PF08632:PF01430:PF09444:PF12628:PF09818,0,8,0,0,8,1010,0.0,0.99,0,0,0,0,0,0,1018,0,1.0,0,0
PF14710,PF02613:PF02588:PF13090:PF02578:PF10410,2,10,1,1,9,1007,0.1,0.99,0.5,0.22,0,0,2,0,1016,0,1.0,0.0,0
PF03938,PF03090:PF08411:PF10793:PF08299:PF05974,6,3,0,6,3,1009,0.0,0.99,0.0,-0.0,0,0,6,0,1012,0,0.99,0.0,0
PF05658,PF13018:PF05662:PF04624:PF02951:PF16590,0,7,0,0,7,1011,0.0,0.99,0,0,0,0,0,0,1018,0,1.0,0,0
PF04593,PF07561:PF15095:PF15752:PF14294:PF03755,0,4,0,0,4,1014,0.0,1.0,0,0,0,0,0,0,1018,0,1.0,0,0
PF03966,PF05365:PF08231:PF06098:PF01641:PF16054,7,26,3,4,23,988,0.12,0.97,0.43,0.21,2,1,6,1,1010,0.5,0.99,0.14,0.26
PF02752,PF05404:PF00339:PF00852:PF08213:PF04577,30,64,28,2,36,952,0.44,0.96,0.93,0.62,4,3,27,1,987,0.75,0.97,0.1,0.27
PF11666,PF02931:PF17209:PF02696:PF00644:PF13606,0,123,0,0,123,895,0.0,0.88,0,0,11,0,0,11,1007,0.0,0.99,0,0
PF10441,PF17034:PF12372:PF15027:PF11781:PF14952,5,16,2,3,14,999,0.12,0.98,0.4,0.22,1,1,4,0,1013,1.0,1.0,0.2,0.45
PF05050,PF13532:PF08592:PF08498:PF13383:PF07722,17,57,7,10,50,951,0.12,0.94,0.41,0.2,4,2,15,2,999,0.5,0.98,0.12,0.24
PF16045,PF14775:PF15456:PF06637:PF10506:PF15877,7,10,2,5,8,1003,0.2,0.99,0.29,0.23,0,0,7,0,1011,0,0.99,0.0,0
PF13952,PF13960:PF13963:PF02992:PF03004:PF03017,3,29,3,0,26,989,0.1,0.97,1.0,0.32,6,2,1,4,1011,0.33,1.0,0.67,0.47
PF13426,PF08447:PF00027:PF13188:PF08629:PF00989,33,107,28,5,79,906,0.26,0.92,0.85,0.44,14,11,22,3,982,0.79,0.98,0.33,0.5
PF11437,PF15281:PF10412:PF13390:PF05489:PF07338,0,8,0,0,8,1010,0.0,0.99,0,0,0,0,0,0,1018,0,1.0,0,0
PF00411,PF00329:PF01196:PF01058:PF00119:PF00507,23,37,8,15,29,966,0.22,0.96,0.35,0.25,6,4,19,2,993,0.67,0.98,0.17,0.33
PF01552,PF12080:PF00947:PF07476:PF11863:PF16449,12,12,12,0,0,1006,1.0,1.0,1.0,1.0,0,0,12,0,1006,0,0.99,0.0,0
PF15131,PF09699:PF11123:PF06197:PF14496:PF15076,0,1,0,0,1,1017,0.0,1.0,0,0,0,0,0,0,1018,0,1.0,0,0
PF08653,PF06485:PF06989:PF12855:PF17078:PF15863,1,7,0,1,7,1010,0.0,0.99,0.0,-0.0,0,0,1,0,1017,0,1.0,0.0,0
PF03044,PF05445:PF00004:PF00400:PF00207:PF13994,0,313,0,0,313,705,0.0,0.69,0,0,15,0,0,15,1003,0.0,0.99,0,0
PF00742,PF03447:PF01958:PF10000:PF13840:PF01817,9,31,7,2,24,985,0.23,0.97,0.78,0.41,4,3,6,1,1008,0.75,0.99,0.33,0.5
PF05014,PF06581:PF07544:PF04856:PF06875:PF02024,3,7,0,3,7,1008,0.0,0.99,0.0,-0.0,0,0,3,0,1015,0,1.0,0.0,0
PF05736,PF16325:PF12477:PF08497:PF02465:PF10566,0,1,0,0,1,1017,0.0,1.0,0,0,0,0,0,0,1018,0,1.0,0,0
PF03911,PF01097:PF03657:PF10244:PF08561:PF10780,8,20,3,5,17,993,0.15,0.98,0.38,0.23,1,1,7,0,1010,1.0,0.99,0.12,0.35
PF15497,PF00706:PF05962:PF15838:PF03379:PF09612,1,2,0,1,2,1015,0.0,1.0,0.0,-0.0,0,0,1,0,1017,0,1.0,0.0,0
PF03446,PF14833:PF00393:PF17042:PF07005:PF01116,37,39,25,12,14,967,0.64,0.97,0.68,0.64,8,8,29,0,981,1.0,0.97,0.22,0.46
PF17054,PF08444:PF08140:PF03768:PF03769:PF09051,6,4,0,6,4,1008,0.0,0.99,0.0,-0.0,0,0,6,0,1012,0,0.99,0.0,0
PF12755,PF13001:PF11916:PF12074:PF12397:PF16507,12,34,9,3,25,981,0.26,0.97,0.75,0.44,2,2,10,0,1006,1.0,0.99,0.17,0.41
PF13911,PF01632:PF02046:PF01097:PF07896:PF08641,17,19,6,11,13,988,0.32,0.98,0.35,0.32,0,0,17,0,1001,0,0.98,0.0,0
PF05057,PF12394:PF17111:PF01734:PF00710:PF17046,32,72,20,12,52,934,0.28,0.94,0.62,0.39,5,5,27,0,986,1.0,0.97,0.16,0.39
PF01683,PF14625:PF04942:PF00368:PF12349:PF01401,21,50,15,6,35,962,0.3,0.96,0.71,0.45,2,2,19,0,997,1.0,0.98,0.1,0.31
PF04434,PF03108:PF03101:PF10551:PF10532:PF10536,24,75,23,1,52,942,0.31,0.95,0.96,0.53,12,10,14,2,992,0.83,0.98,0.42,0.58
PF12626,PF00308:PF04984:PF02211:PF00915:PF13735,3,9,3,0,6,1009,0.33,0.99,1.0,0.58,0,0,3,0,1015,0,1.0,0.0,0
PF00219,PF00007:PF00050:PF09289:PF13180:PF10591,8,53,5,3,48,962,0.09,0.95,0.62,0.23,4,3,5,1,1009,0.75,0.99,0.38,0.53
PF11308,PF04320:PF07312:PF11529:PF13340:PF09611,0,4,0,0,4,1014,0.0,1.0,0,0,0,0,0,0,1018,0,1.0,0,0
PF05265,PF02557:PF16824:PF07980:PF09614:PF12707,0,2,0,0,2,1016,0.0,1.0,0,0,0,0,0,0,1018,0,1.0,0,0
PF06956,PF02979:PF03888:PF17188:PF09904:PF06403,2,4,0,2,4,1012,0.0,0.99,0.0,-0.0,0,0,2,0,1016,0,1.0,0.0,0
PF09500,PF11750:PF01361:PF15658:PF16901:PF13471,0,14,0,0,14,1004,0.0,0.99,0,0,0,0,0,0,1018,0,1.0,0,0
PF14922,PF12948:PF06428:PF15311:PF11727:PF15619,4,17,3,1,14,1000,0.18,0.99,0.75,0.36,0,0,4,0,1014,0,1.0,0.0,0
PF08777,PF14304:PF12196:PF08081:PF12220:PF06495,12,14,5,7,9,997,0.36,0.98,0.42,0.38,1,1,11,0,1006,1.0,0.99,0.08,0.29
PF11230,PF10105:PF11842:PF06962:PF04794:PF12345,2,3,2,0,1,1015,0.67,1.0,1.0,0.82,2,2,0,0,1016,1.0,1.0,1.0,1.0
PF12606,PF11831:PF07557:PF15742:PF06294:PF15877,2,26,1,1,25,991,0.04,0.97,0.5,0.13,0,0,2,0,1016,0,1.0,0.0,0
PF03233,PF03883:PF06639:PF16590:PF07326:PF15175,0,3,0,0,3,1015,0.0,1.0,0,0,0,0,0,0,1018,0,1.0,0,0
PF06883,PF10385:PF04561:PF04563:PF04560:PF00562,5,27,5,0,22,991,0.19,0.98,1.0,0.43,17,3,2,14,999,0.18,0.98,0.6,0.32
PF10698,PF06724:PF05939:PF12628:PF04965:PF03525,0,0,0,0,0,1018,0,1.0,0,0,0,0,0,0,1018,0,1.0,0,0
PF09655,PF14094:PF04748:PF04608:PF10865:PF12932,0,13,0,0,13,1005,0.0,0.99,0,0,0,0,0,0,1018,0,1.0,0,0
PF16500,PF13825:PF12188:PF01617:PF01032:PF16210,1,17,0,1,17,1000,0.0,0.98,0.0,-0.0,0,0,1,0,1017,0,1.0,0.0,0
PF07428,PF03553:PF15555:PF15756:PF03050:PF15185,0,5,0,0,5,1013,0.0,1.0,0,0,0,0,0,0,1018,0,1.0,0,0
PF05043,PF11975:PF02056:PF05513:PF06761:PF05509,5,8,2,3,6,1007,0.25,0.99,0.4,0.31,1,1,4,0,1013,1.0,1.0,0.2,0.45
PF05742,PF05719:PF06172:PF10165:PF03932:PF03972,5,35,2,3,33,980,0.06,0.96,0.4,0.14,2,2,3,0,1013,1.0,1.0,0.4,0.63
PF15472,PF15175:PF08945:PF09365:PF15046:PF05853,0,6,0,0,6,1012,0.0,0.99,0,0,0,0,0,0,1018,0,1.0,0,0
PF15664,PF15119:PF15809:PF05399:PF08040:PF15158,0,2,0,0,2,1016,0.0,1.0,0,0,0,0,0,0,1018,0,1.0,0,0
PF07544,PF12046:PF00737:PF06912:PF09459:PF06351,6,7,0,6,7,1005,0.0,0.99,0.0,-0.01,0,0,6,0,1012,0,0.99,0.0,0
PF04984,PF13722:PF03090:PF08411:PF07409:PF12080,0,1,0,0,1,1017,0.0,1.0,0,0,0,0,0,0,1018,0,1.0,0,0
PF02822,PF02961:PF09307:PF08831:PF11851:PF05375,12,12,4,8,8,998,0.33,0.98,0.33,0.33,0,0,12,0,1006,0,0.99,0.0,0
PF02107,PF02501:PF06429:PF03963:PF14882:PF13007,2,4,2,0,2,1014,0.5,1.0,1.0,0.71,0,0,2,0,1016,0,1.0,0.0,0
PF05912,PF04402:PF00727:PF00714:PF03488:PF14672,3,11,1,2,10,1005,0.09,0.99,0.33,0.17,0,0,3,0,1015,0,1.0,0.0,0
PF00570,PF09382:PF14493:PF01612:PF16202:PF16124,30,71,29,1,42,946,0.41,0.96,0.97,0.61,11,10,20,1,987,0.91,0.98,0.33,0.54
PF08386,PF04083:PF10329:PF16862:PF07035:PF11176,18,52,9,9,43,957,0.17,0.95,0.5,0.27,2,1,17,1,999,0.5,0.98,0.06,0.16
PF08370,PF06422:PF14510:PF08352:PF12399:PF00496,7,35,5,2,30,981,0.14,0.97,0.71,0.31,2,2,5,0,1011,1.0,1.0,0.29,0.53
PF02991,PF10229:PF02661:PF02628:PF01641:PF04110,16,40,8,8,32,970,0.2,0.96,0.5,0.3,3,2,14,1,1001,0.67,0.99,0.12,0.28
PF17110,PF15664:PF08591:PF09428:PF13367:PF04681,0,7,0,0,7,1011,0.0,0.99,0,0,0,0,0,0,1018,0,1.0,0,0
PF04424,PF01085:PF01079:PF15299:PF07973:PF12402,16,45,12,4,33,969,0.27,0.96,0.75,0.43,1,0,16,1,1001,0.0,0.98,0.0,-0.0
PF05207,PF14901:PF00684:PF14308:PF02296:PF15990,14,21,5,9,16,988,0.24,0.98,0.36,0.28,0,0,14,0,1004,0,0.99,0.0,0
PF11032,PF15109:PF15158:PF02448:PF15559:PF04856,3,0,0,3,0,1015,0,1.0,0.0,0,0,0,3,0,1015,0,1.0,0.0,0
PF13340,PF09684:PF04586:PF02452:PF05736:PF16997,3,4,2,1,2,1013,0.5,1.0,0.67,0.58,0,0,3,0,1015,0,1.0,0.0,0
PF05438,PF15744:PF04360:PF03883:PF15829:PF15175,2,3,1,1,2,1014,0.33,1.0,0.5,0.41,0,0,2,0,1016,0,1.0,0.0,0
PF14818,PF07558:PF07001:PF15557:PF10482:PF06972,7,11,2,5,9,1002,0.18,0.99,0.29,0.22,0,0,7,0,1011,0,0.99,0.0,0
PF02933,PF02359:PF05362:PF01749:PF05695:PF00699,10,51,8,2,43,965,0.16,0.96,0.8,0.34,4,4,6,0,1008,1.0,0.99,0.4,0.63
PF02194,PF08628:PF16646:PF12828:PF00615:PF03700,19,63,16,3,47,952,0.25,0.95,0.84,0.45,1,1,18,0,999,1.0,0.98,0.05,0.23
PF02109,PF12006:PF14832:PF14955:PF07347:PF14087,5,25,3,2,22,991,0.12,0.98,0.6,0.26,2,1,4,1,1012,0.5,1.0,0.2,0.31
PF00203,PF00252:PF09439:PF07106:PF06388:PF04176,18,34,7,11,27,973,0.21,0.96,0.39,0.27,4,2,16,2,998,0.5,0.98,0.11,0.23
PF12372,PF14952:PF15912:PF12231:PF10441:PF14726,6,16,1,5,15,997,0.06,0.98,0.17,0.09,0,0,6,0,1012,0,0.99,0.0,0
PF08257,PF02951:PF00997:PF00972:PF06937:PF15169,0,9,0,0,9,1009,0.0,0.99,0,0,0,0,0,0,1018,0,1.0,0,0
PF00010,PF08447:PF11413:PF08815:PF08832:PF16279,100,30,19,81,11,907,0.63,0.91,0.19,0.31,6,5,95,1,917,0.83,0.91,0.05,0.19
PF17056,PF08591:PF06695:PF11341:PF07444:PF02361,0,7,0,0,7,1011,0.0,0.99,0,0,0,0,0,0,1018,0,1.0,0,0
PF09067,PF12772:PF06328:PF16066:PF07227:PF09240,2,8,1,1,7,1009,0.12,0.99,0.5,0.25,1,1,1,0,1016,1.0,1.0,0.5,0.71
PF15118,PF06056:PF06608:PF15050:PF14877:PF14986,3,8,1,2,7,1008,0.12,0.99,0.33,0.2,0,0,3,0,1015,0,1.0,0.0,0
PF13388,PF12240:PF15866:PF15248:PF15742:PF05459,0,10,0,0,10,1008,0.0,0.99,0,0,0,0,0,0,1018,0,1.0,0,0
PF02743,PF08473:PF13757:PF08399:PF06668:PF08487,14,17,5,9,12,992,0.29,0.98,0.36,0.31,3,1,13,2,1002,0.33,0.99,0.07,0.15
PF08576,PF12046:PF02427:PF17032:PF02531:PF09348,3,3,1,2,2,1013,0.33,1.0,0.33,0.33,0,0,3,0,1015,0,1.0,0.0,0
PF05722,PF12731:PF12737:PF07526:PF16493:PF03791,1,6,1,0,5,1012,0.17,1.0,1.0,0.41,1,1,0,0,1017,1.0,1.0,1.0,1.0
PF10009,PF06890:PF02565:PF02399:PF15768:PF04355,0,2,0,0,2,1016,0.0,1.0,0,0,0,0,0,0,1018,0,1.0,0,0
PF08494,PF07077:PF04740:PF06864:PF13780:PF14376,3,6,3,0,3,1012,0.5,1.0,1.0,0.71,0,0,3,0,1015,0,1.0,0.0,0
PF06530,PF05947:PF06798:PF03888:PF04965:PF03241,1,0,0,1,0,1017,0,1.0,0.0,0,0,0,1,0,1017,0,1.0,0.0,0
PF00088,PF16863:PF17137:PF16338:PF13802:PF03423,16,29,8,8,21,981,0.28,0.97,0.5,0.36,4,3,13,1,1001,0.75,0.99,0.19,0.37
PF16925,PF13750:PF13722:PF06798:PF16325:PF04984,1,1,0,1,1,1016,0.0,1.0,0.0,-0.0,0,0,1,0,1017,0,1.0,0.0,0
PF04960,PF16553:PF09310:PF11904:PF00710:PF15898,6,24,2,4,22,990,0.08,0.97,0.33,0.16,1,1,5,0,1012,1.0,1.0,0.17,0.41
PF16483,PF04229:PF05870:PF10868:PF02605:PF10705,4,7,1,3,6,1008,0.14,0.99,0.25,0.18,0,0,4,0,1014,0,1.0,0.0,0
PF04189,PF02731:PF05334:PF10998:PF10188:PF15067,12,16,1,11,15,991,0.06,0.97,0.08,0.06,0,0,12,0,1006,0,0.99,0.0,0
PF12377,PF12361:PF15445:PF15447:PF03011:PF11556,1,1,1,0,0,1017,1.0,1.0,1.0,1.0,1,1,0,0,1017,1.0,1.0,1.0,1.0
PF11033,PF00025:PF08249:PF15840:PF08097:PF10048,0,65,0,0,65,953,0.0,0.94,0,0,1,0,0,1,1017,0.0,1.0,0,0
PF07798,PF04729:PF10276:PF09805:PF05301:PF03479,8,22,4,4,18,992,0.18,0.98,0.5,0.29,1,1,7,0,1010,1.0,0.99,0.12,0.35
PF12448,PF04849:PF16978:PF05422:PF16070:PF16979,2,26,2,0,24,992,0.08,0.98,1.0,0.27,3,1,1,2,1014,0.33,1.0,0.5,0.41
PF09976,PF14308:PF00684:PF14901:PF09350:PF08492,7,22,2,5,20,991,0.09,0.98,0.29,0.15,0,0,7,0,1011,0,0.99,0.0,0
PF03407,PF03016:PF10250:PF03106:PF07887:PF00484,16,73,9,7,64,938,0.12,0.93,0.56,0.24,12,4,12,8,994,0.33,0.98,0.25,0.28
PF06736,PF08204:PF02165:PF04549:PF14161:PF14145,1,2,0,1,2,1015,0.0,1.0,0.0,-0.0,0,0,1,0,1017,0,1.0,0.0,0
PF08072,PF09382:PF16204:PF16202:PF16124:PF08061,7,30,7,0,23,988,0.23,0.98,1.0,0.48,7,7,0,0,1011,1.0,1.0,1.0,1.0
PF13243,PF13249:PF01645:PF03028:PF05746:PF04898,17,67,17,0,50,951,0.25,0.95,1.0,0.49,7,6,11,1,1000,0.86,0.99,0.35,0.55
PF14243,PF15851:PF04223:PF13530:PF17061:PF06670,0,3,0,0,3,1015,0.0,1.0,0,0,0,0,0,0,1018,0,1.0,0,0
PF11561,PF15727:PF15482:PF13767:PF07661:PF15529,1,2,0,1,2,1015,0.0,1.0,0.0,-0.0,0,0,1,0,1017,0,1.0,0.0,0
PF02786,PF00988:PF01808:PF01039:PF02729:PF00185,50,63,31,19,32,936,0.49,0.95,0.62,0.53,13,13,37,0,968,1.0,0.96,0.26,0.5
PF16495,PF16498:PF14379:PF16772:PF16496:PF08558,9,19,8,1,11,998,0.42,0.99,0.89,0.61,1,1,8,0,1009,1.0,0.99,0.11,0.33
PF08537,PF08210:PF08766:PF15943:PF12276:PF04237,0,38,0,0,38,980,0.0,0.96,0,0,0,0,0,0,1018,0,1.0,0,0
PF08983,PF03827:PF10413:PF09193:PF12109:PF12369,1,5,1,0,4,1013,0.2,1.0,1.0,0.45,1,1,0,0,1017,1.0,1.0,1.0,1.0
PF06050,PF09989:PF17192:PF02056:PF03882:PF13746,0,12,0,0,12,1006,0.0,0.99,0,0,0,0,0,0,1018,0,1.0,0,0
PF17137,PF16338:PF00088:PF16863:PF13802:PF03423,6,35,4,2,31,981,0.11,0.97,0.67,0.27,9,2,4,7,1005,0.22,0.99,0.33,0.27
PF01428,PF01754:PF05839:PF02099:PF02338:PF10213,26,56,13,13,43,949,0.23,0.94,0.5,0.32,4,4,22,0,992,1.0,0.98,0.15,0.39
PF09418,PF12126:PF15451:PF03915:PF06211:PF10631,3,9,1,2,8,1007,0.11,0.99,0.33,0.19,2,1,2,1,1014,0.5,1.0,0.33,0.41
PF07444,PF12046:PF00737:PF00489:PF08576:PF15550,0,5,0,0,5,1013,0.0,1.0,0,0,0,0,0,0,1018,0,1.0,0,0
PF15272,PF14842:PF02056:PF08299:PF14841:PF01706,0,9,0,0,9,1009,0.0,0.99,0,0,1,0,0,1,1017,0.0,1.0,0,0
PF04403,PF15395:PF12381:PF16473:PF07394:PF07891,3,10,0,3,10,1005,0.0,0.99,0.0,-0.01,0,0,3,0,1015,0,1.0,0.0,0
PF15934,PF15821:PF13096:PF13870:PF05837:PF11831,0,15,0,0,15,1003,0.0,0.99,0,0,0,0,0,0,1018,0,1.0,0,0
PF01576,PF02736:PF00063:PF12460:PF14432:PF12036,21,98,19,2,79,918,0.19,0.92,0.9,0.4,10,4,17,6,991,0.4,0.98,0.19,0.27
PF12462,PF00516:PF11862:PF06082:PF02561:PF04984,2,1,0,2,1,1015,0.0,1.0,0.0,-0.0,0,0,2,0,1016,0,1.0,0.0,0
PF03692,PF15062:PF08692:PF13270:PF15621:PF09216,1,3,0,1,3,1014,0.0,1.0,0.0,-0.0,0,0,1,0,1017,0,1.0,0.0,0
PF08885,PF12098:PF07157:PF10566:PF07308:PF17076,1,0,0,1,0,1017,0,1.0,0.0,0,0,0,1,0,1017,0,1.0,0.0,0
PF02464,PF02371:PF14659:PF08761:PF15014:PF11175,7,7,0,7,7,1004,0.0,0.99,0.0,-0.01,0,0,7,0,1011,0,0.99,0.0,0
PF07831,PF02885:PF00591:PF08125:PF05683:PF09284,2,21,2,0,19,997,0.1,0.98,1.0,0.31,3,0,2,3,1013,0.0,1.0,0.0,-0.0
PF03004,PF03017:PF10226:PF04880:PF12180:PF09787,20,15,5,15,10,988,0.33,0.98,0.25,0.28,0,0,20,0,998,0,0.98,0.0,0
PF08414,PF08022:PF01794:PF03807:PF08030:PF05684,10,60,9,1,51,957,0.15,0.95,0.9,0.36,39,9,1,30,978,0.23,0.97,0.9,0.45
PF15086,PF05128:PF06780:PF10662:PF09269:PF14714,3,6,1,2,5,1010,0.17,0.99,0.33,0.23,1,1,2,0,1015,1.0,1.0,0.33,0.58
PF02833,PF01368:PF03074:PF12735:PF07971:PF06312,13,39,11,2,28,977,0.28,0.97,0.85,0.48,1,1,12,0,1005,1.0,0.99,0.08,0.28
PF03061,PF10457:PF01852:PF09724:PF02990:PF08652,31,55,14,17,41,946,0.25,0.94,0.45,0.31,11,7,24,4,983,0.64,0.97,0.23,0.37
PF09495,PF06842:PF03962:PF05512:PF06825:PF04110,1,24,0,1,24,993,0.0,0.98,0.0,-0.0,2,0,1,2,1015,0.0,1.0,0.0,-0.0
PF08854,PF05939:PF09951:PF08453:PF11593:PF00813,0,4,0,0,4,1014,0.0,1.0,0,0,0,0,0,0,1018,0,1.0,0,0
PF01351,PF10498:PF08617:PF09696:PF04176:PF10259,16,26,8,8,18,984,0.31,0.97,0.5,0.38,4,4,12,0,1002,1.0,0.99,0.25,0.5
PF13767,PF14841:PF13722:PF07157:PF05840:PF03241,0,1,0,0,1,1017,0.0,1.0,0,0,0,0,0,0,1018,0,1.0,0,0
PF14738,PF16501:PF14662:PF02213:PF15246:PF14722,4,23,1,3,22,992,0.04,0.98,0.25,0.1,0,0,4,0,1014,0,1.0,0.0,0
PF12323,PF07282:PF08297:PF02477:PF12600:PF15073,1,4,1,0,3,1014,0.25,1.0,1.0,0.5,0,0,1,0,1017,0,1.0,0.0,0
PF02977,PF15556:PF06729:PF15119:PF14866:PF15825,0,1,0,0,1,1017,0.0,1.0,0,0,0,0,0,0,1018,0,1.0,0,0
PF08457,PF10638:PF02916:PF17077:PF12449:PF11604,7,6,0,7,6,1005,0.0,0.99,0.0,-0.01,0,0,7,0,1011,0,0.99,0.0,0
PF08911,PF00638:PF04065:PF08604:PF07156:PF16764,6,45,5,1,40,972,0.11,0.96,0.83,0.3,4,2,4,2,1010,0.5,0.99,0.33,0.41
PF11398,PF01874:PF07661:PF11775:PF04011:PF07016,0,3,0,0,3,1015,0.0,1.0,0,0,0,0,0,0,1018,0,1.0,0,0
PF09663,PF15128:PF01752:PF05857:PF14251:PF06798,2,4,0,2,4,1012,0.0,0.99,0.0,-0.0,0,0,2,0,1016,0,1.0,0.0,0
PF04414,PF10340:PF10868:PF08058:PF05870:PF08193,3,3,1,2,2,1013,0.33,1.0,0.33,0.33,0,0,3,0,1015,0,1.0,0.0,0
PF01172,PF09377:PF02537:PF13506:PF14145:PF13880,10,23,8,2,15,993,0.35,0.98,0.8,0.52,0,0,10,0,1008,0,0.99,0.0,0
PF03372,PF14529:PF13966:PF02383:PF08333:PF02994,66,135,46,20,89,863,0.34,0.89,0.7,0.44,13,11,55,2,950,0.85,0.94,0.17,0.36
PF15200,PF17076:PF02557:PF15192:PF15340:PF06724,0,4,0,0,4,1014,0.0,1.0,0,0,0,0,0,0,1018,0,1.0,0,0
PF00727,PF02024:PF06351:PF15071:PF04402:PF16716,4,8,1,3,7,1007,0.12,0.99,0.25,0.17,0,0,4,0,1014,0,1.0,0.0,0
PF15132,PF08945:PF15754:PF15046:PF15207:PF07353,0,4,0,0,4,1014,0.0,1.0,0,0,0,0,0,0,1018,0,1.0,0,0
PF12177,PF05494:PF11892:PF03706:PF10410:PF07494,2,7,0,2,7,1009,0.0,0.99,0.0,-0.0,0,0,2,0,1016,0,1.0,0.0,0
PF15389,PF12540:PF15230:PF12478:PF15888:PF05548,1,7,0,1,7,1010,0.0,0.99,0.0,-0.0,0,0,1,0,1017,0,1.0,0.0,0
PF14233,PF11769:PF06479:PF12605:PF05568:PF08477,0,37,0,0,37,981,0.0,0.96,0,0,2,0,0,2,1016,0.0,1.0,0,0
PF07391,PF13876:PF12603:PF07494:PF07804:PF01706,0,5,0,0,5,1013,0.0,1.0,0,0,0,0,0,0,1018,0,1.0,0,0
PF13232,PF08847:PF13013:PF03379:PF15097:PF09252,0,3,0,0,3,1015,0.0,1.0,0,0,0,0,0,0,1018,0,1.0,0,0
PF14821,PF00290:PF00585:PF00291:PF00275:PF01761,7,70,7,0,63,948,0.1,0.94,1.0,0.31,5,1,6,4,1007,0.2,0.99,0.14,0.16
PF03235,PF13810:PF16071:PF11223:PF05841:PF11179,4,4,1,3,3,1011,0.25,0.99,0.25,0.25,0,0,4,0,1014,0,1.0,0.0,0
PF01738,PF03211:PF04199:PF04979:PF05042:PF12296,19,39,12,7,27,972,0.31,0.97,0.63,0.43,9,6,13,3,996,0.67,0.98,0.32,0.45
PF07681,PF01654:PF07954:PF05218:PF00070:PF06573,2,13,2,0,11,1005,0.15,0.99,1.0,0.39,0,0,2,0,1016,0,1.0,0.0,0
PF08488,PF14380:PF13947:PF08515:PF16579:PF08332,6,39,6,0,33,979,0.15,0.97,1.0,0.39,5,3,3,2,1010,0.6,1.0,0.5,0.55
PF00049,PF08365:PF00375:PF10261:PF04790:PF16680,8,22,3,5,19,991,0.14,0.98,0.38,0.22,1,1,7,0,1010,1.0,0.99,0.12,0.35
PF12440,PF01454:PF17187:PF10806:PF12735:PF12470,1,17,1,0,16,1001,0.06,0.98,1.0,0.24,2,0,1,2,1015,0.0,1.0,0.0,-0.0
PF02886,PF01273:PF01144:PF04833:PF00273:PF08442,13,40,12,1,28,977,0.3,0.97,0.92,0.52,3,3,10,0,1005,1.0,0.99,0.23,0.48
PF10159,PF04090:PF08528:PF10104:PF15264:PF11001,11,16,4,7,12,995,0.25,0.98,0.36,0.29,2,1,10,1,1006,0.5,0.99,0.09,0.21
PF10198,PF10307:PF09463:PF10336:PF10446:PF14977,4,8,1,3,7,1007,0.12,0.99,0.25,0.17,0,0,4,0,1014,0,1.0,0.0,0
PF01696,PF13005:PF13362:PF08856:PF02108:PF10661,0,0,0,0,0,1018,0,1.0,0,0,0,0,0,0,1018,0,1.0,0,0
PF08119,PF12084:PF07700:PF06873:PF14057:PF10828,1,14,0,1,14,1003,0.0,0.99,0.0,-0.0,0,0,1,0,1017,0,1.0,0.0,0
PF01634,PF08029:PF00674:PF05179:PF03102:PF08666,6,20,6,0,14,998,0.3,0.99,1.0,0.54,0,0,6,0,1012,0,0.99,0.0,0
PF10231,PF12494:PF06632:PF01702:PF09430:PF14895,8,25,3,5,22,988,0.12,0.97,0.38,0.2,1,1,7,0,1010,1.0,0.99,0.12,0.35
PF07789,PF11030:PF05416:PF14760:PF15366:PF02322,0,4,0,0,4,1014,0.0,1.0,0,0,0,0,0,0,1018,0,1.0,0,0
PF06027,PF08704:PF07798:PF04570:PF02076:PF13593,8,21,3,5,18,992,0.14,0.98,0.38,0.22,1,1,7,0,1010,1.0,0.99,0.12,0.35
PF14380,PF08488:PF13947:PF16579:PF08515:PF01657,10,41,7,3,34,974,0.17,0.96,0.7,0.33,6,5,5,1,1007,0.83,0.99,0.5,0.64
PF09173,PF16658:PF09107:PF03143:PF08364:PF14492,5,53,4,1,49,964,0.08,0.95,0.8,0.24,3,1,4,2,1011,0.33,0.99,0.2,0.26
PF04548,PF11886:PF00735:PF04103:PF07227:PF09588,22,44,12,10,32,964,0.27,0.96,0.55,0.37,5,4,18,1,995,0.8,0.98,0.18,0.38
PF00964,PF00758:PF06446:PF00537:PF06373:PF15364,0,4,0,0,4,1014,0.0,1.0,0,0,0,0,0,0,1018,0,1.0,0,0
PF00353,PF08657:PF13204:PF00220:PF17054:PF06449,1,14,0,1,14,1003,0.0,0.99,0.0,-0.0,0,0,1,0,1017,0,1.0,0.0,0
PF17014,PF04355:PF04451:PF06890:PF01752:PF11751,0,3,0,0,3,1015,0.0,1.0,0,0,0,0,0,0,1018,0,1.0,0,0
PF03146,PF00050:PF07648:PF01469:PF09289:PF07692,2,37,2,0,35,981,0.05,0.97,1.0,0.23,2,1,1,1,1015,0.5,1.0,0.5,0.5
PF03539,PF10917:PF05869:PF13780:PF02160:PF00606,1,9,1,0,8,1009,0.11,0.99,1.0,0.33,0,0,1,0,1017,0,1.0,0.0,0
PF16905,PF08763:PF16885:PF11933:PF16799:PF03521,6,14,5,1,9,1003,0.36,0.99,0.83,0.54,2,2,4,0,1012,1.0,1.0,0.33,0.58
PF16021,PF12829:PF08730:PF15115:PF14469:PF06100,5,5,0,5,5,1008,0.0,0.99,0.0,-0.0,0,0,5,0,1013,0,1.0,0.0,0
PF08210,PF08028:PF12806:PF09317:PF00441:PF12418,8,60,6,2,54,956,0.1,0.94,0.75,0.26,3,3,5,0,1010,1.0,1.0,0.38,0.61
PF04405,PF04363:PF15167:PF15842:PF05416:PF02465,0,4,0,0,4,1014,0.0,1.0,0,0,2,0,0,2,1016,0.0,1.0,0,0
PF11924,PF07411:PF15150:PF13780:PF12241:PF03865,1,1,0,1,1,1016,0.0,1.0,0.0,-0.0,0,0,1,0,1017,0,1.0,0.0,0
PF01544,PF14441:PF00924:PF10505:PF04576:PF09736,34,30,10,24,20,964,0.33,0.96,0.29,0.29,0,0,34,0,984,0,0.97,0.0,0
PF16685,PF15273:PF10189:PF15326:PF05715:PF16682,3,13,2,1,11,1004,0.15,0.99,0.67,0.32,1,0,3,1,1014,0.0,1.0,0.0,-0.0
PF04500,PF15423:PF16064:PF10551:PF03101:PF10532,23,69,14,9,55,940,0.2,0.94,0.61,0.33,5,5,18,0,995,1.0,0.98,0.22,0.46
PF14324,PF13864:PF02891:PF04278:PF11489:PF04090,9,19,9,0,10,999,0.47,0.99,1.0,0.68,3,3,6,0,1009,1.0,0.99,0.33,0.58
PF14675,PF14676:PF14680:PF14679:PF14677:PF14674,1,1,1,0,0,1017,1.0,1.0,1.0,1.0,1,1,0,0,1017,1.0,1.0,1.0,1.0
PF09758,PF04048:PF08638:PF14649:PF08623:PF09743,2,33,1,1,32,984,0.03,0.97,0.5,0.12,1,0,2,1,1015,0.0,1.0,0.0,-0.0
PF14808,PF06951:PF01294:PF15065:PF10246:PF00965,3,33,0,3,33,982,0.0,0.96,0.0,-0.01,3,0,3,3,1012,0.0,0.99,0.0,-0.0
PF04631,PF03379:PF06868:PF15085:PF10514:PF07327,0,4,0,0,4,1014,0.0,1.0,0,0,0,0,0,0,1018,0,1.0,0,0
PF13002,PF04090:PF10332:PF10104:PF11001:PF08528,4,16,1,3,15,999,0.06,0.98,0.25,0.12,1,0,4,1,1013,0.0,1.0,0.0,-0.0
PF17218,PF13907:PF01393:PF03716:PF00385:PF08198,3,70,3,0,67,948,0.04,0.93,1.0,0.2,4,1,2,3,1012,0.25,1.0,0.33,0.29
PF07244,PF01103:PF02091:PF02092:PF16940:PF09332,6,40,6,0,34,978,0.15,0.97,1.0,0.38,0,0,6,0,1012,0,0.99,0.0,0
PF03690,PF00048:PF05719:PF09749:PF15008:PF00143,12,23,5,7,18,988,0.22,0.98,0.42,0.29,0,0,12,0,1006,0,0.99,0.0,0
PF14204,PF17144:PF01643:PF03766:PF14577:PF02747,15,25,11,4,14,989,0.44,0.98,0.73,0.56,0,0,15,0,1003,0,0.99,0.0,0
PF03119,PF01653:PF03120:PF16893:PF09309:PF16892,3,10,3,0,7,1008,0.3,0.99,1.0,0.55,0,0,3,0,1015,0,1.0,0.0,0
PF10117,PF17164:PF06355:PF09432:PF04222:PF13610,0,3,0,0,3,1015,0.0,1.0,0,0,0,0,0,0,1018,0,1.0,0,0
PF16124,PF09382:PF08072:PF00570:PF16202:PF11408,30,31,20,10,11,977,0.65,0.98,0.67,0.65,7,7,23,0,988,1.0,0.98,0.23,0.48
PF09132,PF15685:PF07149:PF04223:PF03963:PF13421,0,2,0,0,2,1016,0.0,1.0,0,0,0,0,0,0,1018,0,1.0,0,0
PF01581,PF08257:PF10660:PF09360:PF15156:PF06549,5,18,3,2,15,998,0.17,0.98,0.6,0.31,0,0,5,0,1013,0,1.0,0.0,0
PF12281,PF09341:PF05529:PF06457:PF06087:PF03737,0,39,0,0,39,979,0.0,0.96,0,0,4,0,0,4,1014,0.0,1.0,0,0
PF10165,PF05719:PF05742:PF03091:PF15880:PF00143,9,22,4,5,18,991,0.18,0.98,0.44,0.27,0,0,9,0,1009,0,0.99,0.0,0
PF01916,PF03345:PF05995:PF06172:PF05822:PF02098,5,32,2,3,30,983,0.06,0.97,0.4,0.15,3,2,3,1,1012,0.67,1.0,0.4,0.51
PF15310,PF05874:PF15443:PF15553:PF02425:PF15379,3,2,0,3,2,1013,0.0,1.0,0.0,-0.0,0,0,3,0,1015,0,1.0,0.0,0
PF02077,PF09778:PF16860:PF02175:PF05497:PF03073,6,14,4,2,10,1002,0.29,0.99,0.67,0.43,0,0,6,0,1012,0,0.99,0.0,0
PF01296,PF06540:PF05196:PF04644:PF00879:PF05436,1,3,1,0,2,1015,0.33,1.0,1.0,0.58,0,0,1,0,1017,0,1.0,0.0,0
PF03843,PF01673:PF12302:PF05157:PF10566:PF12081,0,3,0,0,3,1015,0.0,1.0,0,0,0,0,0,0,1018,0,1.0,0,0
PF15155,PF15662:PF15128:PF08751:PF06403:PF01913,4,6,0,4,6,1008,0.0,0.99,0.0,-0.0,0,0,4,0,1014,0,1.0,0.0,0
PF15743,PF10452:PF14877:PF15050:PF03275:PF03553,0,10,0,0,10,1008,0.0,0.99,0,0,0,0,0,0,1018,0,1.0,0,0
PF14498,PF10350:PF06964:PF08427:PF07035:PF07539,10,43,8,2,35,973,0.19,0.96,0.8,0.38,2,2,8,0,1008,1.0,0.99,0.2,0.45
PF14656,PF14655:PF07919:PF11817:PF14837:PF12742,6,19,6,0,13,999,0.32,0.99,1.0,0.56,2,0,6,2,1010,0.0,0.99,0.0,-0.0
PF12697,PF00561:PF12146:PF13378:PF02776:PF04083,65,122,43,22,79,874,0.35,0.9,0.66,0.44,27,24,41,3,950,0.89,0.96,0.37,0.56
PF12443,PF15241:PF03344:PF08632:PF10375:PF14669,0,6,0,0,6,1012,0.0,0.99,0,0,0,0,0,0,1018,0,1.0,0,0
PF10167,PF10037:PF14857:PF14822:PF03036:PF05308,5,19,1,4,18,995,0.05,0.98,0.2,0.09,0,0,5,0,1013,0,1.0,0.0,0
PF11415,PF16716:PF08089:PF02024:PF02448:PF10716,0,2,0,0,2,1016,0.0,1.0,0,0,0,0,0,0,1018,0,1.0,0,0
PF09815,PF10744:PF02755:PF04906:PF05770:PF10263,18,38,6,12,32,968,0.16,0.96,0.33,0.21,2,1,17,1,999,0.5,0.98,0.06,0.16
PF04399,PF07987:PF03540:PF14497:PF12792:PF00043,2,69,1,1,68,948,0.01,0.93,0.5,0.08,2,1,1,1,1015,0.5,1.0,0.5,0.5
PF03360,PF00992:PF12483:PF01746:PF15998:PF04502,15,44,9,6,35,968,0.2,0.96,0.6,0.33,4,2,13,2,1001,0.5,0.99,0.13,0.25
PF03247,PF17014:PF15681:PF15119:PF09253:PF15114,5,4,0,5,4,1009,0.0,0.99,0.0,-0.0,0,0,5,0,1013,0,1.0,0.0,0
PF04784,PF14389:PF00610:PF12257:PF00462:PF06936,16,77,13,3,64,938,0.17,0.93,0.81,0.35,7,5,11,2,1000,0.71,0.99,0.31,0.47
PF00609,PF00781:PF14513:PF00130:PF00788:PF06565,20,99,20,0,79,919,0.2,0.92,1.0,0.43,19,12,8,7,991,0.63,0.99,0.6,0.61
PF12403,PF12360:PF04813:PF16557:PF00046:PF16534,1,95,1,0,94,923,0.01,0.91,1.0,0.1,2,1,0,1,1016,0.5,1.0,1.0,0.71
PF06350,PF07859:PF15610:PF00772:PF06979:PF13662,7,74,7,0,67,944,0.09,0.93,1.0,0.3,4,1,6,3,1008,0.25,0.99,0.14,0.18
PF06146,PF04892:PF09699:PF00419:PF05981:PF01880,1,7,1,0,6,1011,0.14,0.99,1.0,0.38,0,0,1,0,1017,0,1.0,0.0,0
PF03848,PF11751:PF04671:PF03090:PF10279:PF03135,0,6,0,0,6,1012,0.0,0.99,0,0,0,0,0,0,1018,0,1.0,0,0
PF03062,PF09335:PF00777:PF02517:PF01513:PF04769,35,57,17,18,40,943,0.3,0.94,0.49,0.35,3,3,32,0,983,1.0,0.97,0.09,0.29
PF11341,PF13367:PF15312:PF17056:PF13331:PF15062,2,3,0,2,3,1013,0.0,1.0,0.0,-0.0,0,0,2,0,1016,0,1.0,0.0,0
PF04576,PF15275:PF16043:PF08634:PF12253:PF05334,12,11,1,11,10,996,0.09,0.98,0.08,0.08,0,0,12,0,1006,0,0.99,0.0,0
PF05594,PF03958:PF07014:PF01228:PF07963:PF07085,0,9,0,0,9,1009,0.0,0.99,0,0,1,0,0,1,1017,0.0,1.0,0,0
PF17136,PF01777:PF16121:PF08071:PF01929:PF00900,10,39,4,6,35,973,0.1,0.96,0.4,0.19,13,2,8,11,997,0.15,0.98,0.2,0.17
PF12495,PF04489:PF08336:PF01812:PF09845:PF11744,0,24,0,0,24,994,0.0,0.98,0,0,0,0,0,0,1018,0,1.0,0,0
PF08321,PF05011:PF02872:PF03711:PF04152:PF16656,10,50,6,4,44,964,0.12,0.95,0.6,0.25,6,4,6,2,1006,0.67,0.99,0.4,0.51
PF16959,PF01401:PF02935:PF03298:PF15003:PF05512,2,20,2,0,18,998,0.1,0.98,1.0,0.31,0,0,2,0,1016,0,1.0,0.0,0
PF01487,PF08501:PF01488:PF00275:PF01761:PF00745,13,33,11,2,22,983,0.33,0.98,0.85,0.52,11,10,3,1,1004,0.91,1.0,0.77,0.83
PF16830,PF16574:PF12297:PF07926:PF10481:PF07989,0,23,0,0,23,995,0.0,0.98,0,0,1,0,0,1,1017,0.0,1.0,0,0
PF09361,PF16967:PF02601:PF15976:PF06505:PF15775,0,2,0,0,2,1016,0.0,1.0,0,0,0,0,0,0,1018,0,1.0,0,0
PF09954,PF00359:PF13438:PF02756:PF12743:PF02296,0,14,0,0,14,1004,0.0,0.99,0,0,0,0,0,0,1018,0,1.0,0,0
PF16503,PF06041:PF11734:PF10288:PF09179:PF16200,8,17,3,5,14,996,0.18,0.98,0.38,0.25,2,2,6,0,1010,1.0,0.99,0.25,0.5
PF15909,PF03703:PF15045:PF04359:PF15310:PF05991,4,8,1,3,7,1007,0.12,0.99,0.25,0.17,0,0,4,0,1014,0,1.0,0.0,0
PF11211,PF08093:PF11402:PF05962:PF15355:PF11697,0,2,0,0,2,1016,0.0,1.0,0,0,0,0,0,0,1018,0,1.0,0,0
PF00590,PF14823:PF13241:PF04790:PF14824:PF10261,18,16,7,11,9,991,0.44,0.98,0.39,0.4,8,4,14,4,996,0.5,0.98,0.22,0.33
PF05966,PF13116:PF04811:PF03326:PF01321:PF06892,0,40,0,0,40,978,0.0,0.96,0,0,0,0,0,0,1018,0,1.0,0,0
PF11566,PF09346:PF03048:PF04300:PF16856:PF13369,7,15,2,5,13,998,0.13,0.98,0.29,0.19,1,1,6,0,1011,1.0,0.99,0.14,0.38
PF03784,PF16720:PF08027:PF00340:PF12904:PF01387,0,3,0,0,3,1015,0.0,1.0,0,0,0,0,0,0,1018,0,1.0,0,0
PF03223,PF01158:PF01875:PF03842:PF05296:PF15377,8,17,4,4,13,997,0.24,0.98,0.5,0.34,0,0,8,0,1010,0,0.99,0.0,0
PF08344,PF00710:PF16799:PF15808:PF16553:PF03493,8,28,3,5,25,985,0.11,0.97,0.38,0.19,0,0,8,0,1010,0,0.99,0.0,0
PF12948,PF14922:PF08634:PF05508:PF15619:PF11727,0,10,0,0,10,1008,0.0,0.99,0,0,0,0,0,0,1018,0,1.0,0,0
PF02262,PF02762:PF02761:PF04571:PF08295:PF16759,5,31,5,0,26,987,0.16,0.97,1.0,0.4,4,2,3,2,1011,0.5,1.0,0.4,0.44
PF11738,PF02217:PF06798:PF04076:PF11751:PF05974,0,3,0,0,3,1015,0.0,1.0,0,0,0,0,0,0,1018,0,1.0,0,0
PF03349,PF05736:PF02217:PF12477:PF08093:PF17206,0,4,0,0,4,1014,0.0,1.0,0,0,0,0,0,0,1018,0,1.0,0,0
PF01047,PF06804:PF02694:PF01654:PF01523:PF03841,16,18,9,7,9,993,0.5,0.98,0.56,0.52,1,1,15,0,1002,1.0,0.99,0.06,0.25
PF04054,PF16417:PF16418:PF12842:PF16415:PF16419,11,14,10,1,4,1003,0.71,1.0,0.91,0.8,10,9,2,1,1006,0.9,1.0,0.82,0.86
PF10991,PF17056:PF02393:PF15673:PF02361:PF07081,0,10,0,0,10,1008,0.0,0.99,0,0,0,0,0,0,1018,0,1.0,0,0
PF01642,PF02310:PF02965:PF02607:PF00809:PF02574,5,25,5,0,20,993,0.2,0.98,1.0,0.44,6,4,1,2,1011,0.67,1.0,0.8,0.73
PF00084,PF13402:PF02494:PF13948:PF16754:PF01510,52,29,23,29,6,960,0.79,0.97,0.44,0.58,0,0,52,0,966,0,0.95,0.0,0
PF14229,PF07652:PF10927:PF12137:PF03880:PF03461,2,12,2,0,10,1006,0.17,0.99,1.0,0.41,1,1,1,0,1016,1.0,1.0,0.5,0.71
PF01733,PF03194:PF01159:PF03662:PF01731:PF06309,16,37,6,10,31,971,0.16,0.96,0.38,0.23,2,2,14,0,1002,1.0,0.99,0.12,0.35
PF05512,PF03386:PF15003:PF06825:PF03242:PF04418,3,11,0,3,11,1004,0.0,0.99,0.0,-0.01,0,0,3,0,1015,0,1.0,0.0,0
PF06775,PF07798:PF14612:PF04664:PF03162:PF12319,11,12,2,9,10,997,0.17,0.98,0.18,0.16,0,0,11,0,1007,0,0.99,0.0,0
PF12203,PF09757:PF15778:PF15090:PF08997:PF15249,2,23,2,0,21,995,0.09,0.98,1.0,0.29,0,0,2,0,1016,0,1.0,0.0,0
PF03443,PF02015:PF03664:PF01083:PF01341:PF03659,32,39,12,20,27,959,0.31,0.95,0.38,0.32,5,5,27,0,986,1.0,0.97,0.16,0.39
PF09478,PF00553:PF02927:PF00759:PF07966:PF00942,9,21,4,5,17,992,0.19,0.98,0.44,0.28,1,1,8,0,1009,1.0,0.99,0.11,0.33
PF03546,PF07891:PF05337:PF10198:PF09038:PF15257,1,8,0,1,8,1009,0.0,0.99,0.0,-0.0,0,0,1,0,1017,0,1.0,0.0,0
PF04184,PF16720:PF03784:PF15993:PF17054:PF05782,2,10,1,1,9,1007,0.1,0.99,0.5,0.22,0,0,2,0,1016,0,1.0,0.0,0
PF05046,PF10211:PF05361:PF08231:PF03879:PF14908,8,25,2,6,23,987,0.08,0.97,0.25,0.13,2,2,6,0,1010,1.0,0.99,0.25,0.5
PF02375,PF02928:PF08429:PF10497:PF02373:PF01388,19,60,17,2,43,956,0.28,0.96,0.89,0.49,14,12,7,2,997,0.86,0.99,0.63,0.73
PF00618,PF00617:PF00610:PF00027:PF08412:PF12257,40,123,39,1,84,894,0.32,0.92,0.97,0.53,17,13,27,4,974,0.76,0.97,0.33,0.49
PF16136,PF07897:PF16135:PF12165:PF05266:PF06752,1,18,1,0,17,1000,0.06,0.98,1.0,0.23,1,0,1,1,1016,0.0,1.0,0.0,-0.0
PF16113,PF00378:PF06522:PF05995:PF12680:PF06172,20,71,14,6,57,941,0.2,0.94,0.7,0.35,3,3,17,0,998,1.0,0.98,0.15,0.38
PF09755,PF04139:PF04939:PF11945:PF04004:PF10234,4,31,3,1,28,986,0.1,0.97,0.75,0.26,2,1,3,1,1013,0.5,1.0,0.25,0.35
PF14323,PF08483:PF10109:PF02565:PF11245:PF03244,0,1,0,0,1,1017,0.0,1.0,0,0,0,0,0,0,1018,0,1.0,0,0
PF15914,PF05715:PF09322:PF15082:PF07001:PF09441,3,11,1,2,10,1005,0.09,0.99,0.33,0.17,0,0,3,0,1015,0,1.0,0.0,0
PF15662,PF14690:PF05418:PF08497:PF03090:PF04391,0,1,0,0,1,1017,0.0,1.0,0,0,0,0,0,0,1018,0,1.0,0,0
PF16191,PF16190:PF10585:PF16195:PF09358:PF14732,4,20,4,0,16,998,0.2,0.98,1.0,0.44,1,1,3,0,1014,1.0,1.0,0.25,0.5
PF01472,PF01509:PF16198:PF08068:PF10343:PF01029,16,32,8,8,24,978,0.25,0.97,0.5,0.34,6,5,11,1,1001,0.83,0.99,0.31,0.51
PF06743,PF08368:PF08373:PF01321:PF14686:PF09511,8,43,7,1,36,974,0.16,0.96,0.88,0.37,3,2,6,1,1009,0.67,0.99,0.25,0.41
PF11080,PF14551:PF01974:PF08747:PF00316:PF17207,1,75,0,1,75,942,0.0,0.93,0.0,-0.01,16,0,1,16,1001,0.0,0.98,0.0,-0.0
PF09990,PF03379:PF08843:PF12724:PF15380:PF01809,0,1,0,0,1,1017,0.0,1.0,0,0,0,0,0,0,1018,0,1.0,0,0
PF00834,PF00197:PF01115:PF03694:PF01198:PF01912,19,39,8,11,31,968,0.21,0.96,0.42,0.27,2,2,17,0,999,1.0,0.98,0.11,0.32
PF02412,PF05735:PF12947:PF13442:PF10143:PF07474,3,37,3,0,34,981,0.08,0.97,1.0,0.28,4,2,1,2,1013,0.5,1.0,0.67,0.58
PF16769,PF16768:PF03399:PF16766:PF10205:PF09762,1,24,1,0,23,994,0.04,0.98,1.0,0.2,2,1,0,1,1016,0.5,1.0,1.0,0.71
PF13088,PF07896:PF04979:PF05915:PF10218:PF01063,6,34,2,4,32,980,0.06,0.96,0.33,0.13,5,2,4,3,1009,0.4,0.99,0.33,0.36
PF01259,PF02222:PF00731:PF04248:PF06052:PF10785,10,23,3,7,20,988,0.13,0.97,0.3,0.19,0,0,10,0,1008,0,0.99,0.0,0
PF15825,PF15041:PF08730:PF15119:PF02977:PF14866,0,2,0,0,2,1016,0.0,1.0,0,0,0,0,0,0,1018,0,1.0,0,0
PF07540,PF12329:PF10377:PF03801:PF07765:PF11500,4,25,1,3,24,990,0.04,0.97,0.25,0.09,2,1,3,1,1013,0.5,1.0,0.25,0.35
PF00183,PF09239:PF07730:PF10436:PF14959:PF06580,33,31,9,24,22,963,0.29,0.95,0.27,0.26,0,0,33,0,985,0,0.97,0.0,0
PF08881,PF11807:PF03972:PF00797:PF08939:PF12239,8,30,2,6,28,982,0.07,0.97,0.25,0.12,6,0,8,6,1004,0.0,0.99,0.0,-0.01
PF00515,PF07719:PF13414:PF03661:PF11998:PF13174,55,70,38,17,32,931,0.54,0.95,0.69,0.59,9,8,47,1,962,0.89,0.95,0.15,0.35
PF05199,PF00732:PF06964:PF16010:PF12036:PF00150,62,89,56,6,33,923,0.63,0.96,0.9,0.74,12,12,50,0,956,1.0,0.95,0.19,0.43
PF02928,PF02375:PF08429:PF10497:PF01388:PF12269,10,48,10,0,38,970,0.21,0.96,1.0,0.45,12,9,1,3,1005,0.75,1.0,0.9,0.82
PF07994,PF01327:PF01680:PF01997:PF09749:PF06658,4,29,0,4,29,985,0.0,0.97,0.0,-0.01,2,0,4,2,1012,0.0,0.99,0.0,-0.0
PF00468,PF04839:PF13225:PF16009:PF02915:PF00127,5,9,2,3,7,1006,0.22,0.99,0.4,0.29,0,0,5,0,1013,0,1.0,0.0,0
PF10647,PF17005:PF17108:PF11549:PF08581:PF14077,3,6,2,1,4,1011,0.33,1.0,0.67,0.47,1,1,2,0,1015,1.0,1.0,0.33,0.58
PF01019,PF03091:PF07969:PF10165:PF02046:PF06553,36,34,12,24,22,960,0.35,0.95,0.33,0.32,3,2,34,1,981,0.67,0.97,0.06,0.19
PF13860,PF12461:PF14052:PF03406:PF06834:PF01706,1,1,0,1,1,1016,0.0,1.0,0.0,-0.0,0,0,1,0,1017,0,1.0,0.0,0
PF00552,PF02022:PF13276:PF01141:PF08388:PF13655,5,17,5,0,12,1001,0.29,0.99,1.0,0.54,1,1,4,0,1013,1.0,1.0,0.2,0.45
PF12068,PF15733:PF11830:PF00566:PF02893:PF07534,9,105,9,0,96,913,0.09,0.91,1.0,0.28,11,2,7,9,1000,0.18,0.98,0.22,0.19
PF02017,PF12278:PF12253:PF02163:PF14977:PF03085,13,16,3,10,13,992,0.19,0.98,0.23,0.2,1,1,12,0,1005,1.0,0.99,0.08,0.28
PF11771,PF02950:PF05355:PF04691:PF15333:PF14866,0,4,0,0,4,1014,0.0,1.0,0,0,0,0,0,0,1018,0,1.0,0,0
PF10462,PF08744:PF11775:PF15271:PF05947:PF13929,3,0,0,3,0,1015,0,1.0,0.0,0,0,0,3,0,1015,0,1.0,0.0,0
PF04499,PF04109:PF09729:PF13506:PF02946:PF05624,20,28,7,13,21,977,0.25,0.97,0.35,0.28,1,1,19,0,998,1.0,0.98,0.05,0.22
PF16380,PF04994:PF11034:PF11650:PF15217:PF12544,0,4,0,0,4,1014,0.0,1.0,0,0,0,0,0,0,1018,0,1.0,0,0
PF14866,PF15085:PF15119:PF15680:PF05355:PF07936,0,6,0,0,6,1012,0.0,0.99,0,0,0,0,0,0,1018,0,1.0,0,0
PF04288,PF03882:PF17192:PF10797:PF08982:PF12897,0,5,0,0,5,1013,0.0,1.0,0,0,0,0,0,0,1018,0,1.0,0,0
PF03527,PF15798:PF06977:PF10279:PF04917:PF02655,2,2,0,2,2,1014,0.0,1.0,0.0,-0.0,0,0,2,0,1016,0,1.0,0.0,0
PF02747,PF00705:PF09284:PF08523:PF00399:PF01643,11,23,9,2,14,993,0.39,0.98,0.82,0.56,0,0,11,0,1007,0,0.99,0.0,0
PF15722,PF16829:PF10630:PF15234:PF01114:PF02740,0,1,0,0,1,1017,0.0,1.0,0,0,0,0,0,0,1018,0,1.0,0,0
PF05510,PF09384:PF01783:PF05180:PF14077:PF08614,3,21,2,1,19,996,0.1,0.98,0.67,0.25,4,2,1,2,1013,0.5,1.0,0.67,0.58
PF00817,PF11798:PF11799:PF13438:PF06732:PF16589,27,44,25,2,19,972,0.57,0.98,0.93,0.72,3,3,24,0,991,1.0,0.98,0.11,0.33
PF07201,PF07411:PF10411:PF11902:PF04671:PF14882,0,1,0,0,1,1017,0.0,1.0,0,0,0,0,0,0,1018,0,1.0,0,0
PF02626,PF02682:PF00289:PF02785:PF02436:PF08326,11,37,11,0,26,981,0.3,0.97,1.0,0.54,20,8,3,12,995,0.4,0.99,0.73,0.53
PF06245,PF02556:PF06617:PF02934:PF04871:PF04784,0,42,0,0,42,976,0.0,0.96,0,0,1,0,0,1,1017,0.0,1.0,0,0
PF11365,PF04880:PF10226:PF11831:PF13863:PF15871,8,21,4,4,17,993,0.19,0.98,0.5,0.3,1,1,7,0,1010,1.0,0.99,0.12,0.35
PF17077,PF03743:PF14690:PF16824:PF16822:PF11794,1,7,0,1,7,1010,0.0,0.99,0.0,-0.0,0,0,1,0,1017,0,1.0,0.0,0
PF09501,PF06122:PF08651:PF05138:PF12236:PF10099,0,1,0,0,1,1017,0.0,1.0,0,0,0,0,0,0,1018,0,1.0,0,0
PF07203,PF15760:PF15085:PF03379:PF15683:PF09252,1,3,0,1,3,1014,0.0,1.0,0.0,-0.0,0,0,1,0,1017,0,1.0,0.0,0
PF09154,PF16657:PF11941:PF16028:PF10438:PF09260,3,5,2,1,3,1012,0.4,1.0,0.67,0.51,1,1,2,0,1015,1.0,1.0,0.33,0.58
PF04990,PF04992:PF11523:PF04983:PF05001:PF04998,3,40,3,0,37,978,0.07,0.96,1.0,0.27,9,3,0,6,1009,0.33,0.99,1.0,0.58
PF05686,PF04777:PF06964:PF08239:PF08216:PF11374,29,55,18,11,37,952,0.33,0.95,0.62,0.43,4,2,27,2,987,0.5,0.97,0.07,0.18
PF00414,PF17007:PF05787:PF15168:PF04453:PF03212,0,3,0,0,3,1015,0.0,1.0,0,0,0,0,0,0,1018,0,1.0,0,0
PF02872,PF16656:PF14008:PF05011:PF16891:PF04152,15,47,8,7,39,964,0.17,0.95,0.53,0.28,13,5,10,8,995,0.38,0.98,0.33,0.35
PF03746,PF05860:PF08411:PF16473:PF07117:PF04196,1,3,0,1,3,1014,0.0,1.0,0.0,-0.0,0,0,1,0,1017,0,1.0,0.0,0
PF08369,PF00148:PF09363:PF09364:PF03894:PF16954,1,5,1,0,4,1013,0.2,1.0,1.0,0.45,2,0,1,2,1015,0.0,1.0,0.0,-0.0
PF12578,PF00814:PF02893:PF06602:PF03528:PF10240,5,82,5,0,77,936,0.06,0.92,1.0,0.24,8,1,4,7,1006,0.12,0.99,0.2,0.15
PF04321,PF11803:PF14524:PF16363:PF00908:PF01370,16,85,11,5,74,928,0.13,0.92,0.69,0.28,5,4,12,1,1001,0.8,0.99,0.25,0.44
PF15972,PF16649:PF08194:PF15047:PF11341:PF16060,0,8,0,0,8,1010,0.0,0.99,0,0,0,0,0,0,1018,0,1.0,0,0
PF10235,PF02950:PF15160:PF17022:PF00770:PF17124,3,2,0,3,2,1013,0.0,1.0,0.0,-0.0,0,0,3,0,1015,0,1.0,0.0,0
PF15212,PF03050:PF03238:PF15119:PF15141:PF11057,0,1,0,0,1,1017,0.0,1.0,0,0,0,0,0,0,1018,0,1.0,0,0
PF09117,PF11630:PF14672:PF12046:PF16649:PF15724,0,1,0,0,1,1017,0.0,1.0,0,0,0,0,0,0,1018,0,1.0,0,0
PF14878,PF14633:PF14635:PF14641:PF09371:PF14639,13,14,13,0,1,1004,0.93,1.0,1.0,0.96,13,13,0,0,1005,1.0,1.0,1.0,1.0
PF01395,PF05405:PF06083:PF06159:PF03392:PF02995,18,21,5,13,16,984,0.24,0.97,0.28,0.24,1,0,18,1,999,0.0,0.98,0.0,-0.0
PF10297,PF12498:PF07777:PF11785:PF02173:PF11786,5,8,3,2,5,1008,0.38,0.99,0.6,0.47,2,2,3,0,1013,1.0,1.0,0.4,0.63
PF14853,PF14852:PF00101:PF16205:PF11937:PF00283,5,21,4,1,17,996,0.19,0.98,0.8,0.39,1,0,5,1,1012,0.0,0.99,0.0,-0.0
PF12628,PF06724:PF03544:PF15337:PF15391:PF15460,0,8,0,0,8,1010,0.0,0.99,0,0,0,0,0,0,1018,0,1.0,0,0
PF08853,PF08651:PF10664:PF15050:PF05853:PF11371,0,5,0,0,5,1013,0.0,1.0,0,0,0,0,0,0,1018,0,1.0,0,0
PF09332,PF15539:PF16940:PF16041:PF09329:PF12936,4,23,3,1,20,994,0.13,0.98,0.75,0.31,0,0,4,0,1014,0,1.0,0.0,0
PF09258,PF03016:PF06427:PF01501:PF09261:PF03407,13,87,12,1,75,930,0.14,0.93,0.92,0.34,11,4,9,7,998,0.36,0.98,0.31,0.33
PF08246,PF00112:PF08773:PF08127:PF01066:PF04406,35,88,33,2,55,928,0.38,0.94,0.94,0.58,7,5,30,2,981,0.71,0.97,0.14,0.31
PF11907,PF13089:PF13090:PF09966:PF09498:PF02503,1,2,1,0,1,1016,0.5,1.0,1.0,0.71,1,1,0,0,1017,1.0,1.0,1.0,1.0
PF08592,PF10224:PF09424:PF12900:PF01828:PF10455,6,21,2,4,19,993,0.1,0.98,0.33,0.17,0,0,6,0,1012,0,0.99,0.0,0
PF16168,PF15355:PF09611:PF10106:PF08093:PF12477,0,2,0,0,2,1016,0.0,1.0,0,0,0,0,0,0,1018,0,1.0,0,0
PF07439,PF08210:PF04557:PF00749:PF17205:PF07128,1,43,0,1,43,974,0.0,0.96,0.0,-0.01,2,0,1,2,1015,0.0,1.0,0.0,-0.0
PF07403,PF14297:PF04738:PF05756:PF15578:PF02072,0,1,0,0,1,1017,0.0,1.0,0,0,0,0,0,0,1018,0,1.0,0,0
PF05529,PF07933:PF10208:PF10520:PF10185:PF09288,11,21,5,6,16,991,0.24,0.98,0.45,0.32,1,1,10,0,1007,1.0,0.99,0.09,0.3
PF02132,PF08275:PF01807:PF10410:PF02614:PF14903,1,8,0,1,8,1009,0.0,0.99,0.0,-0.0,4,0,1,4,1013,0.0,1.0,0.0,-0.0
PF15301,PF03285:PF12180:PF04921:PF06211:PF01092,4,20,2,2,18,996,0.1,0.98,0.5,0.22,0,0,4,0,1014,0,1.0,0.0,0
PF05783,PF14612:PF06179:PF14937:PF06027:PF03649,9,18,4,5,14,995,0.22,0.98,0.44,0.31,1,1,8,0,1009,1.0,0.99,0.11,0.33
PF01421,PF01562:PF05986:PF00200:PF07786:PF16698,33,46,31,2,15,970,0.67,0.98,0.94,0.79,8,7,26,1,984,0.88,0.97,0.21,0.42
PF17017,PF05939:PF08093:PF12628:PF17015:PF09365,0,3,0,0,3,1015,0.0,1.0,0,0,0,0,0,0,1018,0,1.0,0,0
PF12597,PF06232:PF14774:PF06108:PF06541:PF00159,9,16,3,6,13,996,0.19,0.98,0.33,0.24,0,0,9,0,1009,0,0.99,0.0,0
PF06516,PF06108:PF06912:PF06232:PF08787:PF12115,5,16,1,4,15,998,0.06,0.98,0.2,0.1,0,0,5,0,1013,0,1.0,0.0,0
PF10193,PF16018:PF08161:PF05041:PF12231:PF12422,15,15,2,13,13,990,0.13,0.97,0.13,0.12,1,0,15,1,1002,0.0,0.98,0.0,-0.0
PF01121,PF01467:PF07072:PF13656:PF14840:PF06068,14,49,10,4,39,965,0.2,0.96,0.71,0.37,6,4,10,2,1002,0.67,0.99,0.29,0.43
PF06467,PF12012:PF08394:PF10683:PF15992:PF14372,4,26,4,0,22,992,0.15,0.98,1.0,0.39,3,2,2,1,1013,0.67,1.0,0.5,0.58
PF01888,PF07538:PF04967:PF16117:PF04391:PF00267,1,2,0,1,2,1015,0.0,1.0,0.0,-0.0,0,0,1,0,1017,0,1.0,0.0,0
PF06278,PF16869:PF16858:PF02404:PF00925:PF11265,4,19,4,0,15,999,0.21,0.99,1.0,0.46,0,0,4,0,1014,0,1.0,0.0,0
PF03472,PF09614:PF15529:PF13722:PF03793:PF04917,0,3,0,0,3,1015,0.0,1.0,0,0,0,0,0,0,1018,0,1.0,0,0
PF05936,PF12080:PF06798:PF00516:PF03888:PF11245,2,0,0,2,0,1016,0,1.0,0.0,0,0,0,2,0,1016,0,1.0,0.0,0
PF04865,PF08479:PF07409:PF06890:PF13722:PF02211,0,3,0,0,3,1015,0.0,1.0,0,0,0,0,0,0,1018,0,1.0,0,0
PF05927,PF07294:PF11638:PF04151:PF17006:PF15367,1,5,0,1,5,1012,0.0,0.99,0.0,-0.0,0,0,1,0,1017,0,1.0,0.0,0
PF08790,PF08265:PF15477:PF06365:PF14719:PF15189,8,23,6,2,17,993,0.26,0.98,0.75,0.44,3,2,6,1,1009,0.67,0.99,0.25,0.41
PF04836,PF05004:PF01381:PF08523:PF02256:PF02657,4,18,4,0,14,1000,0.22,0.99,1.0,0.47,1,0,4,1,1013,0.0,1.0,0.0,-0.0
PF04664,PF04090:PF02116:PF15045:PF08528:PF06365,1,12,0,1,12,1005,0.0,0.99,0.0,-0.0,0,0,1,0,1017,0,1.0,0.0,0
PF01433,PF11838:PF11940:PF09127:PF12612:PF11374,52,58,43,9,15,951,0.74,0.98,0.83,0.77,4,4,48,0,966,1.0,0.95,0.08,0.27
PF15680,PF14866:PF15085:PF15809:PF15119:PF15192,0,3,0,0,3,1015,0.0,1.0,0,0,0,0,0,0,1018,0,1.0,0,0
PF06666,PF11202:PF04391:PF04740:PF14690:PF16888,0,0,0,0,0,1018,0,1.0,0,0,0,0,0,0,1018,0,1.0,0,0
PF12729,PF04738:PF07157:PF13722:PF07409:PF13861,1,0,0,1,0,1017,0,1.0,0.0,0,0,0,1,0,1017,0,1.0,0.0,0
PF07294,PF11210:PF11638:PF02399:PF09829:PF11593,1,5,0,1,5,1012,0.0,0.99,0.0,-0.0,0,0,1,0,1017,0,1.0,0.0,0
PF15830,PF16888:PF07157:PF03428:PF03925:PF14842,0,1,0,0,1,1017,0.0,1.0,0,0,0,0,0,0,1018,0,1.0,0,0
PF10073,PF04612:PF16055:PF09673:PF08453:PF15184,0,4,0,0,4,1014,0.0,1.0,0,0,0,0,0,0,1018,0,1.0,0,0
PF05787,PF08411:PF08334:PF07964:PF09798:PF14841,0,4,0,0,4,1014,0.0,1.0,0,0,0,0,0,0,1018,0,1.0,0,0
PF06876,PF15325:PF14290:PF02087:PF17076:PF08131,0,3,0,0,3,1015,0.0,1.0,0,0,0,0,0,0,1018,0,1.0,0,0
PF13482,PF15775:PF14251:PF14512:PF06403:PF08291,1,3,0,1,3,1014,0.0,1.0,0.0,-0.0,0,0,1,0,1017,0,1.0,0.0,0
PF00362,PF17205:PF07965:PF08725:PF15636:PF05593,10,13,9,1,4,1004,0.69,1.0,0.9,0.79,4,4,6,0,1008,1.0,0.99,0.4,0.63
PF17039,PF00852:PF05277:PF08100:PF01066:PF16076,16,72,16,0,56,946,0.22,0.94,1.0,0.46,9,8,8,1,1001,0.89,0.99,0.5,0.66
PF02698,PF10224:PF06108:PF06351:PF06912:PF09597,6,15,1,5,14,998,0.07,0.98,0.17,0.1,0,0,6,0,1012,0,0.99,0.0,0
PF14942,PF11027:PF06639:PF15179:PF06934:PF02501,2,5,0,2,5,1011,0.0,0.99,0.0,-0.0,0,0,2,0,1016,0,1.0,0.0,0
PF05713,PF08808:PF16804:PF12477:PF09677:PF00796,0,0,0,0,0,1018,0,1.0,0,0,0,0,0,0,1018,0,1.0,0,0
PF08375,PF09440:PF05470:PF10602:PF06508:PF00358,8,39,4,4,35,975,0.1,0.96,0.5,0.21,3,1,7,2,1008,0.33,0.99,0.12,0.2
PF07527,PF12533:PF01586:PF09427:PF15372:PF14215,6,14,4,2,10,1002,0.29,0.99,0.67,0.43,1,1,5,0,1012,1.0,1.0,0.17,0.41
PF04950,PF08142:PF13871:PF16568:PF09005:PF16544,19,24,15,4,9,990,0.62,0.99,0.79,0.7,3,3,16,0,999,1.0,0.98,0.16,0.39
PF06011,PF06333:PF11597:PF14558:PF03707:PF14638,7,20,5,2,15,996,0.25,0.98,0.71,0.42,2,2,5,0,1011,1.0,1.0,0.29,0.53
PF03188,PF04526:PF03351:PF16010:PF01578:PF02014,28,37,12,16,25,965,0.32,0.96,0.43,0.35,4,4,24,0,990,1.0,0.98,0.14,0.37
PF03761,PF03703:PF15386:PF10542:PF15389:PF16060,4,7,1,3,6,1008,0.14,0.99,0.25,0.18,0,0,4,0,1014,0,1.0,0.0,0
PF08125,PF01232:PF07831:PF06863:PF01447:PF02884,7,10,6,1,4,1007,0.6,1.0,0.86,0.71,0,0,7,0,1011,0,0.99,0.0,0
PF08552,PF04934:PF15991:PF04729:PF02291:PF03479,9,27,5,4,22,987,0.19,0.97,0.56,0.31,1,0,9,1,1008,0.0,0.99,0.0,-0.0
PF01146,PF14802:PF08286:PF04089:PF00992:PF14997,10,12,1,9,11,997,0.08,0.98,0.1,0.08,1,1,9,0,1008,1.0,0.99,0.1,0.31
PF16020,PF14721:PF14962:PF01180:PF13806:PF14691,2,39,2,0,37,979,0.05,0.96,1.0,0.22,1,1,1,0,1016,1.0,1.0,0.5,0.71
PF00257,PF10222:PF00684:PF14308:PF09495:PF05099,6,18,0,6,18,994,0.0,0.98,0.0,-0.01,1,0,6,1,1011,0.0,0.99,0.0,-0.0
PF09923,PF16416:PF04279:PF14983:PF05506:PF08340,2,5,0,2,5,1011,0.0,0.99,0.0,-0.0,0,0,2,0,1016,0,1.0,0.0,0
PF16186,PF01749:PF16689:PF09863:PF11879:PF14492,21,51,21,0,30,967,0.41,0.97,1.0,0.63,3,3,18,0,997,1.0,0.98,0.14,0.37
PF11916,PF13001:PF12755:PF12074:PF11919:PF08146,6,37,6,0,31,981,0.16,0.97,1.0,0.4,2,2,4,0,1012,1.0,1.0,0.33,0.58
PF13569,PF07560:PF07317:PF09070:PF07676:PF09607,0,35,0,0,35,983,0.0,0.97,0,0,0,0,0,0,1018,0,1.0,0,0
PF04301,PF05518:PF05989:PF04073:PF02059:PF08637,0,21,0,0,21,997,0.0,0.98,0,0,0,0,0,0,1018,0,1.0,0,0
PF02741,PF03729:PF11751:PF15518:PF05513:PF02572,1,4,0,1,4,1013,0.0,1.0,0.0,-0.0,0,0,1,0,1017,0,1.0,0.0,0
PF13330,PF10162:PF09175:PF09206:PF00094:PF08742,16,43,12,4,31,971,0.28,0.97,0.75,0.44,6,3,13,3,999,0.5,0.98,0.19,0.3
PF11332,PF11268:PF16168:PF06222:PF05930:PF11876,0,0,0,0,0,1018,0,1.0,0,0,0,0,0,0,1018,0,1.0,0,0
PF04832,PF10184:PF01091:PF00864:PF03766:PF17215,10,27,3,7,24,984,0.11,0.97,0.3,0.17,0,0,10,0,1008,0,0.99,0.0,0
PF00265,PF07189:PF05078:PF07386:PF00831:PF06232,10,19,5,5,14,994,0.26,0.98,0.5,0.35,2,2,8,0,1008,1.0,0.99,0.2,0.45
PF00793,PF08584:PF02284:PF01774:PF06172:PF07350,12,17,2,10,15,991,0.12,0.98,0.17,0.13,0,0,12,0,1006,0,0.99,0.0,0
PF01900,PF01680:PF11991:PF00453:PF00444:PF05995,15,39,8,7,31,972,0.21,0.96,0.53,0.32,1,0,15,1,1002,0.0,0.98,0.0,-0.0
PF05115,PF08026:PF15105:PF15763:PF02277:PF00519,2,8,0,2,8,1008,0.0,0.99,0.0,-0.0,0,0,2,0,1016,0,1.0,0.0,0
PF15050,PF05853:PF14877:PF15333:PF03907:PF17015,2,6,1,1,5,1011,0.17,0.99,0.5,0.29,0,0,2,0,1016,0,1.0,0.0,0
PF04858,PF00463:PF01274:PF16062:PF00821:PF16576,3,21,2,1,19,996,0.1,0.98,0.67,0.25,0,0,3,0,1015,0,1.0,0.0,0
PF11478,PF05084:PF02392:PF09932:PF08115:PF03040,0,8,0,0,8,1010,0.0,0.99,0,0,0,0,0,0,1018,0,1.0,0,0
PF03734,PF08924:PF00358:PF15225:PF02082:PF13406,3,11,1,2,10,1005,0.09,0.99,0.33,0.17,0,0,3,0,1015,0,1.0,0.0,0
PF13750,PF02413:PF02554:PF01580:PF12615:PF01913,0,6,0,0,6,1012,0.0,0.99,0,0,0,0,0,0,1018,0,1.0,0,0
PF13839,PF14416:PF12314:PF13914:PF00019:PF15813,21,37,18,3,19,978,0.49,0.98,0.86,0.64,3,2,19,1,996,0.67,0.98,0.1,0.25
PF00906,PF08453:PF14690:PF13742:PF08479:PF05947,1,4,0,1,4,1013,0.0,1.0,0.0,-0.0,0,0,1,0,1017,0,1.0,0.0,0
PF04751,PF06217:PF11677:PF10674:PF02531:PF11909,3,4,0,3,4,1011,0.0,0.99,0.0,-0.0,0,0,3,0,1015,0,1.0,0.0,0
PF01347,PF09172:PF06448:PF09175:PF00080:PF12491,19,26,14,5,12,987,0.54,0.98,0.74,0.62,1,1,18,0,999,1.0,0.98,0.05,0.23
PF15721,PF01303:PF15041:PF15085:PF08398:PF03379,1,5,0,1,5,1012,0.0,0.99,0.0,-0.0,0,0,1,0,1017,0,1.0,0.0,0
PF10604,PF06749:PF04520:PF00197:PF06376:PF05910,17,13,3,14,10,991,0.23,0.98,0.18,0.19,1,1,16,0,1001,1.0,0.98,0.06,0.24
PF06639,PF10566:PF07195:PF02277:PF16590:PF07805,0,5,0,0,5,1013,0.0,1.0,0,0,0,0,0,0,1018,0,1.0,0,0
PF01713,PF08590:PF08772:PF16568:PF16041:PF03384,12,24,12,0,12,994,0.5,0.99,1.0,0.7,2,2,10,0,1006,1.0,0.99,0.17,0.41
PF04780,PF04781:PF09743:PF08167:PF13329:PF14661,5,19,3,2,16,997,0.16,0.98,0.6,0.3,0,0,5,0,1013,0,1.0,0.0,0
PF16898,PF00986:PF08070:PF00204:PF00521:PF01751,9,34,8,1,26,983,0.24,0.97,0.89,0.45,19,8,1,11,998,0.42,0.99,0.89,0.61
PF03127,PF00790:PF12210:PF04516:PF10307:PF07535,11,34,11,0,23,984,0.32,0.98,1.0,0.56,5,1,10,4,1003,0.2,0.99,0.09,0.13
PF11946,PF00114:PF10566:PF01337:PF17006:PF10951,0,0,0,0,0,1018,0,1.0,0,0,0,0,0,0,1018,0,1.0,0,0
PF12579,PF11669:PF08265:PF10672:PF12527:PF16091,0,18,0,0,18,1000,0.0,0.98,0,0,0,0,0,0,1018,0,1.0,0,0
PF15488,PF00054:PF05193:PF00675:PF00481:PF05699,0,152,0,0,152,866,0.0,0.85,0,0,32,0,0,32,986,0.0,0.97,0,0
PF06333,PF11597:PF15950:PF08167:PF12842:PF06011,8,22,5,3,17,993,0.23,0.98,0.62,0.37,2,2,6,0,1010,1.0,0.99,0.25,0.5
PF16885,PF08763:PF16905:PF11933:PF16799:PF11601,2,12,2,0,10,1006,0.17,0.99,1.0,0.41,4,2,0,2,1014,0.5,1.0,1.0,0.71
PF03101,PF04434:PF10551:PF10532:PF03108:PF10536,30,70,24,6,46,942,0.34,0.95,0.8,0.5,15,10,20,5,983,0.67,0.98,0.33,0.46
PF08409,PF09295:PF16669:PF07786:PF07719:PF01408,9,72,7,2,65,944,0.1,0.93,0.78,0.26,3,3,6,0,1009,1.0,0.99,0.33,0.58
PF05042,PF06376:PF04520:PF01627:PF06127:PF06749,4,17,2,2,15,999,0.12,0.98,0.5,0.24,1,0,4,1,1013,0.0,1.0,0.0,-0.0
PF04430,PF06388:PF01470:PF04442:PF03834:PF10780,22,29,4,18,25,971,0.14,0.96,0.18,0.14,1,0,22,1,995,0.0,0.98,0.0,-0.0
PF07685,PF11642:PF16829:PF08535:PF05474:PF07556,3,1,0,3,1,1014,0.0,1.0,0.0,-0.0,0,0,3,0,1015,0,1.0,0.0,0
PF15819,PF14539:PF11210:PF14494:PF15343:PF01051,0,1,0,0,1,1017,0.0,1.0,0,0,0,0,0,0,1018,0,1.0,0,0
PF01229,PF04253:PF09112:PF03629:PF11901:PF00758,4,30,4,0,26,988,0.13,0.97,1.0,0.36,1,1,3,0,1014,1.0,1.0,0.25,0.5
PF16754,PF12034:PF13400:PF06305:PF05586:PF10393,0,7,0,0,7,1011,0.0,0.99,0,0,0,0,0,0,1018,0,1.0,0,0
PF12143,PF12142:PF14830:PF12326:PF00691:PF00264,2,44,2,0,42,974,0.05,0.96,1.0,0.21,1,1,1,0,1016,1.0,1.0,0.5,0.71
PF01404,PF14575:PF07699:PF14521:PF12772:PF03575,6,27,5,1,22,990,0.19,0.98,0.83,0.39,1,1,5,0,1012,1.0,1.0,0.17,0.41
PF01771,PF17053:PF04848:PF08453:PF11124:PF04559,1,5,1,0,4,1013,0.2,1.0,1.0,0.45,0,0,1,0,1017,0,1.0,0.0,0
PF08000,PF02074:PF02951:PF15427:PF15976:PF15281,2,9,1,1,8,1008,0.11,0.99,0.5,0.23,0,0,2,0,1016,0,1.0,0.0,0
PF07393,PF05278:PF13369:PF03469:PF03017:PF08755,7,20,4,3,16,995,0.2,0.98,0.57,0.33,3,2,5,1,1010,0.67,0.99,0.29,0.43
PF08308,PF17049:PF04451:PF03244:PF08707:PF04392,0,5,0,0,5,1013,0.0,1.0,0,0,0,0,0,0,1018,0,1.0,0,0
PF13833,PF13499:PF00036:PF13202:PF13405:PF00153,53,215,47,6,168,797,0.22,0.83,0.89,0.39,42,30,23,12,953,0.71,0.97,0.57,0.62
PF01853,PF05712:PF01530:PF08474:PF11717:PF08169,31,42,17,14,25,962,0.4,0.96,0.55,0.45,6,6,25,0,987,1.0,0.98,0.19,0.43
PF12900,PF12716:PF06912:PF06108:PF08641:PF15370,5,15,1,4,14,999,0.07,0.98,0.2,0.11,0,0,5,0,1013,0,1.0,0.0,0
PF16474,PF08687:PF08688:PF16646:PF09469:PF02208,11,9,2,9,7,1000,0.22,0.98,0.18,0.19,1,1,10,0,1007,1.0,0.99,0.09,0.3
PF02301,PF05653:PF14719:PF12998:PF11768:PF09184,11,46,5,6,41,966,0.11,0.95,0.45,0.21,1,1,10,0,1007,1.0,0.99,0.09,0.3
PF12105,PF17191:PF08032:PF11770:PF13435:PF15659,5,7,5,0,2,1011,0.71,1.0,1.0,0.84,0,0,5,0,1013,0,1.0,0.0,0
PF02575,PF05419:PF11909:PF10454:PF05151:PF02941,6,2,0,6,2,1010,0.0,0.99,0.0,-0.0,0,0,6,0,1012,0,0.99,0.0,0
PF13880,PF13878:PF02421:PF04546:PF11958:PF09033,4,17,4,0,13,1001,0.24,0.99,1.0,0.48,0,0,4,0,1014,0,1.0,0.0,0
PF01959,PF11017:PF02371:PF15252:PF06217:PF15667,3,3,1,2,2,1013,0.33,1.0,0.33,0.33,0,0,3,0,1015,0,1.0,0.0,0
PF00299,PF00323:PF01114:PF04644:PF09051:PF09049,1,2,0,1,2,1015,0.0,1.0,0.0,-0.0,0,0,1,0,1017,0,1.0,0.0,0
PF13871,PF14418:PF14061:PF17182:PF16737:PF14443,6,8,3,3,5,1007,0.38,0.99,0.5,0.43,1,1,5,0,1012,1.0,1.0,0.17,0.41
PF16966,PF11471:PF10106:PF10057:PF03323:PF06028,0,11,0,0,11,1007,0.0,0.99,0,0,0,0,0,0,1018,0,1.0,0,0
PF08152,PF10175:PF11719:PF00607:PF07962:PF14437,11,29,4,7,25,982,0.14,0.97,0.36,0.21,3,3,8,0,1007,1.0,0.99,0.27,0.52
PF11160,PF03428:PF11593:PF08795:PF07499:PF05034,0,4,0,0,4,1014,0.0,1.0,0,0,0,0,0,0,1018,0,1.0,0,0
PF01871,PF03350:PF07816:PF04367:PF07809:PF00301,4,5,0,4,5,1009,0.0,0.99,0.0,-0.0,0,0,4,0,1014,0,1.0,0.0,0
PF12284,PF12045:PF10525:PF03529:PF12407:PF03867,1,5,1,0,4,1013,0.2,1.0,1.0,0.45,1,1,0,0,1017,1.0,1.0,1.0,1.0
PF05343,PF13471:PF14804:PF04225:PF02873:PF08545,10,17,4,6,13,995,0.24,0.98,0.4,0.3,1,0,10,1,1007,0.0,0.99,0.0,-0.0
PF04085,PF05065:PF15676:PF13005:PF00524:PF09074,0,5,0,0,5,1013,0.0,1.0,0,0,0,0,0,0,1018,0,1.0,0,0
PF15671,PF04232:PF11703:PF16416:PF13204:PF01415,0,5,0,0,5,1013,0.0,1.0,0,0,0,0,0,0,1018,0,1.0,0,0
PF08089,PF08092:PF04691:PF14986:PF05151:PF11771,0,2,0,0,2,1016,0.0,1.0,0,0,0,0,0,0,1018,0,1.0,0,0
PF01790,PF11751:PF04222:PF02277:PF05887:PF16325,2,4,0,2,4,1012,0.0,0.99,0.0,-0.0,0,0,2,0,1016,0,1.0,0.0,0
PF14705,PF09419:PF15503:PF12319:PF09398:PF07939,4,20,1,3,19,995,0.05,0.98,0.25,0.1,0,0,4,0,1014,0,1.0,0.0,0
PF00116,PF02790:PF13116:PF13442:PF13943:PF06481,15,20,13,2,7,996,0.65,0.99,0.87,0.75,5,5,10,0,1003,1.0,0.99,0.33,0.57
PF07405,PF01913:PF15355:PF05939:PF08093:PF10106,0,3,0,0,3,1015,0.0,1.0,0,0,0,0,0,0,1018,0,1.0,0,0
PF08952,PF16726:PF16776:PF12456:PF07092:PF02383,4,40,4,0,36,978,0.1,0.96,1.0,0.31,2,1,3,1,1013,0.5,1.0,0.25,0.35
PF00189,PF12333:PF14959:PF07810:PF12859:PF02732,10,32,3,7,29,979,0.09,0.96,0.3,0.15,3,0,10,3,1005,0.0,0.99,0.0,-0.01
PF07531,PF08729:PF10309:PF15996:PF12830:PF15353,11,27,2,9,25,982,0.07,0.97,0.18,0.1,3,0,11,3,1004,0.0,0.99,0.0,-0.01
PF10351,PF10344:PF10359:PF10305:PF10293:PF10347,8,5,5,3,0,1010,1.0,1.0,0.62,0.79,4,4,4,0,1010,1.0,1.0,0.5,0.71
PF01052,PF15143:PF15726:PF06082:PF10634:PF06251,0,0,0,0,0,1018,0,1.0,0,0,0,0,0,0,1018,0,1.0,0,0
PF03925,PF07157:PF06070:PF06505:PF04740:PF03428,1,1,0,1,1,1016,0.0,1.0,0.0,-0.0,0,0,1,0,1017,0,1.0,0.0,0
PF01990,PF02392:PF15060:PF03842:PF15377:PF15467,2,8,1,1,7,1009,0.12,0.99,0.5,0.25,0,0,2,0,1016,0,1.0,0.0,0
PF02099,PF08059:PF05839:PF11891:PF03741:PF01428,9,41,4,5,37,972,0.1,0.96,0.44,0.19,3,1,8,2,1007,0.33,0.99,0.11,0.19
PF15636,PF05593:PF06484:PF17205:PF02333:PF00362,1,19,1,0,18,999,0.05,0.98,1.0,0.23,1,1,0,0,1017,1.0,1.0,1.0,1.0
PF00223,PF00421:PF00146:PF01578:PF00124:PF12238,7,31,4,3,27,984,0.13,0.97,0.57,0.26,1,0,7,1,1010,0.0,0.99,0.0,-0.0
PF09326,PF00384:PF04879:PF01568:PF10588:PF14710,15,25,14,1,11,992,0.56,0.99,0.93,0.72,2,1,14,1,1002,0.5,0.99,0.07,0.18
PF06554,PF13548:PF13677:PF09361:PF04965:PF02217,2,4,1,1,3,1013,0.25,1.0,0.5,0.35,0,0,2,0,1016,0,1.0,0.0,0
PF15673,PF08228:PF03907:PF05551:PF17056:PF04359,1,5,0,1,5,1012,0.0,0.99,0.0,-0.0,0,0,1,0,1017,0,1.0,0.0,0
PF05250,PF16037:PF00489:PF15715:PF14936:PF00706,3,1,0,3,1,1014,0.0,1.0,0.0,-0.0,0,0,3,0,1015,0,1.0,0.0,0
PF08843,PF11317:PF15088:PF07327:PF14519:PF02972,0,1,0,0,1,1017,0.0,1.0,0,0,0,0,0,0,1018,0,1.0,0,0
PF08224,PF07899:PF09787:PF04783:PF03469:PF03407,2,36,1,1,35,981,0.03,0.96,0.5,0.11,4,0,2,4,1012,0.0,0.99,0.0,-0.0
PF00036,PF13833:PF13405:PF13499:PF13202:PF08022,37,175,34,3,141,840,0.19,0.86,0.92,0.38,41,24,13,17,964,0.59,0.97,0.65,0.6
PF15029,PF11902:PF06403:PF14690:PF12081:PF17193,0,1,0,0,1,1017,0.0,1.0,0,0,0,0,0,0,1018,0,1.0,0,0
PF12368,PF06617:PF11127:PF03959:PF09122:PF13972,6,30,2,4,28,984,0.07,0.97,0.33,0.14,0,0,6,0,1012,0,0.99,0.0,0
PF15012,PF02366:PF16192:PF04339:PF03487:PF05836,1,16,0,1,16,1001,0.0,0.98,0.0,-0.0,0,0,1,0,1017,0,1.0,0.0,0
PF06013,PF14985:PF00770:PF09990:PF00796:PF15186,0,3,0,0,3,1015,0.0,1.0,0,0,0,0,0,0,1018,0,1.0,0,0
PF16180,PF16181:PF00554:PF16179:PF08198:PF01609,2,20,2,0,18,998,0.1,0.98,1.0,0.31,3,2,0,1,1015,0.67,1.0,1.0,0.82
PF00236,PF05039:PF00714:PF00537:PF00214:PF02024,1,3,1,0,2,1015,0.33,1.0,1.0,0.58,0,0,1,0,1017,0,1.0,0.0,0
PF12943,PF10780:PF00321:PF11779:PF16053:PF09696,4,19,1,3,18,996,0.05,0.98,0.25,0.11,0,0,4,0,1014,0,1.0,0.0,0
PF09157,PF09183:PF14232:PF08068:PF12503:PF06674,3,11,1,2,10,1005,0.09,0.99,0.33,0.17,1,1,2,0,1015,1.0,1.0,0.33,0.58
PF02187,PF14923:PF08976:PF00307:PF08580:PF10358,16,86,11,5,75,927,0.13,0.92,0.69,0.27,4,4,12,0,1002,1.0,0.99,0.25,0.5
PF14244,PF13976:PF03732:PF08284:PF13961:PF02337,28,108,21,7,87,903,0.19,0.91,0.75,0.35,15,9,19,6,984,0.6,0.98,0.32,0.43
PF08080,PF15519:PF11627:PF12220:PF08143:PF08081,1,14,1,0,13,1004,0.07,0.99,1.0,0.27,1,1,0,0,1017,1.0,1.0,1.0,1.0
PF12153,PF02070:PF15482:PF15762:PF06651:PF06681,0,0,0,0,0,1018,0,1.0,0,0,0,0,0,0,1018,0,1.0,0,0
PF03284,PF13366:PF15052:PF11268:PF10422:PF05547,0,5,0,0,5,1013,0.0,1.0,0,0,0,0,0,0,1018,0,1.0,0,0
PF16135,PF07897:PF03735:PF12269:PF14061:PF14051,15,20,7,8,13,990,0.35,0.98,0.47,0.39,3,3,12,0,1003,1.0,0.99,0.2,0.44
PF12202,PF11629:PF14593:PF12063:PF08311:PF13240,11,16,4,7,12,995,0.25,0.98,0.36,0.29,3,3,8,0,1007,1.0,0.99,0.27,0.52
PF00560,PF13855:PF08263:PF12799:PF07725:PF13516,50,187,50,0,137,831,0.27,0.87,1.0,0.48,43,27,23,16,952,0.63,0.96,0.54,0.56
PF00957,PF13774:PF01357:PF03330:PF00166:PF03417,36,46,22,14,24,958,0.48,0.96,0.61,0.52,8,6,30,2,980,0.75,0.97,0.17,0.34
PF15044,PF13236:PF12807:PF05303:PF07721:PF07720,5,24,5,0,19,994,0.21,0.98,1.0,0.45,3,3,2,0,1013,1.0,1.0,0.6,0.77
PF04397,PF00196:PF01339:PF00486:PF02954:PF08667,1,21,1,0,20,997,0.05,0.98,1.0,0.22,2,0,1,2,1015,0.0,1.0,0.0,-0.0
PF07281,PF02285:PF14473:PF06541:PF01716:PF04402,4,10,1,3,9,1005,0.1,0.99,0.25,0.15,0,0,4,0,1014,0,1.0,0.0,0
PF15501,PF14722:PF05781:PF14662:PF15246:PF09808,2,14,1,1,13,1003,0.07,0.99,0.5,0.19,1,1,1,0,1016,1.0,1.0,0.5,0.71
PF07399,PF10694:PF07706:PF04260:PF09029:PF00392,2,23,1,1,22,994,0.04,0.98,0.5,0.14,1,1,1,0,1016,1.0,1.0,0.5,0.71
PF07847,PF00197:PF07896:PF03168:PF04520:PF06376,9,16,3,6,13,996,0.19,0.98,0.33,0.24,0,0,9,0,1009,0,0.99,0.0,0
PF09778,PF00277:PF00272:PF14935:PF14542:PF00711,2,3,0,2,3,1013,0.0,1.0,0.0,-0.0,0,0,2,0,1016,0,1.0,0.0,0
PF07167,PF13722:PF03090:PF11751:PF05974:PF02277,2,3,0,2,3,1013,0.0,1.0,0.0,-0.0,0,0,2,0,1016,0,1.0,0.0,0
PF15011,PF10195:PF04930:PF14989:PF01596:PF02685,4,26,3,1,23,991,0.12,0.98,0.75,0.29,3,1,3,2,1012,0.33,1.0,0.25,0.29
PF00228,PF04916:PF08369:PF10261:PF00162:PF08661,4,34,3,1,31,983,0.09,0.97,0.75,0.25,3,3,1,0,1014,1.0,1.0,0.75,0.87
PF00757,PF01030:PF14843:PF12398:PF09067:PF12772,7,15,7,0,8,1003,0.47,0.99,1.0,0.68,3,3,4,0,1011,1.0,1.0,0.43,0.65
PF16621,PF08944:PF03700:PF13924:PF12026:PF12828,2,12,2,0,10,1006,0.17,0.99,1.0,0.41,2,2,0,0,1016,1.0,1.0,1.0,1.0
PF00489,PF02024:PF14653:PF06875:PF17032:PF06581,1,1,0,1,1,1016,0.0,1.0,0.0,-0.0,0,0,1,0,1017,0,1.0,0.0,0
PF03297,PF00876:PF12223:PF06708:PF11927:PF05078,7,39,4,3,35,976,0.1,0.96,0.57,0.23,0,0,7,0,1011,0,0.99,0.0,0
PF06694,PF15060:PF15467:PF15872:PF15015:PF15427,3,1,0,3,1,1014,0.0,1.0,0.0,-0.0,0,0,3,0,1015,0,1.0,0.0,0
PF00275,PF01761:PF01487:PF08501:PF01488:PF01202,16,29,11,5,18,984,0.38,0.98,0.69,0.5,12,11,5,1,1001,0.92,0.99,0.69,0.79
PF15224,PF06393:PF08857:PF08093:PF08026:PF15186,0,3,0,0,3,1015,0.0,1.0,0,0,0,0,0,0,1018,0,1.0,0,0
PF11236,PF09684:PF13753:PF04671:PF15726:PF04466,0,2,0,0,2,1016,0.0,1.0,0,0,0,0,0,0,1018,0,1.0,0,0
PF06327,PF16214:PF07700:PF08376:PF04940:PF00211,6,60,6,0,54,958,0.1,0.95,1.0,0.31,4,3,3,1,1011,0.75,1.0,0.5,0.61
PF10498,PF12414:PF13865:PF08081:PF08143:PF08617,3,18,3,0,15,1000,0.17,0.99,1.0,0.41,2,1,2,1,1014,0.5,1.0,0.33,0.41
PF13966,PF14529:PF12009:PF14111:PF08333:PF08284,91,107,50,41,57,870,0.47,0.9,0.55,0.45,8,7,84,1,926,0.88,0.92,0.08,0.25
PF05066,PF13922:PF13919:PF10482:PF12031:PF15778,6,19,4,2,15,997,0.21,0.98,0.67,0.37,2,2,4,0,1012,1.0,1.0,0.33,0.58
PF02709,PF13733:PF15048:PF00535:PF01193:PF00852,26,83,22,4,61,931,0.27,0.94,0.85,0.45,10,9,17,1,991,0.9,0.98,0.35,0.55
PF05604,PF08528:PF05548:PF04988:PF15045:PF10104,1,15,1,0,14,1003,0.07,0.99,1.0,0.26,1,1,0,0,1017,1.0,1.0,1.0,1.0
PF00360,PF01590:PF08446:PF10436:PF00512:PF00233,13,74,13,0,61,944,0.18,0.94,1.0,0.41,14,10,3,4,1001,0.71,0.99,0.77,0.74
PF03907,PF17078:PF15863:PF10664:PF15050:PF08653,1,5,1,0,4,1013,0.2,1.0,1.0,0.45,0,0,1,0,1017,0,1.0,0.0,0
PF02513,PF02988:PF06189:PF10265:PF14336:PF01642,1,11,0,1,11,1006,0.0,0.99,0.0,-0.0,0,0,1,0,1017,0,1.0,0.0,0
PF05929,PF02495:PF12276:PF12156:PF00948:PF06440,0,8,0,0,8,1010,0.0,0.99,0,0,0,0,0,0,1018,0,1.0,0,0
PF08907,PF11767:PF04073:PF01927:PF10481:PF04310,3,24,3,0,21,994,0.12,0.98,1.0,0.35,1,1,2,0,1015,1.0,1.0,0.33,0.58
PF05173,PF01113:PF14693:PF01729:PF01386:PF12243,5,22,5,0,17,996,0.23,0.98,1.0,0.47,0,0,5,0,1013,0,1.0,0.0,0
PF00465,PF00171:PF04199:PF07110:PF00551:PF11807,24,119,19,5,100,894,0.16,0.9,0.79,0.33,14,11,13,3,991,0.79,0.98,0.46,0.59
PF16766,PF16768:PF07394:PF16704:PF10407:PF02916,1,8,1,0,7,1010,0.12,0.99,1.0,0.35,0,0,1,0,1017,0,1.0,0.0,0
PF07343,PF14232:PF01228:PF02526:PF00577:PF07806,0,7,0,0,7,1011,0.0,0.99,0,0,0,0,0,0,1018,0,1.0,0,0
PF01039,PF00289:PF02785:PF00364:PF00682:PF08326,34,61,20,14,41,943,0.33,0.95,0.59,0.41,29,18,16,11,973,0.62,0.97,0.53,0.56
PF12414,PF08081:PF12220:PF08143:PF13865:PF11627,4,15,3,1,12,1002,0.2,0.99,0.75,0.38,1,1,3,0,1014,1.0,1.0,0.25,0.5
PF04570,PF10248:PF08536:PF03195:PF08265:PF01279,2,23,0,2,23,993,0.0,0.98,0.0,-0.01,1,0,2,1,1015,0.0,1.0,0.0,-0.0
PF00920,PF14027:PF04597:PF01730:PF05995:PF14033,20,39,11,9,28,970,0.28,0.96,0.55,0.38,4,4,16,0,998,1.0,0.98,0.2,0.44
PF12296,PF04667:PF01987:PF07350:PF11779:PF06127,6,19,3,3,16,996,0.16,0.98,0.5,0.27,0,0,6,0,1012,0,0.99,0.0,0
PF14703,PF02714:PF13967:PF12621:PF03723:PF03722,22,28,21,1,7,989,0.75,0.99,0.95,0.84,12,12,10,0,996,1.0,0.99,0.55,0.73
PF10873,PF09461:PF10279:PF09216:PF16586:PF01051,0,1,0,0,1,1017,0.0,1.0,0,0,0,0,0,0,1018,0,1.0,0,0
PF03871,PF01191:PF03868:PF00993:PF00166:PF16196,12,29,11,1,18,988,0.38,0.98,0.92,0.58,2,2,10,0,1006,1.0,0.99,0.17,0.41
PF00121,PF02672:PF02800:PF00044:PF07000:PF07575,13,48,8,5,40,965,0.17,0.96,0.62,0.3,9,5,8,4,1001,0.56,0.99,0.38,0.46
PF03815,PF08305:PF14200:PF02010:PF00754:PF02140,11,71,8,3,63,944,0.11,0.94,0.73,0.27,8,4,7,4,1003,0.5,0.99,0.36,0.42
PF04803,PF02576:PF06420:PF10330:PF12049:PF11255,3,3,0,3,3,1012,0.0,0.99,0.0,-0.0,0,0,3,0,1015,0,1.0,0.0,0
PF12169,PF15862:PF10395:PF14952:PF08578:PF12432,1,10,0,1,10,1007,0.0,0.99,0.0,-0.0,1,0,1,1,1016,0.0,1.0,0.0,-0.0
PF03343,PF03386:PF08746:PF04006:PF05129:PF05693,9,29,5,4,24,985,0.17,0.97,0.56,0.3,1,1,8,0,1009,1.0,0.99,0.11,0.33
PF04008,PF06239:PF11051:PF12018:PF06762:PF08155,0,35,0,0,35,983,0.0,0.97,0,0,1,0,0,1,1017,0.0,1.0,0,0
PF00103,PF02267:PF12301:PF00711:PF00272:PF05296,4,7,1,3,6,1008,0.14,0.99,0.25,0.18,0,0,4,0,1014,0,1.0,0.0,0
PF10383,PF12432:PF14022:PF06869:PF07891:PF17167,6,9,4,2,5,1007,0.44,0.99,0.67,0.54,0,0,6,0,1012,0,0.99,0.0,0
PF08346,PF06745:PF12302:PF07804:PF06381:PF08404,0,3,0,0,3,1015,0.0,1.0,0,0,0,0,0,0,1018,0,1.0,0,0
PF09388,PF04052:PF12903:PF11650:PF12531:PF10076,0,0,0,0,0,1018,0,1.0,0,0,0,0,0,0,1018,0,1.0,0,0
PF16074,PF13689:PF12098:PF16731:PF01673:PF07659,0,0,0,0,0,1018,0,1.0,0,0,0,0,0,0,1018,0,1.0,0,0
PF10111,PF13477:PF12038:PF05159:PF04413:PF07733,0,15,0,0,15,1003,0.0,0.99,0,0,0,0,0,0,1018,0,1.0,0,0
PF03050,PF13007:PF08497:PF11736:PF07805:PF15212,0,5,0,0,5,1013,0.0,1.0,0,0,0,0,0,0,1018,0,1.0,0,0
PF03901,PF10245:PF05219:PF07542:PF03088:PF01253,30,47,15,15,32,956,0.32,0.95,0.5,0.38,6,4,26,2,986,0.67,0.97,0.13,0.29
PF15478,PF14866:PF15680:PF13094:PF15119:PF08026,1,2,0,1,2,1015,0.0,1.0,0.0,-0.0,0,0,1,0,1017,0,1.0,0.0,0
PF13341,PF03089:PF01134:PF04113:PF14031:PF00842,1,29,1,0,28,989,0.03,0.97,1.0,0.18,2,1,0,1,1016,0.5,1.0,1.0,0.71
PF02214,PF03520:PF03521:PF11879:PF02788:PF16799,47,15,8,39,7,964,0.53,0.95,0.17,0.28,1,1,46,0,971,1.0,0.95,0.02,0.14
PF04502,PF00836:PF03360:PF13593:PF10178:PF03073,23,30,11,12,19,976,0.37,0.97,0.48,0.4,1,1,22,0,995,1.0,0.98,0.04,0.21
PF14802,PF09496:PF08286:PF01730:PF14997:PF00835,0,11,0,0,11,1007,0.0,0.99,0,0,0,0,0,0,1018,0,1.0,0,0
PF12348,PF09743:PF04821:PF12074:PF15917:PF12859,13,15,3,10,12,993,0.2,0.98,0.23,0.2,0,0,13,0,1005,0,0.99,0.0,0
PF00691,PF01475:PF04052:PF07494:PF01364:PF01514,5,7,0,5,7,1006,0.0,0.99,0.0,-0.01,0,0,5,0,1013,0,1.0,0.0,0
PF08888,PF15212:PF06573:PF01303:PF15838:PF15754,0,2,0,0,2,1016,0.0,1.0,0,0,0,0,0,0,1018,0,1.0,0,0
PF11413,PF08778:PF16279:PF08832:PF07469:PF12114,6,12,2,4,10,1002,0.17,0.99,0.33,0.23,4,2,4,2,1010,0.5,0.99,0.33,0.41
PF09200,PF01419:PF15919:PF00393:PF07646:PF03446,0,53,0,0,53,965,0.0,0.95,0,0,8,0,0,8,1010,0.0,0.99,0,0
PF15211,PF07400:PF16649:PF08792:PF15047:PF11630,0,1,0,0,1,1017,0.0,1.0,0,0,0,0,0,0,1018,0,1.0,0,0
PF05483,PF05548:PF07260:PF15090:PF15767:PF07904,4,8,0,4,8,1006,0.0,0.99,0.0,-0.01,0,0,4,0,1014,0,1.0,0.0,0
PF15458,PF10377:PF01465:PF06345:PF10495:PF15246,4,22,1,3,21,993,0.05,0.98,0.25,0.1,1,1,3,0,1014,1.0,1.0,0.25,0.5
PF10716,PF11317:PF15172:PF09459:PF02427:PF00737,1,3,0,1,3,1014,0.0,1.0,0.0,-0.0,0,0,1,0,1017,0,1.0,0.0,0
PF04428,PF16967:PF04632:PF15976:PF07434:PF09327,3,0,0,3,0,1015,0,1.0,0.0,0,0,0,3,0,1015,0,1.0,0.0,0
PF05541,PF05366:PF09141:PF02570:PF08333:PF16511,0,29,0,0,29,989,0.0,0.97,0,0,1,0,0,1,1017,0.0,1.0,0,0
PF16452,PF06805:PF14052:PF12603:PF05939:PF06505,1,1,0,1,1,1016,0.0,1.0,0.0,-0.0,0,0,1,0,1017,0,1.0,0.0,0
PF02399,PF11751:PF12080:PF13247:PF06890:PF15518,2,1,0,2,1,1015,0.0,1.0,0.0,-0.0,0,0,2,0,1016,0,1.0,0.0,0
PF01580,PF06070:PF02554:PF03592:PF17006:PF09397,5,6,5,0,1,1012,0.83,1.0,1.0,0.91,0,0,5,0,1013,0,1.0,0.0,0
PF10363,PF12830:PF12765:PF12397:PF11919:PF10344,3,28,1,2,27,988,0.04,0.97,0.33,0.1,2,1,2,1,1014,0.5,1.0,0.33,0.41
PF00481,PF07830:PF02784:PF00278:PF13088:PF07716,73,57,32,41,25,920,0.56,0.94,0.44,0.46,6,5,68,1,944,0.83,0.93,0.07,0.23
PF15093,PF07891:PF15073:PF12600:PF15235:PF14022,2,4,0,2,4,1012,0.0,0.99,0.0,-0.0,0,0,2,0,1016,0,1.0,0.0,0
PF12896,PF12341:PF10313:PF12931:PF03451:PF08145,14,27,6,8,21,983,0.22,0.97,0.43,0.3,3,3,11,0,1004,1.0,0.99,0.21,0.46
PF02551,PF06798:PF07308:PF06761:PF14564:PF15709,0,1,0,0,1,1017,0.0,1.0,0,0,0,0,0,0,1018,0,1.0,0,0
PF09788,PF15905:PF03470:PF07651:PF03468:PF15908,5,28,4,1,24,989,0.14,0.98,0.8,0.33,2,1,4,1,1012,0.5,1.0,0.2,0.31
PF06390,PF15708:PF04625:PF03848:PF04624:PF15752,1,1,0,1,1,1016,0.0,1.0,0.0,-0.0,0,0,1,0,1017,0,1.0,0.0,0
PF09093,PF04984:PF04552:PF02501:PF04612:PF10567,1,4,0,1,4,1013,0.0,1.0,0.0,-0.0,0,0,1,0,1017,0,1.0,0.0,0
PF01179,PF02728:PF02727:PF09248:PF02887:PF06628,28,52,24,4,28,962,0.46,0.97,0.86,0.62,11,11,17,0,990,1.0,0.98,0.39,0.62
PF01556,PF14308:PF09350:PF12572:PF05154:PF14901,42,31,17,25,14,962,0.55,0.96,0.4,0.45,2,2,40,0,976,1.0,0.96,0.05,0.21
PF07694,PF13556:PF05231:PF12431:PF06078:PF01640,7,5,2,5,3,1008,0.4,0.99,0.29,0.33,0,0,7,0,1011,0,0.99,0.0,0
PF07560,PF07707:PF01569:PF12156:PF13569:PF04577,0,94,0,0,94,924,0.0,0.91,0,0,10,0,0,10,1008,0.0,0.99,0,0
PF13824,PF06047:PF07222:PF14441:PF06584:PF12751,4,16,2,2,14,1000,0.12,0.98,0.5,0.24,1,1,3,0,1014,1.0,1.0,0.25,0.5
PF03199,PF03917:PF15685:PF01609:PF00746:PF02532,2,10,2,0,8,1008,0.2,0.99,1.0,0.45,0,0,2,0,1016,0,1.0,0.0,0
PF12238,PF00499:PF06658:PF00421:PF03973:PF05915,0,22,0,0,22,996,0.0,0.98,0,0,0,0,0,0,1018,0,1.0,0,0
PF08912,PF06918:PF11559:PF16034:PF12455:PF04423,7,18,3,4,15,996,0.17,0.98,0.43,0.26,0,0,7,0,1011,0,0.99,0.0,0
PF05496,PF12002:PF16193:PF14532:PF16565:PF05491,10,20,9,1,11,997,0.45,0.99,0.9,0.63,3,2,8,1,1007,0.67,0.99,0.2,0.36
PF17104,PF17062:PF03883:PF03275:PF06109:PF12204,0,5,0,0,5,1013,0.0,1.0,0,0,0,0,0,0,1018,0,1.0,0,0
PF09850,PF01364:PF05491:PF11304:PF11026:PF15518,1,8,0,1,8,1009,0.0,0.99,0.0,-0.0,0,0,1,0,1017,0,1.0,0.0,0
PF07163,PF05556:PF15829:PF15134:PF04360:PF03275,3,7,1,2,6,1009,0.14,0.99,0.33,0.21,0,0,3,0,1015,0,1.0,0.0,0
PF14529,PF12009:PF13966:PF00075:PF00665:PF05380,45,175,32,13,143,830,0.18,0.85,0.71,0.31,30,14,31,16,957,0.47,0.95,0.31,0.36
PF01057,PF16071:PF15235:PF08744:PF16967:PF12178,2,3,1,1,2,1014,0.33,1.0,0.5,0.41,0,0,2,0,1016,0,1.0,0.0,0
PF06907,PF15831:PF15063:PF13933:PF15744:PF15715,2,0,0,2,0,1016,0,1.0,0.0,0,0,0,2,0,1016,0,1.0,0.0,0
PF05450,PF06880:PF16061:PF04833:PF07786:PF12735,11,10,2,9,8,999,0.2,0.98,0.18,0.18,0,0,11,0,1007,0,0.99,0.0,0
PF02699,PF02355:PF13721:PF02572:PF04196:PF09327,4,7,3,1,4,1010,0.43,1.0,0.75,0.56,0,0,4,0,1014,0,1.0,0.0,0
PF14560,PF01302:PF16641:PF13446:PF12436:PF12455,13,52,9,4,43,962,0.17,0.95,0.69,0.33,4,2,11,2,1003,0.5,0.99,0.15,0.27
PF06232,PF07333:PF00321:PF01716:PF00537:PF11264,4,4,0,4,4,1010,0.0,0.99,0.0,-0.0,0,0,4,0,1014,0,1.0,0.0,0
PF02348,PF02130:PF08282:PF12409:PF09040:PF05757,5,40,3,2,37,976,0.07,0.96,0.6,0.2,2,0,5,2,1011,0.0,0.99,0.0,-0.0
PF11543,PF05020:PF05021:PF03880:PF00833:PF08061,9,28,8,1,20,989,0.29,0.98,0.89,0.5,3,3,6,0,1009,1.0,0.99,0.33,0.58
PF10284,PF10285:PF05295:PF02057:PF06753:PF03578,0,2,0,0,2,1016,0.0,1.0,0,0,0,0,0,0,1018,0,1.0,0,0
PF13813,PF04646:PF01066:PF08652:PF01328:PF08245,14,64,10,4,54,950,0.16,0.94,0.71,0.32,8,4,10,4,1000,0.5,0.99,0.29,0.37
PF04539,PF04545:PF08281:PF04542:PF00140:PF03979,15,29,15,0,14,989,0.52,0.99,1.0,0.71,5,5,10,0,1003,1.0,0.99,0.33,0.57
PF03100,PF02531:PF09117:PF09232:PF09252:PF02507,0,2,0,0,2,1016,0.0,1.0,0,0,0,0,0,0,1018,0,1.0,0,0
PF06131,PF06007:PF06070:PF06798:PF08404:PF01913,2,4,0,2,4,1012,0.0,0.99,0.0,-0.0,0,0,2,0,1016,0,1.0,0.0,0
PF03978,PF13618:PF13785:PF12105:PF05713:PF17191,0,5,0,0,5,1013,0.0,1.0,0,0,0,0,0,0,1018,0,1.0,0,0
PF12031,PF01388:PF08169:PF02257:PF05066:PF13919,8,46,6,2,40,970,0.13,0.96,0.75,0.3,5,2,6,3,1007,0.4,0.99,0.25,0.31
PF15882,PF15013:PF10853:PF06342:PF14799:PF10244,12,17,4,8,13,993,0.24,0.98,0.33,0.27,1,1,11,0,1006,1.0,0.99,0.08,0.29
PF04641,PF15906:PF13879:PF00160:PF15742:PF12185,13,79,8,5,71,934,0.1,0.93,0.62,0.23,4,3,10,1,1004,0.75,0.99,0.23,0.41
PF12887,PF12879:PF15253:PF12090:PF08729:PF12878,0,8,0,0,8,1010,0.0,0.99,0,0,0,0,0,0,1018,0,1.0,0,0
PF01697,PF04646:PF02517:PF04577:PF17175:PF08652,29,39,10,19,29,960,0.26,0.95,0.34,0.27,4,4,25,0,989,1.0,0.98,0.14,0.37
PF08292,PF03876:PF00575:PF14878:PF09371:PF14635,5,44,5,0,39,974,0.11,0.96,1.0,0.33,11,1,4,10,1003,0.09,0.99,0.2,0.13
PF02028,PF04380:PF11493:PF06876:PF15133:PF11027,1,3,0,1,3,1014,0.0,1.0,0.0,-0.0,0,0,1,0,1017,0,1.0,0.0,0
PF03849,PF00793:PF00797:PF12239:PF01774:PF02284,11,40,3,8,37,970,0.07,0.96,0.27,0.13,2,1,10,1,1006,0.5,0.99,0.09,0.21
PF03073,PF13741:PF14954:PF03488:PF06342:PF07096,2,10,1,1,9,1007,0.1,0.99,0.5,0.22,0,0,2,0,1016,0,1.0,0.0,0
PF08205,PF07686:PF13895:PF03921:PF09240:PF02158,29,71,24,5,47,942,0.34,0.95,0.83,0.51,4,3,26,1,988,0.75,0.97,0.1,0.27
PF08211,PF01872:PF00383:PF01249:PF08719:PF11041,3,64,3,0,61,954,0.05,0.94,1.0,0.21,10,1,2,9,1006,0.1,0.99,0.33,0.18
PF02687,PF12704:PF17167:PF15994:PF11229:PF00680,10,21,5,5,16,992,0.24,0.98,0.5,0.34,0,0,10,0,1008,0,0.99,0.0,0
PF06444,PF01059:PF04241:PF00507:PF00499:PF00321,1,16,1,0,15,1002,0.06,0.99,1.0,0.25,0,0,1,0,1017,0,1.0,0.0,0
PF15249,PF12516:PF15778:PF15292:PF10309:PF12478,9,16,3,6,13,996,0.19,0.98,0.33,0.24,0,0,9,0,1009,0,0.99,0.0,0
PF13326,PF09252:PF01809:PF05355:PF05754:PF00770,1,4,0,1,4,1013,0.0,1.0,0.0,-0.0,0,0,1,0,1017,0,1.0,0.0,0
PF14833,PF03446:PF17042:PF00393:PF07005:PF09130,25,38,22,3,16,977,0.58,0.98,0.88,0.71,6,6,19,0,993,1.0,0.98,0.24,0.49
PF16473,PF05202:PF15518:PF04612:PF11612:PF04196,1,3,0,1,3,1014,0.0,1.0,0.0,-0.0,0,0,1,0,1017,0,1.0,0.0,0
PF06631,PF11618:PF00388:PF09457:PF16056:PF15625,4,33,4,0,29,985,0.12,0.97,1.0,0.34,2,2,2,0,1014,1.0,1.0,0.5,0.71
PF14469,PF15172:PF02531:PF15173:PF15109:PF11677,2,3,0,2,3,1013,0.0,1.0,0.0,-0.0,0,0,2,0,1016,0,1.0,0.0,0
PF07780,PF11861:PF14978:PF01728:PF00978:PF11942,14,49,14,0,35,969,0.29,0.97,1.0,0.53,6,6,8,0,1004,1.0,0.99,0.43,0.65
PF06672,PF06832:PF07804:PF04355:PF05488:PF14512,0,2,0,0,2,1016,0.0,1.0,0,0,0,0,0,0,1018,0,1.0,0,0
PF08187,PF05572:PF08225:PF13778:PF14727:PF12130,1,22,0,1,22,995,0.0,0.98,0.0,-0.0,1,0,1,1,1016,0.0,1.0,0.0,-0.0
PF12457,PF07713:PF07842:PF13821:PF01585:PF11952,7,70,7,0,63,948,0.1,0.94,1.0,0.31,6,2,5,4,1007,0.33,0.99,0.29,0.3
PF05675,PF01118:PF00995:PF05720:PF15433:PF06652,0,46,0,0,46,972,0.0,0.95,0,0,2,0,0,2,1016,0.0,1.0,0,0
PF08822,PF13901:PF12430:PF10367:PF04508:PF01802,0,37,0,0,37,981,0.0,0.96,0,0,2,0,0,2,1016,0.0,1.0,0,0
PF00732,PF05199:PF16010:PF02897:PF01735:PF10288,56,87,54,2,33,929,0.62,0.97,0.96,0.76,4,4,52,0,962,1.0,0.95,0.07,0.26
PF16515,PF17045:PF11577:PF04388:PF09762:PF11496,5,21,1,4,20,993,0.05,0.98,0.2,0.09,1,0,5,1,1012,0.0,0.99,0.0,-0.0
PF11591,PF03475:PF06545:PF04221:PF03450:PF04011,2,29,2,0,27,989,0.07,0.97,1.0,0.26,3,2,0,1,1015,0.67,1.0,1.0,0.82
PF02070,PF12153:PF15762:PF06681:PF15312:PF03745,0,0,0,0,0,1018,0,1.0,0,0,0,0,0,0,1018,0,1.0,0,0
PF07816,PF07896:PF03350:PF09597:PF09419:PF03045,0,23,0,0,23,995,0.0,0.98,0,0,0,0,0,0,1018,0,1.0,0,0
PF11937,PF02560:PF01234:PF01774:PF00148:PF01287,4,28,4,0,24,990,0.14,0.98,1.0,0.37,0,0,4,0,1014,0,1.0,0.0,0
PF08553,PF07096:PF05512:PF02133:PF03239:PF03073,3,33,2,1,31,984,0.06,0.97,0.67,0.19,0,0,3,0,1015,0,1.0,0.0,0
PF15779,PF14914:PF10578:PF15362:PF02084:PF15788,4,3,1,3,2,1012,0.33,1.0,0.25,0.29,0,0,4,0,1014,0,1.0,0.0,0
PF04465,PF09260:PF03477:PF16028:PF00880:PF16657,0,17,0,0,17,1001,0.0,0.98,0,0,1,0,0,1,1017,0.0,1.0,0,0
PF02185,PF03097:PF13949:PF15796:PF08926:PF00659,22,42,13,9,29,967,0.31,0.96,0.59,0.41,7,4,18,3,993,0.57,0.98,0.18,0.31
PF05498,PF02704:PF06206:PF06749:PF06697:PF04720,7,17,2,5,15,996,0.12,0.98,0.29,0.17,2,1,6,1,1010,0.5,0.99,0.14,0.26
PF06749,PF04720:PF04520:PF06376:PF04535:PF05498,7,14,3,4,11,1000,0.21,0.99,0.43,0.3,2,1,6,1,1010,0.5,0.99,0.14,0.26
PF00829,PF07798:PF02291:PF03479:PF03647:PF01786,13,31,7,6,24,981,0.23,0.97,0.54,0.34,3,2,11,1,1004,0.67,0.99,0.15,0.32
PF04055,PF06463:PF01967:PF00919:PF01938:PF05277,61,37,26,35,11,946,0.7,0.95,0.43,0.53,7,7,54,0,957,1.0,0.95,0.11,0.33
PF06553,PF15171:PF05612:PF07771:PF15260:PF06351,4,5,1,3,4,1010,0.2,0.99,0.25,0.22,0,0,4,0,1014,0,1.0,0.0,0
PF06298,PF01091:PF00101:PF03979:PF00220:PF03766,1,13,0,1,13,1004,0.0,0.99,0.0,-0.0,0,0,1,0,1017,0,1.0,0.0,0
PF15556,PF02977:PF15119:PF17050:PF05638:PF15828,0,5,0,0,5,1013,0.0,1.0,0,0,0,0,0,0,1018,0,1.0,0,0
PF16006,PF16171:PF05483:PF15669:PF14816:PF05604,1,9,0,1,9,1008,0.0,0.99,0.0,-0.0,0,0,1,0,1017,0,1.0,0.0,0
PF15384,PF15828:PF02979:PF03050:PF13247:PF06890,0,5,0,0,5,1013,0.0,1.0,0,0,0,0,0,0,1018,0,1.0,0,0
PF01357,PF03330:PF01731:PF07258:PF05036:PF10420,14,37,13,1,24,980,0.35,0.98,0.93,0.56,2,2,12,0,1004,1.0,0.99,0.14,0.38
PF06305,PF13400:PF15847:PF15729:PF15756:PF15856,3,5,1,2,4,1011,0.2,0.99,0.33,0.26,0,0,3,0,1015,0,1.0,0.0,0
PF01557,PF09298:PF12146:PF04083:PF10370:PF02129,44,80,33,11,47,927,0.41,0.94,0.75,0.53,13,12,32,1,973,0.92,0.97,0.27,0.49
PF14260,PF03104:PF00136:PF08996:PF12254:PF08490,18,38,18,0,20,980,0.47,0.98,1.0,0.68,19,6,12,13,987,0.32,0.98,0.33,0.31
PF02994,PF12259:PF00589:PF16012:PF08284:PF01107,19,47,7,12,40,959,0.15,0.95,0.37,0.21,5,3,16,2,997,0.6,0.98,0.16,0.3
PF10183,PF09769:PF03980:PF01097:PF06127:PF04716,9,23,2,7,21,988,0.09,0.97,0.22,0.13,1,0,9,1,1008,0.0,0.99,0.0,-0.0
PF00853,PF12540:PF06031:PF05178:PF09816:PF07545,4,15,1,3,14,1000,0.07,0.98,0.25,0.12,1,1,3,0,1014,1.0,1.0,0.25,0.5
PF06482,PF06121:PF01534:PF02191:PF14636:PF10744,5,23,3,2,20,993,0.13,0.98,0.6,0.27,2,2,3,0,1013,1.0,1.0,0.4,0.63
PF06951,PF14954:PF09777:PF00272:PF12020:PF14935,11,6,2,9,4,1003,0.33,0.99,0.18,0.24,0,0,11,0,1007,0,0.99,0.0,0
PF03320,PF08299:PF15518:PF14842:PF14882:PF03406,5,3,1,4,2,1011,0.33,0.99,0.2,0.26,0,0,5,0,1013,0,1.0,0.0,0
PF09095,PF06892:PF02304:PF01721:PF06543:PF11752,2,0,0,2,0,1016,0,1.0,0.0,0,0,0,2,0,1016,0,1.0,0.0,0
PF16649,PF15211:PF15972:PF11630:PF15713:PF08792,1,2,0,1,2,1015,0.0,1.0,0.0,-0.0,0,0,1,0,1017,0,1.0,0.0,0
PF02095,PF09049:PF09051:PF15689:PF15690:PF09050,2,0,0,2,0,1016,0,1.0,0.0,0,0,0,2,0,1016,0,1.0,0.0,0
PF10504,PF15550:PF15814:PF06313:PF03488:PF14747,1,1,0,1,1,1016,0.0,1.0,0.0,-0.0,0,0,1,0,1017,0,1.0,0.0,0
PF02372,PF15071:PF15370:PF00727:PF05039:PF00236,1,8,0,1,8,1009,0.0,0.99,0.0,-0.0,0,0,1,0,1017,0,1.0,0.0,0
PF13089,PF13090:PF02503:PF03090:PF08681:PF03406,1,3,1,0,2,1015,0.33,1.0,1.0,0.58,0,0,1,0,1017,0,1.0,0.0,0
PF14374,PF00573:PF05019:PF00375:PF04064:PF04230,12,37,10,2,27,979,0.27,0.97,0.83,0.47,1,1,11,0,1006,1.0,0.99,0.08,0.29
PF15302,PF02106:PF12904:PF15398:PF15467:PF01114,0,2,0,0,2,1016,0.0,1.0,0,0,0,0,0,0,1018,0,1.0,0,0
PF06658,PF04176:PF02284:PF04716:PF08561:PF05915,3,26,2,1,24,991,0.08,0.98,0.67,0.22,3,1,2,2,1013,0.33,1.0,0.33,0.33
PF11672,PF09967:PF09444:PF06586:PF15763:PF04354,2,4,2,0,2,1014,0.5,1.0,1.0,0.71,0,0,2,0,1016,0,1.0,0.0,0
PF11928,PF06221:PF04087:PF09816:PF08634:PF14909,0,18,0,0,18,1000,0.0,0.98,0,0,1,0,0,1,1017,0.0,1.0,0,0
PF01289,PF07157:PF13722:PF12241:PF06798:PF11751,1,1,0,1,1,1016,0.0,1.0,0.0,-0.0,0,0,1,0,1017,0,1.0,0.0,0
PF06579,PF10259:PF00965:PF10244:PF04176:PF10185,5,26,3,2,23,990,0.12,0.98,0.6,0.26,2,1,4,1,1012,0.5,1.0,0.2,0.31
PF08249,PF04333:PF07679:PF09519:PF02786:PF00336,0,121,0,0,121,897,0.0,0.88,0,0,1,0,0,1,1017,0.0,1.0,0,0
PF14727,PF14728:PF06382:PF14674:PF07574:PF08746,7,16,5,2,11,1000,0.31,0.99,0.71,0.47,2,2,5,0,1011,1.0,1.0,0.29,0.53
PF15137,PF06890:PF13995:PF08411:PF04451:PF07338,1,7,0,1,7,1010,0.0,0.99,0.0,-0.0,0,0,1,0,1017,0,1.0,0.0,0
PF01780,PF04900:PF05254:PF06825:PF15251:PF09774,9,30,7,2,23,986,0.23,0.98,0.78,0.42,1,0,9,1,1008,0.0,0.99,0.0,-0.0
PF01088,PF03577:PF05191:PF09814:PF05859:PF03619,27,44,11,16,33,958,0.25,0.95,0.41,0.3,4,2,25,2,989,0.5,0.97,0.07,0.19
PF15816,PF15829:PF15003:PF09784:PF05512:PF15576,1,6,0,1,6,1011,0.0,0.99,0.0,-0.0,0,0,1,0,1017,0,1.0,0.0,0
PF06742,PF06863:PF07171:PF07364:PF03315:PF05683,3,11,0,3,11,1004,0.0,0.99,0.0,-0.01,1,0,3,1,1014,0.0,1.0,0.0,-0.0
PF15901,PF15902:PF09067:PF06328:PF12772:PF16066,9,14,9,0,5,1004,0.64,1.0,1.0,0.8,1,1,8,0,1009,1.0,0.99,0.11,0.33
PF01844,PF08388:PF13655:PF08284:PF15790:PF13892,12,37,9,3,28,978,0.24,0.97,0.75,0.42,4,4,8,0,1006,1.0,0.99,0.33,0.58
PF15195,PF15828:PF01514:PF17049:PF00669:PF03548,1,6,0,1,6,1011,0.0,0.99,0.0,-0.0,0,0,1,0,1017,0,1.0,0.0,0
PF05823,PF01674:PF15868:PF00965:PF00811:PF05497,2,32,1,1,31,985,0.03,0.97,0.5,0.12,0,0,2,0,1016,0,1.0,0.0,0
PF11903,PF02775:PF10371:PF00205:PF02776:PF16582,4,30,3,1,27,987,0.1,0.97,0.75,0.27,22,2,2,20,994,0.09,0.98,0.5,0.21
PF15431,PF06834:PF10139:PF07805:PF06876:PF15480,0,2,0,0,2,1016,0.0,1.0,0,0,0,0,0,0,1018,0,1.0,0,0
PF04442,PF00436:PF07896:PF07816:PF01470:PF09597,10,34,5,5,29,979,0.15,0.97,0.5,0.26,1,1,9,0,1008,1.0,0.99,0.1,0.31
PF06167,PF13986:PF11304:PF12081:PF03428:PF08479,1,1,1,0,0,1017,1.0,1.0,1.0,1.0,0,0,1,0,1017,0,1.0,0.0,0
PF01327,PF06658:PF04520:PF04176:PF06376:PF05915,8,11,1,7,10,1000,0.09,0.98,0.12,0.1,2,0,8,2,1008,0.0,0.99,0.0,-0.0
PF08859,PF17017:PF15730:PF14216:PF11223:PF05939,0,3,0,0,3,1015,0.0,1.0,0,0,0,0,0,0,1018,0,1.0,0,0
PF08510,PF05128:PF15086:PF09269:PF14714:PF06780,13,8,1,12,7,998,0.12,0.98,0.08,0.09,1,1,12,0,1005,1.0,0.99,0.08,0.28
PF04516,PF15996:PF04087:PF05334:PF10179:PF04109,8,21,4,4,17,993,0.19,0.98,0.5,0.3,0,0,8,0,1010,0,0.99,0.0,0
PF10667,PF15207:PF07243:PF08093:PF05294:PF03601,1,2,0,1,2,1015,0.0,1.0,0.0,-0.0,0,0,1,0,1017,0,1.0,0.0,0
PF13882,PF06583:PF12355:PF05473:PF06957:PF03921,3,15,1,2,14,1001,0.07,0.98,0.33,0.14,1,1,2,0,1015,1.0,1.0,0.33,0.58
PF05167,PF06890:PF09498:PF01752:PF01514:PF11794,1,2,0,1,2,1015,0.0,1.0,0.0,-0.0,0,0,1,0,1017,0,1.0,0.0,0
PF01345,PF15334:PF15748:PF05355:PF15770:PF01316,0,4,0,0,4,1014,0.0,1.0,0,0,0,0,0,0,1018,0,1.0,0,0
PF02965,PF02607:PF02310:PF01642:PF00809:PF02574,5,25,5,0,20,993,0.2,0.98,1.0,0.44,5,4,1,1,1012,0.8,1.0,0.8,0.8
PF01749,PF16186:PF00514:PF02933:PF00658:PF02363,21,73,18,3,55,942,0.25,0.94,0.86,0.44,8,7,14,1,996,0.88,0.99,0.33,0.53
PF05478,PF06473:PF03416:PF01007:PF14565:PF05871,5,40,2,3,38,975,0.05,0.96,0.4,0.13,2,1,4,1,1012,0.5,1.0,0.2,0.31
PF16029,PF11029:PF15884:PF06351:PF12716:PF15173,6,5,1,5,4,1008,0.2,0.99,0.17,0.18,1,1,5,0,1012,1.0,1.0,0.17,0.41
PF07565,PF00955:PF00359:PF13020:PF01336:PF05010,7,68,7,0,61,950,0.1,0.94,1.0,0.31,3,2,5,1,1010,0.67,0.99,0.29,0.43
PF12394,PF05057:PF17046:PF07555:PF17111:PF14420,2,47,2,0,45,971,0.04,0.96,1.0,0.2,6,0,2,6,1010,0.0,0.99,0.0,-0.0
PF09428,PF09962:PF03745:PF05448:PF15312:PF10333,1,3,0,1,3,1014,0.0,1.0,0.0,-0.0,0,0,1,0,1017,0,1.0,0.0,0
PF07139,PF07223:PF00363:PF02186:PF11708:PF04004,4,31,1,3,30,984,0.03,0.97,0.25,0.08,2,0,4,2,1012,0.0,0.99,0.0,-0.0
PF04830,PF09861:PF11092:PF01514:PF08708:PF01752,0,2,0,0,2,1016,0.0,1.0,0,0,0,0,0,0,1018,0,1.0,0,0
PF06360,PF15091:PF05736:PF15770:PF15334:PF15465,0,1,0,0,1,1017,0.0,1.0,0,0,0,0,0,0,1018,0,1.0,0,0
PF08045,PF09991:PF15289:PF05428:PF07298:PF12263,3,4,0,3,4,1011,0.0,0.99,0.0,-0.0,0,0,3,0,1015,0,1.0,0.0,0
PF12738,PF00533:PF16892:PF01834:PF16893:PF16770,24,56,22,2,34,960,0.39,0.96,0.92,0.59,2,2,22,0,994,1.0,0.98,0.08,0.29
PF09725,PF07052:PF11623:PF12926:PF16007:PF01878,9,18,2,7,16,993,0.11,0.98,0.22,0.15,1,0,9,1,1008,0.0,0.99,0.0,-0.0
PF09056,PF06369:PF12351:PF08738:PF12716:PF03576,4,4,0,4,4,1010,0.0,0.99,0.0,-0.0,0,0,4,0,1014,0,1.0,0.0,0
PF14646,PF14909:PF15279:PF16019:PF11768:PF11977,6,12,1,5,11,1001,0.08,0.98,0.17,0.11,0,0,6,0,1012,0,0.99,0.0,0
PF07858,PF06243:PF00890:PF17023:PF04814:PF04812,0,49,0,0,49,969,0.0,0.95,0,0,3,0,0,3,1015,0.0,1.0,0,0
PF04883,PF13942:PF06094:PF17029:PF09739:PF08846,0,28,0,0,28,990,0.0,0.97,0,0,0,0,0,0,1018,0,1.0,0,0
PF02424,PF02910:PF00890:PF12831:PF04205:PF00175,2,89,2,0,87,929,0.02,0.91,1.0,0.14,15,2,0,13,1003,0.13,0.99,1.0,0.36
PF06524,PF04643:PF15165:PF01387:PF05296:PF02106,3,4,1,2,3,1012,0.25,1.0,0.33,0.29,0,0,3,0,1015,0,1.0,0.0,0
PF13884,PF13887:PF13888:PF05224:PF09332:PF05178,8,24,7,1,17,993,0.29,0.98,0.88,0.5,6,6,2,0,1010,1.0,1.0,0.75,0.87
PF04247,PF08274:PF09648:PF06445:PF09397:PF09614,0,9,0,0,9,1009,0.0,0.99,0,0,0,0,0,0,1018,0,1.0,0,0
PF03842,PF01701:PF15467:PF15060:PF15398:PF17085,0,2,0,0,2,1016,0.0,1.0,0,0,0,0,0,0,1018,0,1.0,0,0
PF02404,PF06387:PF14047:PF10488:PF15691:PF14049,1,5,0,1,5,1012,0.0,0.99,0.0,-0.0,0,0,1,0,1017,0,1.0,0.0,0
PF11598,PF01414:PF00129:PF13344:PF08652:PF07593,2,35,2,0,33,983,0.06,0.97,1.0,0.24,4,2,0,2,1014,0.5,1.0,1.0,0.71
PF05051,PF01115:PF06093:PF09749:PF07096:PF05910,7,22,5,2,17,994,0.23,0.98,0.71,0.4,4,2,5,2,1009,0.5,0.99,0.29,0.37
PF05100,PF06805:PF08411:PF11751:PF08461:PF16449,0,1,0,0,1,1017,0.0,1.0,0,0,0,0,0,0,1018,0,1.0,0,0
PF13580,PF08345:PF11794:PF14376:PF05736:PF13746,2,6,1,1,5,1011,0.17,0.99,0.5,0.29,0,0,2,0,1016,0,1.0,0.0,0
PF04464,PF17164:PF14573:PF03925:PF04221:PF09614,1,2,0,1,2,1015,0.0,1.0,0.0,-0.0,0,0,1,0,1017,0,1.0,0.0,0
PF14214,PF05970:PF02689:PF13538:PF02721:PF04843,24,47,18,6,29,965,0.38,0.97,0.75,0.52,7,7,17,0,994,1.0,0.98,0.29,0.54
PF06249,PF05899:PF02502:PF12973:PF04229:PF01977,3,24,3,0,21,994,0.12,0.98,1.0,0.35,0,0,3,0,1015,0,1.0,0.0,0
PF00781,PF00609:PF08652:PF00788:PF00617:PF00130,47,101,36,11,65,906,0.36,0.93,0.77,0.49,24,17,30,7,964,0.71,0.96,0.36,0.49
PF00388,PF00387:PF09279:PF06631:PF16457:PF16056,23,27,19,4,8,987,0.7,0.99,0.83,0.76,6,6,17,0,995,1.0,0.98,0.26,0.51
PF08908,PF04289:PF04333:PF14063:PF08094:PF01000,0,8,0,0,8,1010,0.0,0.99,0,0,0,0,0,0,1018,0,1.0,0,0
PF05649,PF01431:PF04616:PF04042:PF01578:PF01212,35,84,33,2,51,932,0.39,0.95,0.94,0.59,11,9,26,2,981,0.82,0.97,0.26,0.45
PF00393,PF03446:PF14833:PF17042:PF09130:PF07005,12,40,11,1,29,977,0.28,0.97,0.92,0.49,6,2,10,4,1002,0.33,0.99,0.17,0.23
PF06148,PF08314:PF10475:PF15492:PF12074:PF11934,11,15,4,7,11,996,0.27,0.98,0.36,0.3,0,0,11,0,1007,0,0.99,0.0,0
PF16838,PF05352:PF02399:PF13296:PF12603:PF12256,0,4,0,0,4,1014,0.0,1.0,0,0,0,0,0,0,1018,0,1.0,0,0
PF13942,PF06451:PF14995:PF15429:PF02669:PF13449,0,11,0,0,11,1007,0.0,0.99,0,0,0,0,0,0,1018,0,1.0,0,0
PF02110,PF02581:PF08543:PF07364:PF03102:PF15350,6,25,3,3,22,990,0.12,0.98,0.5,0.24,1,1,5,0,1012,1.0,1.0,0.17,0.41
PF13963,PF13960:PF13952:PF02992:PF03004:PF03017,10,27,8,2,19,989,0.3,0.98,0.8,0.48,2,2,8,0,1008,1.0,0.99,0.2,0.45
PF10609,PF01883:PF06155:PF02668:PF03834:PF05141,21,58,12,9,46,951,0.21,0.95,0.57,0.32,7,4,17,3,994,0.57,0.98,0.19,0.32
PF13892,PF09110:PF09111:PF08658:PF15790:PF07443,16,21,12,4,9,993,0.57,0.99,0.75,0.65,4,4,12,0,1002,1.0,0.99,0.25,0.5
PF02153,PF00800:PF05439:PF00155:PF04119:PF13508,14,110,8,6,102,902,0.07,0.89,0.57,0.18,7,3,11,4,1000,0.43,0.99,0.21,0.3
PF02701,PF09816:PF06886:PF04109:PF15279:PF08613,10,33,4,6,29,979,0.12,0.97,0.4,0.21,2,1,9,1,1007,0.5,0.99,0.1,0.22
PF11756,PF01476:PF09362:PF09514:PF09794:PF13321,0,51,0,0,51,967,0.0,0.95,0,0,1,0,0,1,1017,0.0,1.0,0,0
PF08628,PF02194:PF03700:PF09325:PF12825:PF13924,15,37,15,0,22,981,0.41,0.98,1.0,0.63,5,4,11,1,1002,0.8,0.99,0.27,0.46
PF04059,PF12196:PF08143:PF08081:PF08777:PF06495,6,12,2,4,10,1002,0.17,0.99,0.33,0.23,1,1,5,0,1012,1.0,1.0,0.17,0.41
PF05254,PF09748:PF05512:PF03386:PF07344:PF13593,8,17,2,6,15,995,0.12,0.98,0.25,0.16,2,0,8,2,1008,0.0,0.99,0.0,-0.0
PF08767,PF03378:PF03810:PF08389:PF11865:PF13001,11,69,9,2,60,947,0.13,0.94,0.82,0.31,13,3,8,10,997,0.23,0.98,0.27,0.24
PF15017,PF17146:PF08772:PF12348:PF14061:PF08783,1,26,1,0,25,992,0.04,0.98,1.0,0.19,3,1,0,2,1015,0.33,1.0,1.0,0.58
PF10853,PF10244:PF04716:PF15370:PF08561:PF00965,4,28,3,1,25,989,0.11,0.97,0.75,0.28,2,2,2,0,1014,1.0,1.0,0.5,0.71
PF05914,PF15302:PF02106:PF05111:PF02057:PF12904,2,2,0,2,2,1014,0.0,1.0,0.0,-0.0,0,0,2,0,1016,0,1.0,0.0,0
PF05992,PF03459:PF02694:PF05936:PF03186:PF00950,3,6,2,1,4,1011,0.33,1.0,0.67,0.47,2,2,1,0,1015,1.0,1.0,0.67,0.82
PF05350,PF06382:PF02157:PF02101:PF07344:PF15502,2,14,0,2,14,1002,0.0,0.98,0.0,-0.01,0,0,2,0,1016,0,1.0,0.0,0
PF13007,PF03050:PF07476:PF14882:PF07805:PF08411,0,2,0,0,2,1016,0.0,1.0,0,0,0,0,0,0,1018,0,1.0,0,0
PF05518,PF04301:PF01957:PF10761:PF13994:PF10867,0,0,0,0,0,1018,0,1.0,0,0,0,0,0,0,1018,0,1.0,0,0
PF05951,PF00555:PF09614:PF17017:PF13322:PF11675,0,2,0,0,2,1016,0.0,1.0,0,0,0,0,0,0,1018,0,1.0,0,0
PF01153,PF04636:PF04155:PF13695:PF10477:PF00877,11,25,1,10,24,983,0.04,0.97,0.09,0.04,0,0,11,0,1007,0,0.99,0.0,0
PF00011,PF00525:PF01161:PF12483:PF13508:PF01730,34,41,13,21,28,956,0.32,0.95,0.38,0.32,2,2,32,0,984,1.0,0.97,0.06,0.24
PF15675,PF16007:PF03823:PF03883:PF05532:PF08649,1,7,0,1,7,1010,0.0,0.99,0.0,-0.0,1,0,1,1,1016,0.0,1.0,0.0,-0.0
PF02884,PF02278:PF08124:PF04425:PF16485:PF04426,1,6,1,0,5,1012,0.17,1.0,1.0,0.41,0,0,1,0,1017,0,1.0,0.0,0
PF16003,PF16032:PF15805:PF14047:PF15803:PF14049,1,0,0,1,0,1017,0,1.0,0.0,0,0,0,1,0,1017,0,1.0,0.0,0
PF03078,PF02337:PF03716:PF02093:PF00607:PF12384,1,12,0,1,12,1005,0.0,0.99,0.0,-0.0,4,0,1,4,1013,0.0,1.0,0.0,-0.0
PF15103,PF07310:PF17017:PF15756:PF15483:PF01948,2,3,0,2,3,1013,0.0,1.0,0.0,-0.0,0,0,2,0,1016,0,1.0,0.0,0
PF07942,PF01217:PF09786:PF10574:PF09174:PF00928,9,59,6,3,53,956,0.1,0.94,0.67,0.25,3,2,7,1,1008,0.67,0.99,0.22,0.38
PF17132,PF12735:PF05450:PF12955:PF07287:PF16401,6,21,2,4,19,993,0.1,0.98,0.33,0.17,0,0,6,0,1012,0,0.99,0.0,0
PF16108,PF15602:PF10946:PF10366:PF10367:PF04293,0,21,0,0,21,997,0.0,0.98,0,0,0,0,0,0,1018,0,1.0,0,0
PF17028,PF07540:PF11231:PF14876:PF12329:PF06440,0,17,0,0,17,1001,0.0,0.98,0,0,0,0,0,0,1018,0,1.0,0,0
PF04795,PF04925:PF13959:PF07999:PF04146:PF12029,2,43,1,1,42,974,0.02,0.96,0.5,0.1,4,1,1,3,1013,0.25,1.0,0.5,0.35
PF16836,PF15483:PF07804:PF01913:PF08404:PF12615,0,3,0,0,3,1015,0.0,1.0,0,0,0,0,0,0,1018,0,1.0,0,0
PF00427,PF00502:PF01383:PF12853:PF04952:PF07846,0,9,0,0,9,1009,0.0,0.99,0,0,0,0,0,0,1018,0,1.0,0,0
PF06628,PF00199:PF01965:PF01761:PF08501:PF01202,19,56,18,1,38,961,0.32,0.96,0.95,0.54,13,4,15,9,990,0.31,0.98,0.21,0.24
PF13280,PF09012:PF16861:PF11975:PF10554:PF08411,2,14,0,2,14,1002,0.0,0.98,0.0,-0.01,0,0,2,0,1016,0,1.0,0.0,0
PF10144,PF04955:PF09391:PF06676:PF10460:PF01743,0,12,0,0,12,1006,0.0,0.99,0,0,0,0,0,0,1018,0,1.0,0,0
PF10142,PF10370:PF13026:PF07238:PF02271:PF01557,6,51,2,4,49,963,0.04,0.95,0.33,0.1,1,0,6,1,1011,0.0,0.99,0.0,-0.0
PF09193,PF10413:PF12109:PF03827:PF08983:PF12369,1,5,1,0,4,1013,0.2,1.0,1.0,0.45,1,1,0,0,1017,1.0,1.0,1.0,1.0
PF04736,PF11029:PF15071:PF06679:PF06351:PF15884,1,5,0,1,5,1012,0.0,0.99,0.0,-0.0,1,0,1,1,1016,0.0,1.0,0.0,-0.0
PF12038,PF13439:PF15924:PF04413:PF13579:PF00862,2,33,0,2,33,983,0.0,0.97,0.0,-0.01,1,0,2,1,1015,0.0,1.0,0.0,-0.0
PF03986,PF10381:PF03987:PF01113:PF13284:PF05173,10,21,9,1,12,996,0.43,0.99,0.9,0.62,2,0,10,2,1006,0.0,0.99,0.0,-0.0
PF04045,PF00079:PF16038:PF08584:PF02284:PF14027,18,46,5,13,41,959,0.11,0.95,0.28,0.15,2,1,17,1,999,0.5,0.98,0.06,0.16
PF01094,PF00211:PF01547:PF02608:PF12849:PF07701,65,74,34,31,40,913,0.46,0.93,0.52,0.45,8,6,59,2,951,0.75,0.94,0.09,0.25
PF01927,PF08066:PF07750:PF00570:PF14493:PF08907,4,33,3,1,30,984,0.09,0.97,0.75,0.25,2,2,2,0,1014,1.0,1.0,0.5,0.71
PF10175,PF08152:PF07962:PF14437:PF00607:PF09692,6,28,2,4,26,986,0.07,0.97,0.33,0.14,3,2,4,1,1011,0.67,1.0,0.33,0.47
PF01463,PF01462:PF01049:PF03736:PF00054:PF11921,6,29,6,0,23,989,0.21,0.98,1.0,0.45,3,3,3,0,1012,1.0,1.0,0.5,0.71
PF02932,PF02931:PF04406:PF05450:PF04859:PF06237,69,93,65,4,28,921,0.7,0.97,0.94,0.8,7,5,64,2,947,0.71,0.94,0.07,0.21
PF02481,PF02729:PF00185:PF04557:PF04558:PF02142,8,40,7,1,33,977,0.17,0.97,0.88,0.38,15,5,3,10,1000,0.33,0.99,0.62,0.45
PF10602,PF05470:PF08375:PF09440:PF01894:PF00903,15,59,10,5,49,954,0.17,0.95,0.67,0.32,4,2,13,2,1001,0.5,0.99,0.13,0.25
PF05965,PF05964:PF03353:PF11764:PF10440:PF08429,19,35,17,2,18,981,0.49,0.98,0.89,0.65,3,3,16,0,999,1.0,0.98,0.16,0.39
PF07508,PF13408:PF00239:PF08461:PF03963:PF03090,2,4,2,0,2,1014,0.5,1.0,1.0,0.71,0,0,2,0,1016,0,1.0,0.0,0
PF06001,PF08214:PF02135:PF09030:PF17105:PF12064,12,31,12,0,19,987,0.39,0.98,1.0,0.62,9,7,5,2,1004,0.78,0.99,0.58,0.67
PF01684,PF16709:PF16711:PF07975:PF16712:PF16875,0,8,0,0,8,1010,0.0,0.99,0,0,1,0,0,1,1017,0.0,1.0,0,0
PF11702,PF07573:PF08550:PF10671:PF10638:PF00815,1,26,1,0,25,992,0.04,0.98,1.0,0.19,1,0,1,1,1016,0.0,1.0,0.0,-0.0
PF08188,PF09707:PF12777:PF03373:PF16350:PF12780,1,47,1,0,46,971,0.02,0.95,1.0,0.14,6,0,1,6,1011,0.0,0.99,0.0,-0.0
PF12744,PF16577:PF04586:PF06586:PF07178:PF02472,1,5,1,0,4,1013,0.2,1.0,1.0,0.45,0,0,1,0,1017,0,1.0,0.0,0
PF00014,PF10223:PF15761:PF00095:PF00061:PF02961,48,42,18,30,24,946,0.43,0.95,0.38,0.37,3,3,45,0,970,1.0,0.96,0.06,0.24
PF15996,PF05041:PF00924:PF04087:PF14611:PF11977,8,30,6,2,24,986,0.2,0.97,0.75,0.38,1,0,8,1,1009,0.0,0.99,0.0,-0.0
PF16315,PF01475:PF02654:PF04501:PF03538:PF08892,0,9,0,0,9,1009,0.0,0.99,0,0,0,0,0,0,1018,0,1.0,0,0
PF03824,PF08228:PF15831:PF01878:PF06109:PF11711,9,13,3,6,10,999,0.23,0.98,0.33,0.27,0,0,9,0,1009,0,0.99,0.0,0
PF07559,PF03963:PF06429:PF09250:PF07499:PF09327,1,5,1,0,4,1013,0.2,1.0,1.0,0.45,0,0,1,0,1017,0,1.0,0.0,0
PF07727,PF13976:PF14244:PF13961:PF00665:PF00075,121,157,86,35,71,826,0.55,0.9,0.71,0.57,22,22,99,0,897,1.0,0.9,0.18,0.4
PF04063,PF04064:PF04615:PF16086:PF00573:PF00674,3,34,3,0,31,984,0.09,0.97,1.0,0.29,0,0,3,0,1015,0,1.0,0.0,0
PF03568,PF08638:PF14649:PF15246:PF07792:PF04048,11,23,4,7,19,988,0.17,0.97,0.36,0.24,0,0,11,0,1007,0,0.99,0.0,0
PF01548,PF09829:PF00419:PF06890:PF08483:PF14323,2,2,0,2,2,1014,0.0,1.0,0.0,-0.0,0,0,2,0,1016,0,1.0,0.0,0
PF03531,PF08512:PF13775:PF08644:PF09667:PF16090,10,21,10,0,11,997,0.48,0.99,1.0,0.69,2,2,8,0,1008,1.0,0.99,0.2,0.45
PF00961,PF14528:PF07453:PF07460:PF01541:PF10210,9,30,8,1,22,987,0.27,0.98,0.89,0.48,3,2,7,1,1008,0.67,0.99,0.22,0.38
PF15950,PF11597:PF06333:PF12145:PF16419:PF15927,2,16,2,0,14,1002,0.12,0.99,1.0,0.35,4,1,1,3,1013,0.25,1.0,0.5,0.35
PF09979,PF05164:PF10375:PF13495:PF05065:PF00524,0,6,0,0,6,1012,0.0,0.99,0,0,0,0,0,0,1018,0,1.0,0,0
PF08058,PF10333:PF09428:PF15062:PF09962:PF02393,0,2,0,0,2,1016,0.0,1.0,0,0,0,0,0,0,1018,0,1.0,0,0
PF04886,PF09272:PF02983:PF16030:PF12032:PF15494,12,27,6,6,21,985,0.22,0.97,0.5,0.32,1,1,11,0,1006,1.0,0.99,0.08,0.29
PF01594,PF09733:PF15627:PF13320:PF14613:PF09740,5,8,1,4,7,1006,0.12,0.99,0.2,0.15,0,0,5,0,1013,0,1.0,0.0,0
PF00737,PF01947:PF15085:PF09252:PF07444:PF14866,1,2,0,1,2,1015,0.0,1.0,0.0,-0.0,0,0,1,0,1017,0,1.0,0.0,0
PF05430,PF08245:PF06813:PF03109:PF04082:PF10699,1,176,0,1,176,841,0.0,0.83,0.0,-0.01,13,0,1,13,1004,0.0,0.99,0.0,-0.0
PF02520,PF01277:PF04107:PF03103:PF00468:PF13695,3,21,3,0,18,997,0.14,0.98,1.0,0.37,0,0,3,0,1015,0,1.0,0.0,0
PF01348,PF01215:PF01329:PF12280:PF04520:PF01791,11,38,3,8,35,972,0.08,0.96,0.27,0.13,1,0,11,1,1006,0.0,0.99,0.0,-0.0
PF15818,PF14926:PF15467:PF12264:PF07263:PF03842,0,5,0,0,5,1013,0.0,1.0,0,0,0,0,0,0,1018,0,1.0,0,0
PF06834,PF07511:PF01706:PF12080:PF01913:PF05939,0,2,0,0,2,1016,0.0,1.0,0,0,0,0,0,0,1018,0,1.0,0,0
PF15905,PF17045:PF15908:PF10205:PF09762:PF03800,1,9,1,0,8,1009,0.11,0.99,1.0,0.33,1,1,0,0,1017,1.0,1.0,1.0,1.0
PF03732,PF01107:PF08284:PF12259:PF14244:PF13961,58,55,26,32,29,931,0.47,0.94,0.45,0.43,7,7,51,0,960,1.0,0.95,0.12,0.34
PF12214,PF04087:PF06886:PF05334:PF10496:PF12253,7,21,3,4,18,993,0.14,0.98,0.43,0.24,0,0,7,0,1011,0,0.99,0.0,0
PF08802,PF02921:PF09165:PF04305:PF00848:PF10399,3,26,2,1,24,991,0.08,0.98,0.67,0.22,5,2,1,3,1012,0.4,1.0,0.67,0.51
PF03242,PF03386:PF05512:PF07344:PF02431:PF04418,0,11,0,0,11,1007,0.0,0.99,0,0,0,0,0,0,1018,0,1.0,0,0
PF03291,PF05719:PF05839:PF02245:PF13593:PF03034,8,23,4,4,19,991,0.17,0.98,0.5,0.29,1,0,8,1,1009,0.0,0.99,0.0,-0.0
PF11527,PF10501:PF06637:PF10361:PF12527:PF16043,4,3,0,4,3,1011,0.0,0.99,0.0,-0.0,0,0,4,0,1014,0,1.0,0.0,0
PF12528,PF15938:PF00682:PF00129:PF16488:PF03124,0,50,0,0,50,968,0.0,0.95,0,0,6,0,0,6,1012,0.0,0.99,0,0
PF12423,PF16183:PF12473:PF16540:PF13931:PF00225,14,104,14,0,90,914,0.13,0.91,1.0,0.35,17,14,0,3,1001,0.82,1.0,1.0,0.91
PF09366,PF07939:PF09419:PF08536:PF07011:PF06446,6,16,1,5,15,997,0.06,0.98,0.17,0.09,0,0,6,0,1012,0,0.99,0.0,0
PF04800,PF07896:PF01097:PF07816:PF02704:PF10276,9,14,2,7,12,997,0.14,0.98,0.22,0.17,0,0,9,0,1009,0,0.99,0.0,0
PF14814,PF06798:PF00381:PF07157:PF11736:PF12477,0,4,0,0,4,1014,0.0,1.0,0,0,0,0,0,0,1018,0,1.0,0,0
PF03859,PF00710:PF16553:PF07693:PF09310:PF09372,7,20,4,3,16,995,0.2,0.98,0.57,0.33,1,1,6,0,1011,1.0,0.99,0.14,0.38
PF09730,PF16516:PF09728:PF15921:PF12180:PF10595,5,16,0,5,16,997,0.0,0.98,0.0,-0.01,1,0,5,1,1012,0.0,0.99,0.0,-0.0
PF15276,PF13325:PF16508:PF15308:PF16697:PF15678,1,15,1,0,14,1003,0.07,0.99,1.0,0.26,3,1,0,2,1015,0.33,1.0,1.0,0.58
PF07023,PF12416:PF02845:PF16286:PF02759:PF00794,0,70,0,0,70,948,0.0,0.93,0,0,4,0,0,4,1014,0.0,1.0,0,0
PF02119,PF11794:PF04391:PF03831:PF02554:PF16822,2,0,0,2,0,1016,0,1.0,0.0,0,0,0,2,0,1016,0,1.0,0.0,0
PF04532,PF05299:PF15662:PF05962:PF15212:PF16931,1,1,0,1,1,1016,0.0,1.0,0.0,-0.0,0,0,1,0,1017,0,1.0,0.0,0
PF00531,PF01335:PF00791:PF09034:PF11957:PF13820,39,26,19,20,7,972,0.73,0.97,0.49,0.58,2,2,37,0,979,1.0,0.96,0.05,0.22
PF03412,PF03459:PF05936:PF02694:PF07123:PF00950,4,9,3,1,6,1008,0.33,0.99,0.75,0.5,2,2,2,0,1014,1.0,1.0,0.5,0.71
PF15578,PF15085:PF15107:PF15141:PF03974:PF14124,1,3,0,1,3,1014,0.0,1.0,0.0,-0.0,0,0,1,0,1017,0,1.0,0.0,0
PF14389,PF04784:PF12257:PF00610:PF10193:PF15025,6,60,6,0,54,958,0.1,0.95,1.0,0.31,4,2,4,2,1010,0.5,0.99,0.33,0.41
PF04714,PF07052:PF10571:PF15242:PF15342:PF15991,3,17,0,3,17,998,0.0,0.98,0.0,-0.01,0,0,3,0,1015,0,1.0,0.0,0
PF10104,PF04090:PF15045:PF02116:PF10180:PF10330,8,13,2,6,11,999,0.15,0.98,0.25,0.19,1,0,8,1,1009,0.0,0.99,0.0,-0.0
PF09836,PF06001:PF06546:PF05911:PF09351:PF03886,0,25,0,0,25,993,0.0,0.98,0,0,0,0,0,0,1018,0,1.0,0,0
PF02592,PF15775:PF08026:PF07209:PF04392:PF05962,3,4,0,3,4,1011,0.0,0.99,0.0,-0.0,0,0,3,0,1015,0,1.0,0.0,0
PF12326,PF13334:PF07061:PF00337:PF04099:PF01762,4,61,3,1,58,956,0.05,0.94,0.75,0.18,11,2,2,9,1005,0.18,0.99,0.5,0.3
PF01436,PF01082:PF03712:PF13905:PF08450:PF03008,37,44,19,18,25,956,0.43,0.96,0.51,0.45,8,7,30,1,980,0.88,0.97,0.19,0.4
PF07093,PF09751:PF05653:PF14719:PF03239:PF01910,4,33,1,3,32,982,0.03,0.97,0.25,0.08,3,1,3,2,1012,0.33,1.0,0.25,0.29
PF07571,PF09830:PF08731:PF11928:PF10179:PF04087,6,14,1,5,13,999,0.07,0.98,0.17,0.1,0,0,6,0,1012,0,0.99,0.0,0
PF04863,PF04864:PF03979:PF07014:PF16048:PF08018,2,10,2,0,8,1008,0.2,0.99,1.0,0.45,0,0,2,0,1016,0,1.0,0.0,0
PF10303,PF09810:PF10356:PF14378:PF01386:PF14768,1,13,0,1,13,1004,0.0,0.99,0.0,-0.0,0,0,1,0,1017,0,1.0,0.0,0
PF03404,PF00174:PF01070:PF00970:PF00487:PF13875,20,93,20,0,73,925,0.22,0.93,1.0,0.45,15,12,8,3,995,0.8,0.99,0.6,0.69
PF15369,PF08528:PF06365:PF15669:PF04664:PF13002,2,15,1,1,14,1002,0.07,0.99,0.5,0.18,0,0,2,0,1016,0,1.0,0.0,0
PF04188,PF14656:PF05742:PF14724:PF16062:PF00220,12,15,4,8,11,995,0.27,0.98,0.33,0.29,0,0,12,0,1006,0,0.99,0.0,0
PF07392,PF15120:PF07259:PF15046:PF15849:PF15829,0,5,0,0,5,1013,0.0,1.0,0,0,0,0,0,0,1018,0,1.0,0,0
PF02775,PF02776:PF00205:PF10371:PF16582:PF01558,25,29,23,2,6,987,0.79,0.99,0.92,0.85,4,4,21,0,993,1.0,0.98,0.16,0.4
PF04905,PF04902:PF04904:PF10488:PF15059:PF15805,4,6,2,2,4,1010,0.33,0.99,0.5,0.41,0,0,4,0,1014,0,1.0,0.0,0
PF05680,PF14542:PF14935:PF07114:PF15884:PF10147,5,11,2,3,9,1004,0.18,0.99,0.4,0.26,1,0,5,1,1012,0.0,0.99,0.0,-0.0
PF14257,PF14985:PF01316:PF03238:PF15380:PF07021,0,5,0,0,5,1013,0.0,1.0,0,0,0,0,0,0,1018,0,1.0,0,0
PF05152,PF11130:PF09669:PF06725:PF12477:PF01289,0,3,0,0,3,1015,0.0,1.0,0,0,0,0,0,0,1018,0,1.0,0,0
PF00756,PF12311:PF05724:PF08584:PF14027:PF01063,17,43,6,11,37,964,0.14,0.95,0.35,0.2,1,1,16,0,1001,1.0,0.98,0.06,0.24
PF16042,PF03383:PF10148:PF15254:PF15095:PF15671,1,6,0,1,6,1011,0.0,0.99,0.0,-0.0,0,0,1,0,1017,0,1.0,0.0,0
PF03816,PF15175:PF15046:PF15776:PF17015:PF03203,2,5,2,0,3,1013,0.4,1.0,1.0,0.63,0,0,2,0,1016,0,1.0,0.0,0
PF08021,PF14882:PF04954:PF03831:PF06890:PF14690,0,0,0,0,0,1018,0,1.0,0,0,0,0,0,0,1018,0,1.0,0,0
PF03900,PF00766:PF01379:PF08327:PF01154:PF16200,16,48,15,1,33,969,0.31,0.97,0.94,0.53,4,3,13,1,1001,0.75,0.99,0.19,0.37
PF15620,PF15622:PF15058:PF10198:PF11699:PF10699,0,13,0,0,13,1005,0.0,0.99,0,0,0,0,0,0,1018,0,1.0,0,0
PF00210,PF02284:PF05047:PF04176:PF00143:PF01775,13,22,7,6,15,990,0.32,0.98,0.54,0.4,5,3,10,2,1003,0.6,0.99,0.23,0.37
PF03152,PF15090:PF04699:PF11547:PF07260:PF12861,17,21,5,12,16,985,0.24,0.97,0.29,0.25,1,1,16,0,1001,1.0,0.98,0.06,0.24
PF03921,PF11465:PF07204:PF06583:PF13895:PF02158,4,32,2,2,30,984,0.06,0.97,0.5,0.17,2,2,2,0,1014,1.0,1.0,0.5,0.71
PF09349,PF02394:PF00449:PF00699:PF00547:PF11693,8,11,3,5,8,1002,0.27,0.99,0.38,0.31,6,2,6,4,1006,0.33,0.99,0.25,0.28
PF01353,PF15377:PF15252:PF01387:PF09781:PF01415,2,3,0,2,3,1013,0.0,1.0,0.0,-0.0,0,0,2,0,1016,0,1.0,0.0,0
PF06596,PF14998:PF09348:PF00489:PF02393:PF02427,1,4,1,0,3,1014,0.25,1.0,1.0,0.5,0,0,1,0,1017,0,1.0,0.0,0
PF07906,PF05726:PF02664:PF16916:PF10241:PF04621,0,26,0,0,26,992,0.0,0.97,0,0,1,0,0,1,1017,0.0,1.0,0,0
PF06773,PF14882:PF09074:PF11435:PF07476:PF15079,0,1,0,0,1,1017,0.0,1.0,0,0,0,0,0,0,1018,0,1.0,0,0
PF06683,PF12121:PF01114:PF00323:PF07806:PF15722,0,1,0,0,1,1017,0.0,1.0,0,0,0,0,0,0,1018,0,1.0,0,0
PF08588,PF10332:PF04090:PF10104:PF13002:PF15045,3,12,0,3,12,1003,0.0,0.99,0.0,-0.01,0,0,3,0,1015,0,1.0,0.0,0
PF01278,PF08411:PF01706:PF16449:PF09829:PF04559,1,2,0,1,2,1015,0.0,1.0,0.0,-0.0,0,0,1,0,1017,0,1.0,0.0,0
PF12739,PF08626:PF12612:PF15979:PF14222:PF07539,8,35,3,5,32,978,0.09,0.96,0.38,0.17,6,0,8,6,1004,0.0,0.99,0.0,-0.01
PF06473,PF05478:PF06189:PF11703:PF07354:PF14931,0,8,0,0,8,1010,0.0,0.99,0,0,1,0,0,1,1017,0.0,1.0,0,0
PF02837,PF02929:PF16353:PF02836:PF00703:PF16355,16,30,15,1,15,987,0.5,0.98,0.94,0.68,10,7,9,3,999,0.7,0.99,0.44,0.55
PF03712,PF01082:PF03351:PF10517:PF01436:PF10355,17,50,17,0,33,968,0.34,0.97,1.0,0.57,11,10,7,1,1000,0.91,0.99,0.59,0.73
PF10344,PF10359:PF10305:PF10293:PF10351:PF10347,2,8,2,0,6,1010,0.25,0.99,1.0,0.5,5,2,0,3,1013,0.4,1.0,1.0,0.63
PF05489,PF06805:PF05939:PF06890:PF04625:PF12615,0,1,0,0,1,1017,0.0,1.0,0,0,0,0,0,0,1018,0,1.0,0,0
PF14220,PF09327:PF13808:PF13876:PF07523:PF04196,2,4,2,0,2,1014,0.5,1.0,1.0,0.71,0,0,2,0,1016,0,1.0,0.0,0
PF14728,PF14727:PF13725:PF15006:PF08746:PF06382,5,26,5,0,21,992,0.19,0.98,1.0,0.43,2,2,3,0,1013,1.0,1.0,0.4,0.63
PF03707,PF16415:PF11597:PF06011:PF14558:PF12842,7,21,1,6,20,991,0.05,0.97,0.14,0.07,2,1,6,1,1010,0.5,0.99,0.14,0.26
PF05324,PF04644:PF04643:PF00323:PF07685:PF06540,0,4,0,0,4,1014,0.0,1.0,0,0,1,0,0,1,1017,0.0,1.0,0,0
PF09085,PF09991:PF02620:PF03703:PF14279:PF03193,0,14,0,0,14,1004,0.0,0.99,0,0,0,0,0,0,1018,0,1.0,0,0
PF03122,PF05643:PF04094:PF02606:PF00815:PF13266,1,20,0,1,20,997,0.0,0.98,0.0,-0.0,0,0,1,0,1017,0,1.0,0.0,0
PF02367,PF06832:PF03401:PF15041:PF08404:PF03819,2,4,0,2,4,1012,0.0,0.99,0.0,-0.0,0,0,2,0,1016,0,1.0,0.0,0
PF03211,PF00457:PF01083:PF12296:PF04667:PF11991,12,28,7,5,21,985,0.25,0.97,0.58,0.37,2,1,11,1,1005,0.5,0.99,0.08,0.2
PF10092,PF04421:PF04992:PF01141:PF05944:PF01340,0,15,0,0,15,1003,0.0,0.99,0,0,1,0,0,1,1017,0.0,1.0,0,0
PF04677,PF04676:PF08603:PF10443:PF01288:PF07975,23,42,23,0,19,976,0.55,0.98,1.0,0.73,4,4,19,0,995,1.0,0.98,0.17,0.41
PF07160,PF10278:PF05612:PF14935:PF09778:PF14770,3,11,0,3,11,1004,0.0,0.99,0.0,-0.01,1,0,3,1,1014,0.0,1.0,0.0,-0.0
PF01129,PF12020:PF00143:PF10160:PF04176:PF00965,9,15,4,5,11,998,0.27,0.98,0.44,0.34,0,0,9,0,1009,0,0.99,0.0,0
PF02892,PF04937:PF14372:PF05699:PF10683:PF14291,31,81,22,9,59,928,0.27,0.93,0.71,0.41,13,11,20,2,985,0.85,0.98,0.35,0.54
PF15048,PF10044:PF04138:PF09837:PF03762:PF12585,2,5,0,2,5,1011,0.0,0.99,0.0,-0.0,0,0,2,0,1016,0,1.0,0.0,0
PF01681,PF05986:PF05642:PF08685:PF00007:PF06838,0,25,0,0,25,993,0.0,0.98,0,0,1,0,0,1,1017,0.0,1.0,0,0
PF03173,PF03174:PF02838:PF14220:PF14845:PF16712,2,27,2,0,25,991,0.07,0.98,1.0,0.27,3,1,1,2,1014,0.33,1.0,0.5,0.41
PF05691,PF10288:PF11899:PF12831:PF07732:PF03422,12,68,8,4,60,946,0.12,0.94,0.67,0.26,4,3,9,1,1005,0.75,0.99,0.25,0.43
PF06470,PF12455:PF03801:PF15905:PF07989:PF04423,17,28,2,15,26,975,0.07,0.96,0.12,0.07,1,1,16,0,1001,1.0,0.98,0.06,0.24
PF04106,PF08561:PF00143:PF04520:PF02284:PF06658,16,13,4,12,9,993,0.31,0.98,0.25,0.27,0,0,16,0,1002,0,0.98,0.0,0
PF13300,PF00930:PF02897:PF11379:PF12144:PF04576,10,37,8,2,29,979,0.22,0.97,0.8,0.41,2,1,9,1,1007,0.5,0.99,0.1,0.22
PF14933,PF15444:PF15130:PF10856:PF08964:PF00997,2,1,0,2,1,1015,0.0,1.0,0.0,-0.0,0,0,2,0,1016,0,1.0,0.0,0
PF08212,PF00061:PF03973:PF05434:PF06870:PF06477,8,34,2,6,32,978,0.06,0.96,0.25,0.11,2,0,8,2,1008,0.0,0.99,0.0,-0.0
PF16861,PF03090:PF07157:PF11751:PF08411:PF03831,3,1,0,3,1,1014,0.0,1.0,0.0,-0.0,0,0,3,0,1015,0,1.0,0.0,0
PF00113,PF03952:PF00016:PF00883:PF02788:PF00390,15,52,13,2,39,964,0.25,0.96,0.87,0.45,1,1,14,0,1003,1.0,0.99,0.07,0.26
PF04640,PF04032:PF10248:PF09340:PF08536:PF06645,6,23,3,3,20,992,0.13,0.98,0.5,0.25,2,1,5,1,1011,0.5,0.99,0.17,0.29
PF00174,PF03404:PF00970:PF01070:PF04116:PF00487,20,104,20,0,84,914,0.19,0.92,1.0,0.42,19,12,8,7,991,0.63,0.99,0.6,0.61
PF01099,PF06373:PF05039:PF06446:PF02285:PF00537,1,5,0,1,5,1012,0.0,0.99,0.0,-0.0,0,0,1,0,1017,0,1.0,0.0,0
PF12320,PF01340:PF14077:PF01797:PF09384:PF14121,0,16,0,0,16,1002,0.0,0.98,0,0,0,0,0,0,1018,0,1.0,0,0
PF10381,PF03986:PF03987:PF13284:PF01113:PF05173,9,22,9,0,13,996,0.41,0.99,1.0,0.64,2,0,9,2,1007,0.0,0.99,0.0,-0.0
PF16988,PF04157:PF11605:PF02040:PF08728:PF13945,3,23,3,0,20,995,0.13,0.98,1.0,0.36,0,0,3,0,1015,0,1.0,0.0,0
PF12656,PF02357:PF09816:PF00849:PF09808:PF04000,15,53,7,8,46,957,0.13,0.95,0.47,0.23,2,2,13,0,1003,1.0,0.99,0.13,0.36
PF13299,PF07521:PF11718:PF07289:PF16661:PF10996,14,41,12,2,29,975,0.29,0.97,0.86,0.49,21,6,8,15,989,0.29,0.98,0.43,0.34
PF15734,PF10500:PF09216:PF03692:PF06162:PF13270,3,5,1,2,4,1011,0.2,0.99,0.33,0.26,0,0,3,0,1015,0,1.0,0.0,0
PF00364,PF00289:PF00198:PF01039:PF02817:PF02785,44,60,39,5,21,953,0.65,0.97,0.89,0.75,21,21,23,0,974,1.0,0.98,0.48,0.68
PF15037,PF16556:PF16742:PF08357:PF07923:PF06657,1,17,1,0,16,1001,0.06,0.98,1.0,0.24,2,0,1,2,1015,0.0,1.0,0.0,-0.0
PF06626,PF06724:PF05939:PF10566:PF09818:PF15482,1,1,0,1,1,1016,0.0,1.0,0.0,-0.0,0,0,1,0,1017,0,1.0,0.0,0
PF09014,PF10511:PF02961:PF08433:PF03782:PF13778,1,24,1,0,23,994,0.04,0.98,1.0,0.2,1,0,1,1,1016,0.0,1.0,0.0,-0.0
PF00890,PF02910:PF02424:PF12831:PF07976:PF01494,48,97,33,15,64,906,0.34,0.92,0.69,0.45,8,8,40,0,970,1.0,0.96,0.17,0.4
PF03525,PF08744:PF06724:PF02557:PF09861:PF08795,0,2,0,0,2,1016,0.0,1.0,0,0,0,0,0,0,1018,0,1.0,0,0
PF00447,PF01985:PF06546:PF09744:PF04388:PF02954,30,26,10,20,16,972,0.38,0.96,0.33,0.34,3,3,27,0,988,1.0,0.97,0.1,0.31
PF14841,PF14842:PF01706:PF08299:PF08479:PF16325,1,3,1,0,2,1015,0.33,1.0,1.0,0.58,0,0,1,0,1017,0,1.0,0.0,0
PF00162,PF02390:PF15473:PF00228:PF00563:PF06229,21,36,11,10,25,972,0.31,0.97,0.52,0.38,3,3,18,0,997,1.0,0.98,0.14,0.37
PF00850,PF09757:PF08997:PF12203:PF00443:PF07576,48,119,28,20,91,879,0.24,0.89,0.58,0.32,5,5,43,0,970,1.0,0.96,0.1,0.32
PF04347,PF15681:PF15195:PF08036:PF14985:PF15809,0,6,0,0,6,1012,0.0,0.99,0,0,0,0,0,0,1018,0,1.0,0,0
PF14793,PF11892:PF11862:PF11775:PF13421:PF16967,0,1,0,0,1,1017,0.0,1.0,0,0,0,0,0,0,1018,0,1.0,0,0
PF00549,PF08442:PF02629:PF16114:PF06971:PF00285,30,40,26,4,14,974,0.65,0.98,0.87,0.74,5,5,25,0,988,1.0,0.98,0.17,0.4
PF05116,PF08472:PF12038:PF15924:PF00862:PF04413,11,18,7,4,11,996,0.39,0.99,0.64,0.49,1,1,10,0,1007,1.0,0.99,0.09,0.3
PF12511,PF15311:PF04090:PF12606:PF11267:PF15045,8,10,4,4,6,1004,0.4,0.99,0.5,0.44,0,0,8,0,1010,0,0.99,0.0,0
PF04523,PF06450:PF04352:PF00114:PF14871:PF10411,0,2,0,0,2,1016,0.0,1.0,0,0,0,0,0,0,1018,0,1.0,0,0
PF08569,PF15390:PF09748:PF05254:PF10483:PF03242,7,21,5,2,16,995,0.24,0.98,0.71,0.41,0,0,7,0,1011,0,0.99,0.0,0
PF08164,PF16174:PF16550:PF15285:PF09598:PF15827,14,7,2,12,5,999,0.29,0.98,0.14,0.19,0,0,14,0,1004,0,0.99,0.0,0
PF07731,PF07732:PF00394:PF04578:PF00723:PF03936,50,78,48,2,30,938,0.62,0.97,0.96,0.75,13,13,37,0,968,1.0,0.96,0.26,0.5
PF14919,PF14918:PF14920:PF09050:PF09051:PF14654,0,0,0,0,0,1018,0,1.0,0,0,0,0,0,0,1018,0,1.0,0,0
PF03357,PF07491:PF13023:PF04419:PF08583:PF02515,47,50,18,29,32,939,0.36,0.94,0.38,0.34,7,6,41,1,970,0.86,0.96,0.13,0.32
PF10166,PF15252:PF01387:PF03842:PF14931:PF15551,2,1,0,2,1,1015,0.0,1.0,0.0,-0.0,0,0,2,0,1016,0,1.0,0.0,0
PF08645,PF00645:PF08063:PF05406:PF03120:PF14716,13,51,4,9,47,958,0.08,0.94,0.31,0.13,8,4,9,4,1001,0.5,0.99,0.31,0.39
PF06559,PF15175:PF03275:PF17062:PF02067:PF15135,1,3,0,1,3,1014,0.0,1.0,0.0,-0.0,0,0,1,0,1017,0,1.0,0.0,0
PF02874,PF07497:PF08216:PF14906:PF02878:PF00006,41,78,40,1,38,939,0.51,0.96,0.98,0.69,4,3,38,1,976,0.75,0.96,0.07,0.23
PF04489,PF07445:PF12495:PF08984:PF08587:PF15113,0,13,0,0,13,1005,0.0,0.99,0,0,0,0,0,0,1018,0,1.0,0,0
PF17030,PF11794:PF14842:PF14841:PF16325:PF03589,0,3,0,0,3,1015,0.0,1.0,0,0,0,0,0,0,1018,0,1.0,0,0
PF12973,PF09056:PF15825:PF14534:PF07464:PF08738,3,5,2,1,3,1012,0.4,1.0,0.67,0.51,0,0,3,0,1015,0,1.0,0.0,0
PF15730,PF10951:PF11124:PF14251:PF04451:PF03749,1,5,0,1,5,1012,0.0,0.99,0.0,-0.0,0,0,1,0,1017,0,1.0,0.0,0
PF03437,PF14931:PF14963:PF15302:PF10166:PF01701,2,5,1,1,4,1012,0.2,1.0,0.5,0.31,0,0,2,0,1016,0,1.0,0.0,0
PF02114,PF01784:PF05995:PF09812:PF05047:PF01997,6,26,3,3,23,989,0.12,0.97,0.5,0.23,3,1,5,2,1010,0.33,0.99,0.17,0.23
PF14144,PF02173:PF03957:PF12498:PF08601:PF07777,8,9,3,5,6,1004,0.33,0.99,0.38,0.35,2,2,6,0,1010,1.0,0.99,0.25,0.5
PF00842,PF14031:PF08661:PF14918:PF09400:PF02367,0,16,0,0,16,1002,0.0,0.98,0,0,0,0,0,0,1018,0,1.0,0,0
PF04721,PF07912:PF10404:PF10403:PF03835:PF15928,4,15,4,0,11,1003,0.27,0.99,1.0,0.51,7,3,1,4,1010,0.43,1.0,0.75,0.56
PF13612,PF11751:PF01752:PF07505:PF01913:PF03831,3,3,0,3,3,1012,0.0,0.99,0.0,-0.0,0,0,3,0,1015,0,1.0,0.0,0
PF01765,PF12483:PF10173:PF14769:PF00212:PF04706,10,16,3,7,13,995,0.19,0.98,0.3,0.23,0,0,10,0,1008,0,0.99,0.0,0
PF13570,PF13360:PF01011:PF07774:PF14535:PF06464,7,35,6,1,29,982,0.17,0.97,0.86,0.38,6,3,4,3,1008,0.5,0.99,0.43,0.46
PF13932,PF01134:PF16044:PF03343:PF06783:PF04113,17,33,17,0,16,985,0.52,0.98,1.0,0.71,4,4,13,0,1001,1.0,0.99,0.24,0.48
PF07404,PF15482:PF02425:PF05874:PF15337:PF15895,1,4,0,1,4,1013,0.0,1.0,0.0,-0.0,0,0,1,0,1017,0,1.0,0.0,0
PF12570,PF15208:PF13753:PF11697:PF02211:PF07337,0,4,0,0,4,1014,0.0,1.0,0,0,0,0,0,0,1018,0,1.0,0,0
PF03581,PF09676:PF06476:PF11102:PF06150:PF01054,0,1,0,0,1,1017,0.0,1.0,0,0,0,0,0,0,1018,0,1.0,0,0
PF01490,PF00657:PF03659:PF08216:PF13472:PF01425,61,110,36,25,74,883,0.33,0.9,0.59,0.39,11,9,52,2,955,0.82,0.95,0.15,0.33
PF04101,PF06925:PF08660:PF00804:PF15886:PF06955,13,38,8,5,30,975,0.21,0.97,0.62,0.35,4,3,10,1,1004,0.75,0.99,0.23,0.41
PF12253,PF08634:PF16944:PF05334:PF04087:PF04576,3,16,0,3,16,999,0.0,0.98,0.0,-0.01,0,0,3,0,1015,0,1.0,0.0,0
PF00351,PF10369:PF01842:PF12549:PF10637:PF13840,22,42,11,11,31,965,0.26,0.96,0.5,0.34,2,2,20,0,996,1.0,0.98,0.09,0.3
PF16866,PF02008:PF12269:PF16987:PF02375:PF08429,7,44,6,1,38,973,0.14,0.96,0.86,0.33,6,4,3,2,1009,0.67,1.0,0.57,0.61
PF07529,PF15790:PF14619:PF06465:PF07533:PF08073,17,25,10,7,15,986,0.4,0.98,0.59,0.47,7,4,13,3,998,0.57,0.98,0.24,0.36
PF16748,PF13320:PF15793:PF15027:PF08168:PF13910,0,2,0,0,2,1016,0.0,1.0,0,0,0,0,0,0,1018,0,1.0,0,0
PF06781,PF11625:PF06181:PF15553:PF10999:PF05874,0,1,0,0,1,1017,0.0,1.0,0,0,0,0,0,0,1018,0,1.0,0,0
PF17152,PF01752:PF11751:PF00669:PF09483:PF01514,1,3,0,1,3,1014,0.0,1.0,0.0,-0.0,0,0,1,0,1017,0,1.0,0.0,0
PF12424,PF12409:PF16212:PF12515:PF09040:PF02348,9,55,4,5,51,958,0.07,0.94,0.44,0.16,5,2,7,3,1006,0.4,0.99,0.22,0.29
PF02807,PF00217:PF14868:PF03143:PF02797:PF00044,18,71,18,0,53,947,0.25,0.95,1.0,0.49,7,7,11,0,1000,1.0,0.99,0.39,0.62
PF03453,PF03454:PF06844:PF00994:PF01507:PF02464,23,50,20,3,30,965,0.4,0.97,0.87,0.58,3,2,21,1,994,0.67,0.98,0.09,0.24
PF01157,PF01907:PF05197:PF00831:PF05676:PF13023,14,28,5,9,23,981,0.18,0.97,0.36,0.24,3,2,12,1,1003,0.67,0.99,0.14,0.3
PF01398,PF13012:PF10596:PF12134:PF10597:PF13679,46,55,32,14,23,949,0.58,0.96,0.7,0.62,15,11,35,4,968,0.73,0.96,0.24,0.41
PF02827,PF14672:PF15724:PF08738:PF17124:PF07327,1,1,0,1,1,1016,0.0,1.0,0.0,-0.0,0,0,1,0,1017,0,1.0,0.0,0
PF05255,PF16839:PF10166:PF03437:PF14941:PF01415,10,6,2,8,4,1004,0.33,0.99,0.2,0.25,0,0,10,0,1008,0,0.99,0.0,0
PF15610,PF08744:PF05901:PF17164:PF05488:PF10924,1,0,0,1,0,1017,0,1.0,0.0,0,0,0,1,0,1017,0,1.0,0.0,0
PF12298,PF09282:PF00212:PF14769:PF10173:PF10217,6,11,2,4,9,1003,0.18,0.99,0.33,0.24,0,0,6,0,1012,0,0.99,0.0,0
PF10431,PF07724:PF02151:PF02861:PF02577:PF09079,26,44,25,1,19,973,0.57,0.98,0.96,0.73,4,4,22,0,992,1.0,0.98,0.15,0.39
PF15860,PF08561:PF01632:PF04716:PF09769:PF10853,6,24,1,5,23,989,0.04,0.97,0.17,0.07,2,0,6,2,1010,0.0,0.99,0.0,-0.0
PF09368,PF09732:PF13724:PF15539:PF15070:PF04266,3,19,1,2,18,997,0.05,0.98,0.33,0.13,0,0,3,0,1015,0,1.0,0.0,0
PF08578,PF15862:PF15997:PF07891:PF02200:PF11331,5,7,2,3,5,1008,0.29,0.99,0.4,0.33,0,0,5,0,1013,0,1.0,0.0,0
PF13638,PF17215:PF17216:PF10374:PF10351:PF12397,14,27,11,3,16,988,0.41,0.98,0.79,0.56,3,2,12,1,1003,0.67,0.99,0.14,0.3
PF00532,PF00356:PF00308:PF08479:PF12779:PF10554,5,17,5,0,12,1001,0.29,0.99,1.0,0.54,0,0,5,0,1013,0,1.0,0.0,0
PF17003,PF00895:PF16851:PF03379:PF15205:PF15832,0,2,0,0,2,1016,0.0,1.0,0,0,0,0,0,0,1018,0,1.0,0,0
PF15023,PF06834:PF01668:PF01706:PF08497:PF17206,0,4,0,0,4,1014,0.0,1.0,0,0,0,0,0,0,1018,0,1.0,0,0
PF00935,PF01198:PF12020:PF15260:PF00143:PF04901,17,28,8,9,20,981,0.29,0.97,0.47,0.35,0,0,17,0,1001,0,0.98,0.0,0
PF07506,PF11405:PF02543:PF01807:PF07409:PF03640,0,8,0,0,8,1010,0.0,0.99,0,0,0,0,0,0,1018,0,1.0,0,0
PF04116,PF04765:PF04819:PF00487:PF04117:PF12076,31,72,17,14,55,932,0.24,0.93,0.55,0.33,5,5,26,0,987,1.0,0.97,0.16,0.4
PF08530,PF02129:PF02065:PF16874:PF16875:PF09298,17,34,17,0,17,984,0.5,0.98,1.0,0.7,4,3,14,1,1000,0.75,0.99,0.18,0.36
PF12036,PF04091:PF07035:PF08427:PF04842:PF15627,2,31,1,1,30,986,0.03,0.97,0.5,0.12,1,0,2,1,1015,0.0,1.0,0.0,-0.0
PF01712,PF04176:PF10160:PF15013:PF15454:PF03942,7,24,5,2,19,992,0.21,0.98,0.71,0.38,1,0,7,1,1010,0.0,0.99,0.0,-0.0
PF12369,PF09193:PF10413:PF03827:PF08983:PF12109,2,5,2,0,3,1013,0.4,1.0,1.0,0.63,1,1,1,0,1016,1.0,1.0,0.5,0.71
PF12012,PF15273:PF11261:PF12509:PF08394:PF12618,10,14,3,7,11,997,0.21,0.98,0.3,0.24,0,0,10,0,1008,0,0.99,0.0,0
PF16803,PF05093:PF02912:PF01617:PF12589:PF08279,6,33,6,0,27,985,0.18,0.97,1.0,0.42,5,0,6,5,1007,0.0,0.99,0.0,-0.01
PF05615,PF10173:PF10217:PF10180:PF17098:PF15313,6,27,2,4,25,987,0.07,0.97,0.33,0.15,1,0,6,1,1011,0.0,0.99,0.0,-0.0
PF09597,PF08641:PF06108:PF01632:PF09769:PF09631,1,23,0,1,23,994,0.0,0.98,0.0,-0.0,1,0,1,1,1016,0.0,1.0,0.0,-0.0
PF07259,PF15120:PF15849:PF15839:PF15576:PF07458,1,3,0,1,3,1014,0.0,1.0,0.0,-0.0,0,0,1,0,1017,0,1.0,0.0,0
PF14234,PF00797:PF12239:PF01184:PF01960:PF11937,3,43,1,2,42,973,0.02,0.96,0.33,0.08,2,0,3,2,1013,0.0,1.0,0.0,-0.0
PF15311,PF17098:PF10361:PF11727:PF15264:PF04090,6,9,2,4,7,1005,0.22,0.99,0.33,0.27,0,0,6,0,1012,0,0.99,0.0,0
PF07502,PF16915:PF09342:PF01522:PF15761:PF01823,2,53,2,0,51,965,0.04,0.95,1.0,0.19,1,1,1,0,1016,1.0,1.0,0.5,0.71
PF07945,PF09280:PF01206:PF05903:PF12295:PF13325,0,32,0,0,32,986,0.0,0.97,0,0,3,0,0,3,1015,0.0,1.0,0,0
PF07058,PF02057:PF06683:PF03331:PF01114:PF12121,5,3,0,5,3,1010,0.0,0.99,0.0,-0.0,0,0,5,0,1013,0,1.0,0.0,0
PF01541,PF07460:PF07453:PF05192:PF05190:PF00961,24,45,16,8,29,965,0.36,0.96,0.67,0.47,6,6,18,0,994,1.0,0.98,0.25,0.5
PF08463,PF03146:PF02667:PF03291:PF08803:PF08143,2,10,1,1,9,1007,0.1,0.99,0.5,0.22,0,0,2,0,1016,0,1.0,0.0,0
PF07077,PF08494:PF08744:PF04740:PF05939:PF13780,3,3,3,0,0,1015,1.0,1.0,1.0,1.0,0,0,3,0,1015,0,1.0,0.0,0
PF06821,PF15088:PF08843:PF00519:PF15856:PF13247,2,6,0,2,6,1010,0.0,0.99,0.0,-0.0,0,0,2,0,1016,0,1.0,0.0,0
PF02306,PF17193:PF02399:PF08456:PF03605:PF01580,1,8,0,1,8,1009,0.0,0.99,0.0,-0.0,1,0,1,1,1016,0.0,1.0,0.0,-0.0
PF15625,PF16056:PF11618:PF08151:PF08150:PF16562,3,15,1,2,14,1001,0.07,0.98,0.33,0.14,1,1,2,0,1015,1.0,1.0,0.33,0.58
PF05938,PF04520:PF00197:PF06749:PF10604:PF05910,9,27,8,1,19,990,0.3,0.98,0.89,0.51,2,2,7,0,1009,1.0,0.99,0.22,0.47
PF14910,PF14911:PF14950:PF14951:PF01114:PF03769,3,4,1,2,3,1012,0.25,1.0,0.33,0.29,0,0,3,0,1015,0,1.0,0.0,0
PF05439,PF15925:PF08592:PF13095:PF04119:PF01739,6,14,3,3,11,1001,0.21,0.99,0.5,0.32,1,1,5,0,1012,1.0,1.0,0.17,0.41
PF10660,PF09360:PF00525:PF16205:PF15689:PF12338,2,29,2,0,27,989,0.07,0.97,1.0,0.26,1,1,1,0,1016,1.0,1.0,0.5,0.71
PF10146,PF14931:PF06473:PF02792:PF15551:PF02126,3,12,1,2,11,1004,0.08,0.99,0.33,0.16,0,0,3,0,1015,0,1.0,0.0,0
PF04126,PF15696:PF10295:PF10138:PF03743:PF16997,3,11,1,2,10,1005,0.09,0.99,0.33,0.17,0,0,3,0,1015,0,1.0,0.0,0
PF08258,PF02277:PF15482:PF02503:PF05840:PF07484,0,5,0,0,5,1013,0.0,1.0,0,0,0,0,0,0,1018,0,1.0,0,0
PF04689,PF15486:PF10428:PF04471:PF07834:PF16029,6,13,4,2,9,1003,0.31,0.99,0.67,0.45,1,1,5,0,1012,1.0,1.0,0.17,0.41
PF01186,PF00530:PF02449:PF03523:PF03945:PF07282,5,53,4,1,49,964,0.08,0.95,0.8,0.24,0,0,5,0,1013,0,1.0,0.0,0
PF05178,PF12936:PF05508:PF15279:PF00853:PF10177,8,11,8,0,3,1007,0.73,1.0,1.0,0.85,1,1,7,0,1010,1.0,0.99,0.12,0.35
PF00124,PF00119:PF00507:PF00499:PF00430:PF01058,2,27,1,1,26,990,0.04,0.97,0.5,0.13,3,0,2,3,1013,0.0,1.0,0.0,-0.0
PF04916,PF08661:PF10266:PF04756:PF10504:PF05434,9,24,5,4,19,990,0.21,0.98,0.56,0.33,2,1,8,1,1008,0.5,0.99,0.11,0.23
PF00521,PF16898:PF08070:PF00204:PF01751:PF00986,19,33,17,2,16,983,0.52,0.98,0.89,0.67,15,12,7,3,996,0.8,0.99,0.63,0.71
PF15177,PF06679:PF14935:PF15260:PF02372:PF15187,6,5,1,5,4,1008,0.2,0.99,0.17,0.18,0,0,6,0,1012,0,0.99,0.0,0
PF02805,PF00165:PF08639:PF14161:PF04422:PF15805,6,10,6,0,4,1008,0.6,1.0,1.0,0.77,0,0,6,0,1012,0,0.99,0.0,0
PF14000,PF06977:PF11502:PF15423:PF13448:PF05894,0,1,0,0,1,1017,0.0,1.0,0,0,0,0,0,0,1018,0,1.0,0,0
PF00209,PF03491:PF05291:PF03137:PF02416:PF05653,39,41,11,28,30,949,0.27,0.94,0.28,0.25,4,4,35,0,979,1.0,0.97,0.1,0.31
PF11895,PF00141:PF06721:PF03442:PF10329:PF09072,2,45,2,0,43,973,0.04,0.96,1.0,0.21,1,0,2,1,1015,0.0,1.0,0.0,-0.0
PF08474,PF01530:PF17208:PF01853:PF12140:PF13438,4,42,4,0,38,976,0.1,0.96,1.0,0.3,3,2,2,1,1013,0.67,1.0,0.5,0.58
PF05443,PF11862:PF11245:PF10988:PF04671:PF01790,2,4,0,2,4,1012,0.0,0.99,0.0,-0.0,0,0,2,0,1016,0,1.0,0.0,0
PF10233,PF15359:PF09793:PF00159:PF01097:PF16541,8,13,2,6,11,999,0.15,0.98,0.25,0.19,1,1,7,0,1010,1.0,0.99,0.12,0.35
PF03085,PF15067:PF05841:PF07931:PF08634:PF13810,0,9,0,0,9,1009,0.0,0.99,0,0,0,0,0,0,1018,0,1.0,0,0
PF04992,PF04990:PF04983:PF11523:PF04998:PF04997,4,40,4,0,36,978,0.1,0.96,1.0,0.31,29,3,1,26,988,0.1,0.97,0.75,0.27
PF01084,PF00329:PF00886:PF00159:PF01058:PF00430,12,32,4,8,28,978,0.12,0.96,0.33,0.19,3,2,10,1,1005,0.67,0.99,0.17,0.33
PF12411,PF16347:PF12548:PF08019:PF04987:PF00884,1,51,1,0,50,967,0.02,0.95,1.0,0.14,5,1,0,4,1013,0.2,1.0,1.0,0.45
PF03445,PF07721:PF14280:PF07720:PF13176:PF04049,11,45,9,2,36,971,0.2,0.96,0.82,0.39,4,1,10,3,1004,0.25,0.99,0.09,0.15
PF02252,PF02251:PF16565:PF03665:PF07286:PF15345,12,13,9,3,4,1002,0.69,0.99,0.75,0.72,0,0,12,0,1006,0,0.99,0.0,0
PF09594,PF09834:PF05164:PF00524:PF09979:PF05065,1,5,0,1,5,1012,0.0,0.99,0.0,-0.0,0,0,1,0,1017,0,1.0,0.0,0
PF13821,PF07713:PF12457:PF11952:PF07842:PF03467,7,28,5,2,23,988,0.18,0.98,0.71,0.35,6,3,4,3,1008,0.5,0.99,0.43,0.46
PF16808,PF16579:PF12063:PF14593:PF12605:PF11629,3,20,2,1,18,997,0.1,0.98,0.67,0.25,4,2,1,2,1013,0.5,1.0,0.67,0.58
PF01043,PF07516:PF15994:PF15995:PF00680:PF07517,3,17,3,0,14,1001,0.18,0.99,1.0,0.42,0,0,3,0,1015,0,1.0,0.0,0
PF10018,PF07939:PF09419:PF04839:PF07816:PF09805,16,20,5,11,15,987,0.25,0.97,0.31,0.27,0,0,16,0,1002,0,0.98,0.0,0
PF14849,PF10139:PF13746:PF02753:PF07520:PF08274,2,7,0,2,7,1009,0.0,0.99,0.0,-0.0,0,0,2,0,1016,0,1.0,0.0,0
PF01630,PF06083:PF12273:PF10246:PF04505:PF00811,8,35,4,4,31,979,0.11,0.97,0.5,0.23,3,2,6,1,1009,0.67,0.99,0.25,0.41
PF13369,PF08755:PF04379:PF12014:PF04300:PF09346,7,21,6,1,15,996,0.29,0.98,0.86,0.49,2,1,6,1,1010,0.5,0.99,0.14,0.26
PF04857,PF08675:PF15019:PF01866:PF01160:PF10213,23,28,9,14,19,976,0.32,0.97,0.39,0.34,0,0,23,0,995,0,0.98,0.0,0
PF05449,PF10995:PF06505:PF01913:PF03925:PF09611,0,2,0,0,2,1016,0.0,1.0,0,0,0,0,0,0,1018,0,1.0,0,0
PF03116,PF14026:PF08025:PF06101:PF00736:PF08165,0,39,0,0,39,979,0.0,0.96,0,0,1,0,0,1,1017,0.0,1.0,0,0
PF01603,PF04729:PF15998:PF09756:PF07851:PF01176,21,32,9,12,23,974,0.28,0.97,0.43,0.33,2,2,19,0,997,1.0,0.98,0.1,0.31
PF05397,PF15624:PF09441:PF13945:PF15914:PF07001,11,13,2,9,11,996,0.15,0.98,0.18,0.16,0,0,11,0,1007,0,0.99,0.0,0
PF03894,PF09363:PF09364:PF03185:PF08369:PF14745,2,15,2,0,13,1003,0.13,0.99,1.0,0.36,0,0,2,0,1016,0,1.0,0.0,0
PF15932,PF09697:PF08538:PF07080:PF08883:PF09056,0,18,0,0,18,1000,0.0,0.98,0,0,1,0,0,1,1017,0.0,1.0,0,0
PF02475,PF02676:PF15679:PF10102:PF07646:PF09118,22,27,9,13,18,978,0.33,0.97,0.41,0.35,1,1,21,0,996,1.0,0.98,0.05,0.21
PF09282,PF07223:PF00212:PF12049:PF14769:PF11267,2,6,0,2,6,1010,0.0,0.99,0.0,-0.0,0,0,2,0,1016,0,1.0,0.0,0
PF05899,PF02502:PF07883:PF06249:PF14388:PF05724,5,47,5,0,42,971,0.11,0.96,1.0,0.32,2,1,4,1,1012,0.5,1.0,0.2,0.31
PF02026,PF01365:PF08454:PF08709:PF06459:PF02815,8,31,7,1,24,986,0.23,0.98,0.88,0.44,10,5,3,5,1005,0.5,0.99,0.62,0.56
PF10446,PF09463:PF10307:PF15918:PF10198:PF10336,1,6,0,1,6,1011,0.0,0.99,0.0,-0.0,0,0,1,0,1017,0,1.0,0.0,0
PF01938,PF00919:PF01967:PF06969:PF13597:PF12345,18,24,14,4,10,990,0.58,0.99,0.78,0.67,3,2,16,1,999,0.67,0.98,0.11,0.27
PF15989,PF15325:PF01316:PF06876:PF03238:PF15758,0,3,0,0,3,1015,0.0,1.0,0,0,0,0,0,0,1018,0,1.0,0,0
PF04236,PF09026:PF09607:PF04218:PF03221:PF05225,4,66,2,2,64,950,0.03,0.94,0.5,0.11,10,2,2,8,1006,0.2,0.99,0.5,0.31
PF10346,PF14232:PF08657:PF10685:PF09367:PF00807,1,3,0,1,3,1014,0.0,1.0,0.0,-0.0,0,0,1,0,1017,0,1.0,0.0,0
PF03673,PF12453:PF12567:PF16066:PF09314:PF05473,1,5,1,0,4,1013,0.2,1.0,1.0,0.45,1,1,0,0,1017,1.0,1.0,1.0,1.0
PF02614,PF07523:PF09397:PF13746:PF01136:PF07805,2,11,0,2,11,1005,0.0,0.99,0.0,-0.0,0,0,2,0,1016,0,1.0,0.0,0
PF08332,PF12605:PF16579:PF14593:PF11629:PF03822,7,16,4,3,12,999,0.25,0.99,0.57,0.37,4,3,4,1,1010,0.75,1.0,0.43,0.56
PF16741,PF16099:PF12542:PF07217:PF09746:PF06058,2,28,2,0,26,990,0.07,0.97,1.0,0.26,0,0,2,0,1016,0,1.0,0.0,0
PF00607,PF02093:PF02337:PF00077:PF07962:PF01140,11,18,7,4,11,996,0.39,0.99,0.64,0.49,4,4,7,0,1007,1.0,0.99,0.36,0.6
PF02702,PF10412:PF07881:PF15050:PF02863:PF03065,2,6,0,2,6,1010,0.0,0.99,0.0,-0.0,0,0,2,0,1016,0,1.0,0.0,0
PF15770,PF15334:PF15760:PF15680:PF08092:PF15085,0,3,0,0,3,1015,0.0,1.0,0,0,0,0,0,0,1018,0,1.0,0,0
PF16367,PF16366:PF16368:PF10267:PF01773:PF08081,13,26,12,1,14,991,0.46,0.99,0.92,0.65,3,3,10,0,1005,1.0,0.99,0.23,0.48
PF15886,PF06955:PF00722:PF02948:PF04101:PF02550,7,58,5,2,53,958,0.09,0.95,0.71,0.24,4,2,5,2,1009,0.5,0.99,0.29,0.37
PF14716,PF10391:PF14792:PF14791:PF03119:PF12821,19,22,14,5,8,991,0.64,0.99,0.74,0.68,11,11,8,0,999,1.0,0.99,0.58,0.76
PF04110,PF06388:PF14542:PF11779:PF14935:PF06232,8,12,2,6,10,1000,0.17,0.98,0.25,0.2,1,1,7,0,1010,1.0,0.99,0.12,0.35
PF05794,PF09138:PF07406:PF08228:PF06907:PF01878,10,17,3,7,14,994,0.18,0.98,0.3,0.22,3,1,9,2,1006,0.33,0.99,0.1,0.18
PF03523,PF00229:PF12287:PF09006:PF00386:PF14917,1,31,1,0,30,987,0.03,0.97,1.0,0.18,0,0,1,0,1017,0,1.0,0.0,0
PF14465,PF15082:PF15259:PF15997:PF09038:PF05715,2,6,1,1,5,1011,0.17,0.99,0.5,0.29,0,0,2,0,1016,0,1.0,0.0,0
PF05099,PF15990:PF00684:PF15820:PF06961:PF14901,0,7,0,0,7,1011,0.0,0.99,0,0,0,0,0,0,1018,0,1.0,0,0
PF01191,PF03871:PF03868:PF00993:PF16196:PF03986,10,29,10,0,19,989,0.34,0.98,1.0,0.58,1,0,10,1,1007,0.0,0.99,0.0,-0.0
PF16561,PF04739:PF14671:PF09192:PF08766:PF03126,21,44,16,5,28,969,0.36,0.97,0.76,0.51,4,4,17,0,997,1.0,0.98,0.19,0.43
PF10996,PF16661:PF07521:PF13299:PF07289:PF11718,32,43,32,0,11,975,0.74,0.99,1.0,0.86,10,10,22,0,986,1.0,0.98,0.31,0.55
PF14250,PF11128:PF06689:PF14050:PF04387:PF04968,0,34,0,0,34,984,0.0,0.97,0,0,0,0,0,0,1018,0,1.0,0,0
PF08557,PF11960:PF01070:PF00173:PF13875:PF10559,6,104,5,1,99,913,0.05,0.9,0.83,0.19,5,3,3,2,1010,0.6,1.0,0.5,0.55
PF04136,PF04048:PF10441:PF14952:PF17034:PF12612,13,28,6,7,22,983,0.21,0.97,0.46,0.3,2,1,12,1,1004,0.5,0.99,0.08,0.19
PF05006,PF05234:PF00419:PF03605:PF07882:PF07338,0,8,0,0,8,1010,0.0,0.99,0,0,0,0,0,0,1018,0,1.0,0,0
PF14850,PF06433:PF00171:PF05708:PF00696:PF00465,4,125,4,0,121,893,0.03,0.88,1.0,0.17,9,1,3,8,1006,0.11,0.99,0.25,0.16
PF16097,PF16098:PF16096:PF12235:PF05266:PF03726,1,14,1,0,13,1004,0.07,0.99,1.0,0.27,1,1,0,0,1017,1.0,1.0,1.0,1.0
PF12013,PF00172:PF16783:PF14619:PF03902:PF14773,11,144,10,1,134,873,0.07,0.87,0.91,0.23,3,3,8,0,1007,1.0,0.99,0.27,0.52
PF15016,PF15146:PF12886:PF15025:PF11699:PF16794,2,17,2,0,15,1001,0.12,0.99,1.0,0.34,1,1,1,0,1016,1.0,1.0,0.5,0.71
PF01212,PF02347:PF11991:PF01965:PF00793:PF02897,24,54,14,10,40,954,0.26,0.95,0.58,0.37,5,3,21,2,992,0.6,0.98,0.12,0.27
PF04625,PF06890:PF02277:PF03963:PF10279:PF15708,1,4,0,1,4,1013,0.0,1.0,0.0,-0.0,0,0,1,0,1017,0,1.0,0.0,0
PF13313,PF13482:PF06651:PF02086:PF10999:PF15337,0,5,0,0,5,1013,0.0,1.0,0,0,0,0,0,0,1018,0,1.0,0,0
PF02106,PF15302:PF15467:PF15398:PF15087:PF15069,0,2,0,0,2,1016,0.0,1.0,0,0,0,0,0,0,1018,0,1.0,0,0
PF05007,PF04790:PF00590:PF14823:PF14824:PF13241,9,25,4,5,21,988,0.16,0.97,0.44,0.26,9,2,7,7,1002,0.22,0.99,0.22,0.22
PF09239,PF07730:PF06580:PF16359:PF17203:PF08918,2,20,0,2,20,996,0.0,0.98,0.0,-0.01,1,0,2,1,1015,0.0,1.0,0.0,-0.0
PF05117,PF02217:PF05840:PF11124:PF02557:PF03589,0,5,0,0,5,1013,0.0,1.0,0,0,0,0,0,0,1018,0,1.0,0,0
PF05474,PF07149:PF11109:PF02951:PF15096:PF06670,0,5,0,0,5,1013,0.0,1.0,0,0,0,0,0,0,1018,0,1.0,0,0
PF00839,PF04815:PF08033:PF04558:PF16863:PF04810,3,48,1,2,47,968,0.02,0.95,0.33,0.07,21,0,3,21,994,0.0,0.98,0.0,-0.01
PF00176,PF08797:PF08774:PF06465:PF13892:PF06461,115,37,32,83,5,898,0.86,0.91,0.28,0.46,7,7,108,0,903,1.0,0.89,0.06,0.23
PF06240,PF04290:PF08402:PF08352:PF12857:PF09383,7,12,6,1,6,1005,0.5,0.99,0.86,0.65,2,2,5,0,1011,1.0,1.0,0.29,0.53
PF16675,PF16676:PF09354:PF08430:PF16159:PF00250,3,45,3,0,42,973,0.07,0.96,1.0,0.25,4,2,1,2,1013,0.5,1.0,0.67,0.58
PF00217,PF02807:PF14868:PF12078:PF07735:PF07177,19,34,16,3,18,981,0.47,0.98,0.84,0.62,4,3,16,1,998,0.75,0.98,0.16,0.34
PF06162,PF01051:PF15169:PF15356:PF15233:PF05685,0,6,0,0,6,1012,0.0,0.99,0,0,0,0,0,0,1018,0,1.0,0,0
PF01015,PF16054:PF01907:PF01176:PF06825:PF03386,9,20,4,5,16,993,0.2,0.98,0.44,0.29,1,0,9,1,1008,0.0,0.99,0.0,-0.0
PF01389,PF14334:PF08116:PF07152:PF17221:PF10865,0,1,0,0,1,1017,0.0,1.0,0,0,0,0,0,0,1018,0,1.0,0,0
PF02638,PF13406:PF17049:PF15312:PF15828:PF17006,4,4,0,4,4,1010,0.0,0.99,0.0,-0.0,0,0,4,0,1014,0,1.0,0.0,0
PF08599,PF14348:PF16771:PF11862:PF13722:PF12729,1,3,0,1,3,1014,0.0,1.0,0.0,-0.0,0,0,1,0,1017,0,1.0,0.0,0
PF00354,PF10393:PF00194:PF07593:PF16754:PF08488,17,30,5,12,25,976,0.17,0.96,0.29,0.2,2,2,15,0,1001,1.0,0.99,0.12,0.34
PF05904,PF09284:PF14683:PF14576:PF06045:PF02901,1,24,1,0,23,994,0.04,0.98,1.0,0.2,0,0,1,0,1017,0,1.0,0.0,0
PF16661,PF10996:PF07521:PF13299:PF07289:PF11718,30,40,27,3,13,975,0.68,0.98,0.9,0.77,15,10,20,5,983,0.67,0.98,0.33,0.46
PF11268,PF15482:PF15895:PF15553:PF11092:PF05874,0,1,0,0,1,1017,0.0,1.0,0,0,0,0,0,0,1018,0,1.0,0,0
PF12353,PF12220:PF08081:PF12196:PF11627:PF15519,18,14,4,14,10,990,0.29,0.98,0.22,0.24,1,1,17,0,1000,1.0,0.98,0.06,0.23
PF07442,PF10101:PF03400:PF09827:PF09531:PF10070,0,14,0,0,14,1004,0.0,0.99,0,0,0,0,0,0,1018,0,1.0,0,0
PF03805,PF01194:PF00489:PF11771:PF02531:PF09232,0,7,0,0,7,1011,0.0,0.99,0,0,0,0,0,0,1018,0,1.0,0,0
PF06763,PF11924:PF03562:PF04687:PF13530:PF06251,0,5,0,0,5,1013,0.0,1.0,0,0,0,0,0,0,1018,0,1.0,0,0
PF14844,PF06469:PF15787:PF02138:PF12660:PF12657,21,41,20,1,21,976,0.49,0.98,0.95,0.67,1,1,20,0,997,1.0,0.98,0.05,0.22
PF12793,PF05710:PF14871:PF04170:PF10731:PF12835,0,2,0,0,2,1016,0.0,1.0,0,0,0,0,0,0,1018,0,1.0,0,0
PF10076,PF05947:PF01752:PF16967:PF06864:PF01514,0,3,0,0,3,1015,0.0,1.0,0,0,0,0,0,0,1018,0,1.0,0,0
PF08243,PF12169:PF08578:PF08161:PF15862:PF11822,12,15,2,10,13,993,0.13,0.98,0.17,0.14,1,1,11,0,1006,1.0,0.99,0.08,0.29
PF00433,PF12179:PF03822:PF14593:PF12605:PF00139,34,27,7,27,20,964,0.26,0.95,0.21,0.21,2,2,32,0,984,1.0,0.97,0.06,0.24
PF08512,PF03531:PF10155:PF08517:PF13775:PF14441,18,24,10,8,14,986,0.42,0.98,0.56,0.47,1,1,17,0,1000,1.0,0.98,0.06,0.23
PF07105,PF05926:PF02556:PF07348:PF00260:PF05103,0,8,0,0,8,1010,0.0,0.99,0,0,0,0,0,0,1018,0,1.0,0,0
PF13502,PF08345:PF12241:PF13722:PF06798:PF14841,1,2,0,1,2,1015,0.0,1.0,0.0,-0.0,0,0,1,0,1017,0,1.0,0.0,0
PF14634,PF00025:PF13445:PF15840:PF12126:PF03915,17,103,12,5,91,910,0.12,0.91,0.71,0.26,5,5,12,0,1001,1.0,0.99,0.29,0.54
PF04052,PF01514:PF04355:PF08334:PF10566:PF12392,0,2,0,0,2,1016,0.0,1.0,0,0,0,0,0,0,1018,0,1.0,0,0
PF03914,PF00924:PF06584:PF13934:PF09736:PF14611,18,29,7,11,22,978,0.24,0.97,0.39,0.29,2,2,16,0,1000,1.0,0.98,0.11,0.33
PF12509,PF11261:PF10264:PF08729:PF13945:PF07001,4,18,0,4,18,996,0.0,0.98,0.0,-0.01,2,0,4,2,1012,0.0,0.99,0.0,-0.0
PF10333,PF09428:PF02393:PF15062:PF09962:PF04681,0,6,0,0,6,1012,0.0,0.99,0,0,0,0,0,0,1018,0,1.0,0,0
PF04551,PF02901:PF15252:PF05690:PF02371:PF01228,5,13,2,3,11,1002,0.15,0.99,0.4,0.24,2,2,3,0,1013,1.0,1.0,0.4,0.63
PF04280,PF16516:PF15558:PF09730:PF03800:PF13851,7,15,0,7,15,996,0.0,0.98,0.0,-0.01,0,0,7,0,1011,0,0.99,0.0,0
PF09759,PF14764:PF09822:PF06662:PF15296:PF02449,8,24,4,4,20,990,0.17,0.98,0.5,0.28,2,2,6,0,1010,1.0,0.99,0.25,0.5
PF06551,PF06462:PF00523:PF00337:PF07684:PF06816,0,35,0,0,35,983,0.0,0.97,0,0,3,0,0,3,1015,0.0,1.0,0,0
PF11202,PF04671:PF10411:PF07411:PF08298:PF04717,0,1,0,0,1,1017,0.0,1.0,0,0,0,0,0,0,1018,0,1.0,0,0
PF15936,PF14138:PF06456:PF12315:PF09045:PF00412,7,103,6,1,97,914,0.06,0.9,0.86,0.21,3,2,5,1,1010,0.67,0.99,0.29,0.43
PF17027,PF10618:PF08453:PF03428:PF04351:PF03888,0,2,0,0,2,1016,0.0,1.0,0,0,0,0,0,0,1018,0,1.0,0,0
PF10443,PF08081:PF12220:PF08075:PF12353:PF12196,7,25,2,5,23,988,0.08,0.97,0.29,0.14,2,1,6,1,1010,0.5,0.99,0.14,0.26
PF05398,PF05611:PF06403:PF15716:PF15039:PF01051,0,2,0,0,2,1016,0.0,1.0,0,0,0,0,0,0,1018,0,1.0,0,0
PF11259,PF08708:PF10109:PF04451:PF06724:PF07157,0,1,0,0,1,1017,0.0,1.0,0,0,0,0,0,0,1018,0,1.0,0,0
PF02945,PF03175:PF13251:PF15995:PF16685:PF00073,6,29,6,0,23,989,0.21,0.98,1.0,0.45,0,0,6,0,1012,0,0.99,0.0,0
PF01944,PF14258:PF07499:PF13722:PF13742:PF04552,0,5,0,0,5,1013,0.0,1.0,0,0,0,0,0,0,1018,0,1.0,0,0
PF08259,PF11751:PF06798:PF01312:PF07499:PF03090,0,2,0,0,2,1016,0.0,1.0,0,0,0,0,0,0,1018,0,1.0,0,0
PF06888,PF01937:PF05742:PF01093:PF15008:PF15012,4,21,3,1,18,996,0.14,0.98,0.75,0.32,0,0,4,0,1014,0,1.0,0.0,0
PF11648,PF08061:PF13234:PF03461:PF03368:PF03880,10,23,5,5,18,990,0.22,0.98,0.5,0.32,2,2,8,0,1008,1.0,0.99,0.2,0.45
PF13801,PF11316:PF15856:PF15199:PF04941:PF03742,0,4,0,0,4,1014,0.0,1.0,0,0,0,0,0,0,1018,0,1.0,0,0
PF07080,PF09056:PF07464:PF09057:PF16851:PF06369,3,6,1,2,5,1010,0.17,0.99,0.33,0.23,0,0,3,0,1015,0,1.0,0.0,0
PF07671,PF16485:PF01447:PF10404:PF02278:PF02868,2,9,0,2,9,1007,0.0,0.99,0.0,-0.0,1,0,2,1,1015,0.0,1.0,0.0,-0.0
PF16016,PF02893:PF16056:PF15625:PF12335:PF11618,16,37,9,7,28,974,0.24,0.97,0.56,0.36,2,2,14,0,1002,1.0,0.99,0.12,0.35
PF00640,PF06311:PF08916:PF08574:PF00611:PF00620,27,87,18,9,69,922,0.21,0.92,0.67,0.34,5,3,24,2,989,0.6,0.97,0.11,0.25
PF10151,PF01959:PF06217:PF14713:PF15377:PF11017,6,5,1,5,4,1008,0.2,0.99,0.17,0.18,0,0,6,0,1012,0,0.99,0.0,0
PF00436,PF04667:PF07816:PF09597:PF01987:PF04716,22,23,3,19,20,976,0.13,0.96,0.14,0.11,0,0,22,0,996,0,0.98,0.0,0
PF07721,PF07720:PF16669:PF15044:PF03445:PF12807,6,29,3,3,26,986,0.1,0.97,0.5,0.22,1,1,5,0,1012,1.0,1.0,0.17,0.41
PF12577,PF02161:PF12743:PF02155:PF02159:PF14046,3,12,3,0,9,1006,0.25,0.99,1.0,0.5,5,3,0,2,1013,0.6,1.0,1.0,0.77
PF06439,PF03422:PF04616:PF03442:PF05506:PF16990,1,47,1,0,46,971,0.02,0.95,1.0,0.14,4,1,0,3,1014,0.25,1.0,1.0,0.5
PF07311,PF05109:PF15518:PF03831:PF02119:PF16889,0,4,0,0,4,1014,0.0,1.0,0,0,0,0,0,0,1018,0,1.0,0,0
PF08397,PF12026:PF08824:PF07815:PF02208:PF04088,7,14,3,4,11,1000,0.21,0.99,0.43,0.3,1,1,6,0,1011,1.0,0.99,0.14,0.38
PF10414,PF13404:PF14823:PF02604:PF12299:PF01890,2,13,2,0,11,1005,0.15,0.99,1.0,0.39,1,1,1,0,1016,1.0,1.0,0.5,0.71
PF02029,PF15388:PF05693:PF05091:PF03343:PF03298,7,32,3,4,29,982,0.09,0.97,0.43,0.19,4,2,5,2,1009,0.5,0.99,0.29,0.37
PF07430,PF15722:PF10630:PF16829:PF15234:PF02740,0,1,0,0,1,1017,0.0,1.0,0,0,0,0,0,0,1018,0,1.0,0,0
PF10422,PF15356:PF03739:PF14539:PF15756:PF10412,1,6,0,1,6,1011,0.0,0.99,0.0,-0.0,0,0,1,0,1017,0,1.0,0.0,0
PF10212,PF16704:PF03470:PF15908:PF04388:PF15905,4,15,3,1,12,1002,0.2,0.99,0.75,0.38,1,1,3,0,1014,1.0,1.0,0.25,0.5
PF10856,PF04624:PF08964:PF15709:PF15823:PF02074,0,2,0,0,2,1016,0.0,1.0,0,0,0,0,0,0,1018,0,1.0,0,0
PF00905,PF03717:PF07014:PF10290:PF15710:PF03984,19,18,16,3,2,997,0.89,1.0,0.84,0.86,0,0,19,0,999,0,0.98,0.0,0
PF14959,PF13910:PF15627:PF08168:PF15027:PF12333,1,9,0,1,9,1008,0.0,0.99,0.0,-0.0,0,0,1,0,1017,0,1.0,0.0,0
PF09312,PF13145:PF11924:PF04279:PF15153:PF01289,1,9,1,0,8,1009,0.11,0.99,1.0,0.33,0,0,1,0,1017,0,1.0,0.0,0
PF13645,PF15102:PF02827:PF03317:PF04837:PF05115,0,10,0,0,10,1008,0.0,0.99,0,0,0,0,0,0,1018,0,1.0,0,0
PF14015,PF15856:PF08744:PF01668:PF02554:PF08093,0,4,0,0,4,1014,0.0,1.0,0,0,0,0,0,0,1018,0,1.0,0,0
PF02590,PF10693:PF02575:PF16974:PF02605:PF02341,3,10,2,1,8,1007,0.2,0.99,0.67,0.36,0,0,3,0,1015,0,1.0,0.0,0
PF09822,PF14764:PF02449:PF11698:PF15296:PF10022,5,31,2,3,29,984,0.06,0.97,0.4,0.15,0,0,5,0,1013,0,1.0,0.0,0
PF06943,PF04086:PF06124:PF05140:PF09996:PF00885,2,21,1,1,20,996,0.05,0.98,0.5,0.15,1,0,2,1,1015,0.0,1.0,0.0,-0.0
PF06189,PF07354:PF15008:PF15053:PF05612:PF06473,3,4,0,3,4,1011,0.0,0.99,0.0,-0.0,0,0,3,0,1015,0,1.0,0.0,0
PF01326,PF00391:PF02896:PF05524:PF08314:PF02738,14,41,11,3,30,974,0.27,0.97,0.79,0.45,5,3,11,2,1002,0.6,0.99,0.21,0.35
PF14832,PF17124:PF13095:PF15152:PF08847:PF15091,5,3,0,5,3,1010,0.0,0.99,0.0,-0.0,0,0,5,0,1013,0,1.0,0.0,0
PF03575,PF05405:PF01632:PF10218:PF15860:PF06159,1,19,0,1,19,998,0.0,0.98,0.0,-0.0,0,0,1,0,1017,0,1.0,0.0,0
PF16835,PF12240:PF16782:PF12001:PF08286:PF15248,12,9,4,8,5,1001,0.44,0.99,0.33,0.38,0,0,12,0,1006,0,0.99,0.0,0
PF05622,PF04388:PF03800:PF06470:PF09190:PF01406,14,41,8,6,33,971,0.2,0.96,0.57,0.32,2,2,12,0,1004,1.0,0.99,0.14,0.38
PF05755,PF15786:PF02569:PF09784:PF06907:PF15744,2,13,1,1,12,1004,0.08,0.99,0.5,0.19,0,0,2,0,1016,0,1.0,0.0,0
PF01979,PF07969:PF02142:PF00547:PF00699:PF00449,47,39,17,30,22,949,0.44,0.95,0.36,0.37,6,6,41,0,971,1.0,0.96,0.13,0.35
PF15391,PF12628:PF06724:PF08744:PF15337:PF08093,1,4,1,0,3,1014,0.25,1.0,1.0,0.5,0,0,1,0,1017,0,1.0,0.0,0
PF03737,PF04148:PF06884:PF10455:PF12296:PF07745,12,21,4,8,17,989,0.19,0.98,0.33,0.24,2,2,10,0,1006,1.0,0.99,0.17,0.41
PF13136,PF05129:PF13564:PF10203:PF05532:PF03760,4,23,1,3,22,992,0.04,0.98,0.25,0.1,1,0,4,1,1013,0.0,1.0,0.0,-0.0
PF09447,PF10490:PF05685:PF11291:PF15233:PF15400,1,9,0,1,9,1008,0.0,0.99,0.0,-0.0,0,0,1,0,1017,0,1.0,0.0,0
PF16197,PF00698:PF00975:PF02801:PF14765:PF04587,36,69,36,0,33,949,0.52,0.97,1.0,0.71,32,31,5,1,981,0.97,0.99,0.86,0.91
PF00658,PF11532:PF16842:PF08080:PF00632:PF01749,14,74,11,3,63,941,0.15,0.94,0.79,0.32,1,1,13,0,1004,1.0,0.99,0.07,0.27
PF02516,PF04516:PF04981:PF06830:PF08652:PF01458,17,16,6,11,10,991,0.38,0.98,0.35,0.35,0,0,17,0,1001,0,0.98,0.0,0
PF03892,PF09488:PF15952:PF08595:PF09498:PF15856,0,9,0,0,9,1009,0.0,0.99,0,0,0,0,0,0,1018,0,1.0,0,0
PF13553,PF02760:PF02758:PF00619:PF11957:PF09034,6,34,4,2,30,982,0.12,0.97,0.67,0.27,2,1,5,1,1011,0.5,0.99,0.17,0.29
PF05853,PF15050:PF17015:PF15036:PF17062:PF15175,1,3,0,1,3,1014,0.0,1.0,0.0,-0.0,0,0,1,0,1017,0,1.0,0.0,0
PF10587,PF00736:PF07899:PF05542:PF02083:PF14766,18,34,18,0,16,984,0.53,0.98,1.0,0.72,1,0,18,1,999,0.0,0.98,0.0,-0.0
PF03068,PF08527:PF08526:PF02971:PF04961:PF14951,8,9,4,4,5,1005,0.44,0.99,0.5,0.47,0,0,8,0,1010,0,0.99,0.0,0
PF08491,PF12831:PF01266:PF01494:PF16901:PF06314,4,120,4,0,116,898,0.03,0.89,1.0,0.17,15,4,0,11,1003,0.27,0.99,1.0,0.51
PF02387,PF04355:PF04451:PF17014:PF05272:PF00767,0,3,0,0,3,1015,0.0,1.0,0,0,0,0,0,0,1018,0,1.0,0,0
PF02118,PF10323:PF10317:PF10319:PF10318:PF10325,4,28,3,1,25,989,0.11,0.97,0.75,0.28,0,0,4,0,1014,0,1.0,0.0,0
PF15291,PF08308:PF03548:PF05838:PF03944:PF09951,1,5,0,1,5,1012,0.0,0.99,0.0,-0.0,0,0,1,0,1017,0,1.0,0.0,0
PF08024,PF09786:PF03351:PF06080:PF00549:PF10574,0,53,0,0,53,965,0.0,0.95,0,0,2,0,0,2,1016,0.0,1.0,0,0
PF05295,PF10285:PF10630:PF10284:PF15467:PF15015,0,0,0,0,0,1018,0,1.0,0,0,0,0,0,0,1018,0,1.0,0,0
PF07189,PF05612:PF06217:PF02605:PF07464:PF15171,7,2,0,7,2,1009,0.0,0.99,0.0,-0.0,0,0,7,0,1011,0,0.99,0.0,0
PF14949,PF12596:PF04583:PF04508:PF05485:PF14811,8,61,6,2,55,955,0.1,0.94,0.75,0.26,2,2,6,0,1010,1.0,0.99,0.25,0.5
PF07846,PF12904:PF15302:PF16829:PF01114:PF13204,1,1,0,1,1,1016,0.0,1.0,0.0,-0.0,0,0,1,0,1017,0,1.0,0.0,0
PF00646,PF12937:PF08387:PF03478:PF07734:PF07723,94,117,51,43,66,858,0.44,0.89,0.54,0.43,14,13,81,1,923,0.93,0.92,0.14,0.34
PF05181,PF07111:PF07137:PF09775:PF15313:PF15005,8,17,3,5,14,996,0.18,0.98,0.38,0.25,0,0,8,0,1010,0,0.99,0.0,0
PF08155,PF06858:PF02421:PF10998:PF05553:PF06428,16,36,16,0,20,982,0.44,0.98,1.0,0.66,1,1,15,0,1002,1.0,0.99,0.06,0.25
PF04709,PF00688:PF09771:PF09157:PF14353:PF09664,1,19,1,0,18,999,0.05,0.98,1.0,0.23,1,0,1,1,1016,0.0,1.0,0.0,-0.0
PF03793,PF03241:PF14842:PF07499:PF11751:PF15518,3,3,1,2,2,1013,0.33,1.0,0.33,0.33,0,0,3,0,1015,0,1.0,0.0,0
PF00729,PF03729:PF01913:PF07310:PF08751:PF10459,1,8,0,1,8,1009,0.0,0.99,0.0,-0.0,0,0,1,0,1017,0,1.0,0.0,0
PF10042,PF00038:PF08757:PF00932:PF10664:PF15043,2,28,0,2,28,988,0.0,0.97,0.0,-0.01,0,0,2,0,1016,0,1.0,0.0,0
PF08593,PF09122:PF11127:PF11830:PF15733:PF15145,1,6,0,1,6,1011,0.0,0.99,0.0,-0.0,0,0,1,0,1017,0,1.0,0.0,0
PF05232,PF08497:PF03428:PF17206:PF10995:PF05509,0,1,0,0,1,1017,0.0,1.0,0,0,0,0,0,0,1018,0,1.0,0,0
PF16973,PF15143:PF03831:PF05280:PF13612:PF02543,0,9,0,0,9,1009,0.0,0.99,0,0,0,0,0,0,1018,0,1.0,0,0
PF00954,PF08276:PF01453:PF04833:PF08652:PF13947,26,53,24,2,29,963,0.45,0.97,0.92,0.63,9,9,17,0,992,1.0,0.98,0.35,0.58
PF03464,PF03463:PF03465:PF04927:PF14577:PF14576,8,12,8,0,4,1006,0.67,1.0,1.0,0.81,1,1,7,0,1010,1.0,0.99,0.12,0.35
PF10325,PF10327:PF10319:PF10318:PF02118:PF10316,3,20,2,1,18,997,0.1,0.98,0.67,0.25,3,1,2,2,1013,0.33,1.0,0.33,0.33
PF15482,PF08795:PF15312:PF06651:PF06724:PF05939,0,0,0,0,0,1018,0,1.0,0,0,0,0,0,0,1018,0,1.0,0,0
PF11978,PF01505:PF10998:PF10312:PF11727:PF05334,2,16,2,0,14,1002,0.12,0.99,1.0,0.35,0,0,2,0,1016,0,1.0,0.0,0
PF15784,PF10506:PF15368:PF11559:PF16574:PF11577,0,15,0,0,15,1003,0.0,0.99,0,0,0,0,0,0,1018,0,1.0,0,0
PF05292,PF06244:PF03878:PF01597:PF03350:PF07816,11,37,7,4,30,977,0.19,0.97,0.64,0.34,2,2,9,0,1007,1.0,0.99,0.18,0.42
PF05684,PF08414:PF04452:PF04107:PF11221:PF02401,2,25,2,0,23,993,0.08,0.98,1.0,0.28,0,0,2,0,1016,0,1.0,0.0,0
PF10014,PF02950:PF09428:PF16311:PF10333:PF15097,2,3,0,2,3,1013,0.0,1.0,0.0,-0.0,0,0,2,0,1016,0,1.0,0.0,0
PF01415,PF15252:PF15551:PF15231:PF15741:PF16001,2,2,0,2,2,1014,0.0,1.0,0.0,-0.0,0,0,2,0,1016,0,1.0,0.0,0
PF06762,PF16027:PF07298:PF05859:PF09443:PF15998,3,12,0,3,12,1003,0.0,0.99,0.0,-0.01,0,0,3,0,1015,0,1.0,0.0,0
PF01442,PF15239:PF06189:PF02267:PF06888:PF10616,6,11,5,1,6,1006,0.45,0.99,0.83,0.61,0,0,6,0,1012,0,0.99,0.0,0
PF12800,PF11953:PF12837:PF12617:PF07123:PF03412,2,8,2,0,6,1010,0.25,0.99,1.0,0.5,0,0,2,0,1016,0,1.0,0.0,0
PF01457,PF09992:PF07974:PF02333:PF00021:PF09443,10,44,5,5,39,969,0.11,0.96,0.5,0.22,0,0,10,0,1008,0,0.99,0.0,0
PF10375,PF15453:PF11291:PF05164:PF10490:PF02108,1,4,0,1,4,1013,0.0,1.0,0.0,-0.0,0,0,1,0,1017,0,1.0,0.0,0
PF08591,PF07961:PF05754:PF04691:PF15055:PF14519,0,1,0,0,1,1017,0.0,1.0,0,0,0,0,0,0,1018,0,1.0,0,0
PF05015,PF14655:PF14656:PF00583:PF08336:PF02836,0,100,0,0,100,918,0.0,0.9,0,0,9,0,0,9,1009,0.0,0.99,0,0
PF10436,PF09239:PF07730:PF00183:PF00360:PF00204,16,55,7,9,48,954,0.13,0.94,0.44,0.21,4,2,14,2,1000,0.5,0.98,0.12,0.24
PF04450,PF04690:PF06404:PF06206:PF02681:PF16974,2,9,0,2,9,1007,0.0,0.99,0.0,-0.0,0,0,2,0,1016,0,1.0,0.0,0
PF15627,PF14959:PF13910:PF08216:PF15027:PF11028,2,9,0,2,9,1007,0.0,0.99,0.0,-0.0,0,0,2,0,1016,0,1.0,0.0,0
PF08256,PF08248:PF07149:PF11800:PF03963:PF07559,0,1,0,0,1,1017,0.0,1.0,0,0,0,0,0,0,1018,0,1.0,0,0
PF06890,PF07157:PF11751:PF02277:PF07409:PF03428,0,3,0,0,3,1015,0.0,1.0,0,0,0,0,0,0,1018,0,1.0,0,0
PF07111,PF13097:PF15313:PF07137:PF00835:PF15233,3,19,2,1,17,998,0.11,0.98,0.67,0.26,0,0,3,0,1015,0,1.0,0.0,0
PF01448,PF08558:PF01426:PF07988:PF16772:PF14379,17,49,8,9,41,960,0.16,0.95,0.47,0.26,0,0,17,0,1001,0,0.98,0.0,0
PF09069,PF09068:PF16577:PF12744:PF16158:PF00569,6,50,6,0,44,968,0.12,0.96,1.0,0.34,2,2,4,0,1012,1.0,1.0,0.33,0.58
PF16022,PF07178:PF05509:PF05513:PF04354:PF05309,0,2,0,0,2,1016,0.0,1.0,0,0,1,0,0,1,1017,0.0,1.0,0,0
PF00045,PF01471:PF08924:PF15225:PF00413:PF01033,26,49,26,0,23,969,0.53,0.98,1.0,0.72,8,8,18,0,992,1.0,0.98,0.31,0.55
PF06918,PF16034:PF04423:PF08912:PF12455:PF07989,2,27,0,2,27,989,0.0,0.97,0.0,-0.01,2,0,2,2,1014,0.0,1.0,0.0,-0.0
PF00913,PF13206:PF00835:PF10173:PF08227:PF10583,0,11,0,0,11,1007,0.0,0.99,0,0,0,0,0,0,1018,0,1.0,0,0
PF04642,PF15553:PF04370:PF15482:PF06724:PF12628,1,0,0,1,0,1017,0,1.0,0.0,0,0,0,1,0,1017,0,1.0,0.0,0
PF14622,PF00636:PF16482:PF00035:PF07528:PF02137,22,65,17,5,48,948,0.26,0.95,0.77,0.43,11,5,17,6,990,0.45,0.98,0.23,0.31
PF02362,PF06507:PF00847:PF02309:PF07496:PF14733,30,49,21,9,28,960,0.43,0.96,0.7,0.53,5,5,25,0,988,1.0,0.98,0.17,0.4
PF13764,PF16399:PF02916:PF02617:PF12166:PF12366,9,23,4,5,19,990,0.17,0.98,0.44,0.27,3,1,8,2,1007,0.33,0.99,0.11,0.19
PF06534,PF06535:PF17187:PF05023:PF00273:PF09164,0,11,0,0,11,1007,0.0,0.99,0,0,0,0,0,0,1018,0,1.0,0,0
PF06580,PF07730:PF09239:PF02954:PF00486:PF04397,9,18,6,3,12,997,0.33,0.99,0.67,0.47,3,1,8,2,1007,0.33,0.99,0.11,0.19
PF02526,PF05594:PF14232:PF01228:PF07014:PF16173,0,2,0,0,2,1016,0.0,1.0,0,0,0,0,0,0,1018,0,1.0,0,0
PF05151,PF09252:PF14866:PF15838:PF08092:PF14986,0,1,0,0,1,1017,0.0,1.0,0,0,0,0,0,0,1018,0,1.0,0,0
PF01508,PF13948:PF06671:PF15789:PF10578:PF12782,0,5,0,0,5,1013,0.0,1.0,0,0,0,0,0,0,1018,0,1.0,0,0
PF03354,PF06346:PF06311:PF06345:PF07647:PF12889,0,45,0,0,45,973,0.0,0.96,0,0,1,0,0,1,1017,0.0,1.0,0,0
PF09754,PF06127:PF01097:PF09631:PF10183:PF03980,6,27,3,3,24,988,0.11,0.97,0.5,0.23,0,0,6,0,1012,0,0.99,0.0,0
PF04229,PF09796:PF10340:PF08843:PF12680:PF03576,5,12,1,4,11,1002,0.08,0.99,0.2,0.12,0,0,5,0,1013,0,1.0,0.0,0
PF06176,PF07930:PF11954:PF01427:PF00144:PF12209,0,69,0,0,69,949,0.0,0.93,0,0,0,0,0,0,1018,0,1.0,0,0
PF12147,PF10971:PF14671:PF09192:PF01331:PF03919,1,18,1,0,17,1000,0.06,0.98,1.0,0.23,2,1,0,1,1016,0.5,1.0,1.0,0.71
PF13751,PF05947:PF15976:PF03888:PF07434:PF01330,2,2,0,2,2,1014,0.0,1.0,0.0,-0.0,0,0,2,0,1016,0,1.0,0.0,0
PF04098,PF08081:PF16131:PF03467:PF12220:PF13865,9,30,2,7,28,981,0.07,0.97,0.22,0.11,4,2,7,2,1007,0.5,0.99,0.22,0.33
PF01139,PF05434:PF16954:PF05497:PF15008:PF03997,11,16,2,9,14,993,0.12,0.98,0.18,0.14,0,0,11,0,1007,0,0.99,0.0,0
PF07503,PF00267:PF12425:PF08093:PF12843:PF06431,1,5,0,1,5,1012,0.0,0.99,0.0,-0.0,0,0,1,0,1017,0,1.0,0.0,0
PF03943,PF09162:PF02136:PF05620:PF15705:PF14304,5,30,4,1,26,987,0.13,0.97,0.8,0.32,1,1,4,0,1013,1.0,1.0,0.2,0.45
PF07494,PF01580:PF08345:PF14882:PF06744:PF08334,1,6,0,1,6,1011,0.0,0.99,0.0,-0.0,0,0,1,0,1017,0,1.0,0.0,0
PF10396,PF12631:PF07975:PF02789:PF16711:PF14687,12,31,8,4,23,983,0.26,0.97,0.67,0.4,1,1,11,0,1006,1.0,0.99,0.08,0.29
PF07463,PF14849:PF11209:PF16273:PF15234:PF12916,4,4,1,3,3,1011,0.25,0.99,0.25,0.25,0,0,4,0,1014,0,1.0,0.0,0
PF00225,PF16540:PF13931:PF16796:PF12423:PF14739,102,24,23,79,1,915,0.96,0.92,0.23,0.44,4,4,98,0,916,1.0,0.9,0.04,0.19
PF01694,PF04114:PF14923:PF13833:PF02517:PF00254,45,101,28,17,73,900,0.28,0.91,0.62,0.38,7,6,39,1,972,0.86,0.96,0.13,0.33
PF12799,PF12819:PF13855:PF15904:PF00560:PF16095,42,157,39,3,118,858,0.25,0.88,0.93,0.44,15,9,33,6,970,0.6,0.96,0.21,0.34
PF06730,PF15991:PF16007:PF07052:PF10273:PF03479,5,19,1,4,18,995,0.05,0.98,0.2,0.09,2,0,5,2,1011,0.0,0.99,0.0,-0.0
PF15554,PF08653:PF15669:PF07904:PF04487:PF06989,2,7,0,2,7,1009,0.0,0.99,0.0,-0.0,0,0,2,0,1016,0,1.0,0.0,0
PF11650,PF14322:PF10109:PF10618:PF08280:PF04221,0,1,0,0,1,1017,0.0,1.0,0,0,0,0,0,0,1018,0,1.0,0,0
PF00235,PF04177:PF15377:PF05351:PF09778:PF01353,12,18,5,7,13,993,0.28,0.98,0.42,0.33,1,1,11,0,1006,1.0,0.99,0.08,0.29
PF10065,PF08498:PF12589:PF17086:PF08247:PF01865,0,14,0,0,14,1004,0.0,0.99,0,0,0,0,0,0,1018,0,1.0,0,0
PF15009,PF14954:PF15260:PF12020:PF00708:PF04538,1,11,1,0,10,1007,0.09,0.99,1.0,0.3,0,0,1,0,1017,0,1.0,0.0,0
PF00866,PF06995:PF06445:PF09677:PF02119:PF03323,7,12,1,6,11,1000,0.08,0.98,0.14,0.1,0,0,7,0,1011,0,0.99,0.0,0
PF01403,PF08337:PF01437:PF00047:PF01833:PF03921,22,67,19,3,48,948,0.28,0.95,0.86,0.48,12,10,12,2,994,0.83,0.99,0.45,0.61
PF07857,PF08140:PF12853:PF03769:PF12150:PF03768,9,9,0,9,9,1000,0.0,0.98,0.0,-0.01,0,0,9,0,1009,0,0.99,0.0,0
PF07743,PF09350:PF09320:PF00684:PF15990:PF14901,17,19,5,12,14,987,0.26,0.97,0.29,0.27,0,0,17,0,1001,0,0.98,0.0,0
PF11229,PF12530:PF10487:PF08158:PF01930:PF03511,2,14,1,1,13,1003,0.07,0.99,0.5,0.19,0,0,2,0,1016,0,1.0,0.0,0
PF14811,PF01160:PF03776:PF13092:PF13225:PF13826,4,15,1,3,14,1000,0.07,0.98,0.25,0.12,0,0,4,0,1014,0,1.0,0.0,0
PF01502,PF01503:PF00815:PF11597:PF14638:PF06333,15,31,11,4,20,983,0.35,0.98,0.73,0.5,5,3,12,2,1001,0.6,0.99,0.2,0.34
PF00097,PF13445:PF13639:PF14634:PF12940:PF04859,71,151,47,24,104,843,0.31,0.87,0.66,0.4,13,11,60,2,945,0.85,0.94,0.15,0.35
PF06398,PF06462:PF08150:PF00337:PF16562:PF08165,15,34,6,9,28,975,0.18,0.96,0.4,0.25,2,2,13,0,1003,1.0,0.99,0.13,0.36
PF03317,PF15200:PF05115:PF15556:PF08189:PF15105,5,2,1,4,1,1012,0.5,1.0,0.2,0.31,0,0,5,0,1013,0,1.0,0.0,0
PF02445,PF03458:PF16576:PF05658:PF01701:PF17085,3,3,0,3,3,1012,0.0,0.99,0.0,-0.0,0,0,3,0,1015,0,1.0,0.0,0
PF01559,PF03331:PF03032:PF00103:PF03030:PF12056,1,19,0,1,19,998,0.0,0.98,0.0,-0.0,1,0,1,1,1016,0.0,1.0,0.0,-0.0
PF04597,PF14802:PF09496:PF04440:PF01730:PF00836,10,16,2,8,14,994,0.12,0.98,0.2,0.15,0,0,10,0,1008,0,0.99,0.0,0
PF00293,PF00828:PF01008:PF01725:PF00494:PF09297,79,71,34,45,37,902,0.48,0.92,0.43,0.41,12,10,69,2,937,0.83,0.93,0.13,0.31
PF09749,PF06658:PF02284:PF06172:PF01680:PF01774,10,20,6,4,14,994,0.3,0.98,0.6,0.42,0,0,10,0,1008,0,0.99,0.0,0
PF08644,PF14826:PF16188:PF03531:PF08512:PF01321,7,28,7,0,21,990,0.25,0.98,1.0,0.49,5,3,4,2,1009,0.6,0.99,0.43,0.5
PF10281,PF07543:PF03795:PF00366:PF11595:PF09351,8,28,5,3,23,987,0.18,0.97,0.62,0.33,3,3,5,0,1010,1.0,1.0,0.38,0.61
PF16065,PF01933:PF13349:PF10218:PF15684:PF06581,7,6,1,6,5,1006,0.17,0.99,0.14,0.15,0,0,7,0,1011,0,0.99,0.0,0
PF12078,PF07735:PF00068:PF07114:PF03879:PF06542,6,26,4,2,22,990,0.15,0.98,0.67,0.31,2,0,6,2,1010,0.0,0.99,0.0,-0.0
PF06071,PF01018:PF08701:PF05128:PF08153:PF09269,9,15,3,6,12,997,0.2,0.98,0.33,0.25,1,1,8,0,1009,1.0,0.99,0.11,0.33
PF00007,PF00219:PF00093:PF07452:PF06212:PF00090,9,66,9,0,57,952,0.14,0.94,1.0,0.36,7,4,5,3,1006,0.57,0.99,0.44,0.5
PF14997,PF08286:PF05281:PF01241:PF07740:PF12638,4,7,1,3,6,1008,0.14,0.99,0.25,0.18,0,0,4,0,1014,0,1.0,0.0,0
PF06404,PF06206:PF07712:PF02422:PF04690:PF02681,1,10,0,1,10,1007,0.0,0.99,0.0,-0.0,0,0,1,0,1017,0,1.0,0.0,0
PF11968,PF10218:PF15243:PF07114:PF02372:PF15370,8,7,0,8,7,1003,0.0,0.99,0.0,-0.01,0,0,8,0,1010,0,0.99,0.0,0
PF06608,PF11317:PF03379:PF15055:PF08092:PF10514,1,2,0,1,2,1015,0.0,1.0,0.0,-0.0,0,0,1,0,1017,0,1.0,0.0,0
PF00976,PF16102:PF08035:PF08384:PF13092:PF03776,0,11,0,0,11,1007,0.0,0.99,0,0,0,0,0,0,1018,0,1.0,0,0
PF17058,PF01077:PF03460:PF00769:PF12889:PF01174,0,25,0,0,25,993,0.0,0.98,0,0,3,0,0,3,1015,0.0,1.0,0,0
PF03351,PF10517:PF01082:PF03188:PF03712:PF04526,19,44,19,0,25,974,0.43,0.98,1.0,0.65,7,5,14,2,997,0.71,0.98,0.26,0.43
PF06737,PF02557:PF09669:PF06724:PF09867:PF08795,0,3,0,0,3,1015,0.0,1.0,0,0,0,0,0,0,1018,0,1.0,0,0
PF07117,PF15976:PF07434:PF14113:PF16861:PF08411,0,4,0,0,4,1014,0.0,1.0,0,0,0,0,0,0,1018,0,1.0,0,0
PF05611,PF07353:PF03275:PF09832:PF08093:PF14877,0,8,0,0,8,1010,0.0,0.99,0,0,0,0,0,0,1018,0,1.0,0,0
PF16004,PF14492:PF03764:PF06421:PF16658:PF00679,10,58,9,1,49,959,0.16,0.95,0.9,0.36,23,7,3,16,992,0.3,0.98,0.7,0.45
PF08531,PF05592:PF14200:PF03422:PF03633:PF05390,13,33,13,0,20,985,0.39,0.98,1.0,0.62,2,2,11,0,1005,1.0,0.99,0.15,0.39
PF04859,PF04833:PF06830:PF12579:PF01458:PF07762,3,21,2,1,19,996,0.1,0.98,0.67,0.25,0,0,3,0,1015,0,1.0,0.0,0
PF09424,PF10224:PF12900:PF08787:PF12351:PF10161,6,17,1,5,16,996,0.06,0.98,0.17,0.09,0,0,6,0,1012,0,0.99,0.0,0
PF14050,PF04968:PF05002:PF16273:PF09032:PF04969,1,53,1,0,52,965,0.02,0.95,1.0,0.13,7,0,1,7,1010,0.0,0.99,0.0,-0.0
PF09510,PF08795:PF11214:PF06724:PF04076:PF04392,0,2,0,0,2,1016,0.0,1.0,0,0,0,0,0,0,1018,0,1.0,0,0
PF15129,PF14984:PF11630:PF00758:PF08194:PF07172,1,4,1,0,3,1014,0.25,1.0,1.0,0.5,0,0,1,0,1017,0,1.0,0.0,0
PF01756,PF14749:PF08028:PF09317:PF00441:PF12806,20,65,14,6,51,947,0.22,0.94,0.7,0.37,3,3,17,0,998,1.0,0.98,0.15,0.38
PF01423,PF05907:PF07426:PF05180:PF05019:PF10203,69,26,17,52,9,940,0.65,0.94,0.25,0.38,3,3,66,0,949,1.0,0.94,0.04,0.2
PF06020,PF15343:PF15776:PF15207:PF17015:PF08093,0,4,0,0,4,1014,0.0,1.0,0,0,0,0,0,0,1018,0,1.0,0,0
PF15297,PF15893:PF15064:PF16829:PF06567:PF15234,4,3,0,4,3,1011,0.0,0.99,0.0,-0.0,0,0,4,0,1014,0,1.0,0.0,0
PF03781,PF12867:PF10017:PF00463:PF14656:PF01300,11,35,9,2,26,981,0.26,0.97,0.82,0.45,2,2,9,0,1007,1.0,0.99,0.18,0.42
PF04077,PF03244:PF08308:PF05666:PF17049:PF05326,1,1,0,1,1,1016,0.0,1.0,0.0,-0.0,0,0,1,0,1017,0,1.0,0.0,0
PF07019,PF06246:PF04930:PF15013:PF15860:PF12296,17,28,7,10,21,980,0.25,0.97,0.41,0.31,1,1,16,0,1001,1.0,0.98,0.06,0.24
PF07143,PF17186:PF02649:PF10116:PF03718:PF06804,1,10,0,1,10,1007,0.0,0.99,0.0,-0.0,0,0,1,0,1017,0,1.0,0.0,0
PF01361,PF09500:PF02801:PF05366:PF06693:PF02304,1,59,0,1,59,958,0.0,0.94,0.0,-0.01,0,0,1,0,1017,0,1.0,0.0,0
PF00230,PF04535:PF06749:PF12296:PF03942:PF13088,40,32,10,30,22,956,0.31,0.95,0.25,0.25,2,2,38,0,978,1.0,0.96,0.05,0.22
PF10543,PF14791:PF14792:PF10391:PF14850:PF14716,0,28,0,0,28,990,0.0,0.97,0,0,14,0,0,14,1004,0.0,0.99,0,0
PF06055,PF05325:PF00496:PF01080:PF02653:PF04895,4,34,2,2,32,982,0.06,0.97,0.5,0.16,0,0,4,0,1014,0,1.0,0.0,0
PF11719,PF16783:PF03159:PF07652:PF03880:PF03461,10,29,8,2,21,987,0.28,0.98,0.8,0.46,2,2,8,0,1008,1.0,0.99,0.2,0.45
PF15879,PF10310:PF10775:PF13933:PF04852:PF08649,5,6,2,3,4,1009,0.33,0.99,0.4,0.36,0,0,5,0,1013,0,1.0,0.0,0
PF07101,PF03917:PF05084:PF03199:PF04034:PF14843,0,23,0,0,23,995,0.0,0.98,0,0,2,0,0,2,1016,0.0,1.0,0,0
PF11187,PF15318:PF03048:PF04892:PF16840:PF13151,2,1,1,1,0,1016,1.0,1.0,0.5,0.71,0,0,2,0,1016,0,1.0,0.0,0
PF03168,PF06749:PF14547:PF04535:PF10604:PF04720,12,30,10,2,20,986,0.33,0.98,0.83,0.52,2,2,10,0,1006,1.0,0.99,0.17,0.41
PF06733,PF13307:PF06777:PF13890:PF07422:PF11916,22,25,21,1,4,992,0.84,1.0,0.95,0.89,5,5,17,0,996,1.0,0.98,0.23,0.47
PF00852,PF17039:PF01066:PF05277:PF08100:PF02752,23,76,16,7,60,935,0.21,0.93,0.7,0.36,8,7,16,1,994,0.88,0.98,0.3,0.51
PF02875,PF01225:PF03533:PF07361:PF01098:PF09179,17,20,11,6,9,992,0.55,0.99,0.65,0.59,2,2,15,0,1001,1.0,0.99,0.12,0.34
PF02198,PF12310:PF04621:PF11620:PF00178:PF16019,16,30,13,3,17,985,0.43,0.98,0.81,0.59,2,2,14,0,1002,1.0,0.99,0.12,0.35
PF03071,PF04133:PF05221:PF06312:PF02833:PF16282,11,29,4,7,25,982,0.14,0.97,0.36,0.21,3,2,9,1,1006,0.67,0.99,0.18,0.34
PF07998,PF07282:PF16692:PF05337:PF15759:PF15235,5,7,0,5,7,1006,0.0,0.99,0.0,-0.01,1,0,5,1,1012,0.0,0.99,0.0,-0.0
PF00296,PF06609:PF13577:PF11700:PF04479:PF04299,19,37,10,9,27,972,0.27,0.96,0.53,0.36,7,4,15,3,996,0.57,0.98,0.21,0.34
PF10705,PF10868:PF07961:PF03488:PF00714:PF15109,0,2,0,0,2,1016,0.0,1.0,0,0,0,0,0,0,1018,0,1.0,0,0
PF00152,PF01336:PF16900:PF09170:PF08784:PF02938,70,60,44,26,16,932,0.73,0.96,0.63,0.66,7,7,63,0,948,1.0,0.94,0.1,0.31
PF15702,PF08570:PF15480:PF15843:PF06952:PF04848,3,6,0,3,6,1009,0.0,0.99,0.0,-0.0,0,0,3,0,1015,0,1.0,0.0,0
PF11678,PF00514:PF14535:PF03673:PF04958:PF01403,0,75,0,0,75,943,0.0,0.93,0,0,2,0,0,2,1016,0.0,1.0,0,0
PF04360,PF15175:PF05853:PF15046:PF10664:PF15849,0,5,0,0,5,1013,0.0,1.0,0,0,0,0,0,0,1018,0,1.0,0,0
PF05090,PF08014:PF11727:PF16043:PF15929:PF02731,7,9,1,6,8,1003,0.11,0.99,0.14,0.12,0,0,7,0,1011,0,0.99,0.0,0
PF04273,PF03200:PF04864:PF03368:PF10547:PF14085,1,23,1,0,22,995,0.04,0.98,1.0,0.21,1,0,1,1,1016,0.0,1.0,0.0,-0.0
PF09295,PF16669:PF07721:PF07219:PF05279:PF13174,2,22,2,0,20,996,0.09,0.98,1.0,0.3,1,1,1,0,1016,1.0,1.0,0.5,0.71
PF05579,PF02075:PF02445:PF04607:PF13328:PF11903,1,24,0,1,24,993,0.0,0.98,0.0,-0.0,0,0,1,0,1017,0,1.0,0.0,0
PF16218,PF15550:PF14972:PF02393:PF13301:PF02427,0,4,0,0,4,1014,0.0,1.0,0,0,0,0,0,0,1018,0,1.0,0,0
PF05190,PF05192:PF05188:PF00488:PF01624:PF01541,6,56,6,0,50,962,0.11,0.95,1.0,0.32,28,5,1,23,989,0.18,0.98,0.83,0.38
PF03006,PF04178:PF13088:PF00810:PF03942:PF00119,21,46,11,10,35,962,0.24,0.96,0.52,0.33,3,2,19,1,996,0.67,0.98,0.1,0.25
PF10080,PF10634:PF07157:PF13421:PF03888:PF17188,0,0,0,0,0,1018,0,1.0,0,0,0,0,0,0,1018,0,1.0,0,0
PF12432,PF10395:PF15793:PF15735:PF14952:PF08161,4,10,3,1,7,1007,0.3,0.99,0.75,0.47,1,1,3,0,1014,1.0,1.0,0.25,0.5
PF13922,PF05066:PF13919:PF12031:PF12509:PF10482,4,21,4,0,17,997,0.19,0.98,1.0,0.43,2,2,2,0,1014,1.0,1.0,0.5,0.71
PF03352,PF07545:PF10332:PF03703:PF10104:PF16072,4,9,0,4,9,1005,0.0,0.99,0.0,-0.01,0,0,4,0,1014,0,1.0,0.0,0
PF13890,PF09733:PF11977:PF07810:PF07782:PF12422,4,30,3,1,27,987,0.1,0.97,0.75,0.27,3,1,3,2,1012,0.33,1.0,0.25,0.29
PF09279,PF00388:PF00387:PF03490:PF08703:PF16457,9,30,9,0,21,988,0.3,0.98,1.0,0.54,8,7,2,1,1008,0.88,1.0,0.78,0.82
PF08102,PF13737:PF07366:PF01478:PF15208:PF06360,0,6,0,0,6,1012,0.0,0.99,0,0,0,0,0,0,1018,0,1.0,0,0
PF03390,PF08291:PF07589:PF07804:PF07404:PF08093,1,3,0,1,3,1014,0.0,1.0,0.0,-0.0,0,0,1,0,1017,0,1.0,0.0,0
PF10589,PF10531:PF01512:PF04064:PF13375:PF00674,7,18,7,0,11,1000,0.39,0.99,1.0,0.62,0,0,7,0,1011,0,0.99,0.0,0
PF15628,PF15629:PF00073:PF08811:PF12381:PF11765,3,17,1,2,16,999,0.06,0.98,0.33,0.13,0,0,3,0,1015,0,1.0,0.0,0
PF10305,PF10359:PF10293:PF10344:PF10351:PF10347,4,8,4,0,4,1010,0.5,1.0,1.0,0.71,5,4,0,1,1013,0.8,1.0,1.0,0.89
PF09752,PF15794:PF07344:PF06382:PF15671:PF10483,8,10,1,7,9,1001,0.1,0.98,0.12,0.1,0,0,8,0,1010,0,0.99,0.0,0
PF03226,PF05362:PF01434:PF02190:PF00004:PF06632,20,161,15,5,146,852,0.09,0.85,0.75,0.23,23,10,10,13,985,0.43,0.98,0.5,0.45
PF07655,PF10079:PF13435:PF10106:PF11876:PF01580,1,6,0,1,6,1011,0.0,0.99,0.0,-0.0,0,0,1,0,1017,0,1.0,0.0,0
PF02319,PF16421:PF08781:PF15244:PF02940:PF05346,24,37,18,6,19,975,0.49,0.98,0.75,0.59,0,0,24,0,994,0,0.98,0.0,0
PF04264,PF13722:PF08497:PF15843:PF02277:PF05974,0,3,0,0,3,1015,0.0,1.0,0,0,0,0,0,0,1018,0,1.0,0,0
PF08131,PF06876:PF15141:PF02087:PF02025:PF17076,0,4,0,0,4,1014,0.0,1.0,0,0,0,0,0,0,1018,0,1.0,0,0
PF13188,PF08448:PF00990:PF00672:PF00158:PF08629,5,32,5,0,27,986,0.16,0.97,1.0,0.39,7,4,1,3,1010,0.57,1.0,0.8,0.67
PF00405,PF09439:PF16470:PF00408:PF09286:PF00151,9,67,6,3,61,948,0.09,0.94,0.67,0.23,8,2,7,6,1003,0.25,0.99,0.22,0.23
PF09207,PF16011:PF13094:PF09818:PF15485:PF11057,0,4,0,0,4,1014,0.0,1.0,0,0,0,0,0,0,1018,0,1.0,0,0
PF01973,PF00002:PF06243:PF06299:PF07210:PF08646,0,71,0,0,71,947,0.0,0.93,0,0,0,0,0,0,1018,0,1.0,0,0
PF00300,PF01591:PF01513:PF09741:PF10419:PF04406,67,44,25,42,19,932,0.57,0.94,0.37,0.43,6,6,61,0,951,1.0,0.94,0.09,0.29
PF09045,PF15737:PF09007:PF16667:PF11818:PF08687,1,7,1,0,6,1011,0.14,0.99,1.0,0.38,1,1,0,0,1017,1.0,1.0,1.0,1.0
PF10141,PF12779:PF15096:PF02369:PF05658:PF04239,1,3,0,1,3,1014,0.0,1.0,0.0,-0.0,0,0,1,0,1017,0,1.0,0.0,0
PF00864,PF03036:PF03299:PF15390:PF15388:PF03298,10,18,2,8,16,992,0.11,0.98,0.2,0.14,1,1,9,0,1008,1.0,0.99,0.1,0.31
PF03736,PF01463:PF12534:PF01462:PF10461:PF00401,9,9,3,6,6,1003,0.33,0.99,0.33,0.33,2,2,7,0,1009,1.0,0.99,0.22,0.47
PF04699,PF03152:PF16558:PF06730:PF15285:PF03759,5,28,2,3,26,987,0.07,0.97,0.4,0.16,1,1,4,0,1013,1.0,1.0,0.2,0.45
PF05577,PF00232:PF00248:PF00314:PF00445:PF04199,28,112,19,9,93,897,0.17,0.9,0.68,0.31,17,9,19,8,982,0.53,0.97,0.32,0.4
PF02633,PF13322:PF03616:PF15272:PF07769:PF09614,2,1,0,2,1,1015,0.0,1.0,0.0,-0.0,0,0,2,0,1016,0,1.0,0.0,0
PF03967,PF08748:PF10468:PF09498:PF15847:PF08982,1,7,0,1,7,1010,0.0,0.99,0.0,-0.0,0,0,1,0,1017,0,1.0,0.0,0
PF04842,PF17034:PF12036:PF13355:PF15627:PF15027,4,11,0,4,11,1003,0.0,0.99,0.0,-0.01,0,0,4,0,1014,0,1.0,0.0,0
PF00344,PF10559:PF05004:PF02607:PF02965:PF02310,17,18,9,8,9,992,0.5,0.98,0.53,0.51,5,2,15,3,998,0.4,0.98,0.12,0.21
PF05956,PF05937:PF05924:PF16689:PF05923:PF10508,3,17,3,0,14,1001,0.18,0.99,1.0,0.42,4,3,0,1,1014,0.75,1.0,1.0,0.87
PF16419,PF15309:PF12842:PF12381:PF16415:PF07792,0,20,0,0,20,998,0.0,0.98,0,0,2,0,0,2,1016,0.0,1.0,0,0
PF02036,PF01575:PF15011:PF15975:PF10195:PF14989,20,41,12,8,29,969,0.29,0.96,0.6,0.4,1,1,19,0,998,1.0,0.98,0.05,0.22
PF08997,PF09757:PF00850:PF12203:PF07075:PF08956,7,52,6,1,46,965,0.12,0.95,0.86,0.3,1,1,6,0,1011,1.0,0.99,0.14,0.38
PF03092,PF04859:PF07786:PF04833:PF00349:PF04791,8,37,2,6,35,975,0.05,0.96,0.25,0.1,2,1,7,1,1009,0.5,0.99,0.12,0.25
PF05591,PF05943:PF13722:PF05947:PF05974:PF07499,0,2,0,0,2,1016,0.0,1.0,0,0,0,0,0,0,1018,0,1.0,0,0
PF07830,PF04471:PF00481:PF04689:PF02590:PF08376,9,75,9,0,66,943,0.12,0.94,1.0,0.33,3,1,8,2,1007,0.33,0.99,0.11,0.19
PF15349,PF07807:PF17100:PF17107:PF02650:PF09902,0,37,0,0,37,981,0.0,0.96,0,0,1,0,0,1,1017,0.0,1.0,0,0
PF01762,PF00337:PF04099:PF13334:PF12326:PF07061,40,40,18,22,22,956,0.45,0.96,0.45,0.43,4,4,36,0,978,1.0,0.96,0.1,0.31
PF16091,PF15759:PF05841:PF14040:PF13810:PF12898,1,1,0,1,1,1016,0.0,1.0,0.0,-0.0,0,0,1,0,1017,0,1.0,0.0,0
PF01392,PF01534:PF00051:PF16977:PF06121:PF06482,24,42,19,5,23,971,0.45,0.97,0.79,0.59,3,3,21,0,994,1.0,0.98,0.12,0.35
PF01232,PF08125:PF06742:PF06863:PF05683:PF07831,6,16,6,0,10,1002,0.38,0.99,1.0,0.61,0,0,6,0,1012,0,0.99,0.0,0
PF04536,PF11282:PF08034:PF12926:PF15673:PF06989,4,3,0,4,3,1011,0.0,0.99,0.0,-0.0,0,0,4,0,1014,0,1.0,0.0,0
PF07035,PF08427:PF12036:PF12460:PF08696:PF03190,7,29,1,6,28,983,0.03,0.97,0.14,0.06,2,0,7,2,1009,0.0,0.99,0.0,-0.0
PF13382,PF03841:PF00449:PF01475:PF00699:PF00547,3,10,1,2,9,1006,0.1,0.99,0.33,0.18,6,1,2,5,1010,0.17,0.99,0.33,0.23
PF04665,PF10544:PF04383:PF03288:PF04483:PF06581,3,16,3,0,13,1002,0.19,0.99,1.0,0.43,0,0,3,0,1015,0,1.0,0.0,0
PF10134,PF10554:PF07523:PF03428:PF02561:PF11492,0,1,0,0,1,1017,0.0,1.0,0,0,0,0,0,0,1018,0,1.0,0,0
PF16102,PF08035:PF00976:PF08384:PF16672:PF01337,0,6,0,0,6,1012,0.0,0.99,0,0,0,0,0,0,1018,0,1.0,0,0
PF13257,PF15934:PF15821:PF12240:PF15122:PF05459,4,1,0,4,1,1013,0.0,1.0,0.0,-0.0,0,0,4,0,1014,0,1.0,0.0,0
PF09050,PF09051:PF09049:PF07014:PF15690:PF15689,0,0,0,0,0,1018,0,1.0,0,0,0,0,0,0,1018,0,1.0,0,0
PF03181,PF03514:PF05687:PF08314:PF15492:PF01373,5,28,3,2,25,988,0.11,0.97,0.6,0.25,2,0,5,2,1011,0.0,0.99,0.0,-0.0
PF05435,PF08485:PF03832:PF04285:PF06007:PF12461,4,7,0,4,7,1007,0.0,0.99,0.0,-0.01,0,0,4,0,1014,0,1.0,0.0,0
PF08632,PF16051:PF01430:PF05974:PF15392:PF05100,5,1,0,5,1,1012,0.0,0.99,0.0,-0.0,0,0,5,0,1013,0,1.0,0.0,0
PF16055,PF08497:PF00669:PF08453:PF09861:PF02277,0,6,0,0,6,1012,0.0,0.99,0,0,0,0,0,0,1018,0,1.0,0,0
PF08778,PF11413:PF16279:PF08629:PF08832:PF12114,3,16,2,1,14,1001,0.12,0.99,0.67,0.28,2,2,1,0,1015,1.0,1.0,0.67,0.82
PF02672,PF00121:PF00044:PF02800:PF07801:PF00766,3,49,3,0,46,969,0.06,0.95,1.0,0.24,7,1,2,6,1009,0.14,0.99,0.33,0.21
PF00799,PF08283:PF07085:PF00577:PF16576:PF08275,2,16,2,0,14,1002,0.12,0.99,1.0,0.35,0,0,2,0,1016,0,1.0,0.0,0
PF05218,PF06007:PF12477:PF15204:PF08497:PF01292,2,7,1,1,6,1010,0.14,0.99,0.5,0.26,0,0,2,0,1016,0,1.0,0.0,0
PF01196,PF15860:PF04716:PF08641:PF10780:PF06244,16,28,7,9,21,981,0.25,0.97,0.44,0.32,1,1,15,0,1002,1.0,0.99,0.06,0.25
PF06588,PF10102:PF09118:PF02676:PF07646:PF10539,3,31,1,2,30,985,0.03,0.97,0.33,0.1,3,1,2,2,1013,0.33,1.0,0.33,0.33
PF15117,PF08404:PF08497:PF02465:PF15212:PF01316,0,2,0,0,2,1016,0.0,1.0,0,0,0,0,0,0,1018,0,1.0,0,0
PF14701,PF06202:PF14702:PF14699:PF05285:PF12530,2,18,2,0,16,1000,0.11,0.98,1.0,0.33,1,0,2,1,1015,0.0,1.0,0.0,-0.0
PF09867,PF02413:PF02277:PF01752:PF11363:PF07157,0,5,0,0,5,1013,0.0,1.0,0,0,0,0,0,0,1018,0,1.0,0,0
PF17119,PF06883:PF04183:PF00674:PF15786:PF15134,4,9,3,1,6,1008,0.33,0.99,0.75,0.5,0,0,4,0,1014,0,1.0,0.0,0
PF01701,PF10856:PF15319:PF01840:PF15231:PF15060,1,0,0,1,0,1017,0,1.0,0.0,0,0,0,1,0,1017,0,1.0,0.0,0
PF00907,PF11078:PF00853:PF12598:PF16176:PF00250,19,49,13,6,36,963,0.27,0.96,0.68,0.41,1,1,18,0,999,1.0,0.98,0.05,0.23
PF14464,PF15160:PF08331:PF03389:PF07655:PF09421,5,5,1,4,4,1009,0.2,0.99,0.2,0.2,0,0,5,0,1013,0,1.0,0.0,0
PF14531,PF15067:PF11669:PF05149:PF12527:PF10361,1,9,0,1,9,1008,0.0,0.99,0.0,-0.0,0,0,1,0,1017,0,1.0,0.0,0
PF10427,PF12938:PF16608:PF06012:PF15861:PF08585,2,24,1,1,23,993,0.04,0.98,0.5,0.14,2,1,1,1,1015,0.5,1.0,0.5,0.5
PF00281,PF00673:PF09285:PF13259:PF03463:PF03464,22,31,18,4,13,983,0.58,0.98,0.82,0.68,4,4,18,0,996,1.0,0.98,0.18,0.42
PF04845,PF15388:PF08643:PF16086:PF12317:PF10239,6,13,1,5,12,1000,0.08,0.98,0.17,0.11,0,0,6,0,1012,0,0.99,0.0,0
PF15460,PF09715:PF17078:PF08642:PF13559:PF09962,1,3,0,1,3,1014,0.0,1.0,0.0,-0.0,0,0,1,0,1017,0,1.0,0.0,0
PF15351,PF12090:PF11365:PF12887:PF15253:PF16788,2,14,0,2,14,1002,0.0,0.98,0.0,-0.01,1,0,2,1,1015,0.0,1.0,0.0,-0.0
PF01125,PF09784:PF01878:PF13933:PF08228:PF15744,11,12,2,9,10,997,0.17,0.98,0.18,0.16,0,0,11,0,1007,0,0.99,0.0,0
PF10099,PF06122:PF15460:PF05962:PF06210:PF15482,0,2,0,0,2,1016,0.0,1.0,0,0,0,0,0,0,1018,0,1.0,0,0
PF01862,PF15796:PF02196:PF09727:PF08912:PF09128,1,22,0,1,22,995,0.0,0.98,0.0,-0.0,3,0,1,3,1014,0.0,1.0,0.0,-0.0
PF16482,PF14622:PF07528:PF02137:PF15081:PF15849,4,42,3,1,39,975,0.07,0.96,0.75,0.22,3,1,3,2,1012,0.33,1.0,0.25,0.29
PF12045,PF12284:PF03529:PF03867:PF10525:PF04617,1,5,1,0,4,1013,0.2,1.0,1.0,0.45,1,1,0,0,1017,1.0,1.0,1.0,1.0
PF10190,PF02284:PF02046:PF12020:PF07114:PF08584,6,13,3,3,10,1002,0.23,0.99,0.5,0.33,0,0,6,0,1012,0,0.99,0.0,0
PF11523,PF04990:PF04992:PF04983:PF04998:PF05001,8,37,5,3,32,978,0.14,0.97,0.62,0.28,8,3,5,5,1005,0.38,0.99,0.38,0.37
PF10578,PF02420:PF15362:PF12782:PF15788:PF02343,0,3,0,0,3,1015,0.0,1.0,0,0,0,0,0,0,1018,0,1.0,0,0
PF05926,PF00364:PF01528:PF07105:PF04332:PF02978,0,62,0,0,62,956,0.0,0.94,0,0,0,0,0,0,1018,0,1.0,0,0
PF13457,PF08461:PF06890:PF02305:PF09829:PF05598,1,4,1,0,3,1014,0.25,1.0,1.0,0.5,0,0,1,0,1017,0,1.0,0.0,0
PF07677,PF01835:PF07703:PF01821:PF10569:PF07678,14,17,14,0,3,1001,0.82,1.0,1.0,0.91,11,11,3,0,1004,1.0,1.0,0.79,0.89
PF00216,PF08194:PF15713:PF08713:PF15211:PF05419,5,2,0,5,2,1011,0.0,0.99,0.0,-0.0,0,0,5,0,1013,0,1.0,0.0,0
PF10394,PF10496:PF04437:PF06466:PF04981:PF11571,13,32,7,6,25,980,0.22,0.97,0.54,0.33,2,1,12,1,1004,0.5,0.99,0.08,0.19
PF00578,PF10417:PF03931:PF12680:PF13302:PF00959,45,66,35,10,31,942,0.53,0.96,0.78,0.62,9,8,37,1,972,0.89,0.96,0.18,0.39
PF04446,PF14413:PF00794:PF03700:PF11841:PF06045,11,29,10,1,19,988,0.34,0.98,0.91,0.55,5,5,6,0,1007,1.0,0.99,0.45,0.67
PF06640,PF07988:PF08558:PF09316:PF16496:PF16498,1,16,1,0,15,1002,0.06,0.99,1.0,0.25,1,0,1,1,1016,0.0,1.0,0.0,-0.0
PF03194,PF01733:PF07542:PF06309:PF03022:PF01758,10,40,2,8,38,970,0.05,0.95,0.2,0.08,4,2,8,2,1006,0.5,0.99,0.2,0.31
PF06541,PF15715:PF15063:PF14473:PF10839:PF04856,0,0,0,0,0,1018,0,1.0,0,0,0,0,0,0,1018,0,1.0,0,0
PF07740,PF06446:PF16716:PF00537:PF05039:PF01716,1,2,1,0,1,1016,0.5,1.0,1.0,0.71,0,0,1,0,1017,0,1.0,0.0,0
PF03952,PF00113:PF00016:PF02788:PF16401:PF00278,13,34,12,1,22,983,0.35,0.98,0.92,0.56,0,0,13,0,1005,0,0.99,0.0,0
PF03823,PF15829:PF15576:PF15120:PF15839:PF02202,3,3,1,2,2,1013,0.33,1.0,0.33,0.33,0,0,3,0,1015,0,1.0,0.0,0
PF13026,PF10370:PF02719:PF07937:PF01455:PF13580,0,6,0,0,6,1012,0.0,0.99,0,0,0,0,0,0,1018,0,1.0,0,0
PF08923,PF10457:PF07059:PF12221:PF11654:PF03837,3,14,2,1,12,1003,0.14,0.99,0.67,0.3,0,0,3,0,1015,0,1.0,0.0,0
PF07059,PF10457:PF08923:PF01852:PF08916:PF04062,7,38,5,2,33,978,0.13,0.97,0.71,0.3,3,2,5,1,1010,0.67,0.99,0.29,0.43
PF15226,PF05135:PF15121:PF15043:PF17014:PF10315,0,2,0,0,2,1016,0.0,1.0,0,0,0,0,0,0,1018,0,1.0,0,0
PF01750,PF07317:PF06676:PF05284:PF07226:PF03400,2,2,0,2,2,1014,0.0,1.0,0.0,-0.0,0,0,2,0,1016,0,1.0,0.0,0
PF11450,PF06277:PF15521:PF02210:PF00054:PF17151,0,42,0,0,42,976,0.0,0.96,0,0,0,0,0,0,1018,0,1.0,0,0
PF11397,PF09132:PF05636:PF05507:PF07463:PF03457,7,15,3,4,12,999,0.2,0.98,0.43,0.29,0,0,7,0,1011,0,0.99,0.0,0
PF00131,PF14967:PF02106:PF10285:PF10166:PF15467,1,4,0,1,4,1013,0.0,1.0,0.0,-0.0,0,0,1,0,1017,0,1.0,0.0,0
PF16153,PF04567:PF01529:PF08344:PF15808:PF03493,0,65,0,0,65,953,0.0,0.94,0,0,6,0,0,6,1012,0.0,0.99,0,0
PF07454,PF04562:PF15775:PF04076:PF07192:PF15337,0,3,0,0,3,1015,0.0,1.0,0,0,0,0,0,0,1018,0,1.0,0,0
PF05683,PF05681:PF03315:PF07364:PF07171:PF10290,6,10,4,2,6,1006,0.4,0.99,0.67,0.51,0,0,6,0,1012,0,0.99,0.0,0
PF11057,PF15212:PF15041:PF15356:PF15119:PF15825,0,2,0,0,2,1016,0.0,1.0,0,0,0,0,0,0,1018,0,1.0,0,0
PF05038,PF11304:PF01807:PF08275:PF16216:PF01695,3,10,1,2,9,1006,0.1,0.99,0.33,0.18,1,0,3,1,1014,0.0,1.0,0.0,-0.0
PF15486,PF04296:PF13751:PF11217:PF14690:PF17070,1,3,0,1,3,1014,0.0,1.0,0.0,-0.0,0,0,1,0,1017,0,1.0,0.0,0
PF04991,PF07782:PF07162:PF07773:PF07757:PF06237,9,40,3,6,37,972,0.07,0.96,0.33,0.14,2,1,8,1,1008,0.5,0.99,0.11,0.23
PF14413,PF04446:PF00794:PF10785:PF05904:PF11841,10,28,10,0,18,990,0.36,0.98,1.0,0.59,4,4,6,0,1008,1.0,0.99,0.4,0.63
PF15187,PF06875:PF15550:PF17124:PF09057:PF16647,0,1,0,0,1,1017,0.0,1.0,0,0,0,0,0,0,1018,0,1.0,0,0
PF09272,PF02983:PF16030:PF15494:PF12032:PF09396,4,26,2,2,24,990,0.08,0.97,0.5,0.19,1,1,3,0,1014,1.0,1.0,0.25,0.5
PF10533,PF03106:PF14364:PF08731:PF07887:PF04187,3,22,3,0,19,996,0.14,0.98,1.0,0.37,0,0,3,0,1015,0,1.0,0.0,0
PF07468,PF01117:PF02278:PF03648:PF16874:PF02065,4,10,0,4,10,1004,0.0,0.99,0.0,-0.01,0,0,4,0,1014,0,1.0,0.0,0
PF09494,PF03000:PF09237:PF03131:PF12507:PF02135,11,40,6,5,34,973,0.15,0.96,0.55,0.27,6,4,7,2,1005,0.67,0.99,0.36,0.49
PF12302,PF03592:PF10566:PF14882:PF02572:PF04612,2,2,0,2,2,1014,0.0,1.0,0.0,-0.0,0,0,2,0,1016,0,1.0,0.0,0
PF08688,PF08687:PF15737:PF16474:PF02208:PF09469,2,18,2,0,16,1000,0.11,0.98,1.0,0.33,1,1,1,0,1016,1.0,1.0,0.5,0.71
PF10761,PF00619:PF06479:PF05225:PF00530:PF09387,0,76,0,0,76,942,0.0,0.93,0,0,7,0,0,7,1011,0.0,0.99,0,0
PF15717,PF04988:PF16051:PF03344:PF14474:PF04359,0,10,0,0,10,1008,0.0,0.99,0,0,0,0,0,0,1018,0,1.0,0,0
PF04455,PF16653:PF05222:PF02233:PF12769:PF01262,3,23,1,2,22,993,0.04,0.98,0.33,0.11,9,1,2,8,1007,0.11,0.99,0.33,0.19
PF12061,PF05659:PF07725:PF00619:PF11835:PF12442,2,38,2,0,36,980,0.05,0.96,1.0,0.23,4,1,1,3,1013,0.25,1.0,0.5,0.35
PF09717,PF09285:PF01132:PF15671:PF15302:PF02757,1,7,0,1,7,1010,0.0,0.99,0.0,-0.0,0,0,1,0,1017,0,1.0,0.0,0
PF00243,PF01731:PF07258:PF10420:PF01078:PF13391,5,30,1,4,29,984,0.03,0.97,0.2,0.07,1,0,5,1,1012,0.0,0.99,0.0,-0.0
PF03097,PF13949:PF02185:PF12215:PF08688:PF14948,33,47,29,4,18,967,0.62,0.98,0.88,0.73,2,2,31,0,985,1.0,0.97,0.06,0.24
PF01249,PF09803:PF09966:PF06399:PF15938:PF00383,16,55,14,2,41,961,0.25,0.96,0.88,0.46,1,1,15,0,1002,1.0,0.99,0.06,0.25
PF12806,PF08028:PF12418:PF09317:PF06331:PF14749,3,21,3,0,18,997,0.14,0.98,1.0,0.37,3,3,0,0,1015,1.0,1.0,1.0,1.0
PF07661,PF04717:PF15529:PF05797:PF06355:PF01706,2,3,1,1,2,1014,0.33,1.0,0.5,0.41,0,0,2,0,1016,0,1.0,0.0,0
PF12400,PF01779:PF09340:PF09805:PF15998:PF10276,4,27,1,3,26,988,0.04,0.97,0.25,0.09,1,0,4,1,1013,0.0,1.0,0.0,-0.0
PF12779,PF04984:PF05662:PF11492:PF10554:PF15750,0,5,0,0,5,1013,0.0,1.0,0,0,0,0,0,0,1018,0,1.0,0,0
PF06975,PF11136:PF10079:PF03613:PF07209:PF07495,0,2,0,0,2,1016,0.0,1.0,0,0,0,0,0,0,1018,0,1.0,0,0
PF15659,PF16804:PF07353:PF08093:PF05962:PF17017,0,4,0,0,4,1014,0.0,1.0,0,0,0,0,0,0,1018,0,1.0,0,0
PF12359,PF12340:PF15927:PF13329:PF11935:PF10493,8,23,8,0,15,995,0.35,0.99,1.0,0.59,2,1,7,1,1009,0.5,0.99,0.12,0.25
PF01680,PF11779:PF06376:PF02284:PF04520:PF06658,7,12,1,6,11,1000,0.08,0.98,0.14,0.1,1,0,7,1,1010,0.0,0.99,0.0,-0.0
PF02495,PF11731:PF05929:PF04672:PF12156:PF03314,0,6,0,0,6,1012,0.0,0.99,0,0,0,0,0,0,1018,0,1.0,0,0
PF02321,PF01114:PF07014:PF15302:PF08444:PF15265,12,3,0,12,3,1003,0.0,0.99,0.0,-0.01,0,0,12,0,1006,0,0.99,0.0,0
PF11559,PF10506:PF15784:PF11577:PF15368:PF15066,7,8,0,7,8,1003,0.0,0.99,0.0,-0.01,0,0,7,0,1011,0,0.99,0.0,0
PF03610,PF13876:PF07391:PF01913:PF13657:PF14052,3,6,0,3,6,1009,0.0,0.99,0.0,-0.0,0,0,3,0,1015,0,1.0,0.0,0
PF02841,PF02263:PF04871:PF16013:PF09440:PF12631,12,37,12,0,25,981,0.32,0.98,1.0,0.56,5,3,9,2,1004,0.6,0.99,0.25,0.38
PF14160,PF15805:PF15622:PF02750:PF00165:PF04422,2,6,0,2,6,1010,0.0,0.99,0.0,-0.0,0,0,2,0,1016,0,1.0,0.0,0
PF10691,PF11861:PF01585:PF07780:PF09372:PF16553,1,71,1,0,70,947,0.01,0.93,1.0,0.11,6,1,0,5,1012,0.17,1.0,1.0,0.41
PF05028,PF10257:PF10309:PF04821:PF08123:PF11977,15,35,7,8,28,975,0.2,0.96,0.47,0.29,5,4,11,1,1002,0.8,0.99,0.27,0.46
PF12923,PF13865:PF08081:PF12220:PF12353:PF04098,14,33,6,8,27,977,0.18,0.97,0.43,0.26,2,2,12,0,1004,1.0,0.99,0.14,0.38
PF01314,PF15708:PF02503:PF06890:PF02413:PF07499,4,4,0,4,4,1010,0.0,0.99,0.0,-0.0,0,0,4,0,1014,0,1.0,0.0,0
PF11492,PF00915:PF04865:PF15150:PF15518:PF03930,1,2,1,0,1,1016,0.5,1.0,1.0,0.71,0,0,1,0,1017,0,1.0,0.0,0
PF13486,PF10974:PF07421:PF05857:PF08483:PF07195,0,2,0,0,2,1016,0.0,1.0,0,0,0,0,0,0,1018,0,1.0,0,0
PF01026,PF08619:PF05042:PF01238:PF01738:PF03328,21,42,12,9,30,967,0.29,0.96,0.57,0.39,5,5,16,0,997,1.0,0.98,0.24,0.48
PF14733,PF00847:PF12916:PF06779:PF11209:PF11580,2,26,1,1,25,991,0.04,0.97,0.5,0.13,0,0,2,0,1016,0,1.0,0.0,0
PF15179,PF15119:PF15325:PF02565:PF05857:PF04451,1,3,0,1,3,1014,0.0,1.0,0.0,-0.0,0,0,1,0,1017,0,1.0,0.0,0
PF07683,PF02492:PF02317:PF03454:PF08346:PF03453,12,44,11,1,33,973,0.25,0.97,0.92,0.47,3,2,10,1,1005,0.67,0.99,0.17,0.33
PF00606,PF13721:PF04559:PF03793:PF12603:PF08183,4,7,2,2,5,1009,0.29,0.99,0.5,0.37,0,0,4,0,1014,0,1.0,0.0,0
PF15959,PF02305:PF14564:PF04917:PF11751:PF08805,1,3,0,1,3,1014,0.0,1.0,0.0,-0.0,0,0,1,0,1017,0,1.0,0.0,0
PF01434,PF09336:PF12037:PF14363:PF14629:PF00004,38,159,38,0,121,859,0.24,0.88,1.0,0.46,5,5,33,0,980,1.0,0.97,0.13,0.36
PF09746,PF07217:PF10477:PF06886:PF06862:PF04087,9,24,2,7,22,987,0.08,0.97,0.22,0.12,0,0,9,0,1009,0,0.99,0.0,0
PF16952,PF12437:PF04909:PF03951:PF13511:PF16864,2,53,2,0,51,965,0.04,0.95,1.0,0.19,3,1,1,2,1014,0.33,1.0,0.5,0.41
PF16586,PF07409:PF10566:PF07157:PF13722:PF04984,0,0,0,0,0,1018,0,1.0,0,0,0,0,0,0,1018,0,1.0,0,0
PF02627,PF12311:PF11807:PF07110:PF03795:PF04199,17,37,6,11,31,970,0.16,0.96,0.35,0.22,9,4,13,5,996,0.44,0.98,0.24,0.32
PF09902,PF12719:PF01206:PF15354:PF10734:PF07531,0,19,0,0,19,999,0.0,0.98,0,0,0,0,0,0,1018,0,1.0,0,0
PF00620,PF00169:PF00611:PF00617:PF08916:PF09128,82,154,61,21,93,843,0.4,0.89,0.74,0.49,10,10,72,0,936,1.0,0.93,0.12,0.34
PF09439,PF02284:PF05047:PF01774:PF05995:PF05915,6,26,3,3,23,989,0.12,0.97,0.5,0.23,2,0,6,2,1010,0.0,0.99,0.0,-0.0
PF13228,PF05711:PF13698:PF07022:PF06131:PF06934,0,3,0,0,3,1015,0.0,1.0,0,0,0,0,0,0,1018,0,1.0,0,0
PF15693,PF15694:PF06881:PF07500:PF08711:PF01096,0,40,0,0,40,978,0.0,0.96,0,0,10,0,0,10,1008,0.0,0.99,0,0
PF04698,PF02318:PF08151:PF16056:PF08703:PF15625,3,18,3,0,15,1000,0.17,0.99,1.0,0.41,1,0,3,1,1014,0.0,1.0,0.0,-0.0
PF00833,PF04568:PF09111:PF06825:PF05512:PF03386,18,22,6,12,16,984,0.27,0.97,0.33,0.29,1,1,17,0,1000,1.0,0.98,0.06,0.23
PF06241,PF14764:PF06662:PF06427:PF15296:PF06964,1,30,1,0,29,988,0.03,0.97,1.0,0.18,2,1,0,1,1016,0.5,1.0,1.0,0.71
PF02666,PF12588:PF00648:PF01067:PF01735:PF13833,17,88,12,5,76,925,0.14,0.92,0.71,0.29,22,8,9,14,987,0.36,0.98,0.47,0.4
PF13471,PF12883:PF04335:PF04060:PF14685:PF04225,4,14,3,1,11,1003,0.21,0.99,0.75,0.4,2,2,2,0,1014,1.0,1.0,0.5,0.71
PF03880,PF03461:PF07652:PF10927:PF12137:PF08061,5,10,3,2,7,1006,0.3,0.99,0.6,0.42,1,1,4,0,1013,1.0,1.0,0.2,0.45
PF14487,PF10118:PF08437:PF07399:PF13471:PF06476,2,13,1,1,12,1004,0.08,0.99,0.5,0.19,0,0,2,0,1016,0,1.0,0.0,0
PF12148,PF16843:PF09055:PF12057:PF08511:PF05162,5,12,1,4,11,1002,0.08,0.99,0.2,0.12,1,1,4,0,1013,1.0,1.0,0.2,0.45
PF01086,PF08137:PF12023:PF08627:PF06376:PF04012,4,5,0,4,5,1009,0.0,0.99,0.0,-0.0,0,0,4,0,1014,0,1.0,0.0,0
PF00486,PF00196:PF04397:PF06580:PF02954:PF00158,10,23,8,2,15,993,0.35,0.98,0.8,0.52,5,4,6,1,1007,0.8,0.99,0.4,0.56
PF01312,PF17193:PF03244:PF06798:PF09669:PF02413,0,1,0,0,1,1017,0.0,1.0,0,0,0,0,0,0,1018,0,1.0,0,0
PF09814,PF09496:PF04921:PF08286:PF05890:PF14802,12,19,6,6,13,993,0.32,0.98,0.5,0.39,0,0,12,0,1006,0,0.99,0.0,0
PF15787,PF14844:PF06469:PF12657:PF12234:PF09453,11,39,9,2,30,977,0.23,0.97,0.82,0.42,2,1,10,1,1006,0.5,0.99,0.09,0.21
PF10468,PF10079:PF15117:PF14489:PF11057:PF11697,1,1,0,1,1,1016,0.0,1.0,0.0,-0.0,0,0,1,0,1017,0,1.0,0.0,0
PF08395,PF06151:PF05680:PF06477:PF02949:PF01177,25,56,16,9,40,953,0.29,0.95,0.64,0.41,0,0,25,0,993,0,0.98,0.0,0
PF06433,PF14850:PF02911:PF05708:PF13192:PF09330,3,20,2,1,18,997,0.1,0.98,0.67,0.25,1,1,2,0,1015,1.0,1.0,0.33,0.58
PF16313,PF03241:PF00700:PF13861:PF03706:PF05876,2,5,0,2,5,1011,0.0,0.99,0.0,-0.0,0,0,2,0,1016,0,1.0,0.0,0
PF06420,PF10330:PF11489:PF11255:PF12049:PF10104,1,10,0,1,10,1007,0.0,0.99,0.0,-0.0,0,0,1,0,1017,0,1.0,0.0,0
PF10116,PF06082:PF03090:PF11775:PF03406:PF08497,0,0,0,0,0,1018,0,1.0,0,0,0,0,0,0,1018,0,1.0,0,0
PF10999,PF05874:PF15553:PF03588:PF17078:PF08642,0,3,0,0,3,1015,0.0,1.0,0,0,0,0,0,0,1018,0,1.0,0,0
PF17107,PF17100:PF01048:PF17111:PF14420:PF17106,25,54,17,8,37,956,0.31,0.96,0.68,0.44,12,12,13,0,993,1.0,0.99,0.48,0.69
PF05251,PF03348:PF02652:PF07745:PF00148:PF08661,2,28,2,0,26,990,0.07,0.97,1.0,0.26,3,0,2,3,1013,0.0,1.0,0.0,-0.0
PF09757,PF08997:PF00850:PF12203:PF08157:PF11976,6,67,4,2,63,949,0.06,0.94,0.67,0.19,3,2,4,1,1011,0.67,1.0,0.33,0.47
PF10577,PF06484:PF14763:PF14761:PF14762:PF05593,6,8,1,5,7,1005,0.12,0.99,0.17,0.14,0,0,6,0,1012,0,0.99,0.0,0
PF03154,PF08674:PF01448:PF00135:PF01426:PF00320,7,124,6,1,118,893,0.05,0.88,0.86,0.19,11,5,2,6,1005,0.45,0.99,0.71,0.57
PF13305,PF15149:PF08150:PF14613:PF16977:PF16748,0,11,0,0,11,1007,0.0,0.99,0,0,1,0,0,1,1017,0.0,1.0,0,0
PF16915,PF05837:PF13096:PF07502:PF14107:PF14586,1,3,1,0,2,1015,0.33,1.0,1.0,0.58,0,0,1,0,1017,0,1.0,0.0,0
PF00720,PF12686:PF15748:PF07960:PF08021:PF06681,1,2,0,1,2,1015,0.0,1.0,0.0,-0.0,0,0,1,0,1017,0,1.0,0.0,0
PF02664,PF07906:PF03835:PF07915:PF01841:PF02197,2,55,0,2,55,961,0.0,0.94,0.0,-0.01,6,0,2,6,1010,0.0,0.99,0.0,-0.0
PF07776,PF05485:PF12017:PF15423:PF10392:PF08161,50,70,21,29,49,919,0.3,0.92,0.42,0.32,4,4,46,0,968,1.0,0.95,0.08,0.28
PF03501,PF00159:PF07106:PF04667:PF16906:PF00831,7,28,5,2,23,988,0.18,0.98,0.71,0.35,2,2,5,0,1011,1.0,1.0,0.29,0.53
PF13475,PF03516:PF08332:PF02420:PF07213:PF10578,11,11,3,8,8,999,0.27,0.98,0.27,0.26,0,0,11,0,1007,0,0.99,0.0,0
PF04385,PF03302:PF12881:PF02420:PF06671:PF15779,3,7,0,3,7,1008,0.0,0.99,0.0,-0.0,0,0,3,0,1015,0,1.0,0.0,0
PF09235,PF16517:PF15000:PF16117:PF13548:PF03729,1,10,1,0,9,1008,0.1,0.99,1.0,0.31,0,0,1,0,1017,0,1.0,0.0,0
PF11249,PF14092:PF00160:PF06201:PF01798:PF04641,0,101,0,0,101,917,0.0,0.9,0,0,7,0,0,7,1011,0.0,0.99,0,0
PF06957,PF11816:PF04053:PF04192:PF08324:PF15512,11,46,11,0,35,972,0.24,0.97,1.0,0.48,4,3,8,1,1006,0.75,0.99,0.27,0.45
PF02088,PF00010:PF01508:PF01579:PF02664:PF14402,0,102,0,0,102,916,0.0,0.9,0,0,1,0,0,1,1017,0.0,1.0,0,0
PF11028,PF15627:PF10395:PF13320:PF08216:PF14649,1,11,0,1,11,1006,0.0,0.99,0.0,-0.0,0,0,1,0,1017,0,1.0,0.0,0
PF05845,PF03471:PF05772:PF12413:PF15949:PF11569,0,11,0,0,11,1007,0.0,0.99,0,0,0,0,0,0,1018,0,1.0,0,0
PF08479,PF01514:PF04865:PF15518:PF04552:PF14841,0,3,0,0,3,1015,0.0,1.0,0,0,0,0,0,0,1018,0,1.0,0,0
PF02514,PF11965:PF14763:PF06746:PF14761:PF14762,1,4,1,0,3,1014,0.25,1.0,1.0,0.5,0,0,1,0,1017,0,1.0,0.0,0
PF10551,PF04434:PF03101:PF03108:PF10536:PF10532,56,52,32,24,20,942,0.62,0.96,0.57,0.57,10,10,46,0,962,1.0,0.95,0.18,0.41
PF15674,PF02924:PF06074:PF04993:PF04354:PF04717,3,1,0,3,1,1014,0.0,1.0,0.0,-0.0,0,0,3,0,1015,0,1.0,0.0,0
PF08434,PF15300:PF03839:PF13519:PF16754:PF05586,9,38,3,6,35,974,0.08,0.96,0.33,0.15,1,0,9,1,1008,0.0,0.99,0.0,-0.0
PF08081,PF12220:PF12196:PF08143:PF15519:PF12353,1,27,1,0,26,991,0.04,0.97,1.0,0.19,2,1,0,1,1016,0.5,1.0,1.0,0.71
PF06087,PF10283:PF08797:PF10228:PF16203:PF08774,22,42,14,8,28,968,0.33,0.96,0.64,0.44,6,5,17,1,995,0.83,0.98,0.23,0.43
PF07654,PF07686:PF00129:PF08205:PF13895:PF00047,16,81,12,4,69,933,0.15,0.93,0.75,0.31,21,8,8,13,989,0.38,0.98,0.5,0.43
PF07072,PF01467:PF01121:PF15360:PF16825:PF04339,2,45,2,0,43,973,0.04,0.96,1.0,0.21,0,0,2,0,1016,0,1.0,0.0,0
PF11489,PF06420:PF10330:PF04090:PF10104:PF08508,0,13,0,0,13,1005,0.0,0.99,0,0,0,0,0,0,1018,0,1.0,0,0
PF02925,PF13639:PF00544:PF00097:PF07734:PF00642,0,186,0,0,186,832,0.0,0.82,0,0,35,0,0,35,983,0.0,0.97,0,0
PF00792,PF00613:PF02192:PF00794:PF00454:PF02260,24,67,24,0,43,951,0.36,0.96,1.0,0.59,23,21,3,2,992,0.91,1.0,0.88,0.89
PF12118,PF08808:PF02530:PF03592:PF09498:PF17206,1,2,0,1,2,1015,0.0,1.0,0.0,-0.0,0,0,1,0,1017,0,1.0,0.0,0
PF08924,PF15225:PF13406:PF02638:PF03734:PF17007,0,9,0,0,9,1009,0.0,0.99,0,0,0,0,0,0,1018,0,1.0,0,0
PF03109,PF00144:PF01636:PF09797:PF01764:PF10179,42,123,33,9,90,886,0.27,0.9,0.79,0.42,18,14,28,4,972,0.78,0.97,0.33,0.5
PF02543,PF12241:PF01580:PF09327:PF14882:PF06070,3,7,1,2,6,1009,0.14,0.99,0.33,0.21,0,0,3,0,1015,0,1.0,0.0,0
PF03057,PF05287:PF09775:PF03640:PF17223:PF00263,3,4,0,3,4,1011,0.0,0.99,0.0,-0.0,0,0,3,0,1015,0,1.0,0.0,0
PF02245,PF14473:PF00214:PF00236:PF06541:PF00727,4,5,0,4,5,1009,0.0,0.99,0.0,-0.0,0,0,4,0,1014,0,1.0,0.0,0
PF16063,PF15391:PF01666:PF04988:PF03749:PF15344,1,8,1,0,7,1010,0.12,0.99,1.0,0.35,0,0,1,0,1017,0,1.0,0.0,0
PF14954,PF14935:PF02285:PF02372:PF04901:PF05361,2,12,1,1,11,1005,0.08,0.99,0.5,0.2,0,0,2,0,1016,0,1.0,0.0,0
PF03306,PF15703:PF17085:PF10856:PF00548:PF08411,6,13,0,6,13,999,0.0,0.98,0.0,-0.01,0,0,6,0,1012,0,0.99,0.0,0
PF08439,PF06719:PF13280:PF09179:PF01432:PF14509,1,29,1,0,28,989,0.03,0.97,1.0,0.18,0,0,1,0,1017,0,1.0,0.0,0
PF10908,PF10566:PF08497:PF02465:PF13722:PF06798,0,0,0,0,0,1018,0,1.0,0,0,0,0,0,0,1018,0,1.0,0,0
PF09687,PF10332:PF15247:PF11735:PF10159:PF13002,0,27,0,0,27,991,0.0,0.97,0,0,1,0,0,1,1017,0.0,1.0,0,0
PF11873,PF04466:PF01514:PF03592:PF11794:PF15153,0,0,0,0,0,1018,0,1.0,0,0,0,0,0,0,1018,0,1.0,0,0
PF00106,PF15011:PF01575:PF02036:PF00107:PF04930,187,114,71,116,43,788,0.62,0.84,0.38,0.4,15,15,172,0,831,1.0,0.83,0.08,0.26
PF15973,PF03103:PF05428:PF10542:PF09991:PF00877,0,10,0,0,10,1008,0.0,0.99,0,0,0,0,0,0,1018,0,1.0,0,0
PF03167,PF15342:PF09282:PF13864:PF08316:PF04090,21,17,6,15,11,986,0.35,0.97,0.29,0.3,0,0,21,0,997,0,0.98,0.0,0
PF10755,PF15085:PF15097:PF15186:PF03548:PF07327,0,8,0,0,8,1010,0.0,0.99,0,0,0,0,0,0,1018,0,1.0,0,0
PF16574,PF16830:PF11577:PF12297:PF10650:PF04423,2,10,1,1,9,1007,0.1,0.99,0.5,0.22,0,0,2,0,1016,0,1.0,0.0,0
PF01372,PF08110:PF08023:PF16048:PF08248:PF08018,1,0,0,1,0,1017,0,1.0,0.0,0,0,0,1,0,1017,0,1.0,0.0,0
PF16541,PF01097:PF05039:PF02488:PF06446:PF15359,2,5,1,1,4,1012,0.2,1.0,0.5,0.31,0,0,2,0,1016,0,1.0,0.0,0
PF01821,PF07677:PF07703:PF01835:PF10569:PF07678,6,17,6,0,11,1001,0.35,0.99,1.0,0.59,12,6,0,6,1006,0.5,0.99,1.0,0.71
PF09087,PF10438:PF05400:PF06024:PF11941:PF09154,1,3,1,0,2,1015,0.33,1.0,1.0,0.58,1,1,0,0,1017,1.0,1.0,1.0,1.0
PF15443,PF15460:PF05874:PF15553:PF08848:PF15379,1,2,0,1,2,1015,0.0,1.0,0.0,-0.0,0,0,1,0,1017,0,1.0,0.0,0
PF16156,PF13780:PF14690:PF11019:PF01330:PF04738,1,2,0,1,2,1015,0.0,1.0,0.0,-0.0,0,0,1,0,1017,0,1.0,0.0,0
PF06258,PF15699:PF06521:PF17032:PF16089:PF15071,4,1,0,4,1,1013,0.0,1.0,0.0,-0.0,0,0,4,0,1014,0,1.0,0.0,0
PF14969,PF15062:PF13270:PF03692:PF11016:PF15972,3,4,1,2,3,1012,0.25,1.0,0.33,0.29,0,0,3,0,1015,0,1.0,0.0,0
PF01245,PF03195:PF11911:PF12298:PF02325:PF05678,11,19,5,6,14,993,0.26,0.98,0.45,0.34,2,2,9,0,1007,1.0,0.99,0.18,0.42
PF13625,PF16203:PF09416:PF04313:PF16739:PF12008,11,26,11,0,15,992,0.42,0.99,1.0,0.65,5,5,6,0,1007,1.0,0.99,0.45,0.67
PF14359,PF03831:PF11751:PF04717:PF03241:PF10995,0,0,0,0,0,1018,0,1.0,0,0,0,0,0,0,1018,0,1.0,0,0
PF15871,PF17045:PF12632:PF14197:PF11496:PF11500,1,17,0,1,17,1000,0.0,0.98,0.0,-0.0,0,0,1,0,1017,0,1.0,0.0,0
PF00272,PF01716:PF00321:PF04901:PF14935:PF05039,0,5,0,0,5,1013,0.0,1.0,0,0,0,0,0,0,1018,0,1.0,0,0
PF04693,PF14862:PF15224:PF05448:PF15633:PF01752,0,4,0,0,4,1014,0.0,1.0,0,0,0,0,0,0,1018,0,1.0,0,0
PF07412,PF10276:PF07939:PF04949:PF09366:PF09419,5,25,2,3,23,990,0.08,0.97,0.4,0.17,0,0,5,0,1013,0,1.0,0.0,0
PF05403,PF03973:PF12238:PF06951:PF00272:PF00103,0,14,0,0,14,1004,0.0,0.99,0,0,0,0,0,0,1018,0,1.0,0,0
PF05047,PF02284:PF00210:PF04176:PF01625:PF05995,10,39,6,4,33,975,0.15,0.96,0.6,0.29,6,3,7,3,1005,0.5,0.99,0.3,0.38
PF08545,PF08392:PF02504:PF00195:PF01817:PF08541,3,34,3,0,31,984,0.09,0.97,1.0,0.29,4,3,0,1,1014,0.75,1.0,1.0,0.87
PF10573,PF03713:PF15169:PF11584:PF07486:PF13463,3,3,0,3,3,1012,0.0,0.99,0.0,-0.0,0,0,3,0,1015,0,1.0,0.0,0
PF10280,PF01279:PF10775:PF02044:PF14774:PF05676,6,13,0,6,13,999,0.0,0.98,0.0,-0.01,0,0,6,0,1012,0,0.99,0.0,0
PF12821,PF14231:PF14232:PF06738:PF14307:PF00577,0,9,0,0,9,1009,0.0,0.99,0,0,0,0,0,0,1018,0,1.0,0,0
PF00565,PF00567:PF16093:PF01055:PF05827:PF05195,16,73,9,7,64,938,0.12,0.93,0.56,0.24,6,4,12,2,1000,0.67,0.99,0.25,0.4
PF13453,PF06666:PF05621:PF11325:PF02621:PF03065,3,1,0,3,1,1014,0.0,1.0,0.0,-0.0,0,0,3,0,1015,0,1.0,0.0,0
PF07804,PF08404:PF17006:PF07494:PF06070:PF10411,1,2,0,1,2,1015,0.0,1.0,0.0,-0.0,0,0,1,0,1017,0,1.0,0.0,0
PF11816,PF15512:PF13271:PF09453:PF13925:PF04192,16,26,7,9,19,983,0.27,0.97,0.44,0.33,3,3,13,0,1002,1.0,0.99,0.19,0.43
PF14303,PF09756:PF02234:PF08265:PF05678:PF15998,32,33,9,23,24,962,0.27,0.95,0.28,0.25,3,2,30,1,985,0.67,0.97,0.06,0.2
PF03971,PF07805:PF08497:PF10139:PF09498:PF03406,1,1,0,1,1,1016,0.0,1.0,0.0,-0.0,0,0,1,0,1017,0,1.0,0.0,0
PF08417,PF04305:PF00848:PF08802:PF07992:PF00355,9,102,7,2,95,914,0.07,0.9,0.78,0.21,15,3,6,12,997,0.2,0.98,0.33,0.25
PF15182,PF15680:PF13094:PF09962:PF15856:PF05151,0,3,0,0,3,1015,0.0,1.0,0,0,0,0,0,0,1018,0,1.0,0,0
PF10077,PF14983:PF04350:PF13746:PF08345:PF12241,4,8,2,2,6,1008,0.25,0.99,0.5,0.35,0,0,4,0,1014,0,1.0,0.0,0
PF01578,PF00421:PF00253:PF00223:PF00124:PF00499,4,33,4,0,29,985,0.12,0.97,1.0,0.34,1,0,4,1,1013,0.0,1.0,0.0,-0.0
PF04712,PF04064:PF03074:PF06534:PF04063:PF04615,4,23,2,2,21,993,0.09,0.98,0.5,0.2,1,0,4,1,1013,0.0,1.0,0.0,-0.0
PF04413,PF15924:PF12038:PF13439:PF13579:PF13477,1,29,1,0,28,989,0.03,0.97,1.0,0.18,0,0,1,0,1017,0,1.0,0.0,0
PF08266,PF08758:PF01458:PF06414:PF05652:PF10436,5,34,4,1,30,983,0.12,0.97,0.8,0.3,2,1,4,1,1012,0.5,1.0,0.2,0.31
PF03764,PF14492:PF00679:PF16004:PF06421:PF08364,23,60,23,0,37,958,0.38,0.96,1.0,0.61,14,12,11,2,993,0.86,0.99,0.52,0.66
PF02016,PF08744:PF00669:PF15032:PF08707:PF15681,6,5,0,6,5,1007,0.0,0.99,0.0,-0.01,0,0,6,0,1012,0,0.99,0.0,0
PF15833,PF10412:PF08398:PF11593:PF06805:PF03739,1,8,0,1,8,1009,0.0,0.99,0.0,-0.0,0,0,1,0,1017,0,1.0,0.0,0
PF02957,PF04472:PF02611:PF13875:PF15873:PF14099,0,4,0,0,4,1014,0.0,1.0,0,0,0,0,0,0,1018,0,1.0,0,0
PF01676,PF06415:PF10143:PF04987:PF06094:PF08544,15,56,14,1,42,961,0.25,0.96,0.93,0.47,6,6,9,0,1003,1.0,0.99,0.4,0.63
PF07811,PF03470:PF12316:PF01843:PF13676:PF15602,0,45,0,0,45,973,0.0,0.96,0,0,2,0,0,2,1016,0.0,1.0,0,0
PF02622,PF12428:PF07260:PF11945:PF05548:PF15369,8,12,3,5,9,1001,0.25,0.99,0.38,0.3,0,0,8,0,1010,0,0.99,0.0,0
PF00325,PF10137:PF15666:PF13545:PF02551:PF04471,1,5,1,0,4,1013,0.2,1.0,1.0,0.45,0,0,1,0,1017,0,1.0,0.0,0
PF02939,PF01975:PF03133:PF03718:PF01406:PF09204,13,52,9,4,43,962,0.17,0.95,0.69,0.33,1,1,12,0,1005,1.0,0.99,0.08,0.28
PF15826,PF03406:PF08497:PF12856:PF07157:PF14258,0,1,0,0,1,1017,0.0,1.0,0,0,0,0,0,0,1018,0,1.0,0,0
PF07837,PF04961:PF02971:PF14687:PF14920:PF14919,7,11,4,3,7,1004,0.36,0.99,0.57,0.45,1,1,6,0,1011,1.0,0.99,0.14,0.38
PF14437,PF10175:PF00313:PF08922:PF02337:PF07962,6,44,4,2,40,972,0.09,0.96,0.67,0.24,2,0,6,2,1010,0.0,0.99,0.0,-0.0
PF16176,PF12598:PF11078:PF00907:PF09354:PF08430,4,21,4,0,17,997,0.19,0.98,1.0,0.43,2,1,3,1,1013,0.5,1.0,0.25,0.35
PF04115,PF03561:PF13411:PF05432:PF02132:PF07789,11,12,6,5,6,1001,0.5,0.99,0.55,0.52,0,0,11,0,1007,0,0.99,0.0,0
PF02232,PF05167:PF04868:PF03244:PF16654:PF02211,1,6,0,1,6,1011,0.0,0.99,0.0,-0.0,0,0,1,0,1017,0,1.0,0.0,0
PF00673,PF00281:PF13259:PF11937:PF16122:PF00959,23,37,19,4,18,977,0.51,0.98,0.83,0.64,4,3,20,1,994,0.75,0.98,0.13,0.31
PF10179,PF06414:PF05334:PF12576:PF04516:PF10672,3,23,0,3,23,992,0.0,0.97,0.0,-0.01,0,0,3,0,1015,0,1.0,0.0,0
PF16921,PF09371:PF08529:PF14878:PF14633:PF00575,3,37,3,0,34,981,0.08,0.97,1.0,0.28,11,2,1,9,1006,0.18,0.99,0.67,0.34
PF14379,PF16495:PF16772:PF08558:PF00249:PF16498,7,91,5,2,86,925,0.05,0.91,0.71,0.18,7,1,6,6,1005,0.14,0.99,0.14,0.14
PF07927,PF08453:PF04559:PF03241:PF03043:PF03865,2,2,0,2,2,1014,0.0,1.0,0.0,-0.0,0,0,2,0,1016,0,1.0,0.0,0
PF01055,PF13802:PF16863:PF00088:PF17137:PF03423,38,37,29,9,8,972,0.78,0.98,0.76,0.76,9,9,29,0,980,1.0,0.97,0.24,0.48
PF04612,PF11612:PF01580:PF10566:PF08461:PF12615,1,6,1,0,5,1012,0.17,1.0,1.0,0.41,0,0,1,0,1017,0,1.0,0.0,0
PF12795,PF10473:PF10979:PF02108:PF15821:PF17020,4,5,0,4,5,1009,0.0,0.99,0.0,-0.0,0,0,4,0,1014,0,1.0,0.0,0
PF06462,PF06398:PF00337:PF06816:PF01558:PF01855,8,44,3,5,41,969,0.07,0.95,0.38,0.15,6,2,6,4,1006,0.33,0.99,0.25,0.28
PF11369,PF17084:PF11638:PF06890:PF15518:PF01706,0,3,0,0,3,1015,0.0,1.0,0,0,0,0,0,0,1018,0,1.0,0,0
PF08784,PF09170:PF02938:PF10451:PF09924:PF16900,14,23,7,7,16,988,0.3,0.98,0.5,0.38,2,2,12,0,1004,1.0,0.99,0.14,0.38
PF08687,PF08688:PF15737:PF02208:PF16474:PF11261,4,20,2,2,18,996,0.1,0.98,0.5,0.22,1,1,3,0,1014,1.0,1.0,0.25,0.5
PF06297,PF12315:PF04487:PF12371:PF12478:PF15936,6,18,2,4,16,996,0.11,0.98,0.33,0.18,2,2,4,0,1012,1.0,1.0,0.33,0.58
PF04029,PF08795:PF15775:PF06890:PF02601:PF11214,2,2,0,2,2,1014,0.0,1.0,0.0,-0.0,0,0,2,0,1016,0,1.0,0.0,0
PF08281,PF04539:PF04545:PF00140:PF03979:PF04542,5,28,4,1,24,989,0.14,0.98,0.8,0.33,12,3,2,9,1004,0.25,0.99,0.6,0.38
PF05843,PF08492:PF16669:PF02184:PF01755:PF14441,24,28,6,18,22,972,0.21,0.96,0.25,0.21,1,1,23,0,994,1.0,0.98,0.04,0.2
PF09260,PF16028:PF16657:PF09154:PF11941:PF02806,5,21,3,2,18,995,0.14,0.98,0.6,0.29,1,1,4,0,1013,1.0,1.0,0.2,0.45
PF14600,PF07382:PF06483:PF02719:PF15727:PF09669,0,7,0,0,7,1011,0.0,0.99,0,0,0,0,0,0,1018,0,1.0,0,0
PF03485,PF05746:PF00750:PF14510:PF02687:PF17167,17,45,15,2,30,971,0.33,0.97,0.88,0.53,9,7,10,2,999,0.78,0.99,0.41,0.56
PF08886,PF14842:PF04740:PF01136:PF13780:PF01706,0,2,0,0,2,1016,0.0,1.0,0,0,0,0,0,0,1018,0,1.0,0,0
PF10445,PF15776:PF06890:PF15708:PF15185:PF05167,1,5,0,1,5,1012,0.0,0.99,0.0,-0.0,0,0,1,0,1017,0,1.0,0.0,0
PF08558,PF07988:PF16772:PF14379:PF16495:PF01448,4,30,2,2,28,986,0.07,0.97,0.5,0.17,2,0,4,2,1012,0.0,0.99,0.0,-0.0
PF01839,PF08441:PF00882:PF01788:PF00357:PF08473,19,18,17,2,1,998,0.94,1.0,0.89,0.92,2,2,17,0,999,1.0,0.98,0.11,0.32
PF12224,PF16091:PF15759:PF05677:PF12829:PF14040,9,2,0,9,2,1007,0.0,0.99,0.0,-0.0,0,0,9,0,1009,0,0.99,0.0,0
PF09468,PF07106:PF05676:PF14774:PF09777:PF06388,9,18,4,5,14,995,0.22,0.98,0.44,0.31,1,1,8,0,1009,1.0,0.99,0.11,0.33
PF00494,PF00828:PF11833:PF01789:PF04979:PF09335,34,60,20,14,40,944,0.33,0.95,0.59,0.42,5,4,30,1,983,0.8,0.97,0.12,0.3
PF10749,PF04917:PF11751:PF07409:PF17007:PF04738,0,1,0,0,1,1017,0.0,1.0,0,0,0,0,0,0,1018,0,1.0,0,0
PF14606,PF14607:PF07494:PF06744:PF04351:PF13205,2,4,0,2,4,1012,0.0,0.99,0.0,-0.0,0,0,2,0,1016,0,1.0,0.0,0
PF04626,PF14539:PF05962:PF08291:PF08093:PF12192,1,2,0,1,2,1015,0.0,1.0,0.0,-0.0,0,0,1,0,1017,0,1.0,0.0,0
PF07715,PF06937:PF03929:PF15769:PF15345:PF00593,7,7,4,3,3,1008,0.57,0.99,0.57,0.57,0,0,7,0,1011,0,0.99,0.0,0
PF08174,PF08916:PF16018:PF02174:PF05527:PF16528,7,34,4,3,30,981,0.12,0.97,0.57,0.25,2,2,5,0,1011,1.0,1.0,0.29,0.53
PF01794,PF08022:PF08030:PF03807:PF08414:PF03098,41,70,40,1,30,947,0.57,0.97,0.98,0.73,19,17,24,2,975,0.89,0.97,0.41,0.6
PF13644,PF12477:PF10995:PF04671:PF02554:PF12081,1,1,0,1,1,1016,0.0,1.0,0.0,-0.0,0,0,1,0,1017,0,1.0,0.0,0
PF12437,PF16952:PF03951:PF04909:PF16864:PF09164,2,51,2,0,49,967,0.04,0.95,1.0,0.19,2,1,1,1,1015,0.5,1.0,0.5,0.5
PF16853,PF04349:PF07833:PF13421:PF14842:PF16967,1,6,0,1,6,1011,0.0,0.99,0.0,-0.0,0,0,1,0,1017,0,1.0,0.0,0
PF05096,PF04107:PF04452:PF10693:PF07466:PF11703,3,9,0,3,9,1006,0.0,0.99,0.0,-0.01,0,0,3,0,1015,0,1.0,0.0,0
PF11923,PF03159:PF01107:PF02337:PF14893:PF04697,10,26,4,6,22,986,0.15,0.97,0.4,0.24,2,2,8,0,1008,1.0,0.99,0.2,0.45
PF07472,PF17025:PF13371:PF01801:PF09707:PF14402,0,1,0,0,1,1017,0.0,1.0,0,0,0,0,0,0,1018,0,1.0,0,0
PF14041,PF05028:PF07295:PF02788:PF00328:PF00111,0,81,0,0,81,937,0.0,0.92,0,0,4,0,0,4,1014,0.0,1.0,0,0
PF12934,PF12933:PF05683:PF14920:PF14918:PF02971,0,9,0,0,9,1009,0.0,0.99,0,0,0,0,0,0,1018,0,1.0,0,0
PF11422,PF14607:PF11614:PF04122:PF07218:PF06429,0,6,0,0,6,1012,0.0,0.99,0,0,0,0,0,0,1018,0,1.0,0,0
PF12608,PF14317:PF10084:PF01107:PF10962:PF03097,0,37,0,0,37,981,0.0,0.96,0,0,0,0,0,0,1018,0,1.0,0,0
PF13887,PF13888:PF13884:PF05224:PF16099:PF07217,6,21,6,0,15,997,0.29,0.99,1.0,0.53,6,6,0,0,1012,1.0,1.0,1.0,1.0
PF07152,PF01588:PF00579:PF00498:PF08116:PF11066,0,114,0,0,114,904,0.0,0.89,0,0,9,0,0,9,1009,0.0,0.99,0,0
PF10557,PF00888:PF08672:PF03256:PF11515:PF10559,28,52,28,0,24,966,0.54,0.98,1.0,0.72,9,8,20,1,989,0.89,0.98,0.29,0.5
PF13700,PF02217:PF01752:PF04349:PF03428:PF03922,1,5,1,0,4,1013,0.2,1.0,1.0,0.45,0,0,1,0,1017,0,1.0,0.0,0
PF10455,PF10224:PF09424:PF02284:PF03980:PF06108,3,24,0,3,24,991,0.0,0.97,0.0,-0.01,0,0,3,0,1015,0,1.0,0.0,0
PF12269,PF16737:PF03172:PF12165:PF14061:PF02008,6,23,5,1,18,994,0.22,0.98,0.83,0.42,3,2,4,1,1011,0.67,1.0,0.33,0.47
PF06080,PF05811:PF14713:PF01158:PF15710:PF10166,10,15,2,8,13,995,0.13,0.98,0.2,0.15,0,0,10,0,1008,0,0.99,0.0,0
PF07223,PF12049:PF10330:PF10571:PF04090:PF06420,1,4,0,1,4,1013,0.0,1.0,0.0,-0.0,0,0,1,0,1017,0,1.0,0.0,0
PF08914,PF11626:PF06732:PF09197:PF16727:PF08605,14,15,8,6,7,997,0.53,0.99,0.57,0.55,0,0,14,0,1004,0,0.99,0.0,0
PF08084,PF12134:PF08083:PF10596:PF08082:PF10597,13,18,13,0,5,1000,0.72,1.0,1.0,0.85,15,13,0,2,1003,0.87,1.0,1.0,0.93
PF00030,PF03762:PF15048:PF10044:PF10596:PF14517,18,23,5,13,18,982,0.22,0.97,0.28,0.23,0,0,18,0,1000,0,0.98,0.0,0
PF06993,PF12467:PF06834:PF11751:PF11026:PF06805,0,5,0,0,5,1013,0.0,1.0,0,0,0,0,0,0,1018,0,1.0,0,0
PF00676,PF02779:PF02780:PF16078:PF16870:PF08213,35,47,21,14,26,957,0.45,0.96,0.6,0.5,10,9,26,1,982,0.9,0.97,0.26,0.47
PF01115,PF09749:PF06658:PF02284:PF01997:PF01774,6,24,6,0,18,994,0.25,0.98,1.0,0.5,1,1,5,0,1012,1.0,1.0,0.17,0.41
PF15255,PF05041:PF11331:PF15923:PF14611:PF11261,0,21,0,0,21,997,0.0,0.98,0,0,0,0,0,0,1018,0,1.0,0,0
PF15744,PF03823:PF15829:PF15839:PF15576:PF02202,0,5,0,0,5,1013,0.0,1.0,0,0,0,0,0,0,1018,0,1.0,0,0
PF02891,PF02037:PF14443:PF14611:PF15280:PF12998,13,73,9,4,64,941,0.12,0.93,0.69,0.27,4,3,10,1,1004,0.75,0.99,0.23,0.41
PF12646,PF06695:PF11016:PF04359:PF10063:PF15443,0,5,0,0,5,1013,0.0,1.0,0,0,0,0,0,0,1018,0,1.0,0,0
PF01951,PF09174:PF15054:PF10574:PF02559:PF05162,4,13,3,1,10,1004,0.23,0.99,0.75,0.41,0,0,4,0,1014,0,1.0,0.0,0
PF00736,PF10587:PF14768:PF14766:PF04921:PF05542,28,30,20,8,10,980,0.67,0.98,0.71,0.68,1,1,27,0,990,1.0,0.97,0.04,0.19
PF12695,PF15743:PF01057:PF08093:PF06493:PF15337,2,5,0,2,5,1011,0.0,0.99,0.0,-0.0,0,0,2,0,1016,0,1.0,0.0,0
PF05969,PF07405:PF08398:PF13013:PF15680:PF15333,0,2,0,0,2,1016,0.0,1.0,0,0,0,0,0,0,1018,0,1.0,0,0
PF08030,PF08022:PF01794:PF00036:PF03098:PF08414,51,78,44,7,34,933,0.56,0.96,0.86,0.68,21,20,31,1,966,0.95,0.97,0.39,0.6
PF15003,PF03760:PF03823:PF13564:PF08649:PF12304,1,12,0,1,12,1005,0.0,0.99,0.0,-0.0,1,0,1,1,1016,0.0,1.0,0.0,-0.0
PF09362,PF11790:PF02485:PF12529:PF03229:PF01822,10,59,7,3,52,956,0.12,0.95,0.7,0.27,4,1,9,3,1005,0.25,0.99,0.1,0.15
PF01396,PF01131:PF01751:PF13368:PF00521:PF16898,7,37,6,1,31,980,0.16,0.97,0.86,0.36,13,4,3,9,1002,0.31,0.99,0.57,0.41
PF09337,PF07245:PF13276:PF08284:PF12259:PF13976,14,74,9,5,65,939,0.12,0.93,0.64,0.26,6,5,9,1,1003,0.83,0.99,0.36,0.54
PF08097,PF17086:PF17023:PF04293:PF04180:PF03496,0,10,0,0,10,1008,0.0,0.99,0,0,0,0,0,0,1018,0,1.0,0,0
PF11766,PF15427:PF10279:PF05100:PF15395:PF14926,0,2,0,0,2,1016,0.0,1.0,0,0,0,0,0,0,1018,0,1.0,0,0
PF14607,PF13205:PF13746:PF13663:PF02107:PF07499,0,13,0,0,13,1005,0.0,0.99,0,0,0,0,0,0,1018,0,1.0,0,0
PF04628,PF00838:PF11991:PF15011:PF13187:PF05995,11,38,5,6,33,974,0.13,0.96,0.45,0.23,1,1,10,0,1007,1.0,0.99,0.09,0.3
PF00112,PF08246:PF08773:PF12131:PF08127:PF11705,60,39,34,26,5,953,0.87,0.97,0.57,0.69,2,2,58,0,958,1.0,0.94,0.03,0.18
PF08282,PF00689:PF12409:PF12515:PF02348:PF02130,22,71,15,7,56,940,0.21,0.94,0.68,0.36,5,3,19,2,994,0.6,0.98,0.14,0.28
PF17125,PF01029:PF01189:PF17126:PF09446:PF09354,10,35,10,0,25,983,0.29,0.98,1.0,0.53,2,2,8,0,1008,1.0,0.99,0.2,0.45
PF07946,PF02186:PF04939:PF04934:PF12049:PF07800,9,34,6,3,28,981,0.18,0.97,0.67,0.33,1,1,8,0,1009,1.0,0.99,0.11,0.33
PF13298,PF04090:PF11001:PF02631:PF10330:PF10361,8,10,4,4,6,1004,0.4,0.99,0.5,0.44,1,0,8,1,1009,0.0,0.99,0.0,-0.0
PF02893,PF16016:PF02141:PF06602:PF12335:PF03456,33,70,20,13,50,935,0.29,0.94,0.61,0.39,9,9,24,0,985,1.0,0.98,0.27,0.52
PF12139,PF12617:PF12800:PF11953:PF07685:PF12837,0,5,0,0,5,1013,0.0,1.0,0,0,0,0,0,0,1018,0,1.0,0,0
PF15861,PF13643:PF12220:PF11627:PF10378:PF12196,3,9,1,2,8,1007,0.11,0.99,0.33,0.19,1,1,2,0,1015,1.0,1.0,0.33,0.58
PF11595,PF15092:PF08041:PF08566:PF14087:PF17003,3,13,3,0,10,1005,0.23,0.99,1.0,0.48,3,3,0,0,1015,1.0,1.0,1.0,1.0
PF03664,PF00457:PF01083:PF01670:PF02015:PF02982,6,24,5,1,19,993,0.21,0.98,0.83,0.41,3,2,4,1,1011,0.67,1.0,0.33,0.47
PF17031,PF07413:PF12634:PF04801:PF00790:PF16717,0,47,0,0,47,971,0.0,0.95,0,0,1,0,0,1,1017,0.0,1.0,0,0
PF07914,PF16088:PF02958:PF10321:PF03997:PF01060,8,53,5,3,48,962,0.09,0.95,0.62,0.23,4,2,6,2,1008,0.5,0.99,0.25,0.35
PF17032,PF10868:PF12046:PF02427:PF07961:PF08576,0,3,0,0,3,1015,0.0,1.0,0,0,0,0,0,0,1018,0,1.0,0,0
PF11521,PF02002:PF08271:PF07741:PF16833:PF05422,2,25,2,0,23,993,0.08,0.98,1.0,0.28,2,0,2,2,1014,0.0,1.0,0.0,-0.0
PF01913,PF17006:PF05939:PF12477:PF03428:PF10566,1,0,0,1,0,1017,0,1.0,0.0,0,0,0,1,0,1017,0,1.0,0.0,0
PF07771,PF15370:PF15071:PF00214:PF15171:PF02372,0,6,0,0,6,1012,0.0,0.99,0,0,0,0,0,0,1018,0,1.0,0,0
PF13145,PF17193:PF08404:PF09614:PF07411:PF09677,7,0,0,7,0,1011,0,0.99,0.0,0,0,0,7,0,1011,0,0.99,0.0,0
PF07279,PF15302:PF17085:PF16576:PF09044:PF05658,1,3,0,1,3,1014,0.0,1.0,0.0,-0.0,0,0,1,0,1017,0,1.0,0.0,0
PF08429,PF02928:PF02375:PF01388:PF12269:PF12031,12,42,10,2,32,974,0.24,0.97,0.83,0.43,12,9,3,3,1003,0.75,0.99,0.75,0.75
PF02045,PF02234:PF05678:PF07939:PF15247:PF04367,6,22,5,1,17,995,0.23,0.98,0.83,0.43,2,2,4,0,1012,1.0,1.0,0.33,0.58
PF15285,PF04111:PF04422:PF04432:PF07800:PF14849,1,17,0,1,17,1000,0.0,0.98,0.0,-0.0,0,0,1,0,1017,0,1.0,0.0,0
PF11277,PF10479:PF10221:PF15489:PF00680:PF15782,7,26,4,3,22,989,0.15,0.98,0.57,0.29,1,1,6,0,1011,1.0,0.99,0.14,0.38
PF13739,PF08708:PF14690:PF03922:PF12302:PF12191,0,2,0,0,2,1016,0.0,1.0,0,0,0,0,0,0,1018,0,1.0,0,0
PF05444,PF15489:PF08925:PF07857:PF06448:PF09363,3,20,0,3,20,995,0.0,0.98,0.0,-0.01,2,0,3,2,1013,0.0,1.0,0.0,-0.0
PF08235,PF16876:PF04571:PF05029:PF04824:PF08166,11,24,11,0,13,994,0.46,0.99,1.0,0.67,2,2,9,0,1007,1.0,0.99,0.18,0.42
PF00055,PF06008:PF06009:PF02210:PF03723:PF01759,24,56,12,12,44,950,0.21,0.94,0.5,0.3,4,4,20,0,994,1.0,0.98,0.17,0.4
PF01375,PF12726:PF15030:PF11672:PF09967:PF06513,2,7,0,2,7,1009,0.0,0.99,0.0,-0.0,0,0,2,0,1016,0,1.0,0.0,0
PF07276,PF06753:PF10285:PF03991:PF03578:PF10284,0,1,0,0,1,1017,0.0,1.0,0,0,0,0,0,0,1018,0,1.0,0,0
PF06772,PF12224:PF08589:PF03576:PF05426:PF09398,7,21,1,6,20,991,0.05,0.97,0.14,0.07,0,0,7,0,1011,0,0.99,0.0,0
PF02428,PF15302:PF03842:PF14963:PF16829:PF04643,2,4,0,2,4,1012,0.0,0.99,0.0,-0.0,0,0,2,0,1016,0,1.0,0.0,0
PF05751,PF00855:PF07496:PF11467:PF16784:PF01490,0,88,0,0,88,930,0.0,0.91,0,0,12,0,0,12,1006,0.0,0.99,0,0
PF14249,PF00301:PF08137:PF07809:PF14159:PF11255,2,2,0,2,2,1014,0.0,1.0,0.0,-0.0,0,0,2,0,1016,0,1.0,0.0,0
PF02466,PF01192:PF01907:PF01157:PF01987:PF03501,29,30,13,16,17,972,0.43,0.97,0.45,0.42,3,3,26,0,989,1.0,0.97,0.1,0.32
PF03808,PF17049:PF04738:PF01514:PF15141:PF15776,0,3,0,0,3,1015,0.0,1.0,0,0,0,0,0,0,1018,0,1.0,0,0
PF00809,PF02607:PF02965:PF02574:PF02310:PF01642,13,19,7,6,12,993,0.37,0.98,0.54,0.44,6,5,8,1,1004,0.83,0.99,0.38,0.56
PF16312,PF12772:PF12567:PF12453:PF03673:PF09067,1,3,1,0,2,1015,0.33,1.0,1.0,0.58,1,1,0,0,1017,1.0,1.0,1.0,1.0
PF01612,PF00570:PF08066:PF01927:PF00476:PF14493,55,42,31,24,11,952,0.74,0.97,0.56,0.63,3,3,52,0,963,1.0,0.95,0.05,0.23
PF06337,PF14836:PF13446:PF14533:PF00443:PF02148,17,120,16,1,104,897,0.13,0.9,0.94,0.33,9,7,10,2,999,0.78,0.99,0.41,0.56
PF11977,PF05030:PF09736:PF14611:PF15996:PF08624,10,22,7,3,15,993,0.32,0.98,0.7,0.46,0,0,10,0,1008,0,0.99,0.0,0
PF00020,PF09034:PF01335:PF15734:PF00531:PF12721,23,44,16,7,28,967,0.36,0.97,0.7,0.49,5,3,20,2,993,0.6,0.98,0.13,0.27
PF10576,PF14815:PF07934:PF00633:PF02508:PF16174,3,24,3,0,21,994,0.12,0.98,1.0,0.35,1,1,2,0,1015,1.0,1.0,0.33,0.58
PF13336,PF02550:PF01273:PF01144:PF06974:PF03385,12,42,10,2,32,974,0.24,0.97,0.83,0.43,2,1,11,1,1005,0.5,0.99,0.08,0.2
PF05860,PF11245:PF03616:PF06798:PF03090:PF04740,0,1,0,0,1,1017,0.0,1.0,0,0,0,0,0,0,1018,0,1.0,0,0
PF02001,PF13739:PF07937:PF13011:PF12843:PF01943,0,0,0,0,0,1018,0,1.0,0,0,0,0,0,0,1018,0,1.0,0,0
PF09966,PF11907:PF13089:PF15830:PF03244:PF08681,1,2,1,0,1,1016,0.5,1.0,1.0,0.71,0,0,1,0,1017,0,1.0,0.0,0
PF01874,PF03592:PF02572:PF08479:PF11751:PF07016,2,2,1,1,1,1015,0.5,1.0,0.5,0.5,0,0,2,0,1016,0,1.0,0.0,0
PF08540,PF01154:PF08445:PF14784:PF03988:PF08444,17,29,17,0,12,989,0.59,0.99,1.0,0.76,0,0,17,0,1001,0,0.98,0.0,0
PF15095,PF06773:PF13588:PF06876:PF15325:PF16590,1,4,0,1,4,1013,0.0,1.0,0.0,-0.0,0,0,1,0,1017,0,1.0,0.0,0
PF17082,PF00170:PF00849:PF04101:PF10257:PF01545,1,92,0,1,92,925,0.0,0.91,0.0,-0.01,12,0,1,12,1005,0.0,0.99,0.0,-0.0
PF13185,PF16797:PF13281:PF03924:PF13188:PF00072,13,74,10,3,64,941,0.14,0.93,0.77,0.31,5,4,9,1,1004,0.8,0.99,0.31,0.49
PF01341,PF02015:PF03664:PF10503:PF00457:PF02156,8,24,5,3,19,991,0.21,0.98,0.62,0.35,3,2,6,1,1009,0.67,0.99,0.25,0.41
PF01117,PF07468:PF03318:PF02884:PF02278:PF09113,0,7,0,0,7,1011,0.0,0.99,0,0,0,0,0,0,1018,0,1.0,0,0
PF09739,PF08303:PF08302:PF07159:PF09511:PF05994,11,16,2,9,14,993,0.12,0.98,0.18,0.14,5,0,11,5,1002,0.0,0.98,0.0,-0.01
PF11198,PF04001:PF11738:PF08183:PF07610:PF07980,0,1,0,0,1,1017,0.0,1.0,0,0,0,0,0,0,1018,0,1.0,0,0
PF09762,PF17045:PF11577:PF11496:PF07989:PF05104,3,24,1,2,23,992,0.04,0.98,0.33,0.11,1,0,3,1,1014,0.0,1.0,0.0,-0.0
PF00562,PF04561:PF04563:PF04565:PF10385:PF06883,22,25,19,3,6,990,0.76,0.99,0.86,0.81,6,6,16,0,996,1.0,0.98,0.27,0.52
PF08605,PF01834:PF05397:PF03120:PF15624:PF06972,1,25,0,1,25,992,0.0,0.97,0.0,-0.0,1,0,1,1,1016,0.0,1.0,0.0,-0.0
PF16697,PF12479:PF03135:PF05228:PF11988:PF12477,3,6,1,2,5,1010,0.17,0.99,0.33,0.23,0,0,3,0,1015,0,1.0,0.0,0
PF06044,PF12299:PF12101:PF15153:PF10631:PF11074,2,0,0,2,0,1016,0,1.0,0.0,0,0,0,2,0,1016,0,1.0,0.0,0
PF01130,PF16969:PF05693:PF03096:PF15390:PF03896,23,29,9,14,20,975,0.31,0.97,0.39,0.33,2,2,21,0,995,1.0,0.98,0.09,0.29
PF02870,PF01267:PF01035:PF01548:PF11870:PF17054,4,26,4,0,22,992,0.15,0.98,1.0,0.39,2,0,4,2,1012,0.0,0.99,0.0,-0.0
PF08041,PF05419:PF12046:PF02427:PF17032:PF15550,4,0,0,4,0,1014,0,1.0,0.0,0,0,0,4,0,1014,0,1.0,0.0,0
PF13614,PF10407:PF15241:PF04417:PF08183:PF15082,14,5,0,14,5,999,0.0,0.98,0.0,-0.01,0,0,14,0,1004,0,0.99,0.0,0
PF09471,PF03601:PF15460:PF09715:PF09818:PF08848,2,2,0,2,2,1014,0.0,1.0,0.0,-0.0,0,0,2,0,1016,0,1.0,0.0,0
PF11770,PF10295:PF02211:PF13810:PF06724:PF11162,0,7,0,0,7,1011,0.0,0.99,0,0,0,0,0,0,1018,0,1.0,0,0
PF11936,PF16553:PF07684:PF15898:PF09372:PF11904,5,17,4,1,13,1000,0.24,0.99,0.8,0.43,1,1,4,0,1013,1.0,1.0,0.2,0.45
PF01882,PF08751:PF01913:PF05666:PF10566:PF12615,0,5,0,0,5,1013,0.0,1.0,0,0,0,0,0,0,1018,0,1.0,0,0
PF09989,PF06050:PF02056:PF09134:PF17192:PF05509,0,8,0,0,8,1010,0.0,0.99,0,0,0,0,0,0,1018,0,1.0,0,0
PF05920,PF00907:PF03790:PF15499:PF02701:PF15279,25,31,9,16,22,971,0.29,0.96,0.36,0.3,1,1,24,0,993,1.0,0.98,0.04,0.2
PF08169,PF12031:PF01388:PF02928:PF08429:PF12269,5,37,5,0,32,981,0.14,0.97,1.0,0.36,10,2,3,8,1005,0.2,0.99,0.4,0.28
PF07308,PF03090:PF06082:PF12081:PF06890:PF13722,0,0,0,0,0,1018,0,1.0,0,0,0,0,0,0,1018,0,1.0,0,0
PF16121,PF08071:PF00900:PF17136:PF01777:PF00467,14,37,14,0,23,981,0.38,0.98,1.0,0.61,8,7,7,1,1003,0.88,0.99,0.5,0.66
PF10644,PF14881:PF08221:PF08631:PF07555:PF11934,10,26,8,2,18,990,0.31,0.98,0.8,0.49,1,1,9,0,1008,1.0,0.99,0.1,0.31
PF13907,PF08074:PF15790:PF17218:PF06461:PF08073,14,15,6,8,9,995,0.4,0.98,0.43,0.41,11,5,9,6,998,0.45,0.99,0.36,0.4
PF09303,PF03185:PF14944:PF09049:PF09051:PF09050,2,11,2,0,9,1007,0.18,0.99,1.0,0.42,0,0,2,0,1016,0,1.0,0.0,0
PF10329,PF05704:PF08386:PF06441:PF13378:PF10022,4,52,2,2,50,964,0.04,0.95,0.5,0.13,5,1,3,4,1010,0.2,0.99,0.25,0.22
PF01784,PF09812:PF02284:PF05995:PF02114:PF05047,3,24,2,1,22,993,0.08,0.98,0.67,0.23,2,1,2,1,1014,0.5,1.0,0.33,0.41
PF10225,PF11282:PF11250:PF04765:PF04819:PF06814,9,27,2,7,25,984,0.07,0.97,0.22,0.12,1,0,9,1,1008,0.0,0.99,0.0,-0.0
PF01174,PF03102:PF09363:PF04775:PF03894:PF00674,3,7,0,3,7,1008,0.0,0.99,0.0,-0.0,0,0,3,0,1015,0,1.0,0.0,0
PF09481,PF15355:PF15662:PF02119:PF06082:PF12919,0,3,0,0,3,1015,0.0,1.0,0,0,0,0,0,0,1018,0,1.0,0,0
PF00500,PF15273:PF15258:PF16685:PF16682:PF04313,1,10,0,1,10,1007,0.0,0.99,0.0,-0.0,0,0,1,0,1017,0,1.0,0.0,0
PF09994,PF01018:PF08701:PF08153:PF05128:PF01926,17,71,10,7,61,940,0.14,0.93,0.59,0.27,3,3,14,0,1001,1.0,0.99,0.18,0.42
PF08918,PF02768:PF02203:PF05231:PF02767:PF12729,4,13,2,2,11,1003,0.15,0.99,0.5,0.27,0,0,4,0,1014,0,1.0,0.0,0
PF03608,PF03829:PF03612:PF08220:PF09677:PF10035,2,7,2,0,5,1011,0.29,1.0,1.0,0.53,2,2,0,0,1016,1.0,1.0,1.0,1.0
PF08412,PF13545:PF10137:PF16526:PF03520:PF03521,6,19,2,4,17,995,0.11,0.98,0.33,0.18,1,1,5,0,1012,1.0,1.0,0.17,0.41
PF04501,PF05489:PF07505:PF17164:PF02979:PF02654,1,6,0,1,6,1011,0.0,0.99,0.0,-0.0,0,0,1,0,1017,0,1.0,0.0,0
PF02685,PF05996:PF15011:PF04725:PF07823:PF14770,6,14,1,5,13,999,0.07,0.98,0.17,0.1,1,0,6,1,1011,0.0,0.99,0.0,-0.0
PF08456,PF02572:PF13995:PF05100:PF13722:PF07499,3,3,1,2,2,1013,0.33,1.0,0.33,0.33,0,0,3,0,1015,0,1.0,0.0,0
PF14999,PF05425:PF04355:PF17188:PF05857:PF15976,0,0,0,0,0,1018,0,1.0,0,0,0,0,0,0,1018,0,1.0,0,0
PF01287,PF11937:PF02560:PF00590:PF00444:PF01132,15,32,7,8,25,978,0.22,0.97,0.47,0.31,2,0,15,2,1001,0.0,0.98,0.0,-0.01
PF05222,PF12769:PF02233:PF04455:PF01262:PF16653,18,19,12,6,7,993,0.63,0.99,0.67,0.64,8,8,10,0,1000,1.0,0.99,0.44,0.66
PF02643,PF16903:PF05943:PF06745:PF02572:PF15976,0,3,0,0,3,1015,0.0,1.0,0,0,0,0,0,0,1018,0,1.0,0,0
PF15907,PF06342:PF15800:PF05719:PF16954:PF04790,0,12,0,0,12,1006,0.0,0.99,0,0,1,0,0,1,1017,0.0,1.0,0,0
PF15309,PF15392:PF09441:PF04357:PF15082:PF09322,3,4,0,3,4,1011,0.0,0.99,0.0,-0.0,0,0,3,0,1015,0,1.0,0.0,0
PF09917,PF12628:PF03525:PF02557:PF03090:PF10295,0,5,0,0,5,1013,0.0,1.0,0,0,0,0,0,0,1018,0,1.0,0,0
PF04061,PF14770:PF03652:PF05910:PF06376:PF09696,6,21,3,3,18,994,0.14,0.98,0.5,0.26,3,2,4,1,1011,0.67,1.0,0.33,0.47
PF08626,PF12739:PF00988:PF14222:PF14225:PF14228,12,27,5,7,22,984,0.19,0.97,0.42,0.27,7,3,9,4,1002,0.43,0.99,0.25,0.32
PF15633,PF15482:PF06681:PF17206:PF08093:PF06725,0,3,0,0,3,1015,0.0,1.0,0,0,0,0,0,0,1018,0,1.0,0,0
PF02951,PF15976:PF02955:PF06592:PF04865:PF06798,4,5,4,0,1,1013,0.8,1.0,1.0,0.89,0,0,4,0,1014,0,1.0,0.0,0
PF05822,PF00965:PF05719:PF15008:PF05434:PF04176,15,20,5,10,15,988,0.25,0.98,0.33,0.28,0,0,15,0,1003,0,0.99,0.0,0
PF10467,PF11855:PF10084:PF05103:PF10118:PF17075,1,8,0,1,8,1009,0.0,0.99,0.0,-0.0,0,0,1,0,1017,0,1.0,0.0,0
PF03487,PF13530:PF02561:PF03865:PF15484:PF06826,0,5,0,0,5,1013,0.0,1.0,0,0,0,0,0,0,1018,0,1.0,0,0
PF14073,PF09073:PF05681:PF09772:PF09305:PF16032,3,11,0,3,11,1004,0.0,0.99,0.0,-0.01,0,0,3,0,1015,0,1.0,0.0,0
PF06862,PF03085:PF09746:PF08731:PF04037:PF04910,11,19,3,8,16,991,0.16,0.98,0.27,0.2,0,0,11,0,1007,0,0.99,0.0,0
PF05942,PF03739:PF12628:PF07996:PF09510:PF01668,0,9,0,0,9,1009,0.0,0.99,0,0,0,0,0,0,1018,0,1.0,0,0
PF07943,PF00768:PF08275:PF01807:PF16833:PF15751,6,13,6,0,7,1005,0.46,0.99,1.0,0.68,0,0,6,0,1012,0,0.99,0.0,0
PF06954,PF14672:PF15724:PF06875:PF15550:PF02531,1,2,0,1,2,1015,0.0,1.0,0.0,-0.0,0,0,1,0,1017,0,1.0,0.0,0
PF15296,PF14764:PF08640:PF08216:PF08161:PF06662,6,21,2,4,19,993,0.1,0.98,0.33,0.17,2,2,4,0,1012,1.0,1.0,0.33,0.58
PF11585,PF08189:PF13737:PF09669:PF03317:PF08843,0,6,0,0,6,1012,0.0,0.99,0,0,0,0,0,0,1018,0,1.0,0,0
PF02161,PF12577:PF02155:PF12743:PF02159:PF14046,6,11,5,1,6,1006,0.45,0.99,0.83,0.61,5,5,1,0,1012,1.0,1.0,0.83,0.91
PF15112,PF09432:PF15118:PF00263:PF10423:PF09851,3,9,1,2,8,1007,0.11,0.99,0.33,0.19,1,0,3,1,1014,0.0,1.0,0.0,-0.0
PF01828,PF09424:PF02372:PF08787:PF04901:PF12900,7,17,3,4,14,997,0.18,0.98,0.43,0.27,0,0,7,0,1011,0,0.99,0.0,0
PF10565,PF04069:PF10562:PF00497:PF01547:PF10613,2,65,2,0,63,953,0.03,0.94,1.0,0.17,9,2,0,7,1009,0.22,0.99,1.0,0.47
PF02983,PF09272:PF15494:PF09396:PF16030:PF12032,2,27,1,1,26,990,0.04,0.97,0.5,0.13,1,1,1,0,1016,1.0,1.0,0.5,0.71
PF14653,PF06875:PF00489:PF02024:PF15173:PF06581,0,2,0,0,2,1016,0.0,1.0,0,0,0,0,0,0,1018,0,1.0,0,0
PF13323,PF00368:PF03176:PF16414:PF02460:PF12349,3,61,3,0,58,957,0.05,0.94,1.0,0.22,16,3,0,13,1002,0.19,0.99,1.0,0.43
PF00516,PF08497:PF06834:PF05939:PF03428:PF06007,0,2,0,0,2,1016,0.0,1.0,0,0,0,0,0,0,1018,0,1.0,0,0
PF02621,PF05939:PF08497:PF09498:PF06082:PF05840,0,0,0,0,0,1018,0,1.0,0,0,0,0,0,0,1018,0,1.0,0,0
PF14579,PF07733:PF09170:PF02938:PF08784:PF13477,13,29,13,0,16,989,0.45,0.98,1.0,0.66,1,1,12,0,1005,1.0,0.99,0.08,0.28
PF05183,PF12612:PF10350:PF15979:PF08631:PF08216,27,32,6,21,26,965,0.19,0.95,0.22,0.18,3,2,25,1,990,0.67,0.97,0.07,0.22
PF12435,PF02041:PF15519:PF08080:PF08617:PF14304,5,27,2,3,25,988,0.07,0.97,0.4,0.16,2,1,4,1,1012,0.5,1.0,0.2,0.31
PF16366,PF16368:PF16367:PF10267:PF08081:PF06495,12,18,11,1,7,999,0.61,0.99,0.92,0.74,2,2,10,0,1006,1.0,0.99,0.17,0.41
PF14571,PF05605:PF03868:PF03986:PF02988:PF07298,2,32,2,0,30,986,0.06,0.97,1.0,0.25,1,1,1,0,1016,1.0,1.0,0.5,0.71
PF15015,PF15685:PF03058:PF06670:PF05671:PF01969,0,2,0,0,2,1016,0.0,1.0,0,0,0,0,0,0,1018,0,1.0,0,0
PF02943,PF15109:PF12046:PF06581:PF08576:PF15172,1,4,0,1,4,1013,0.0,1.0,0.0,-0.0,0,0,1,0,1017,0,1.0,0.0,0
PF08618,PF02076:PF15991:PF03479:PF02234:PF04934,1,30,0,1,30,987,0.0,0.97,0.0,-0.01,0,0,1,0,1017,0,1.0,0.0,0
PF03567,PF01896:PF00708:PF06083:PF00777:PF12483,16,34,5,11,29,973,0.15,0.96,0.31,0.2,2,2,14,0,1002,1.0,0.99,0.12,0.35
PF10232,PF07406:PF10273:PF05308:PF14857:PF06098,9,14,4,5,10,999,0.29,0.99,0.44,0.35,0,0,9,0,1009,0,0.99,0.0,0
PF07708,PF10279:PF06056:PF17017:PF06403:PF09109,1,2,0,1,2,1015,0.0,1.0,0.0,-0.0,0,0,1,0,1017,0,1.0,0.0,0
PF03973,PF12238:PF00143:PF06658:PF00272:PF02284,0,9,0,0,9,1009,0.0,0.99,0,0,0,0,0,0,1018,0,1.0,0,0
PF06273,PF16485:PF14918:PF14920:PF01447:PF07014,5,1,0,5,1,1012,0.0,0.99,0.0,-0.0,0,0,5,0,1013,0,1.0,0.0,0
PF15074,PF13684:PF08036:PF01904:PF13013:PF14866,4,9,0,4,9,1005,0.0,0.99,0.0,-0.01,0,0,4,0,1014,0,1.0,0.0,0
PF02921,PF08802:PF09165:PF00848:PF04305:PF10399,15,20,8,7,12,991,0.4,0.98,0.53,0.45,2,2,13,0,1003,1.0,0.99,0.13,0.36
PF10164,PF15071:PF15715:PF10839:PF06912:PF04402,2,8,0,2,8,1008,0.0,0.99,0.0,-0.0,0,0,2,0,1016,0,1.0,0.0,0
PF00212,PF14769:PF15342:PF09282:PF02576:PF11255,1,9,0,1,9,1008,0.0,0.99,0.0,-0.0,0,0,1,0,1017,0,1.0,0.0,0
PF00895,PF15212:PF01292:PF05797:PF09951:PF10951,1,6,0,1,6,1011,0.0,0.99,0.0,-0.0,0,0,1,0,1017,0,1.0,0.0,0
PF01705,PF07809:PF09756:PF15298:PF10018:PF07051,8,21,4,4,17,993,0.19,0.98,0.5,0.3,0,0,8,0,1010,0,0.99,0.0,0
PF15577,PF15856:PF04610:PF11751:PF08291:PF06681,3,4,1,2,3,1012,0.25,1.0,0.33,0.29,0,0,3,0,1015,0,1.0,0.0,0
PF08730,PF15825:PF10974:PF16001:PF15340:PF15952,0,3,0,0,3,1015,0.0,1.0,0,0,0,0,0,0,1018,0,1.0,0,0
PF00348,PF03834:PF01215:PF06244:PF02104:PF03134,45,45,18,27,27,946,0.4,0.95,0.4,0.37,6,5,40,1,972,0.83,0.96,0.11,0.3
PF03958,PF07963:PF00263:PF16416:PF02056:PF06429,2,13,2,0,11,1005,0.15,0.99,1.0,0.39,0,0,2,0,1016,0,1.0,0.0,0
PF05827,PF16692:PF16401:PF10022:PF10288:PF07786,8,18,2,6,16,994,0.11,0.98,0.25,0.16,0,0,8,0,1010,0,0.99,0.0,0
PF17111,PF15898:PF14420:PF17106:PF16553:PF17046,20,19,8,12,11,987,0.42,0.98,0.4,0.4,1,1,19,0,998,1.0,0.98,0.05,0.22
PF01239,PF07711:PF04566:PF00288:PF03171:PF05922,27,89,18,9,71,920,0.2,0.92,0.67,0.34,12,7,20,5,986,0.58,0.98,0.26,0.38
PF02233,PF12769:PF05222:PF01262:PF04455:PF16653,7,25,7,0,18,993,0.28,0.98,1.0,0.52,9,7,0,2,1009,0.78,1.0,1.0,0.88
PF04412,PF01989:PF00680:PF00073:PF12381:PF14763,1,13,1,0,12,1005,0.08,0.99,1.0,0.28,4,0,1,4,1013,0.0,1.0,0.0,-0.0
PF08390,PF12403:PF04618:PF12045:PF03792:PF00046,5,95,5,0,90,923,0.05,0.91,1.0,0.22,2,0,5,2,1011,0.0,0.99,0.0,-0.0
PF07128,PF05761:PF01938:PF06628:PF03094:PF01965,0,64,0,0,64,954,0.0,0.94,0,0,6,0,0,6,1012,0.0,0.99,0,0
PF15441,PF15720:PF12015:PF16523:PF14348:PF09441,2,4,2,0,2,1014,0.5,1.0,1.0,0.71,1,1,1,0,1016,1.0,1.0,0.5,0.71
PF13898,PF15019:PF01758:PF07139:PF03261:PF02401,9,22,2,7,20,989,0.09,0.97,0.22,0.13,1,1,8,0,1009,1.0,0.99,0.11,0.33
PF00476,PF01927:PF01612:PF08066:PF00570:PF09369,15,64,13,2,51,952,0.2,0.95,0.87,0.4,13,4,11,9,994,0.31,0.98,0.27,0.28
PF07267,PF15547:PF09361:PF08093:PF15207:PF01303,0,2,0,0,2,1016,0.0,1.0,0,0,0,0,0,0,1018,0,1.0,0,0
PF11744,PF04535:PF06749:PF14009:PF03874:PF03321,7,26,4,3,22,989,0.15,0.98,0.57,0.29,5,2,5,3,1008,0.4,0.99,0.29,0.33
PF12338,PF00101:PF08523:PF01091:PF06298:PF01381,4,14,4,0,10,1004,0.29,0.99,1.0,0.53,2,1,3,1,1013,0.5,1.0,0.25,0.35
PF05720,PF07944:PF03644:PF05675:PF10521:PF10329,0,34,0,0,34,984,0.0,0.97,0,0,1,0,0,1,1017,0.0,1.0,0,0
PF10311,PF13390:PF04625:PF13694:PF03749:PF03306,5,9,1,4,8,1005,0.11,0.99,0.2,0.14,0,0,5,0,1013,0,1.0,0.0,0
PF05392,PF07391:PF11870:PF10671:PF02224:PF16838,3,5,0,3,5,1010,0.0,0.99,0.0,-0.0,0,0,3,0,1015,0,1.0,0.0,0
PF15204,PF01668:PF15023:PF05418:PF15334:PF11697,0,3,0,0,3,1015,0.0,1.0,0,0,0,0,0,0,1018,0,1.0,0,0
PF05958,PF03467:PF04059:PF10443:PF01938:PF05827,17,35,9,8,26,975,0.26,0.97,0.53,0.35,3,2,15,1,1000,0.67,0.98,0.12,0.28
PF08477,PF16095:PF12799:PF13676:PF15904:PF00531,30,74,24,6,50,938,0.32,0.94,0.8,0.49,11,10,20,1,987,0.91,0.98,0.33,0.54
PF01963,PF07896:PF04107:PF03878:PF04505:PF05915,10,28,4,6,24,984,0.14,0.97,0.4,0.23,1,1,9,0,1008,1.0,0.99,0.1,0.31
PF04196,PF15518:PF11751:PF09327:PF03534:PF07523,1,1,1,0,0,1017,1.0,1.0,1.0,1.0,0,0,1,0,1017,0,1.0,0.0,0
PF17206,PF03592:PF08497:PF08708:PF01752:PF13247,1,2,0,1,2,1015,0.0,1.0,0.0,-0.0,0,0,1,0,1017,0,1.0,0.0,0
PF04255,PF05736:PF04657:PF04350:PF03241:PF03428,0,4,0,0,4,1014,0.0,1.0,0,0,0,0,0,0,1018,0,1.0,0,0
PF08232,PF03920:PF13925:PF09453:PF14538:PF07304,8,32,2,6,30,980,0.06,0.96,0.25,0.11,2,1,7,1,1009,0.5,0.99,0.12,0.25
PF08783,PF13696:PF17180:PF03159:PF02337:PF12384,7,27,7,0,20,991,0.26,0.98,1.0,0.5,2,2,5,0,1011,1.0,1.0,0.29,0.53
PF14535,PF07074:PF15163:PF13570:PF15819:PF04552,1,13,1,0,12,1005,0.08,0.99,1.0,0.28,1,0,1,1,1016,0.0,1.0,0.0,-0.0
PF15362,PF12278:PF10583:PF10578:PF03436:PF02343,1,2,0,1,2,1015,0.0,1.0,0.0,-0.0,0,0,1,0,1017,0,1.0,0.0,0
PF04488,PF04572:PF13679:PF13344:PF13506:PF14868,30,49,13,17,36,952,0.27,0.95,0.43,0.31,0,0,30,0,988,0,0.97,0.0,0
PF16863,PF00088:PF16338:PF13802:PF17137:PF01055,19,46,19,0,27,972,0.41,0.97,1.0,0.63,10,8,11,2,997,0.8,0.99,0.42,0.58
PF13990,PF07699:PF07973:PF04566:PF06119:PF00346,0,60,0,0,60,958,0.0,0.94,0,0,7,0,0,7,1011,0.0,0.99,0,0
PF04476,PF10412:PF11037:PF06945:PF02413:PF03432,0,0,0,0,0,1018,0,1.0,0,0,0,0,0,0,1018,0,1.0,0,0
PF06995,PF12080:PF08497:PF07195:PF02465:PF03406,0,0,0,0,0,1018,0,1.0,0,0,0,0,0,0,1018,0,1.0,0,0
PF08523,PF09363:PF03894:PF09364:PF01091:PF01381,6,13,6,0,7,1005,0.46,0.99,1.0,0.68,2,0,6,2,1010,0.0,0.99,0.0,-0.0
PF09743,PF08638:PF15917:PF04118:PF14952:PF14665,4,19,1,3,18,996,0.05,0.98,0.25,0.11,0,0,4,0,1014,0,1.0,0.0,0
PF00063,PF01576:PF02736:PF06017:PF00784:PF01843,73,70,50,23,20,925,0.71,0.96,0.68,0.68,12,10,63,2,943,0.83,0.94,0.14,0.32
PF03537,PF06206:PF01670:PF07172:PF07333:PF11264,6,10,3,3,7,1005,0.3,0.99,0.5,0.38,0,0,6,0,1012,0,0.99,0.0,0
PF01288,PF00809:PF02152:PF02607:PF02574:PF02965,11,26,9,2,17,990,0.35,0.98,0.82,0.53,8,3,8,5,1002,0.38,0.99,0.27,0.31
PF02972,PF05754:PF14985:PF08843:PF10106:PF12201,0,3,0,0,3,1015,0.0,1.0,0,0,0,0,0,0,1018,0,1.0,0,0
PF06532,PF13793:PF12465:PF10584:PF08327:PF14953,0,56,0,0,56,962,0.0,0.94,0,0,5,0,0,5,1013,0.0,1.0,0,0
PF06863,PF06742:PF07364:PF02884:PF07171:PF02278,0,8,0,0,8,1010,0.0,0.99,0,0,0,0,0,0,1018,0,1.0,0,0
PF15790,PF07529:PF13892:PF06465:PF12054:PF13907,1,44,1,0,43,974,0.02,0.96,1.0,0.15,7,1,0,6,1011,0.14,0.99,1.0,0.38
PF15207,PF06573:PF01752:PF15343:PF15175:PF00796,1,3,0,1,3,1014,0.0,1.0,0.0,-0.0,0,0,1,0,1017,0,1.0,0.0,0
PF06663,PF10534:PF04629:PF09246:PF09045:PF00778,1,12,1,0,11,1006,0.08,0.99,1.0,0.29,1,1,0,0,1017,1.0,1.0,1.0,1.0
PF00888,PF10557:PF08672:PF03256:PF11515:PF09782,39,46,34,5,12,967,0.74,0.98,0.87,0.79,9,9,30,0,979,1.0,0.97,0.23,0.47
PF02330,PF06749:PF01791:PF01625:PF04176:PF00810,7,45,5,2,40,971,0.11,0.96,0.71,0.27,4,3,4,1,1010,0.75,1.0,0.43,0.56
PF12467,PF13780:PF11026:PF10554:PF11751:PF15518,5,1,0,5,1,1012,0.0,0.99,0.0,-0.0,0,0,5,0,1013,0,1.0,0.0,0
PF10982,PF06995:PF06934:PF02119:PF16822:PF08345,1,3,0,1,3,1014,0.0,1.0,0.0,-0.0,0,0,1,0,1017,0,1.0,0.0,0
PF01020,PF04758:PF16843:PF09055:PF05162:PF13373,12,21,3,9,18,988,0.14,0.97,0.25,0.18,1,1,11,0,1006,1.0,0.99,0.08,0.29
PF06235,PF02378:PF12242:PF06942:PF09183:PF15022,2,8,1,1,7,1009,0.12,0.99,0.5,0.25,0,0,2,0,1016,0,1.0,0.0,0
PF01195,PF04690:PF04720:PF06749:PF05498:PF05910,8,21,3,5,18,992,0.14,0.98,0.38,0.22,2,1,7,1,1009,0.5,0.99,0.12,0.25
PF13812,PF17177:PF12921:PF16953:PF13762:PF14700,57,49,32,25,17,944,0.65,0.96,0.56,0.58,1,1,56,0,961,1.0,0.94,0.02,0.13
PF15128,PF06798:PF06403:PF05466:PF01752:PF03888,0,3,0,0,3,1015,0.0,1.0,0,0,0,0,0,0,1018,0,1.0,0,0
PF02219,PF03385:PF07034:PF10022:PF14764:PF01285,8,19,3,5,16,994,0.16,0.98,0.38,0.23,0,0,8,0,1010,0,0.99,0.0,0
PF08619,PF16644:PF02254:PF01026:PF00999:PF02080,2,68,2,0,66,950,0.03,0.94,1.0,0.17,4,1,1,3,1013,0.25,1.0,0.5,0.35
PF01773,PF07670:PF07662:PF07664:PF03068:PF08527,12,25,11,1,14,992,0.44,0.99,0.92,0.63,2,1,11,1,1005,0.5,0.99,0.08,0.2
PF01823,PF01522:PF07502:PF01735:PF16977:PF16056,22,51,7,15,44,952,0.14,0.94,0.32,0.18,2,1,21,1,995,0.5,0.98,0.05,0.15
PF07710,PF08563:PF11619:PF00870:PF04516:PF16533,2,11,2,0,9,1007,0.18,0.99,1.0,0.42,2,2,0,0,1016,1.0,1.0,1.0,1.0
PF14091,PF10220:PF05212:PF01644:PF01222:PF13458,0,48,0,0,48,970,0.0,0.95,0,0,2,0,0,2,1016,0.0,1.0,0,0
PF05640,PF16944:PF12887:PF10033:PF08729:PF15396,3,8,1,2,7,1008,0.12,0.99,0.33,0.2,1,1,2,0,1015,1.0,1.0,0.33,0.58
PF02420,PF02084:PF10578:PF07276:PF10630:PF03578,0,0,0,0,0,1018,0,1.0,0,0,0,0,0,0,1018,0,1.0,0,0
PF15065,PF06951:PF15260:PF15008:PF05497:PF14954,8,18,2,6,16,994,0.11,0.98,0.25,0.16,0,0,8,0,1010,0,0.99,0.0,0
PF09829,PF08411:PF16449:PF06890:PF08461:PF15518,0,2,0,0,2,1016,0.0,1.0,0,0,0,0,0,0,1018,0,1.0,0,0
PF03770,PF01513:PF02517:PF04117:PF16077:PF04577,25,61,12,13,49,944,0.2,0.94,0.48,0.28,6,5,20,1,992,0.83,0.98,0.2,0.4
PF04981,PF05334:PF10496:PF12309:PF09830:PF04087,5,26,3,2,23,990,0.12,0.98,0.6,0.26,0,0,5,0,1013,0,1.0,0.0,0
PF14495,PF09057:PF01741:PF01947:PF06679:PF00489,2,3,0,2,3,1013,0.0,1.0,0.0,-0.0,0,0,2,0,1016,0,1.0,0.0,0
PF09350,PF12572:PF09320:PF14901:PF14308:PF00684,3,30,1,2,29,986,0.03,0.97,0.33,0.1,2,0,3,2,1013,0.0,1.0,0.0,-0.0
PF06041,PF11734:PF16503:PF09179:PF10288:PF01171,8,21,2,6,19,991,0.1,0.98,0.25,0.14,5,2,6,3,1007,0.4,0.99,0.25,0.31
PF02453,PF01073:PF14934:PF07722:PF12734:PF09439,14,25,4,10,21,983,0.16,0.97,0.29,0.2,1,0,14,1,1003,0.0,0.99,0.0,-0.0
PF05344,PF01529:PF03632:PF00132:PF01734:PF07885,0,155,0,0,155,863,0.0,0.85,0,0,21,0,0,21,997,0.0,0.98,0,0
PF01204,PF07492:PF08583:PF04800:PF10277:PF00793,23,54,15,8,39,956,0.28,0.95,0.65,0.41,4,3,20,1,994,0.75,0.98,0.13,0.31
PF02996,PF01956:PF13664:PF03657:PF10183:PF03162,28,29,10,18,19,971,0.34,0.96,0.36,0.33,4,2,26,2,988,0.5,0.97,0.07,0.18
PF00651,PF12313:PF00887:PF09494:PF11900:PF15881,138,55,37,101,18,862,0.67,0.88,0.27,0.38,3,3,135,0,880,1.0,0.87,0.02,0.14
PF01815,PF04958:PF17009:PF09655:PF01206:PF03465,0,13,0,0,13,1005,0.0,0.99,0,0,0,0,0,0,1018,0,1.0,0,0
PF08629,PF08778:PF11413:PF13188:PF16279:PF07469,1,15,0,1,15,1002,0.0,0.98,0.0,-0.0,2,0,1,2,1015,0.0,1.0,0.0,-0.0
PF03912,PF02427:PF15125:PF06109:PF14985:PF15107,0,4,0,0,4,1014,0.0,1.0,0,0,0,0,0,0,1018,0,1.0,0,0
PF12633,PF16449:PF03865:PF04453:PF09829:PF05947,3,0,0,3,0,1015,0,1.0,0.0,0,0,0,3,0,1015,0,1.0,0.0,0
PF14072,PF09967:PF11542:PF05100:PF06586:PF05309,1,3,0,1,3,1014,0.0,1.0,0.0,-0.0,1,0,1,1,1016,0.0,1.0,0.0,-0.0
PF06884,PF12296:PF11991:PF06127:PF10455:PF07350,7,20,4,3,16,995,0.2,0.98,0.57,0.33,0,0,7,0,1011,0,0.99,0.0,0
PF02439,PF02124:PF09291:PF10570:PF02480:PF07010,2,5,2,0,3,1013,0.4,1.0,1.0,0.63,0,0,2,0,1016,0,1.0,0.0,0
PF05934,PF15877:PF15313:PF07137:PF11712:PF15233,6,19,2,4,17,995,0.11,0.98,0.33,0.18,0,0,6,0,1012,0,0.99,0.0,0
PF07535,PF08630:PF08634:PF15275:PF15257:PF16043,6,12,4,2,8,1004,0.33,0.99,0.67,0.47,0,0,6,0,1012,0,0.99,0.0,0
PF07753,PF02955:PF15143:PF08021:PF04013:PF08404,0,5,0,0,5,1013,0.0,1.0,0,0,0,0,0,0,1018,0,1.0,0,0
PF15492,PF08314:PF17167:PF06165:PF10337:PF15025,1,16,1,0,15,1002,0.06,0.99,1.0,0.25,1,0,1,1,1016,0.0,1.0,0.0,-0.0
PF15718,PF15302:PF11035:PF16720:PF12904:PF02106,2,3,0,2,3,1013,0.0,1.0,0.0,-0.0,0,0,2,0,1016,0,1.0,0.0,0
PF10224,PF10780:PF10244:PF06108:PF06127:PF15071,4,17,2,2,15,999,0.12,0.98,0.5,0.24,0,0,4,0,1014,0,1.0,0.0,0
PF01262,PF12769:PF02233:PF05222:PF04455:PF16653,11,23,9,2,14,993,0.39,0.98,0.82,0.56,8,8,3,0,1007,1.0,1.0,0.73,0.85
PF00306,PF01333:PF03118:PF07850:PF05450:PF16491,12,38,6,6,32,974,0.16,0.96,0.5,0.27,2,1,11,1,1005,0.5,0.99,0.08,0.2
PF06387,PF09784:PF06109:PF15744:PF10664:PF08228,3,4,0,3,4,1011,0.0,0.99,0.0,-0.0,0,0,3,0,1015,0,1.0,0.0,0
PF08662,PF08159:PF12341:PF11540:PF12894:PF03451,15,63,10,5,53,950,0.16,0.94,0.67,0.31,6,4,11,2,1001,0.67,0.99,0.27,0.42
PF15842,PF15097:PF15142:PF16311:PF15334:PF10988,2,3,1,1,2,1014,0.33,1.0,0.5,0.41,0,0,2,0,1016,0,1.0,0.0,0
PF02127,PF14388:PF06079:PF01963:PF08285:PF05705,9,40,5,4,35,974,0.12,0.96,0.56,0.25,4,2,7,2,1007,0.5,0.99,0.22,0.33
PF00900,PF08071:PF16121:PF01777:PF00163:PF17136,15,40,14,1,26,977,0.35,0.97,0.93,0.56,6,5,10,1,1002,0.83,0.99,0.33,0.52
PF02888,PF03530:PF15113:PF07885:PF07137:PF11539,9,66,9,0,57,952,0.14,0.94,1.0,0.36,0,0,9,0,1009,0,0.99,0.0,0
PF08007,PF15249:PF10309:PF05182:PF08123:PF12480,16,36,8,8,28,974,0.22,0.96,0.5,0.32,6,4,12,2,1000,0.67,0.99,0.25,0.4
PF05842,PF07679:PF15210:PF04847:PF03663:PF01353,1,100,0,1,100,917,0.0,0.9,0.0,-0.01,2,0,1,2,1015,0.0,1.0,0.0,-0.0
PF09179,PF11734:PF16822:PF14882:PF02119:PF14690,3,5,3,0,2,1013,0.6,1.0,1.0,0.77,0,0,3,0,1015,0,1.0,0.0,0
PF14026,PF03116:PF04034:PF09776:PF16698:PF15897,0,16,0,0,16,1002,0.0,0.98,0,0,0,0,0,0,1018,0,1.0,0,0
PF15477,PF11669:PF12527:PF10361:PF05841:PF06365,8,9,2,6,7,1003,0.22,0.99,0.25,0.23,0,0,8,0,1010,0,0.99,0.0,0
PF01985,PF07766:PF04388:PF16471:PF09730:PF09744,9,32,5,4,27,982,0.16,0.97,0.56,0.28,1,1,8,0,1009,1.0,0.99,0.11,0.33
PF11528,PF16011:PF03562:PF04963:PF03090:PF11124,0,3,0,0,3,1015,0.0,1.0,0,0,0,0,0,0,1018,0,1.0,0,0
PF04995,PF03260:PF14305:PF15101:PF16011:PF06651,0,3,0,0,3,1015,0.0,1.0,0,0,0,0,0,0,1018,0,1.0,0,0
PF13663,PF02565:PF07805:PF13247:PF06798:PF02336,2,3,0,2,3,1013,0.0,1.0,0.0,-0.0,0,0,2,0,1016,0,1.0,0.0,0
PF03364,PF11303:PF10275:PF00452:PF14547:PF13088,13,20,5,8,15,990,0.25,0.98,0.38,0.3,0,0,13,0,1005,0,0.99,0.0,0
PF04221,PF04170:PF03925:PF13876:PF06505:PF09951,1,2,1,0,1,1016,0.5,1.0,1.0,0.71,0,0,1,0,1017,0,1.0,0.0,0
PF01729,PF02749:PF05173:PF02222:PF12243:PF01113,10,24,10,0,14,994,0.42,0.99,1.0,0.64,2,1,9,1,1007,0.5,0.99,0.1,0.22
PF00867,PF12247:PF12246:PF05700:PF00752:PF11788,38,40,30,8,10,970,0.75,0.98,0.79,0.76,5,5,33,0,980,1.0,0.97,0.13,0.36
PF07687,PF01546:PF03417:PF01988:PF09767:PF13508,11,56,9,2,47,960,0.16,0.95,0.82,0.35,7,3,8,4,1003,0.43,0.99,0.27,0.34
PF05697,PF05698:PF15350:PF16669:PF11698:PF14764,3,21,3,0,18,997,0.14,0.98,1.0,0.37,0,0,3,0,1015,0,1.0,0.0,0
PF17013,PF04370:PF07192:PF08291:PF05707:PF13575,0,0,0,0,0,1018,0,1.0,0,0,0,0,0,0,1018,0,1.0,0,0
PF05642,PF01810:PF02501:PF13205:PF07964:PF03729,2,13,0,2,13,1003,0.0,0.99,0.0,-0.01,0,0,2,0,1016,0,1.0,0.0,0
PF06024,PF09087:PF05400:PF10438:PF07243:PF12778,1,2,1,0,1,1016,0.5,1.0,1.0,0.71,1,1,0,0,1017,1.0,1.0,1.0,1.0
PF13320,PF16748:PF14613:PF15491:PF15793:PF13020,0,5,0,0,5,1013,0.0,1.0,0,0,0,0,0,0,1018,0,1.0,0,0
PF01246,PF07052:PF10273:PF08636:PF03760:PF11282,10,19,4,6,15,993,0.21,0.98,0.4,0.28,0,0,10,0,1008,0,0.99,0.0,0
PF15992,PF04583:PF10683:PF07927:PF07839:PF11175,1,8,1,0,7,1010,0.12,0.99,1.0,0.35,0,0,1,0,1017,0,1.0,0.0,0
PF00317,PF02867:PF03477:PF03989:PF08343:PF07047,11,26,11,0,15,992,0.42,0.99,1.0,0.65,5,5,6,0,1007,1.0,0.99,0.45,0.67
PF10992,PF16649:PF15211:PF15972:PF07400:PF08194,2,1,0,2,1,1015,0.0,1.0,0.0,-0.0,0,0,2,0,1016,0,1.0,0.0,0
PF01150,PF06179:PF11976:PF16815:PF02146:PF16118,22,70,12,10,58,938,0.17,0.93,0.55,0.28,4,4,18,0,996,1.0,0.98,0.18,0.42
PF03249,PF06140:PF10318:PF00510:PF01216:PF13936,0,31,0,0,31,987,0.0,0.97,0,0,1,0,0,1,1017,0.0,1.0,0,0
PF09131,PF00419:PF11027:PF15709:PF10856:PF10974,0,3,0,0,3,1015,0.0,1.0,0,0,0,0,0,0,1018,0,1.0,0,0
PF01252,PF03971:PF13663:PF04932:PF07195:PF01628,4,5,1,3,4,1010,0.2,0.99,0.25,0.22,0,0,4,0,1014,0,1.0,0.0,0
PF10148,PF15929:PF15328:PF09789:PF04664:PF17098,4,9,1,3,8,1006,0.11,0.99,0.25,0.16,0,0,4,0,1014,0,1.0,0.0,0
PF00072,PF03924:PF00512:PF08448:PF06580:PF00672,71,52,46,25,6,941,0.88,0.97,0.65,0.74,12,12,59,0,947,1.0,0.94,0.17,0.4
PF08762,PF12381:PF12264:PF01660:PF14307:PF00548,4,16,4,0,12,1002,0.25,0.99,1.0,0.5,4,4,0,0,1014,1.0,1.0,1.0,1.0
PF00240,PF09055:PF16843:PF14621:PF05162:PF16455,88,17,14,74,3,927,0.82,0.92,0.16,0.34,1,1,87,0,930,1.0,0.91,0.01,0.1
PF07959,PF10509:PF08544:PF00288:PF05038:PF02776,6,63,5,1,58,954,0.08,0.94,0.83,0.25,15,2,4,13,999,0.13,0.98,0.33,0.2
PF16557,PF16534:PF02376:PF12403:PF12509:PF00157,2,15,2,0,13,1003,0.13,0.99,1.0,0.36,3,2,0,1,1015,0.67,1.0,1.0,0.82
PF05206,PF11722:PF05253:PF02971:PF07837:PF03648,9,25,7,2,18,991,0.28,0.98,0.78,0.46,1,0,9,1,1008,0.0,0.99,0.0,-0.0
PF11471,PF16966:PF15424:PF10106:PF03323:PF06028,0,11,0,0,11,1007,0.0,0.99,0,0,0,0,0,0,1018,0,1.0,0,0
PF08324,PF06957:PF09070:PF15512:PF04192:PF07569,11,30,6,5,24,983,0.2,0.97,0.55,0.32,4,3,8,1,1006,0.75,0.99,0.27,0.45
PF14839,PF03878:PF15298:PF02038:PF05283:PF04831,0,18,0,0,18,1000,0.0,0.98,0,0,1,0,0,1,1017,0.0,1.0,0,0
PF12759,PF16590:PF02457:PF15214:PF16822:PF04657,0,7,0,0,7,1011,0.0,0.99,0,0,0,0,0,0,1018,0,1.0,0,0
PF02868,PF16485:PF01447:PF09051:PF09049:PF14232,1,1,1,0,0,1017,1.0,1.0,1.0,1.0,0,0,1,0,1017,0,1.0,0.0,0
PF03835,PF10405:PF10403:PF10404:PF04721:PF06657,12,15,11,1,4,1002,0.73,1.0,0.92,0.82,7,7,5,0,1006,1.0,1.0,0.58,0.76
PF15134,PF15036:PF14865:PF11771:PF15676:PF15115,1,1,0,1,1,1016,0.0,1.0,0.0,-0.0,0,0,1,0,1017,0,1.0,0.0,0
PF02694,PF03459:PF05936:PF01032:PF03412:PF16326,2,11,2,0,9,1007,0.18,0.99,1.0,0.42,2,2,0,0,1016,1.0,1.0,1.0,1.0
PF07749,PF07912:PF06201:PF07449:PF15928:PF04721,7,24,5,2,19,992,0.21,0.98,0.71,0.38,1,1,6,0,1011,1.0,0.99,0.14,0.38
PF00605,PF10401:PF16983:PF02219:PF10155:PF16401,11,25,10,1,15,992,0.4,0.98,0.91,0.6,0,0,11,0,1007,0,0.99,0.0,0
PF15979,PF10350:PF12612:PF07539:PF02368:PF17034,12,30,7,5,23,983,0.23,0.97,0.58,0.36,3,1,11,2,1004,0.33,0.99,0.08,0.16
PF11718,PF07521:PF13299:PF10484:PF14864:PF16123,12,45,11,1,34,972,0.24,0.97,0.92,0.46,5,3,9,2,1004,0.6,0.99,0.25,0.38
PF07657,PF01414:PF17102:PF11380:PF06816:PF17101,3,20,3,0,17,998,0.15,0.98,1.0,0.38,5,1,2,4,1011,0.2,0.99,0.33,0.26
PF06432,PF05562:PF03331:PF15377:PF10166:PF15239,12,7,2,10,5,1001,0.29,0.99,0.17,0.21,0,0,12,0,1006,0,0.99,0.0,0
PF04766,PF02809:PF04366:PF05928:PF09311:PF11464,0,43,0,0,43,975,0.0,0.96,0,0,2,0,0,2,1016,0.0,1.0,0,0
PF06058,PF15996:PF07217:PF08634:PF16944:PF14611,6,20,1,5,19,993,0.05,0.98,0.17,0.08,0,0,6,0,1012,0,0.99,0.0,0
PF05013,PF03841:PF02613:PF05797:PF15175:PF13767,1,2,1,0,1,1016,0.5,1.0,1.0,0.71,0,0,1,0,1017,0,1.0,0.0,0
PF12868,PF15856:PF10618:PF04355:PF08291:PF11214,1,1,0,1,1,1016,0.0,1.0,0.0,-0.0,0,0,1,0,1017,0,1.0,0.0,0
PF00626,PF04810:PF12799:PF02209:PF04815:PF08033,48,67,38,10,29,941,0.57,0.96,0.79,0.65,21,21,27,0,970,1.0,0.97,0.44,0.65
PF09986,PF05124:PF11392:PF06103:PF10357:PF06543,0,12,0,0,12,1006,0.0,0.99,0,0,0,0,0,0,1018,0,1.0,0,0
PF12304,PF15003:PF03823:PF15744:PF15829:PF02202,1,4,0,1,4,1013,0.0,1.0,0.0,-0.0,0,0,1,0,1017,0,1.0,0.0,0
PF02559,PF07999:PF16204:PF03880:PF12029:PF09369,3,14,2,1,12,1003,0.14,0.99,0.67,0.3,2,2,1,0,1015,1.0,1.0,0.67,0.82
PF01270,PF05448:PF03745:PF03238:PF06681:PF06651,1,2,0,1,2,1015,0.0,1.0,0.0,-0.0,0,0,1,0,1017,0,1.0,0.0,0
PF10250,PF09335:PF04570:PF13695:PF03647:PF05678,36,40,10,26,30,952,0.25,0.94,0.28,0.24,3,3,33,0,982,1.0,0.97,0.08,0.28
PF13762,PF08334:PF04347:PF01475:PF15726:PF06800,0,6,0,0,6,1012,0.0,0.99,0,0,0,0,0,0,1018,0,1.0,0,0
PF05866,PF15082:PF09322:PF15392:PF07610:PF04001,1,4,0,1,4,1013,0.0,1.0,0.0,-0.0,0,0,1,0,1017,0,1.0,0.0,0
PF06506,PF09327:PF08479:PF12256:PF15518:PF13269,4,1,0,4,1,1013,0.0,1.0,0.0,-0.0,0,0,4,0,1014,0,1.0,0.0,0
PF06573,PF15207:PF03050:PF03238:PF06952:PF15190,2,2,1,1,1,1015,0.5,1.0,0.5,0.5,0,0,2,0,1016,0,1.0,0.0,0
PF08748,PF04848:PF11124:PF10951:PF02601:PF09361,0,5,0,0,5,1013,0.0,1.0,0,0,0,0,0,0,1018,0,1.0,0,0
PF05202,PF02277:PF07157:PF01330:PF13722:PF09108,0,5,0,0,5,1013,0.0,1.0,0,0,0,0,0,0,1018,0,1.0,0,0
PF16977,PF07602:PF15494:PF09342:PF01392:PF16915,7,30,5,2,25,986,0.17,0.97,0.71,0.34,2,1,6,1,1010,0.5,0.99,0.14,0.26
PF00533,PF12738:PF16770:PF16893:PF16892:PF03119,52,28,23,29,5,961,0.82,0.97,0.44,0.59,3,2,50,1,965,0.67,0.95,0.04,0.15
PF00071,PF00255:PF01015:PF10149:PF03501:PF09724,144,37,27,117,10,864,0.73,0.88,0.19,0.33,6,6,138,0,874,1.0,0.86,0.04,0.19
PF12901,PF14437:PF08604:PF14304:PF08922:PF09292,7,23,2,5,21,990,0.09,0.97,0.29,0.15,0,0,7,0,1011,0,0.99,0.0,0
PF04483,PF13225:PF04839:PF15503:PF15346:PF12328,1,11,0,1,11,1006,0.0,0.99,0.0,-0.0,0,0,1,0,1017,0,1.0,0.0,0
PF06330,PF06581:PF12328:PF05824:PF05014:PF01741,2,11,0,2,11,1005,0.0,0.99,0.0,-0.0,0,0,2,0,1016,0,1.0,0.0,0
PF05523,PF01865:PF16834:PF08407:PF12087:PF00112,0,67,0,0,67,951,0.0,0.93,0,0,0,0,0,0,1018,0,1.0,0,0
PF13013,PF13094:PF08398:PF15097:PF15141:PF15085,1,5,0,1,5,1012,0.0,0.99,0.0,-0.0,0,0,1,0,1017,0,1.0,0.0,0
PF14526,PF00183:PF13493:PF06957:PF08386:PF11816,4,61,2,2,59,955,0.03,0.94,0.5,0.12,6,0,4,6,1008,0.0,0.99,0.0,-0.0
PF08961,PF09049:PF09050:PF07334:PF09051:PF17169,1,1,0,1,1,1016,0.0,1.0,0.0,-0.0,0,0,1,0,1017,0,1.0,0.0,0
PF06379,PF12081:PF08479:PF04865:PF14842:PF01514,1,0,0,1,0,1017,0,1.0,0.0,0,0,0,1,0,1017,0,1.0,0.0,0
PF03325,PF15909:PF10571:PF05991:PF15310:PF02308,1,10,0,1,10,1007,0.0,0.99,0.0,-0.0,0,0,1,0,1017,0,1.0,0.0,0
PF02195,PF04736:PF16089:PF09057:PF00489:PF01903,8,4,0,8,4,1006,0.0,0.99,0.0,-0.01,0,0,8,0,1010,0,0.99,0.0,0
PF05901,PF06651:PF07016:PF01790:PF05797:PF17206,0,3,0,0,3,1015,0.0,1.0,0,0,0,0,0,0,1018,0,1.0,0,0
PF16049,PF10410:PF03865:PF14564:PF12299:PF08345,0,6,0,0,6,1012,0.0,0.99,0,0,0,0,0,0,1018,0,1.0,0,0
PF04191,PF03388:PF06258:PF08633:PF07047:PF01531,4,31,3,1,28,986,0.1,0.97,0.75,0.26,1,0,4,1,1013,0.0,1.0,0.0,-0.0
PF17175,PF09687:PF13908:PF04769:PF04622:PF12579,11,8,3,8,5,1002,0.38,0.99,0.27,0.31,0,0,11,0,1007,0,0.99,0.0,0
PF05093,PF12589:PF16803:PF08498:PF07109:PF10437,16,23,9,7,14,988,0.39,0.98,0.56,0.46,1,1,15,0,1002,1.0,0.99,0.06,0.25
PF09770,PF03993:PF00073:PF05594:PF14951:PF02226,3,15,0,3,15,1000,0.0,0.98,0.0,-0.01,0,0,3,0,1015,0,1.0,0.0,0
PF12191,PF01752:PF07016:PF01514:PF06070:PF03241,0,3,0,0,3,1015,0.0,1.0,0,0,0,0,0,0,1018,0,1.0,0,0
PF03870,PF03331:PF10166:PF02175:PF10251:PF15139,7,7,1,6,6,1005,0.14,0.99,0.14,0.14,0,0,7,0,1011,0,0.99,0.0,0
PF11254,PF02863:PF14871:PF11876:PF01913:PF06082,1,4,0,1,4,1013,0.0,1.0,0.0,-0.0,0,0,1,0,1017,0,1.0,0.0,0
PF14066,PF03742:PF06505:PF07753:PF11863:PF08093,0,2,0,0,2,1016,0.0,1.0,0,0,0,0,0,0,1018,0,1.0,0,0
PF06678,PF17193:PF03739:PF06403:PF04451:PF01051,0,7,0,0,7,1011,0.0,0.99,0,0,0,0,0,0,1018,0,1.0,0,0
PF09280,PF09055:PF09668:PF16843:PF05162:PF04758,9,32,5,4,27,982,0.16,0.97,0.56,0.28,2,2,7,0,1009,1.0,0.99,0.22,0.47
PF06508,PF08252:PF00697:PF00958:PF06418:PF00218,3,37,3,0,34,981,0.08,0.97,1.0,0.28,0,0,3,0,1015,0,1.0,0.0,0
PF00002,PF01825:PF02793:PF16489:PF06652:PF14291,56,61,44,12,17,945,0.72,0.97,0.79,0.74,10,8,48,2,960,0.8,0.95,0.14,0.33
PF15725,PF10994:PF15216:PF15339:PF11771:PF02972,0,1,0,0,1,1017,0.0,1.0,0,0,0,0,0,0,1018,0,1.0,0,0
PF09133,PF10033:PF16944:PF09429:PF05030:PF00649,5,24,2,3,22,991,0.08,0.98,0.4,0.17,0,0,5,0,1013,0,1.0,0.0,0
PF04587,PF00698:PF16197:PF16073:PF02801:PF14765,13,65,9,4,56,949,0.14,0.94,0.69,0.29,39,7,6,32,973,0.18,0.96,0.54,0.3
PF13598,PF10212:PF16704:PF15964:PF03470:PF15908,7,10,3,4,7,1004,0.3,0.99,0.43,0.35,1,1,6,0,1011,1.0,0.99,0.14,0.38
PF02862,PF02121:PF09246:PF14360:PF00644:PF15982,16,57,7,9,50,952,0.12,0.94,0.44,0.21,2,2,14,0,1002,1.0,0.99,0.12,0.35
PF10088,PF12937:PF06291:PF09794:PF08094:PF00233,0,112,0,0,112,906,0.0,0.89,0,0,1,0,0,1,1017,0.0,1.0,0,0
PF01966,PF02541:PF14360:PF04616:PF01965:PF13813,25,66,16,9,50,943,0.24,0.94,0.64,0.37,9,8,17,1,992,0.89,0.98,0.32,0.53
PF00136,PF03104:PF14260:PF12254:PF08996:PF08490,37,37,36,1,1,980,0.97,1.0,0.97,0.97,14,14,23,0,981,1.0,0.98,0.38,0.61
PF05826,PF10192:PF15019:PF01758:PF11303:PF01513,11,30,7,4,23,984,0.23,0.97,0.64,0.38,0,0,11,0,1007,0,0.99,0.0,0
PF16976,PF13629:PF07195:PF05666:PF13746:PF11614,1,5,1,0,4,1013,0.2,1.0,1.0,0.45,0,0,1,0,1017,0,1.0,0.0,0
PF14624,PF13757:PF08487:PF06668:PF15057:PF13519,8,46,8,0,38,972,0.17,0.96,1.0,0.41,4,2,6,2,1008,0.5,0.99,0.25,0.35
PF10680,PF08744:PF13929:PF16967:PF09361:PF08453,8,2,1,7,1,1009,0.5,0.99,0.12,0.25,0,0,8,0,1010,0,0.99,0.0,0
PF03721,PF03720:PF00984:PF03483:PF02550:PF02781,7,42,7,0,35,976,0.17,0.97,1.0,0.4,2,1,6,1,1010,0.5,0.99,0.14,0.26
PF11221,PF14748:PF07253:PF02464:PF16740:PF08538,4,19,1,3,18,996,0.05,0.98,0.25,0.11,1,1,3,0,1014,1.0,1.0,0.25,0.5
PF11917,PF09729:PF13434:PF16944:PF12998:PF09184,6,44,5,1,39,973,0.11,0.96,0.83,0.3,2,0,6,2,1010,0.0,0.99,0.0,-0.0
PF04776,PF06271:PF08227:PF14769:PF07890:PF15313,9,20,2,7,18,991,0.1,0.98,0.22,0.14,0,0,9,0,1009,0,0.99,0.0,0
PF09006,PF08391:PF03954:PF06023:PF09064:PF03523,0,4,0,0,4,1014,0.0,1.0,0,0,0,0,0,0,1018,0,1.0,0,0
PF01359,PF06159:PF07542:PF14811:PF07258:PF05191,45,33,12,33,21,952,0.36,0.95,0.27,0.28,4,4,41,0,973,1.0,0.96,0.09,0.29
PF04627,PF08367:PF15098:PF16187:PF04538:PF15683,12,27,3,9,24,982,0.11,0.97,0.25,0.15,0,0,12,0,1006,0,0.99,0.0,0
PF09855,PF06877:PF05751:PF06115:PF14876:PF07156,0,14,0,0,14,1004,0.0,0.99,0,0,0,0,0,0,1018,0,1.0,0,0
PF06242,PF00580:PF07943:PF07497:PF08472:PF05116,4,33,4,0,29,985,0.12,0.97,1.0,0.34,1,1,3,0,1014,1.0,1.0,0.25,0.5
PF10320,PF06784:PF05719:PF14778:PF10323:PF10328,8,29,3,5,26,984,0.1,0.97,0.38,0.19,1,1,7,0,1010,1.0,0.99,0.12,0.35
PF08889,PF11862:PF10908:PF13742:PF01330:PF05939,0,5,0,0,5,1013,0.0,1.0,0,0,0,0,0,0,1018,0,1.0,0,0
PF00577,PF13953:PF00345:PF15130:PF13954:PF17085,5,6,5,0,1,1012,0.83,1.0,1.0,0.91,3,3,2,0,1013,1.0,1.0,0.6,0.77
PF15150,PF12241:PF16325:PF15518:PF04671:PF07523,0,4,0,0,4,1014,0.0,1.0,0,0,0,0,0,0,1018,0,1.0,0,0
PF10731,PF06681:PF05666:PF10106:PF17193:PF07495,0,2,0,0,2,1016,0.0,1.0,0,0,0,0,0,0,1018,0,1.0,0,0
PF01269,PF03103:PF15973:PF04107:PF01620:PF01277,15,12,2,13,10,993,0.17,0.98,0.13,0.14,0,0,15,0,1003,0,0.99,0.0,0
PF04233,PF06074:PF02554:PF01312:PF00669:PF04451,0,1,0,0,1,1017,0.0,1.0,0,0,0,0,0,0,1018,0,1.0,0,0
PF14722,PF16043:PF10309:PF14662:PF12516:PF11500,7,14,1,6,13,998,0.07,0.98,0.14,0.09,0,0,7,0,1011,0,0.99,0.0,0
PF00163,PF00900:PF00849:PF16065:PF04442:PF03928,15,59,7,8,52,951,0.12,0.94,0.47,0.21,5,3,12,2,1001,0.6,0.99,0.2,0.34
PF16000,PF10699:PF09797:PF16401:PF13361:PF10022,3,31,2,1,29,986,0.06,0.97,0.67,0.2,0,0,3,0,1015,0,1.0,0.0,0
PF14616,PF03918:PF07353:PF09365:PF15771:PF10106,5,6,1,4,5,1008,0.17,0.99,0.2,0.18,0,0,5,0,1013,0,1.0,0.0,0
PF03529,PF12284:PF12045:PF13293:PF03867:PF10525,2,4,1,1,3,1013,0.25,1.0,0.5,0.35,1,1,1,0,1016,1.0,1.0,0.5,0.71
PF12019,PF08724:PF03831:PF14841:PF06890:PF03428,1,1,0,1,1,1016,0.0,1.0,0.0,-0.0,0,0,1,0,1017,0,1.0,0.0,0
PF01723,PF06679:PF16981:PF15475:PF14495:PF04736,1,4,0,1,4,1013,0.0,1.0,0.0,-0.0,0,0,1,0,1017,0,1.0,0.0,0
PF14106,PF11002:PF02151:PF14782:PF09454:PF05743,0,29,0,0,29,989,0.0,0.97,0,0,4,0,0,4,1014,0.0,1.0,0,0
PF13392,PF07929:PF04194:PF09698:PF14737:PF08788,7,29,3,4,26,985,0.1,0.97,0.43,0.2,0,0,7,0,1011,0,0.99,0.0,0
PF08541,PF08392:PF09261:PF02793:PF02449:PF07748,9,50,8,1,42,967,0.16,0.96,0.89,0.37,7,4,5,3,1006,0.57,0.99,0.44,0.5
PF04644,PF04643:PF01296:PF00220:PF15690:PF05324,1,4,1,0,3,1014,0.25,1.0,1.0,0.5,0,0,1,0,1017,0,1.0,0.0,0
PF03176,PF13323:PF02460:PF16414:PF12349:PF00368,12,55,6,6,49,957,0.11,0.95,0.5,0.22,15,0,12,15,991,0.0,0.97,0.0,-0.01
PF08294,PF01126:PF10276:PF07939:PF09340:PF07816,10,16,4,6,12,996,0.25,0.98,0.4,0.31,0,0,10,0,1008,0,0.99,0.0,0
PF04074,PF09785:PF04760:PF16686:PF04715:PF02540,0,44,0,0,44,974,0.0,0.96,0,0,1,0,0,1,1017,0.0,1.0,0,0
PF15621,PF04370:PF15062:PF11771:PF15036:PF15754,0,1,0,0,1,1017,0.0,1.0,0,0,0,0,0,0,1018,0,1.0,0,0
PF15820,PF15990:PF04359:PF06989:PF08653:PF14969,0,9,0,0,9,1009,0.0,0.99,0,0,0,0,0,0,1018,0,1.0,0,0
PF11628,PF16680:PF02189:PF03298:PF15388:PF15744,4,8,1,3,7,1007,0.12,0.99,0.25,0.17,0,0,4,0,1014,0,1.0,0.0,0
PF04003,PF08149:PF12490:PF11816:PF04192:PF08232,13,29,4,9,25,980,0.14,0.97,0.31,0.19,3,2,11,1,1004,0.67,0.99,0.15,0.32
PF14008,PF16656:PF02872:PF05011:PF16891:PF04152,26,51,23,3,28,964,0.45,0.97,0.88,0.62,5,5,21,0,992,1.0,0.98,0.19,0.43
PF09585,PF14290:PF06876:PF10994:PF17076:PF03745,1,0,0,1,0,1017,0,1.0,0.0,0,0,0,1,0,1017,0,1.0,0.0,0
PF07676,PF02897:PF00930:PF00326:PF12566:PF03059,23,49,15,8,34,961,0.31,0.96,0.65,0.43,7,6,17,1,994,0.86,0.98,0.26,0.47
PF07746,PF11800:PF12081:PF15150:PF14842:PF08479,0,0,0,0,0,1018,0,1.0,0,0,0,0,0,0,1018,0,1.0,0,0
PF06699,PF06218:PF02961:PF01234:PF00444:PF02560,14,20,5,9,15,989,0.25,0.98,0.36,0.29,1,1,13,0,1004,1.0,0.99,0.07,0.27
PF01281,PF07542:PF00327:PF01159:PF13092:PF02401,14,46,9,5,37,967,0.2,0.96,0.64,0.34,3,2,12,1,1003,0.67,0.99,0.14,0.3
PF02595,PF02565:PF11245:PF08497:PF17206:PF03050,1,1,0,1,1,1016,0.0,1.0,0.0,-0.0,0,0,1,0,1017,0,1.0,0.0,0
PF16485,PF01447:PF02868:PF00073:PF14232:PF02884,1,14,1,0,13,1004,0.07,0.99,1.0,0.27,0,0,1,0,1017,0,1.0,0.0,0
PF04438,PF14773:PF05030:PF08655:PF13959:PF16563,20,34,9,11,25,973,0.26,0.96,0.45,0.33,0,0,20,0,998,0,0.98,0.0,0
PF00198,PF02817:PF00364:PF10937:PF13824:PF07998,21,48,19,2,29,968,0.4,0.97,0.9,0.59,5,5,16,0,997,1.0,0.98,0.24,0.48
PF06172,PF01774:PF02284:PF01775:PF01680:PF09749,0,27,0,0,27,991,0.0,0.97,0,0,4,0,0,4,1014,0.0,1.0,0,0
PF08357,PF15037:PF14441:PF01285:PF07923:PF16742,9,15,8,1,7,1002,0.53,0.99,0.89,0.69,0,0,9,0,1009,0,0.99,0.0,0
PF10288,PF10022:PF16503:PF05827:PF06041:PF08245,5,49,3,2,46,967,0.06,0.95,0.6,0.18,3,2,3,1,1012,0.67,1.0,0.4,0.51
PF15741,PF17085:PF01840:PF10856:PF15060:PF15703,1,0,0,1,0,1017,0,1.0,0.0,0,0,0,1,0,1017,0,1.0,0.0,0
PF05039,PF15359:PF00236:PF01097:PF15370:PF01716,0,10,0,0,10,1008,0.0,0.99,0,0,0,0,0,0,1018,0,1.0,0,0
PF00375,PF03096:PF14798:PF00049:PF01294:PF05197,12,18,2,10,16,990,0.11,0.97,0.17,0.12,1,1,11,0,1006,1.0,0.99,0.08,0.29
PF12770,PF17109:PF11701:PF14420:PF06424:PF10441,13,27,8,5,19,986,0.3,0.98,0.62,0.42,2,2,11,0,1005,1.0,0.99,0.15,0.39
PF00692,PF00077:PF00607:PF02093:PF02337:PF12259,14,20,7,7,13,991,0.35,0.98,0.5,0.41,5,5,9,0,1004,1.0,0.99,0.36,0.59
PF06761,PF03241:PF04865:PF07411:PF15851:PF13722,0,0,0,0,0,1018,0,1.0,0,0,0,0,0,0,1018,0,1.0,0,0
PF14573,PF08093:PF15775:PF09361:PF07209:PF08744,0,2,0,0,2,1016,0.0,1.0,0,0,0,0,0,0,1018,0,1.0,0,0
PF12241,PF02277:PF14882:PF07157:PF03241:PF02543,1,6,0,1,6,1011,0.0,0.99,0.0,-0.0,0,0,1,0,1017,0,1.0,0.0,0
PF07030,PF09481:PF09343:PF02097:PF14248:PF15490,0,4,0,0,4,1014,0.0,1.0,0,0,0,0,0,0,1018,0,1.0,0,0
PF01176,PF01907:PF03298:PF03386:PF01922:PF05129,13,25,7,6,18,987,0.28,0.98,0.54,0.38,1,1,12,0,1005,1.0,0.99,0.08,0.28
PF16984,PF06585:PF06757:PF08840:PF03040:PF04775,3,19,2,1,17,998,0.11,0.98,0.67,0.26,1,0,3,1,1014,0.0,1.0,0.0,-0.0
PF16944,PF05508:PF08634:PF05030:PF08624:PF08630,2,14,0,2,14,1002,0.0,0.98,0.0,-0.01,0,0,2,0,1016,0,1.0,0.0,0
PF14992,PF08964:PF10856:PF15623:PF07957:PF03710,1,3,0,1,3,1014,0.0,1.0,0.0,-0.0,0,0,1,0,1017,0,1.0,0.0,0
PF11915,PF08631:PF16201:PF08146:PF15979:PF10487,22,30,13,9,17,979,0.43,0.97,0.59,0.49,1,1,21,0,996,1.0,0.98,0.05,0.21
PF02407,PF14113:PF00548:PF08411:PF04559:PF10279,5,13,3,2,10,1003,0.23,0.99,0.6,0.37,0,0,5,0,1013,0,1.0,0.0,0
PF04453,PF07499:PF04865:PF03944:PF11304:PF02572,0,5,0,0,5,1013,0.0,1.0,0,0,0,0,0,0,1018,0,1.0,0,0
PF00322,PF02394:PF05283:PF14946:PF02267:PF15794,1,15,1,0,14,1003,0.07,0.99,1.0,0.26,1,0,1,1,1016,0.0,1.0,0.0,-0.0
PF06394,PF06784:PF16860:PF06382:PF03073:PF06825,7,14,1,6,13,998,0.07,0.98,0.14,0.09,1,1,6,0,1011,1.0,0.99,0.14,0.38
PF08873,PF05290:PF02684:PF01645:PF01676:PF04898,0,21,0,0,21,997,0.0,0.98,0,0,1,0,0,1,1017,0.0,1.0,0,0
PF01063,PF12311:PF03358:PF04140:PF11807:PF00756,20,47,10,10,37,961,0.21,0.95,0.5,0.31,3,2,18,1,997,0.67,0.98,0.1,0.25
PF03834,PF07816:PF07896:PF01871:PF02630:PF05609,14,24,8,6,16,988,0.33,0.98,0.57,0.43,0,0,14,0,1004,0,0.99,0.0,0
PF15181,PF16477:PF15703:PF02063:PF14220:PF11870,1,5,0,1,5,1012,0.0,0.99,0.0,-0.0,0,0,1,0,1017,0,1.0,0.0,0
PF15164,PF02543:PF16861:PF12241:PF13722:PF07308,0,4,0,0,4,1014,0.0,1.0,0,0,0,0,0,0,1018,0,1.0,0,0
PF12604,PF03406:PF06070:PF07494:PF00308:PF12392,0,8,0,0,8,1010,0.0,0.99,0,0,0,0,0,0,1018,0,1.0,0,0
PF17215,PF17216:PF13638:PF07504:PF02128:PF12742,6,20,6,0,14,998,0.3,0.99,1.0,0.54,1,0,6,1,1011,0.0,0.99,0.0,-0.0
PF04333,PF08249:PF08908:PF10546:PF13827:PF01446,0,1,0,0,1,1017,0.0,1.0,0,0,0,0,0,0,1018,0,1.0,0,0
PF01035,PF01910:PF13741:PF15006:PF11711:PF07253,15,8,1,14,7,996,0.12,0.98,0.07,0.08,0,0,15,0,1003,0,0.99,0.0,0
PF06923,PF00766:PF08025:PF01512:PF06527:PF02659,0,19,0,0,19,999,0.0,0.98,0,0,0,0,0,0,1018,0,1.0,0,0
PF05638,PF00796:PF15556:PF17076:PF01316:PF15763,1,2,1,0,1,1016,0.5,1.0,1.0,0.71,0,0,1,0,1017,0,1.0,0.0,0
PF04277,PF15214:PF15272:PF15325:PF08483:PF15763,2,4,0,2,4,1012,0.0,0.99,0.0,-0.0,0,0,2,0,1016,0,1.0,0.0,0
PF03481,PF10437:PF01184:PF09825:PF12867:PF01118,8,37,5,3,32,978,0.14,0.97,0.62,0.28,2,1,7,1,1009,0.5,0.99,0.12,0.25
PF03638,PF01754:PF03909:PF05920:PF02919:PF04926,10,53,7,3,46,962,0.13,0.95,0.7,0.29,9,5,5,4,1004,0.56,0.99,0.5,0.52
PF07769,PF13722:PF07409:PF06450:PF07157:PF04865,0,1,0,0,1,1017,0.0,1.0,0,0,0,0,0,0,1018,0,1.0,0,0
PF01198,PF02284:PF00143:PF00124:PF08584:PF01791,24,22,6,18,16,978,0.27,0.97,0.25,0.24,1,1,23,0,994,1.0,0.98,0.04,0.2
PF16014,PF04632:PF07610:PF03534:PF08579:PF04196,0,3,0,0,3,1015,0.0,1.0,0,0,0,0,0,0,1018,0,1.0,0,0
PF02570,PF13557:PF16210:PF10077:PF03958:PF09201,4,14,4,0,10,1004,0.29,0.99,1.0,0.53,0,0,4,0,1014,0,1.0,0.0,0
PF00089,PF12032:PF08610:PF16030:PF02983:PF15494,126,30,25,101,5,887,0.83,0.9,0.2,0.38,2,2,124,0,892,1.0,0.88,0.02,0.12
PF14307,PF08762:PF16126:PF04196:PF08706:PF08275,0,13,0,0,13,1005,0.0,0.99,0,0,0,0,0,0,1018,0,1.0,0,0
PF11630,PF08194:PF15211:PF09117:PF14672:PF16649,0,1,0,0,1,1017,0.0,1.0,0,0,0,0,0,0,1018,0,1.0,0,0
PF01030,PF00757:PF14843:PF12772:PF09067:PF15913,10,11,6,4,5,1003,0.55,0.99,0.6,0.57,5,4,6,1,1007,0.8,0.99,0.4,0.56
PF09584,PF16669:PF02649:PF10524:PF03552:PF08606,0,37,0,0,37,981,0.0,0.96,0,0,3,0,0,3,1015,0.0,1.0,0,0
PF02803,PF00108:PF02036:PF02737:PF01796:PF00725,39,66,38,1,28,951,0.58,0.97,0.97,0.74,19,15,24,4,975,0.79,0.97,0.38,0.54
PF07742,PF15279:PF09816:PF05182:PF09808:PF07545,10,23,5,5,18,990,0.22,0.98,0.5,0.32,1,0,10,1,1007,0.0,0.99,0.0,-0.0
PF00060,PF10613:PF00497:PF10565:PF00003:PF01594,46,69,35,11,34,938,0.51,0.96,0.76,0.6,10,10,36,0,972,1.0,0.96,0.22,0.46
PF01618,PF14224:PF07476:PF03050:PF13247:PF13007,3,0,0,3,0,1015,0,1.0,0.0,0,0,0,3,0,1015,0,1.0,0.0,0
PF03940,PF11573:PF07942:PF16185:PF10673:PF10867,0,16,0,0,16,1002,0.0,0.98,0,0,1,0,0,1,1017,0.0,1.0,0,0
PF04710,PF16720:PF03784:PF07084:PF08925:PF15993,4,10,2,2,8,1006,0.2,0.99,0.5,0.31,0,0,4,0,1014,0,1.0,0.0,0
PF02035,PF08847:PF15838:PF08856:PF11057:PF15212,0,0,0,0,0,1018,0,1.0,0,0,0,0,0,0,1018,0,1.0,0,0
PF12735,PF12955:PF17132:PF04239:PF05450:PF06214,0,20,0,0,20,998,0.0,0.98,0,0,1,0,0,1,1017,0.0,1.0,0,0
PF08173,PF16327:PF03351:PF03104:PF13607:PF07919,0,49,0,0,49,969,0.0,0.95,0,0,3,0,0,3,1015,0.0,1.0,0,0
PF10950,PF01114:PF00184:PF06683:PF00323:PF12121,0,3,0,0,3,1015,0.0,1.0,0,0,0,0,0,0,1018,0,1.0,0,0
PF14775,PF13166:PF15877:PF01076:PF08647:PF04423,4,13,0,4,13,1001,0.0,0.98,0.0,-0.01,0,0,4,0,1014,0,1.0,0.0,0
PF03797,PF14449:PF14793:PF11862:PF13861:PF08744,2,1,0,2,1,1015,0.0,1.0,0.0,-0.0,0,0,2,0,1016,0,1.0,0.0,0
PF10397,PF08328:PF14698:PF10415:PF00206:PF14932,15,45,15,0,30,973,0.33,0.97,1.0,0.57,5,3,12,2,1001,0.6,0.99,0.2,0.34
PF05357,PF11954:PF07930:PF06176:PF12207:PF05989,0,6,0,0,6,1012,0.0,0.99,0,0,0,0,0,0,1018,0,1.0,0,0
PF06638,PF16954:PF15008:PF06951:PF15260:PF15177,3,19,0,3,19,996,0.0,0.98,0.0,-0.01,0,0,3,0,1015,0,1.0,0.0,0
PF13548,PF13677:PF16925:PF02369:PF11614:PF05034,1,5,0,1,5,1012,0.0,0.99,0.0,-0.0,0,0,1,0,1017,0,1.0,0.0,0
PF13709,PF01455:PF14052:PF13780:PF11026:PF11272,1,0,0,1,0,1017,0,1.0,0.0,0,0,0,1,0,1017,0,1.0,0.0,0
PF04389,PF02225:PF04258:PF01532:PF00884:PF04253,46,101,33,13,68,904,0.33,0.92,0.72,0.45,20,16,30,4,968,0.8,0.97,0.35,0.51
PF09396,PF09272:PF02983:PF15494:PF16030:PF05671,2,22,1,1,21,995,0.05,0.98,0.5,0.15,1,1,1,0,1016,1.0,1.0,0.5,0.71
PF12554,PF03760:PF04852:PF13805:PF15245:PF09340,5,18,1,4,17,996,0.06,0.98,0.2,0.1,0,0,5,0,1013,0,1.0,0.0,0
PF01056,PF02344:PF11851:PF15372:PF12232:PF01586,11,7,4,7,3,1004,0.57,0.99,0.36,0.45,1,1,10,0,1007,1.0,0.99,0.09,0.3
PF14283,PF13098:PF11775:PF06798:PF14328:PF08497,0,5,0,0,5,1013,0.0,1.0,0,0,0,0,0,0,1018,0,1.0,0,0
PF01369,PF12783:PF16213:PF09324:PF08174:PF16453,42,40,26,16,14,962,0.65,0.97,0.62,0.62,12,10,32,2,974,0.83,0.97,0.24,0.43
PF11288,PF00519:PF09666:PF13013:PF14512:PF04965,0,5,0,0,5,1013,0.0,1.0,0,0,0,0,0,0,1018,0,1.0,0,0
PF15878,PF05326:PF04013:PF08856:PF03888:PF11902,0,1,0,0,1,1017,0.0,1.0,0,0,0,0,0,0,1018,0,1.0,0,0
PF04231,PF09962:PF05448:PF12646:PF05151:PF01270,2,4,0,2,4,1012,0.0,0.99,0.0,-0.0,0,0,2,0,1016,0,1.0,0.0,0
PF01546,PF07687:PF00291:PF03417:PF02450:PF09767,37,77,20,17,57,924,0.26,0.93,0.54,0.34,5,5,32,0,981,1.0,0.97,0.14,0.36
PF07496,PF00628:PF10513:PF05964:PF12269:PF01429,20,106,17,3,89,909,0.16,0.91,0.85,0.35,14,7,13,7,991,0.5,0.98,0.35,0.41
PF02401,PF07298:PF14279:PF09991:PF05991:PF03193,5,10,0,5,10,1003,0.0,0.99,0.0,-0.01,0,0,5,0,1013,0,1.0,0.0,0
PF08468,PF11697:PF02465:PF02530:PF02119:PF12241,2,4,0,2,4,1012,0.0,0.99,0.0,-0.0,0,0,2,0,1016,0,1.0,0.0,0
PF05872,PF15442:PF05024:PF14050:PF10179:PF15067,0,16,0,0,16,1002,0.0,0.98,0,0,0,0,0,0,1018,0,1.0,0,0
PF05025,PF08334:PF15150:PF15319:PF08299:PF13269,6,3,0,6,3,1009,0.0,0.99,0.0,-0.0,0,0,6,0,1012,0,0.99,0.0,0
PF10170,PF08669:PF01571:PF16350:PF05690:PF07543,2,38,1,1,37,979,0.03,0.96,0.5,0.11,11,1,1,10,1006,0.09,0.99,0.5,0.21
PF04813,PF04812:PF12360:PF04618:PF04814:PF03867,1,6,1,0,5,1012,0.17,1.0,1.0,0.41,1,1,0,0,1017,1.0,1.0,1.0,1.0
PF01847,PF06127:PF05039:PF12597:PF01097:PF00236,11,17,4,7,13,994,0.24,0.98,0.36,0.28,0,0,11,0,1007,0,0.99,0.0,0
PF17006,PF01913:PF01580:PF06070:PF07804:PF17206,0,8,0,0,8,1010,0.0,0.99,0,0,0,0,0,0,1018,0,1.0,0,0
PF00479,PF02781:PF01182:PF08288:PF01925:PF16983,14,37,14,0,23,981,0.38,0.98,1.0,0.61,5,2,12,3,1001,0.4,0.99,0.14,0.23
PF15757,PF15776:PF03553:PF06056:PF06952:PF09461,0,4,0,0,4,1014,0.0,1.0,0,0,0,0,0,0,1018,0,1.0,0,0
PF14642,PF05179:PF16050:PF14654:PF06566:PF13288,1,12,0,1,12,1005,0.0,0.99,0.0,-0.0,1,0,1,1,1016,0.0,1.0,0.0,-0.0
PF12933,PF12934:PF14920:PF14918:PF14919:PF04961,0,4,0,0,4,1014,0.0,1.0,0,0,0,0,0,0,1018,0,1.0,0,0
PF01569,PF04769:PF03556:PF04819:PF14811:PF03417,40,25,12,28,13,965,0.48,0.96,0.3,0.36,3,3,37,0,978,1.0,0.96,0.07,0.27
PF10825,PF15833:PF15753:PF10412:PF01880:PF03739,0,9,0,0,9,1009,0.0,0.99,0,0,0,0,0,0,1018,0,1.0,0,0
PF08785,PF03731:PF03730:PF02735:PF13869:PF17215,10,36,9,1,27,981,0.25,0.97,0.9,0.47,18,5,5,13,995,0.28,0.98,0.5,0.36
PF02009,PF08027:PF01387:PF06217:PF01959:PF00871,0,8,0,0,8,1010,0.0,0.99,0,0,0,0,0,0,1018,0,1.0,0,0
PF04024,PF07866:PF16058:PF13239:PF06831:PF05097,0,23,0,0,23,995,0.0,0.98,0,0,0,0,0,0,1018,0,1.0,0,0
PF14993,PF01668:PF15204:PF15190:PF02632:PF15662,0,9,0,0,9,1009,0.0,0.99,0,0,0,0,0,0,1018,0,1.0,0,0
PF04636,PF05428:PF01153:PF15010:PF11315:PF04107,8,21,3,5,18,992,0.14,0.98,0.38,0.22,0,0,8,0,1010,0,0.99,0.0,0
PF04148,PF11264:PF04402:PF09459:PF12328:PF10161,4,12,2,2,10,1004,0.17,0.99,0.5,0.28,0,0,4,0,1014,0,1.0,0.0,0
PF11573,PF02403:PF12610:PF12162:PF02121:PF14596,4,35,4,0,31,983,0.11,0.97,1.0,0.33,1,0,4,1,1013,0.0,1.0,0.0,-0.0
PF02924,PF05309:PF07178:PF06586:PF05513:PF01913,0,2,0,0,2,1016,0.0,1.0,0,0,1,0,0,1,1017,0.0,1.0,0,0
PF05026,PF15916:PF14803:PF09296:PF09297:PF10169,12,13,4,8,9,997,0.31,0.98,0.33,0.31,1,1,11,0,1006,1.0,0.99,0.08,0.29
PF17169,PF09050:PF09049:PF09051:PF08961:PF01114,0,2,0,0,2,1016,0.0,1.0,0,0,0,0,0,0,1018,0,1.0,0,0
PF05076,PF12470:PF16173:PF02799:PF16116:PF17187,3,18,3,0,15,1000,0.17,0.99,1.0,0.41,1,1,2,0,1015,1.0,1.0,0.33,0.58
PF12567,PF12453:PF16066:PF03673:PF12355:PF12772,2,2,2,0,0,1016,1.0,1.0,1.0,1.0,1,1,1,0,1016,1.0,1.0,0.5,0.71
PF10506,PF11559:PF15784:PF15368:PF15066:PF06637,4,7,0,4,7,1007,0.0,0.99,0.0,-0.01,0,0,4,0,1014,0,1.0,0.0,0
PF09787,PF11831:PF15934:PF16026:PF13870:PF15821,7,19,3,4,16,995,0.16,0.98,0.43,0.25,0,0,7,0,1011,0,0.99,0.0,0
PF05334,PF04087:PF10496:PF12253:PF06428:PF08634,1,24,0,1,24,993,0.0,0.98,0.0,-0.0,1,0,1,1,1016,0.0,1.0,0.0,-0.0
PF14343,PF15771:PF07209:PF16804:PF15754:PF15380,0,1,0,0,1,1017,0.0,1.0,0,0,0,0,0,0,1018,0,1.0,0,0
PF15372,PF11568:PF12533:PF01586:PF12232:PF01056,1,15,1,0,14,1003,0.07,0.99,1.0,0.26,1,1,0,0,1017,1.0,1.0,1.0,1.0
PF06347,PF10951:PF11039:PF08308:PF06756:PF14224,5,0,0,5,0,1013,0,1.0,0.0,0,0,0,5,0,1013,0,1.0,0.0,0
PF08686,PF15913:PF16470:PF06583:PF05986:PF14843,11,24,9,2,15,992,0.38,0.98,0.82,0.55,7,4,7,3,1004,0.57,0.99,0.36,0.45
PF14512,PF06403:PF04451:PF16325:PF14251:PF02465,0,4,0,0,4,1014,0.0,1.0,0,0,0,0,0,0,1018,0,1.0,0,0
PF00641,PF08604:PF16764:PF17219:PF00929:PF00638,48,72,21,27,51,919,0.29,0.92,0.44,0.32,3,3,45,0,970,1.0,0.96,0.06,0.24
PF00638,PF08911:PF14975:PF12185:PF16764:PF08604,29,17,11,18,6,983,0.65,0.98,0.38,0.48,2,2,27,0,989,1.0,0.97,0.07,0.26
PF10585,PF16190:PF16191:PF16195:PF00899:PF14732,4,57,4,0,53,961,0.07,0.95,1.0,0.26,3,3,1,0,1014,1.0,1.0,0.75,0.87
PF15466,PF14885:PF05797:PF00796:PF02677:PF02595,0,4,0,0,4,1014,0.0,1.0,0,0,0,0,0,0,1018,0,1.0,0,0
PF00224,PF02887:PF02727:PF01179:PF02728:PF09248,39,44,28,11,16,963,0.64,0.97,0.72,0.66,14,8,31,6,973,0.57,0.96,0.21,0.33
PF09698,PF04740:PF04375:PF09684:PF13780:PF03616,0,3,0,0,3,1015,0.0,1.0,0,0,0,0,0,0,1018,0,1.0,0,0
PF05001,PF04990:PF04992:PF08343:PF11523:PF04687,7,12,4,3,8,1003,0.33,0.99,0.57,0.43,2,2,5,0,1011,1.0,1.0,0.29,0.53
PF06400,PF09303:PF06401:PF14762:PF08961:PF16173,2,6,2,0,4,1012,0.33,1.0,1.0,0.58,0,0,2,0,1016,0,1.0,0.0,0
PF10127,PF07805:PF09108:PF03241:PF03775:PF02955,1,5,0,1,5,1012,0.0,0.99,0.0,-0.0,0,0,1,0,1017,0,1.0,0.0,0
PF14647,PF14648:PF09494:PF09324:PF08005:PF12348,3,29,3,0,26,989,0.1,0.97,1.0,0.32,4,1,2,3,1012,0.25,1.0,0.33,0.29
PF16198,PF08068:PF01472:PF01509:PF09183:PF09157,10,28,10,0,18,990,0.36,0.98,1.0,0.59,6,6,4,0,1008,1.0,1.0,0.6,0.77
PF16687,PF15912:PF15557:PF07001:PF02040:PF15624,5,17,1,4,16,997,0.06,0.98,0.2,0.1,0,0,5,0,1013,0,1.0,0.0,0
PF03298,PF15003:PF03760:PF01922:PF01176:PF13564,3,26,1,2,25,990,0.04,0.97,0.33,0.11,1,0,3,1,1014,0.0,1.0,0.0,-0.0
PF15470,PF00936:PF10620:PF04533:PF04224:PF13499,0,125,0,0,125,893,0.0,0.88,0,0,0,0,0,0,1018,0,1.0,0,0
PF11933,PF03521:PF16799:PF11601:PF06512:PF16885,4,11,4,0,7,1007,0.36,0.99,1.0,0.6,1,1,3,0,1014,1.0,1.0,0.25,0.5
PF02234,PF08209:PF11250:PF15991:PF07797:PF07052,8,23,1,7,22,988,0.04,0.97,0.12,0.06,1,0,8,1,1009,0.0,0.99,0.0,-0.0
PF00440,PF08361:PF13421:PF04166:PF07149:PF02951,18,8,2,16,6,994,0.25,0.98,0.11,0.16,1,1,17,0,1000,1.0,0.98,0.06,0.23
PF00069,PF07714:PF00314:PF00139:PF11721:PF00659,346,192,155,191,37,635,0.81,0.78,0.45,0.48,14,14,332,0,672,1.0,0.67,0.04,0.16
PF07929,PF13392:PF04194:PF09698:PF14737:PF08788,5,28,0,5,28,985,0.0,0.97,0.0,-0.01,2,0,5,2,1011,0.0,0.99,0.0,-0.0
PF10509,PF07959:PF08544:PF00288:PF05038:PF00769,12,52,12,0,40,966,0.23,0.96,1.0,0.47,5,2,10,3,1003,0.4,0.99,0.17,0.25
PF12090,PF08729:PF15253:PF12887:PF12480:PF14818,2,14,0,2,14,1002,0.0,0.98,0.0,-0.01,1,0,2,1,1015,0.0,1.0,0.0,-0.0
PF00889,PF09412:PF01299:PF10338:PF08423:PF07896,8,55,5,3,50,960,0.09,0.95,0.62,0.22,5,1,7,4,1006,0.2,0.99,0.12,0.15
PF05460,PF08639:PF15328:PF05859:PF12319:PF04664,3,9,1,2,8,1007,0.11,0.99,0.33,0.19,0,0,3,0,1015,0,1.0,0.0,0
PF07990,PF12600:PF15073:PF00806:PF00376:PF08298,4,22,3,1,19,995,0.14,0.98,0.75,0.31,0,0,4,0,1014,0,1.0,0.0,0
PF05569,PF03831:PF17152:PF07499:PF07157:PF04954,1,3,0,1,3,1014,0.0,1.0,0.0,-0.0,0,0,1,0,1017,0,1.0,0.0,0
PF17167,PF06165:PF08302:PF09511:PF08303:PF12381,3,16,3,0,13,1002,0.19,0.99,1.0,0.43,3,1,2,2,1013,0.33,1.0,0.33,0.33
PF01566,PF07984:PF02705:PF13911:PF12620:PF08613,20,43,8,12,35,963,0.19,0.95,0.4,0.25,4,3,17,1,997,0.75,0.98,0.15,0.33
PF13310,PF01420:PF01254:PF06670:PF04764:PF01052,2,2,2,0,0,1016,1.0,1.0,1.0,1.0,0,0,2,0,1016,0,1.0,0.0,0
PF12014,PF10442:PF04300:PF03048:PF08268:PF08495,2,20,2,0,18,998,0.1,0.98,1.0,0.31,1,1,1,0,1016,1.0,1.0,0.5,0.71
PF14452,PF03069:PF16286:PF14085:PF06899:PF00097,0,76,0,0,76,942,0.0,0.93,0,0,0,0,0,0,1018,0,1.0,0,0
PF10494,PF15305:PF15370:PF06351:PF06581:PF07544,10,13,1,9,12,996,0.08,0.98,0.1,0.08,0,0,10,0,1008,0,0.99,0.0,0
PF01876,PF08347:PF09011:PF08517:PF12067:PF13775,14,22,6,8,16,988,0.27,0.98,0.43,0.33,0,0,14,0,1004,0,0.99,0.0,0
PF02446,PF08536:PF16594:PF01922:PF01910:PF12159,2,13,1,1,12,1004,0.08,0.99,0.5,0.19,0,0,2,0,1016,0,1.0,0.0,0
PF04427,PF13664:PF03942:PF03358:PF06244:PF00436,22,54,12,10,42,954,0.22,0.95,0.55,0.33,5,3,19,2,994,0.6,0.98,0.14,0.28
PF07558,PF14818:PF15624:PF15914:PF09441:PF09322,3,13,3,0,10,1005,0.23,0.99,1.0,0.48,0,0,3,0,1015,0,1.0,0.0,0
PF09745,PF01868:PF07545:PF04004:PF10332:PF13864,8,22,5,3,17,993,0.23,0.98,0.62,0.37,2,2,6,0,1010,1.0,0.99,0.25,0.5
PF04060,PF12883:PF08402:PF00528:PF04335:PF13732,4,41,3,1,38,976,0.07,0.96,0.75,0.23,3,2,2,1,1013,0.67,1.0,0.5,0.58
PF10048,PF13015:PF08086:PF01296:PF13180:PF04202,1,42,1,0,41,976,0.02,0.96,1.0,0.15,0,0,1,0,1017,0,1.0,0.0,0
PF01674,PF00965:PF10853:PF04176:PF00811:PF06658,8,22,3,5,19,991,0.14,0.98,0.38,0.22,4,2,6,2,1008,0.5,0.99,0.25,0.35
PF08509,PF15904:PF08376:PF13458:PF00211:PF04940,6,62,6,0,56,956,0.1,0.94,1.0,0.3,3,2,4,1,1011,0.67,1.0,0.33,0.47
PF03542,PF11864:PF02145:PF11881:PF12166:PF15917,5,21,5,0,16,997,0.24,0.98,1.0,0.48,2,2,3,0,1013,1.0,1.0,0.4,0.63
PF00142,PF06446:PF01097:PF16541:PF01279:PF10839,2,7,0,2,7,1009,0.0,0.99,0.0,-0.0,0,0,2,0,1016,0,1.0,0.0,0
PF06045,PF14683:PF14686:PF09284:PF16712:PF16709,3,18,3,0,15,1000,0.17,0.99,1.0,0.41,8,0,3,8,1007,0.0,0.99,0.0,-0.0
PF02224,PF01037:PF08982:PF07391:PF13657:PF15750,5,9,1,4,8,1005,0.11,0.99,0.2,0.14,0,0,5,0,1013,0,1.0,0.0,0
PF02572,PF06798:PF13722:PF01580:PF12477:PF07499,2,6,1,1,5,1011,0.17,0.99,0.5,0.29,0,0,2,0,1016,0,1.0,0.0,0
PF14842,PF14841:PF15518:PF01706:PF03241:PF01580,0,6,0,0,6,1012,0.0,0.99,0,0,1,0,0,1,1017,0.0,1.0,0,0
PF12824,PF07856:PF07681:PF14249:PF00127:PF16483,7,15,3,4,12,999,0.2,0.98,0.43,0.29,1,1,6,0,1011,1.0,0.99,0.14,0.38
PF12527,PF10361:PF08528:PF11669:PF05841:PF02116,0,10,0,0,10,1008,0.0,0.99,0,0,0,0,0,0,1018,0,1.0,0,0
PF06965,PF00524:PF05164:PF05065:PF11291:PF05685,3,6,1,2,5,1010,0.17,0.99,0.33,0.23,0,0,3,0,1015,0,1.0,0.0,0
PF04781,PF04780:PF08166:PF11699:PF15629:PF02916,2,13,2,0,11,1005,0.15,0.99,1.0,0.39,0,0,2,0,1016,0,1.0,0.0,0
PF05285,PF08158:PF09511:PF08302:PF10487:PF08303,15,22,8,7,14,989,0.36,0.98,0.53,0.43,3,1,14,2,1001,0.33,0.98,0.07,0.14
PF05726,PF02678:PF02744:PF01729:PF01087:PF01733,10,42,10,0,32,976,0.24,0.97,1.0,0.48,3,1,9,2,1006,0.33,0.99,0.1,0.18
PF15483,PF08404:PF08497:PF10908:PF14328:PF01943,1,0,0,1,0,1017,0,1.0,0.0,0,0,0,1,0,1017,0,1.0,0.0,0
PF06121,PF06482:PF01534:PF01392:PF01759:PF07204,2,41,2,0,39,977,0.05,0.96,1.0,0.22,4,1,1,3,1013,0.25,1.0,0.5,0.35
PF02844,PF02843:PF01071:PF00586:PF02769:PF00551,13,40,13,0,27,978,0.33,0.97,1.0,0.56,9,8,5,1,1004,0.89,0.99,0.62,0.74
PF07918,PF10295:PF03525:PF11162:PF08744:PF15774,0,3,0,0,3,1015,0.0,1.0,0,0,0,0,0,0,1018,0,1.0,0,0
PF11571,PF10496:PF15906:PF04437:PF15066:PF14958,8,29,5,3,24,986,0.17,0.97,0.62,0.32,2,1,7,1,1009,0.5,0.99,0.12,0.25
PF02683,PF13270:PF15503:PF11016:PF10333:PF15062,3,4,0,3,4,1011,0.0,0.99,0.0,-0.0,0,0,3,0,1015,0,1.0,0.0,0
PF07819,PF12612:PF07035:PF14498:PF08427:PF17034,12,32,5,7,27,979,0.16,0.97,0.42,0.24,4,1,11,3,1003,0.25,0.99,0.08,0.14
PF08068,PF16198:PF01472:PF01509:PF09183:PF04376,5,32,5,0,27,986,0.16,0.97,1.0,0.39,6,5,0,1,1012,0.83,1.0,1.0,0.91
PF12762,PF07889:PF01632:PF10181:PF13664:PF09769,19,27,5,14,22,977,0.19,0.96,0.26,0.2,1,1,18,0,999,1.0,0.98,0.05,0.23
PF16327,PF01578:PF11817:PF05758:PF03351:PF07919,1,23,1,0,22,995,0.04,0.98,1.0,0.21,3,0,1,3,1014,0.0,1.0,0.0,-0.0
PF03814,PF02669:PF06798:PF02277:PF15856:PF11638,1,7,1,0,6,1011,0.14,0.99,1.0,0.38,0,0,1,0,1017,0,1.0,0.0,0
PF07238,PF06761:PF02951:PF13700:PF07434:PF10856,1,4,0,1,4,1013,0.0,1.0,0.0,-0.0,0,0,1,0,1017,0,1.0,0.0,0
PF06832,PF04355:PF13995:PF10109:PF06070:PF14328,1,1,0,1,1,1016,0.0,1.0,0.0,-0.0,0,0,1,0,1017,0,1.0,0.0,0
PF05196,PF01091:PF01296:PF06540:PF09363:PF08523,1,11,1,0,10,1007,0.09,0.99,1.0,0.3,0,0,1,0,1017,0,1.0,0.0,0
PF04093,PF13502:PF01673:PF15143:PF07157:PF06403,2,2,1,1,1,1015,0.5,1.0,0.5,0.5,0,0,2,0,1016,0,1.0,0.0,0
PF10588,PF00384:PF04879:PF09326:PF01568:PF14710,17,24,15,2,9,992,0.62,0.99,0.88,0.74,2,1,16,1,1000,0.5,0.98,0.06,0.17
PF10357,PF00022:PF15361:PF16840:PF11187:PF15318,12,60,8,4,52,954,0.13,0.94,0.67,0.28,0,0,12,0,1006,0,0.99,0.0,0
PF16859,PF02129:PF06073:PF08783:PF14912:PF08934,0,27,0,0,27,991,0.0,0.97,0,0,0,0,0,0,1018,0,1.0,0,0
PF02129,PF08530:PF02065:PF09298:PF16874:PF16711,20,32,17,3,15,983,0.53,0.98,0.85,0.66,3,3,17,0,998,1.0,0.98,0.15,0.38
PF01483,PF16470:PF12580:PF15913:PF12583:PF09286,21,28,12,9,16,981,0.43,0.98,0.57,0.48,4,4,17,0,997,1.0,0.98,0.19,0.43
PF12422,PF05041:PF14952:PF12231:PF08514:PF12372,2,27,1,1,26,990,0.04,0.97,0.5,0.13,0,0,2,0,1016,0,1.0,0.0,0
PF05212,PF02590:PF06090:PF14476:PF05757:PF04669,12,22,6,6,16,990,0.27,0.98,0.5,0.36,1,1,11,0,1006,1.0,0.99,0.08,0.29
PF06905,PF15054:PF15884:PF01716:PF15719:PF14955,13,15,4,9,11,994,0.27,0.98,0.31,0.28,0,0,13,0,1005,0,0.99,0.0,0
PF15130,PF15231:PF15060:PF15685:PF10856:PF07149,1,0,0,1,0,1017,0,1.0,0.0,0,0,0,1,0,1017,0,1.0,0.0,0
PF17221,PF13183:PF03948:PF13335:PF01710:PF02165,1,15,0,1,15,1002,0.0,0.98,0.0,-0.0,0,0,1,0,1017,0,1.0,0.0,0
PF00238,PF02284:PF01997:PF05995:PF09749:PF06658,14,28,5,9,23,981,0.18,0.97,0.36,0.24,2,0,14,2,1002,0.0,0.98,0.0,-0.01
PF04621,PF12310:PF11620:PF02198:PF15661:PF04926,5,25,3,2,22,991,0.12,0.98,0.6,0.26,2,2,3,0,1013,1.0,1.0,0.4,0.63
PF00580,PF13361:PF12859:PF11781:PF10441:PF13355,18,25,16,2,9,991,0.64,0.99,0.89,0.75,3,3,15,0,1000,1.0,0.99,0.17,0.41
PF04183,PF06276:PF14231:PF09051:PF08165:PF08657,2,5,2,0,3,1013,0.4,1.0,1.0,0.63,0,0,2,0,1016,0,1.0,0.0,0
PF08900,PF01778:PF03900:PF06936:PF14340:PF01154,0,44,0,0,44,974,0.0,0.96,0,0,5,0,0,5,1013,0.0,1.0,0,0
PF12777,PF12780:PF03028:PF08385:PF08393:PF07728,38,56,37,1,19,961,0.66,0.98,0.97,0.79,33,31,7,2,978,0.94,0.99,0.82,0.87
PF09488,PF01338:PF14985:PF10974:PF03244:PF17066,1,3,0,1,3,1014,0.0,1.0,0.0,-0.0,0,0,1,0,1017,0,1.0,0.0,0
PF15551,PF15703:PF15814:PF15741:PF04624:PF09585,0,3,0,0,3,1015,0.0,1.0,0,0,0,0,0,0,1018,0,1.0,0,0
PF10221,PF11277:PF08158:PF10479:PF00680:PF00842,7,26,3,4,23,988,0.12,0.97,0.43,0.21,1,1,6,0,1011,1.0,0.99,0.14,0.38
PF04114,PF01694:PF12595:PF02544:PF06046:PF04666,16,71,10,6,61,941,0.14,0.93,0.62,0.28,8,4,12,4,998,0.5,0.98,0.25,0.35
PF11346,PF03238:PF04222:PF17206:PF09951:PF15186,1,2,0,1,2,1015,0.0,1.0,0.0,-0.0,0,0,1,0,1017,0,1.0,0.0,0
PF01407,PF07882:PF00519:PF03814:PF04911:PF02399,0,9,0,0,9,1009,0.0,0.99,0,0,0,0,0,0,1018,0,1.0,0,0
PF16582,PF02776:PF02775:PF13378:PF10329:PF02746,2,50,2,0,48,968,0.04,0.95,1.0,0.2,9,2,0,7,1009,0.22,0.99,1.0,0.47
PF08317,PF05513:PF12080:PF01913:PF11751:PF15935,5,2,1,4,1,1012,0.5,1.0,0.2,0.31,0,0,5,0,1013,0,1.0,0.0,0
PF14309,PF14383:PF12552:PF04118:PF14075:PF09743,10,17,7,3,10,998,0.41,0.99,0.7,0.53,0,0,10,0,1008,0,0.99,0.0,0
PF01812,PF04098:PF03467:PF16131:PF08081:PF13865,13,37,4,9,33,972,0.11,0.96,0.31,0.16,3,1,12,2,1003,0.33,0.99,0.08,0.16
PF09751,PF15388:PF07767:PF15390:PF14822:PF14798,7,15,4,3,11,1000,0.27,0.99,0.57,0.38,1,1,6,0,1011,1.0,0.99,0.14,0.38
PF03129,PF02403:PF00458:PF09180:PF00587:PF04073,40,61,31,9,30,948,0.51,0.96,0.78,0.61,10,10,30,0,978,1.0,0.97,0.25,0.49
PF16359,PF09239:PF07730:PF06580:PF08918:PF13493,1,19,1,0,18,999,0.05,0.98,1.0,0.23,0,0,1,0,1017,0,1.0,0.0,0
PF15274,PF05483:PF15717:PF15090:PF07260:PF05548,1,8,1,0,7,1010,0.12,0.99,1.0,0.35,0,0,1,0,1017,0,1.0,0.0,0
PF08043,PF10530:PF08063:PF00978:PF00645:PF03119,2,29,1,1,28,988,0.03,0.97,0.5,0.13,1,1,1,0,1016,1.0,1.0,0.5,0.71
PF14078,PF17189:PF16028:PF09694:PF02887:PF09154,0,37,0,0,37,981,0.0,0.96,0,0,1,0,0,1,1017,0.0,1.0,0,0
PF08636,PF11623:PF05387:PF16007:PF03823:PF11282,2,6,0,2,6,1010,0.0,0.99,0.0,-0.0,0,0,2,0,1016,0,1.0,0.0,0
PF13401,PF14630:PF09079:PF00437:PF16783:PF12054,14,35,8,6,27,977,0.23,0.97,0.57,0.35,3,3,11,0,1004,1.0,0.99,0.21,0.46
PF15917,PF09743:PF12166:PF08638:PF04118:PF15903,2,28,2,0,26,990,0.07,0.97,1.0,0.26,1,0,2,1,1015,0.0,1.0,0.0,-0.0
PF11026,PF01913:PF15518:PF11751:PF06834:PF03831,0,2,0,0,2,1016,0.0,1.0,0,0,0,0,0,0,1018,0,1.0,0,0
PF14109,PF14398:PF05398:PF03613:PF10079:PF11211,0,0,0,0,0,1018,0,1.0,0,0,0,0,0,0,1018,0,1.0,0,0
PF02487,PF05189:PF01300:PF09806:PF10504:PF12867,11,27,2,9,25,982,0.07,0.97,0.18,0.1,1,0,11,1,1006,0.0,0.99,0.0,-0.0
PF03666,PF16019:PF10188:PF02731:PF04189:PF02112,6,22,1,5,21,991,0.05,0.97,0.17,0.08,1,1,5,0,1012,1.0,1.0,0.17,0.41
PF06674,PF07377:PF05280:PF04986:PF11272:PF01913,3,6,3,0,3,1012,0.5,1.0,1.0,0.71,1,1,2,0,1015,1.0,1.0,0.33,0.58
PF07686,PF08205:PF13895:PF03921:PF00047:PF09291,57,53,29,28,24,937,0.55,0.95,0.51,0.5,12,10,47,2,959,0.83,0.95,0.18,0.37
PF15114,PF15141:PF15212:PF03050:PF10429:PF08497,0,0,0,0,0,1018,0,1.0,0,0,0,0,0,0,1018,0,1.0,0,0
PF00584,PF08228:PF02427:PF15305:PF15699:PF11947,9,8,2,7,6,1003,0.25,0.99,0.22,0.23,0,0,9,0,1009,0,0.99,0.0,0
PF14937,PF05234:PF15190:PF15107:PF08017:PF09428,4,10,1,3,9,1005,0.1,0.99,0.25,0.15,0,0,4,0,1014,0,1.0,0.0,0
PF10796,PF10146:PF07273:PF06160:PF04924:PF17176,0,5,0,0,5,1013,0.0,1.0,0,0,0,0,0,0,1018,0,1.0,0,0
PF07926,PF10481:PF12297:PF16830:PF05104:PF07989,9,16,3,6,13,996,0.19,0.98,0.33,0.24,0,0,9,0,1009,0,0.99,0.0,0
PF02427,PF02448:PF02531:PF15173:PF08576:PF15559,0,4,0,0,4,1014,0.0,1.0,0,0,0,0,0,0,1018,0,1.0,0,0
PF01965,PF06628:PF00199:PF01578:PF01212:PF01966,35,52,19,16,33,950,0.37,0.95,0.54,0.42,12,7,28,5,978,0.58,0.97,0.2,0.33
PF06493,PF15337:PF16967:PF11162:PF08744:PF02217,0,6,0,0,6,1012,0.0,0.99,0,0,0,0,0,0,1018,0,1.0,0,0
PF02565,PF04355:PF13247:PF06890:PF08411:PF11751,0,1,0,0,1,1017,0.0,1.0,0,0,0,0,0,0,1018,0,1.0,0,0
PF07965,PF08725:PF17205:PF00362:PF15636:PF06484,4,12,4,0,8,1006,0.33,0.99,1.0,0.58,4,4,0,0,1014,1.0,1.0,1.0,1.0
PF01827,PF07735:PF10442:PF08268:PF07734:PF08495,15,29,9,6,20,983,0.31,0.97,0.6,0.42,2,1,14,1,1002,0.5,0.99,0.07,0.18
PF02934,PF02637:PF16709:PF16712:PF16711:PF13336,11,22,9,2,13,994,0.41,0.99,0.82,0.57,1,0,11,1,1006,0.0,0.99,0.0,-0.0
PF08104,PF13368:PF12047:PF16885:PF05325:PF10564,0,18,0,0,18,1000,0.0,0.98,0,0,0,0,0,0,1018,0,1.0,0,0
PF16682,PF16685:PF11262:PF11732:PF10253:PF00746,2,13,2,0,11,1005,0.15,0.99,1.0,0.39,1,0,2,1,1015,0.0,1.0,0.0,-0.0
PF16360,PF13167:PF15086:PF09269:PF06780:PF01018,4,15,1,3,14,1000,0.07,0.98,0.25,0.12,1,1,3,0,1014,1.0,1.0,0.25,0.5
PF06814,PF03195:PF04765:PF01746:PF04819:PF08643,15,35,6,9,29,974,0.17,0.96,0.4,0.25,4,3,12,1,1002,0.75,0.99,0.2,0.38
PF01127,PF15013:PF10183:PF04178:PF00965:PF15454,8,27,4,4,23,987,0.15,0.97,0.5,0.26,1,0,8,1,1009,0.0,0.99,0.0,-0.0
PF03133,PF01975:PF02939:PF03914:PF01697:PF01544,31,74,18,13,56,931,0.24,0.93,0.58,0.35,6,5,26,1,986,0.83,0.97,0.16,0.36
PF00563,PF00990:PF00015:PF02203:PF00672:PF00158,9,30,6,3,24,985,0.2,0.97,0.67,0.36,11,4,5,7,1002,0.36,0.99,0.44,0.4
PF08451,PF00962:PF12213:PF11894:PF14837:PF16854,5,32,5,0,27,986,0.16,0.97,1.0,0.39,3,1,4,2,1011,0.33,0.99,0.2,0.26
PF10367,PF10366:PF00637:PF17122:PF12451:PF12816,18,38,17,1,21,979,0.45,0.98,0.94,0.64,7,7,11,0,1000,1.0,0.99,0.39,0.62
PF05978,PF06813:PF10022:PF07757:PF10288:PF01757,16,49,8,8,41,961,0.16,0.95,0.5,0.27,4,1,15,3,999,0.25,0.98,0.06,0.12
PF00700,PF07409:PF00669:PF03241:PF13722:PF09826,1,3,1,0,2,1015,0.33,1.0,1.0,0.58,0,0,1,0,1017,0,1.0,0.0,0
PF00639,PF09445:PF01846:PF09068:PF12237:PF04279,14,31,8,6,23,981,0.26,0.97,0.57,0.37,2,1,13,1,1003,0.5,0.99,0.07,0.19
PF11794,PF03241:PF12080:PF13722:PF17030:PF02554,0,0,0,0,0,1018,0,1.0,0,0,0,0,0,0,1018,0,1.0,0,0
PF02458,PF01063:PF03140:PF05368:PF07859:PF00141,33,113,19,14,94,891,0.17,0.89,0.58,0.27,20,13,20,7,978,0.65,0.97,0.39,0.49
PF03763,PF01643:PF06298:PF08523:PF01091:PF07958,10,13,2,8,11,997,0.15,0.98,0.2,0.17,0,0,10,0,1008,0,0.99,0.0,0
PF04356,PF03659:PF03178:PF01797:PF02958:PF14228,0,61,0,0,61,957,0.0,0.94,0,0,7,0,0,7,1011,0.0,0.99,0,0
PF07515,PF04941:PF14344:PF15108:PF14814:PF01913,0,5,0,0,5,1013,0.0,1.0,0,0,0,0,0,0,1018,0,1.0,0,0
PF01209,PF01294:PF06825:PF04690:PF05512:PF01680,10,18,2,8,16,992,0.11,0.98,0.2,0.14,0,0,10,0,1008,0,0.99,0.0,0
PF06057,PF12191:PF15771:PF05621:PF15190:PF15100,0,1,0,0,1,1017,0.0,1.0,0,0,0,0,0,0,1018,0,1.0,0,0
PF00308,PF08479:PF15518:PF14841:PF08274:PF08345,5,2,1,4,1,1012,0.5,1.0,0.2,0.31,0,0,5,0,1013,0,1.0,0.0,0
PF08867,PF09498:PF14842:PF08453:PF04349:PF01580,0,7,0,0,7,1011,0.0,0.99,0,0,0,0,0,0,1018,0,1.0,0,0
PF08093,PF05962:PF09365:PF12840:PF11402:PF15355,1,3,0,1,3,1014,0.0,1.0,0.0,-0.0,0,0,1,0,1017,0,1.0,0.0,0
PF07717,PF04408:PF04568:PF08148:PF16420:PF01923,70,88,69,1,19,929,0.78,0.98,0.99,0.87,5,5,65,0,948,1.0,0.94,0.07,0.26
PF14377,PF16727:PF11626:PF13438:PF09197:PF08914,7,16,3,4,13,998,0.19,0.98,0.43,0.28,1,0,7,1,1010,0.0,0.99,0.0,-0.0
PF01887,PF04222:PF14985:PF13689:PF11111:PF00796,0,3,0,0,3,1015,0.0,1.0,0,0,0,0,0,0,1018,0,1.0,0,0
PF03471,PF15450:PF06835:PF04739:PF03968:PF15110,5,10,0,5,10,1003,0.0,0.99,0.0,-0.01,0,0,5,0,1013,0,1.0,0.0,0
PF06372,PF12095:PF06549:PF01194:PF15952:PF08730,2,6,1,1,5,1011,0.17,0.99,0.5,0.29,0,0,2,0,1016,0,1.0,0.0,0
PF13785,PF15117:PF02530:PF08808:PF15033:PF17066,0,4,0,0,4,1014,0.0,1.0,0,0,0,0,0,0,1018,0,1.0,0,0
PF02562,PF17020:PF07547:PF12443:PF13694:PF08579,2,6,0,2,6,1010,0.0,0.99,0.0,-0.0,0,0,2,0,1016,0,1.0,0.0,0
PF06440,PF06209:PF05007:PF11717:PF00447:PF16508,2,54,1,1,53,963,0.02,0.95,0.5,0.09,6,1,1,5,1011,0.17,0.99,0.5,0.29
PF01081,PF07582:PF06983:PF03718:PF01809:PF13580,3,5,0,3,5,1010,0.0,0.99,0.0,-0.0,0,0,3,0,1015,0,1.0,0.0,0
PF00564,PF13240:PF02196:PF08926:PF16577:PF00611,38,31,12,26,19,961,0.39,0.96,0.32,0.33,6,6,32,0,980,1.0,0.97,0.16,0.39
PF06427,PF01501:PF06241:PF08530:PF02219:PF02449,10,64,8,2,56,952,0.12,0.94,0.8,0.3,3,2,8,1,1007,0.67,0.99,0.2,0.36
PF14636,PF14638:PF14637:PF14558:PF11597:PF04096,6,21,6,0,15,997,0.29,0.99,1.0,0.53,3,3,3,0,1012,1.0,1.0,0.5,0.71
PF16832,PF09108:PF13929:PF15518:PF02369:PF04965,0,1,0,0,1,1017,0.0,1.0,0,0,0,0,0,0,1018,0,1.0,0,0
PF06583,PF13882:PF12355:PF05473:PF12453:PF03921,1,10,1,0,9,1008,0.1,0.99,1.0,0.31,1,1,0,0,1017,1.0,1.0,1.0,1.0
PF06991,PF08209:PF03299:PF06413:PF01142:PF05346,7,38,6,1,32,979,0.16,0.97,0.86,0.36,6,4,3,2,1009,0.67,1.0,0.57,0.61
PF02415,PF00746:PF12499:PF14950:PF00073:PF02226,3,12,0,3,12,1003,0.0,0.99,0.0,-0.01,1,0,3,1,1014,0.0,1.0,0.0,-0.0
PF02653,PF12399:PF13732:PF08402:PF08352:PF14396,11,16,9,2,7,1000,0.56,0.99,0.82,0.67,3,3,8,0,1007,1.0,0.99,0.27,0.52
PF03742,PF08404:PF08093:PF10106:PF14512:PF06651,1,2,0,1,2,1015,0.0,1.0,0.0,-0.0,0,0,1,0,1017,0,1.0,0.0,0
PF03957,PF12498:PF08601:PF02173:PF11785:PF11787,3,10,2,1,8,1007,0.2,0.99,0.67,0.36,2,2,1,0,1015,1.0,1.0,0.67,0.82
PF08239,PF08005:PF07691:PF13402:PF03256:PF16558,9,38,6,3,32,977,0.16,0.97,0.67,0.31,1,1,8,0,1009,1.0,0.99,0.11,0.33
PF16112,PF14114:PF09498:PF10566:PF08681:PF03406,1,1,1,0,0,1017,1.0,1.0,1.0,1.0,0,0,1,0,1017,0,1.0,0.0,0
PF14338,PF11332:PF12920:PF01034:PF05991:PF13959,0,27,0,0,27,991,0.0,0.97,0,0,0,0,0,0,1018,0,1.0,0,0
PF16810,PF10504:PF01387:PF01698:PF15377:PF05612,8,2,0,8,2,1008,0.0,0.99,0.0,-0.0,0,0,8,0,1010,0,0.99,0.0,0
PF09249,PF17007:PF11751:PF13742:PF10279:PF06744,2,2,0,2,2,1014,0.0,1.0,0.0,-0.0,0,0,2,0,1016,0,1.0,0.0,0
PF16864,PF02545:PF08100:PF04093:PF16952:PF06807,11,33,4,7,29,978,0.12,0.96,0.36,0.2,0,0,11,0,1007,0,0.99,0.0,0
PF05388,PF00450:PF04252:PF09478:PF16655:PF00525,2,62,2,0,60,956,0.03,0.94,1.0,0.17,1,0,2,1,1015,0.0,1.0,0.0,-0.0
PF05835,PF05395:PF15691:PF02157:PF03298:PF15794,5,20,4,1,16,997,0.2,0.98,0.8,0.4,0,0,5,0,1013,0,1.0,0.0,0
PF01721,PF09095:PF07105:PF08682:PF14487:PF02304,0,4,0,0,4,1014,0.0,1.0,0,0,0,0,0,0,1018,0,1.0,0,0
PF07887,PF03514:PF03106:PF03407:PF01980:PF01092,11,38,11,0,27,980,0.29,0.97,1.0,0.53,5,4,7,1,1006,0.8,0.99,0.36,0.54
PF00999,PF16644:PF02254:PF08619:PF05631:PF01501,55,58,27,28,31,932,0.47,0.94,0.49,0.45,3,3,52,0,963,1.0,0.95,0.05,0.23
PF07916,PF12255:PF09327:PF06826:PF15168:PF06458,0,4,0,0,4,1014,0.0,1.0,0,0,0,0,0,0,1018,0,1.0,0,0
PF12114,PF07469:PF08815:PF16279:PF08832:PF08778,6,7,1,5,6,1006,0.14,0.99,0.17,0.15,6,1,5,5,1007,0.17,0.99,0.17,0.16
PF06623,PF00195:PF08344:PF14365:PF07654:PF03951,1,45,1,0,44,973,0.02,0.96,1.0,0.15,4,0,1,4,1013,0.0,1.0,0.0,-0.0
PF11652,PF15379:PF06485:PF17078:PF15553:PF06989,1,5,0,1,5,1012,0.0,0.99,0.0,-0.0,0,0,1,0,1017,0,1.0,0.0,0
PF09803,PF11093:PF06907:PF12494:PF02448:PF02044,10,6,1,9,5,1003,0.17,0.99,0.1,0.12,0,0,10,0,1008,0,0.99,0.0,0
PF05960,PF15377:PF14936:PF05612:PF15814:PF15053,1,2,0,1,2,1015,0.0,1.0,0.0,-0.0,0,0,1,0,1017,0,1.0,0.0,0
PF00668,PF16177:PF00975:PF13193:PF07774:PF00550,35,116,33,2,83,900,0.28,0.92,0.94,0.49,21,13,22,8,975,0.62,0.97,0.37,0.47
PF06783,PF00995:PF15433:PF10510:PF01200:PF02416,2,52,2,0,50,966,0.04,0.95,1.0,0.19,5,0,2,5,1011,0.0,0.99,0.0,-0.0
PF07426,PF10173:PF13097:PF01730:PF15313:PF00835,7,19,1,6,18,993,0.05,0.98,0.14,0.08,0,0,7,0,1011,0,0.99,0.0,0
PF17070,PF04296:PF06725:PF09493:PF12856:PF13751,0,4,0,0,4,1014,0.0,1.0,0,0,0,0,0,0,1018,0,1.0,0,0
PF09397,PF01580:PF08886:PF06070:PF06445:PF16325,5,11,5,0,6,1007,0.45,0.99,1.0,0.67,0,0,5,0,1013,0,1.0,0.0,0
PF01187,PF15133:PF11105:PF08627:PF09924:PF06730,11,12,3,8,9,998,0.25,0.98,0.27,0.25,0,0,11,0,1007,0,0.99,0.0,0
PF14564,PF06761:PF07149:PF03963:PF06798:PF13588,1,3,0,1,3,1014,0.0,1.0,0.0,-0.0,0,0,1,0,1017,0,1.0,0.0,0
PF00510,PF00146:PF05405:PF00421:PF03973:PF00507,9,34,8,1,26,983,0.24,0.97,0.89,0.45,5,1,8,4,1005,0.2,0.99,0.11,0.14
PF04205,PF00070:PF00998:PF02378:PF03180:PF13098,2,20,1,1,19,997,0.05,0.98,0.5,0.15,0,0,2,0,1016,0,1.0,0.0,0
PF05573,PF11775:PF06798:PF08886:PF03090:PF07157,0,0,0,0,0,1018,0,1.0,0,0,0,0,0,0,1018,0,1.0,0,0
PF14049,PF14047:PF15805:PF10488:PF15803:PF03458,0,2,0,0,2,1016,0.0,1.0,0,0,0,0,0,0,1018,0,1.0,0,0
PF05272,PF11751:PF07409:PF06798:PF06890:PF08411,0,1,0,0,1,1017,0.0,1.0,0,0,0,0,0,0,1018,0,1.0,0,0
PF05280,PF12241:PF03831:PF09826:PF07157:PF06070,4,4,1,3,3,1011,0.25,0.99,0.25,0.25,0,0,4,0,1014,0,1.0,0.0,0
PF16965,PF02277:PF07805:PF02336:PF07157:PF08497,1,6,0,1,6,1011,0.0,0.99,0.0,-0.0,0,0,1,0,1017,0,1.0,0.0,0
PF16720,PF03784:PF08027:PF12904:PF15302:PF13204,1,1,1,0,0,1017,1.0,1.0,1.0,1.0,0,0,1,0,1017,0,1.0,0.0,0
PF15220,PF11044:PF07392:PF05611:PF15175:PF15771,0,0,0,0,0,1018,0,1.0,0,0,0,0,0,0,1018,0,1.0,0,0
PF01286,PF09775:PF05181:PF04432:PF08564:PF07111,4,17,4,0,13,1001,0.24,0.99,1.0,0.48,0,0,4,0,1014,0,1.0,0.0,0
PF14224,PF15984:PF01618:PF05962:PF10951:PF15312,0,4,0,0,4,1014,0.0,1.0,0,0,0,0,0,0,1018,0,1.0,0,0
PF10310,PF10775:PF13741:PF15879:PF16594:PF02044,2,7,2,0,5,1011,0.29,1.0,1.0,0.53,0,0,2,0,1016,0,1.0,0.0,0
PF15686,PF15289:PF15324:PF00363:PF14946:PF05642,3,8,1,2,7,1008,0.12,0.99,0.33,0.2,0,0,3,0,1015,0,1.0,0.0,0
PF03915,PF12126:PF15246:PF00643:PF10377:PF04108,6,57,4,2,53,959,0.07,0.95,0.67,0.2,1,1,5,0,1012,1.0,1.0,0.17,0.41
PF00604,PF08744:PF10933:PF05947:PF16071:PF11196,2,0,0,2,0,1016,0,1.0,0.0,0,0,0,2,0,1016,0,1.0,0.0,0
PF00154,PF03198:PF00332:PF07983:PF04535:PF05078,16,44,9,7,35,967,0.2,0.96,0.56,0.32,5,3,13,2,1000,0.6,0.99,0.19,0.33
PF12138,PF09117:PF06377:PF08738:PF10542:PF15724,3,2,0,3,2,1013,0.0,1.0,0.0,-0.0,0,0,3,0,1015,0,1.0,0.0,0
PF06652,PF02793:PF01825:PF03827:PF08983:PF00002,3,65,3,0,62,953,0.05,0.94,1.0,0.21,5,1,2,4,1011,0.2,0.99,0.33,0.26
PF00050,PF09289:PF07648:PF01469:PF10591:PF00219,19,34,12,7,22,977,0.35,0.97,0.63,0.46,4,2,17,2,997,0.5,0.98,0.11,0.22
PF00534,PF08472:PF00862:PF16760:PF00128:PF08323,51,48,22,29,26,941,0.46,0.95,0.43,0.42,2,2,49,0,967,1.0,0.95,0.04,0.19
PF10157,PF01221:PF06039:PF10454:PF05564:PF15219,10,19,6,4,13,995,0.32,0.98,0.6,0.43,1,0,10,1,1007,0.0,0.99,0.0,-0.0
PF02828,PF00625:PF10608:PF09060:PF00595:PF10600,9,129,9,0,120,889,0.07,0.88,1.0,0.25,2,1,8,1,1008,0.5,0.99,0.11,0.23
PF12168,PF01706:PF13742:PF04170:PF08453:PF00906,1,6,0,1,6,1011,0.0,0.99,0.0,-0.0,0,0,1,0,1017,0,1.0,0.0,0
PF06708,PF05014:PF10868:PF09459:PF16594:PF08656,2,7,1,1,6,1010,0.14,0.99,0.5,0.26,0,0,2,0,1016,0,1.0,0.0,0
PF06859,PF01207:PF15925:PF05439:PF13847:PF05050,4,80,3,1,77,937,0.04,0.92,0.75,0.16,3,2,2,1,1013,0.67,1.0,0.5,0.58
PF15552,PF15180:PF08208:PF14216:PF03749:PF15696,1,11,1,0,10,1007,0.09,0.99,1.0,0.3,0,0,1,0,1017,0,1.0,0.0,0
PF08511,PF10213:PF12148:PF09280:PF09668:PF08325,5,37,4,1,33,980,0.11,0.97,0.8,0.29,3,2,3,1,1012,0.67,1.0,0.4,0.51
PF08114,PF06934:PF10106:PF15186:PF11697:PF01292,1,8,0,1,8,1009,0.0,0.99,0.0,-0.0,0,0,1,0,1017,0,1.0,0.0,0
PF00271,PF16203:PF13625:PF07999:PF02559:PF07516,232,18,18,214,0,786,1.0,0.79,0.08,0.25,2,2,230,0,786,1.0,0.77,0.01,0.08
PF06687,PF13805:PF01111:PF10775:PF01279:PF09340,7,22,2,5,20,991,0.09,0.98,0.29,0.15,0,0,7,0,1011,0,0.99,0.0,0
PF11421,PF07497:PF07498:PF16886:PF03856:PF00401,3,31,1,2,30,985,0.03,0.97,0.33,0.1,2,1,2,1,1014,0.5,1.0,0.33,0.41
PF13828,PF09580:PF08446:PF04987:PF10964:PF00664,0,113,0,0,113,905,0.0,0.89,0,0,8,0,0,8,1010,0.0,0.99,0,0
PF10062,PF11790:PF08562:PF09362:PF01613:PF14200,0,29,0,0,29,989,0.0,0.97,0,0,3,0,0,3,1015,0.0,1.0,0,0
PF08484,PF08421:PF02425:PF11967:PF07505:PF14344,2,2,2,0,0,1016,1.0,1.0,1.0,1.0,0,0,2,0,1016,0,1.0,0.0,0
PF10671,PF13269:PF14113:PF02951:PF16001:PF16838,0,5,0,0,5,1013,0.0,1.0,0,0,0,0,0,0,1018,0,1.0,0,0
PF03420,PF14685:PF14526:PF04225:PF03965:PF08437,1,13,0,1,13,1004,0.0,0.99,0.0,-0.0,0,0,1,0,1017,0,1.0,0.0,0
PF17209,PF00856:PF00676:PF02780:PF02779:PF00211,1,163,1,0,162,855,0.01,0.84,1.0,0.07,29,1,0,28,989,0.03,0.97,1.0,0.18
PF16007,PF05387:PF11282:PF08636:PF12926:PF08034,1,4,0,1,4,1013,0.0,1.0,0.0,-0.0,0,0,1,0,1017,0,1.0,0.0,0
PF03782,PF00094:PF10162:PF09175:PF13330:PF06119,12,50,12,0,38,968,0.24,0.96,1.0,0.48,5,5,7,0,1006,1.0,0.99,0.42,0.64
PF03588,PF17078:PF15052:PF15553:PF10999:PF02425,1,4,0,1,4,1013,0.0,1.0,0.0,-0.0,0,0,1,0,1017,0,1.0,0.0,0
PF01537,PF17007:PF04632:PF17164:PF12255:PF03944,0,2,0,0,2,1016,0.0,1.0,0,0,0,0,0,0,1018,0,1.0,0,0
PF12488,PF00796:PF17206:PF17076:PF03238:PF06074,1,1,0,1,1,1016,0.0,1.0,0.0,-0.0,0,0,1,0,1017,0,1.0,0.0,0
PF00659,PF08332:PF03822:PF16579:PF12605:PF14593,9,19,4,5,15,994,0.21,0.98,0.44,0.3,3,3,6,0,1009,1.0,0.99,0.33,0.58
PF16590,PF02951:PF17061:PF03050:PF06798:PF00997,1,4,0,1,4,1013,0.0,1.0,0.0,-0.0,0,0,1,0,1017,0,1.0,0.0,0
PF16033,PF10204:PF06809:PF07248:PF02245:PF03359,4,18,4,0,14,1000,0.22,0.99,1.0,0.47,1,0,4,1,1013,0.0,1.0,0.0,-0.0
PF12811,PF11211:PF14109:PF12840:PF14328:PF07902,0,1,0,0,1,1017,0.0,1.0,0,0,0,0,0,0,1018,0,1.0,0,0
PF00680,PF00910:PF00073:PF12381:PF04412:PF01989,12,15,12,0,3,1003,0.8,1.0,1.0,0.89,4,4,8,0,1006,1.0,0.99,0.33,0.58
PF04796,PF15097:PF07804:PF14552:PF15186:PF05567,0,4,0,0,4,1014,0.0,1.0,0,0,0,0,0,0,1018,0,1.0,0,0
PF08286,PF12240:PF08227:PF11291:PF05685:PF14997,0,12,0,0,12,1006,0.0,0.99,0,0,0,0,0,0,1018,0,1.0,0,0
PF15206,PF02277:PF05974:PF06082:PF12477:PF15281,0,6,0,0,6,1012,0.0,0.99,0,0,0,0,0,0,1018,0,1.0,0,0
PF13151,PF06681:PF15856:PF17010:PF15097:PF17193,0,2,0,0,2,1016,0.0,1.0,0,0,0,0,0,0,1018,0,1.0,0,0
PF06421,PF00679:PF03764:PF14492:PF16004:PF08364,21,60,21,0,39,958,0.35,0.96,1.0,0.58,23,8,13,15,982,0.35,0.97,0.38,0.35
PF01706,PF06834:PF14841:PF14842:PF15518:PF01136,1,3,1,0,2,1015,0.33,1.0,1.0,0.58,0,0,1,0,1017,0,1.0,0.0,0
PF11529,PF17206:PF06651:PF15482:PF07434:PF09498,0,1,0,0,1,1017,0.0,1.0,0,0,0,0,0,0,1018,0,1.0,0,0
PF10642,PF14877:PF08653:PF17017:PF17078:PF07404,0,7,0,0,7,1011,0.0,0.99,0,0,0,0,0,0,1018,0,1.0,0,0
PF06881,PF07500:PF15694:PF15693:PF08711:PF03715,4,40,3,1,37,977,0.07,0.96,0.75,0.23,3,1,3,2,1012,0.33,1.0,0.25,0.29
PF16876,PF08235:PF04571:PF12366:PF05029:PF08166,9,20,9,0,11,998,0.45,0.99,1.0,0.67,2,1,8,1,1008,0.5,0.99,0.11,0.23
PF03632,PF03636:PF03633:PF04935:PF16874:PF16875,8,13,4,4,9,1001,0.31,0.99,0.5,0.39,0,0,8,0,1010,0,0.99,0.0,0
PF15141,PF15212:PF17049:PF15114:PF15085:PF15097,0,4,0,0,4,1014,0.0,1.0,0,0,0,0,0,0,1018,0,1.0,0,0
PF09259,PF00267:PF10618:PF17006:PF09365:PF07022,2,4,0,2,4,1012,0.0,0.99,0.0,-0.0,0,0,2,0,1016,0,1.0,0.0,0
PF10360,PF04152:PF05334:PF08634:PF05508:PF15067,4,20,2,2,18,996,0.1,0.98,0.5,0.22,0,0,4,0,1014,0,1.0,0.0,0
PF11708,PF09282:PF10234:PF02470:PF04004:PF07223,12,18,4,8,14,992,0.22,0.98,0.33,0.26,0,0,12,0,1006,0,0.99,0.0,0
PF03271,PF15147:PF12510:PF00402:PF12130:PF10358,14,35,8,6,27,977,0.23,0.97,0.57,0.35,1,1,13,0,1004,1.0,0.99,0.07,0.27
PF14282,PF03847:PF05875:PF03959:PF07830:PF03661,2,57,2,0,55,961,0.04,0.95,1.0,0.18,3,1,1,2,1014,0.33,1.0,0.5,0.41
PF15768,PF05202:PF10009:PF17060:PF06832:PF06407,0,2,0,0,2,1016,0.0,1.0,0,0,0,0,0,0,1018,0,1.0,0,0
PF16314,PF05974:PF15212:PF06805:PF15484:PF11245,0,2,0,0,2,1016,0.0,1.0,0,0,0,0,0,0,1018,0,1.0,0,0
PF02433,PF12139:PF14983:PF01959:PF03331:PF01415,4,8,0,4,8,1006,0.0,0.99,0.0,-0.01,0,0,4,0,1014,0,1.0,0.0,0
PF02576,PF11255:PF14279:PF06420:PF06989:PF15045,0,1,0,0,1,1017,0.0,1.0,0,0,0,0,0,0,1018,0,1.0,0,0
PF15339,PF14866:PF00770:PF06875:PF05355:PF09252,0,4,0,0,4,1014,0.0,1.0,0,0,0,0,0,0,1018,0,1.0,0,0
PF12996,PF11750:PF12495:PF06243:PF05987:PF11992,0,1,0,0,1,1017,0.0,1.0,0,0,0,0,0,0,1018,0,1.0,0,0
PF04554,PF03466:PF02948:PF12933:PF02132:PF00377,1,15,0,1,15,1002,0.0,0.98,0.0,-0.0,0,0,1,0,1017,0,1.0,0.0,0
PF16647,PF05355:PF15119:PF17050:PF14866:PF07327,1,5,0,1,5,1012,0.0,0.99,0.0,-0.0,0,0,1,0,1017,0,1.0,0.0,0
PF07064,PF17034:PF10392:PF08640:PF10441:PF14906,5,22,0,5,22,991,0.0,0.97,0.0,-0.01,3,0,5,3,1010,0.0,0.99,0.0,-0.0
PF16837,PF11931:PF12108:PF16958:PF01715:PF12171,6,48,6,0,42,970,0.12,0.96,1.0,0.35,5,5,1,0,1012,1.0,1.0,0.83,0.91
PF04146,PF03467:PF10453:PF05030:PF15477:PF07742,25,32,12,13,20,973,0.38,0.97,0.48,0.41,3,3,22,0,993,1.0,0.98,0.12,0.34
PF08724,PF14841:PF01913:PF16449:PF12019:PF06805,0,3,0,0,3,1015,0.0,1.0,0,0,0,0,0,0,1018,0,1.0,0,0
PF14744,PF14745:PF14746:PF03894:PF09363:PF09051,8,9,7,1,2,1008,0.78,1.0,0.88,0.82,0,0,8,0,1010,0,0.99,0.0,0
PF09611,PF15529:PF01580:PF06007:PF17164:PF06505,0,7,0,0,7,1011,0.0,0.99,0,0,0,0,0,0,1018,0,1.0,0,0
PF06123,PF02014:PF00271:PF04969:PF08098:PF02066,0,247,0,0,247,771,0.0,0.76,0,0,6,0,0,6,1012,0.0,0.99,0,0
PF13180,PF12812:PF00219:PF03572:PF03146:PF07222,32,25,10,22,15,971,0.4,0.96,0.31,0.34,1,1,31,0,986,1.0,0.97,0.03,0.17
PF03311,PF05051:PF02114:PF00274:PF05529:PF01641,14,36,6,8,30,974,0.17,0.96,0.43,0.25,4,3,11,1,1003,0.75,0.99,0.21,0.4
PF03937,PF01987:PF03942:PF10276:PF10780:PF08695,3,23,1,2,22,993,0.04,0.98,0.33,0.11,1,0,3,1,1014,0.0,1.0,0.0,-0.0
PF05420,PF06406:PF12256:PF12255:PF03534:PF11713,0,1,0,0,1,1017,0.0,1.0,0,0,0,0,0,0,1018,0,1.0,0,0
PF02092,PF02091:PF06792:PF17167:PF06165:PF12733,11,11,7,4,4,1003,0.64,0.99,0.64,0.63,1,1,10,0,1007,1.0,0.99,0.09,0.3
PF17123,PF14624:PF13436:PF13639:PF15057:PF12861,17,130,16,1,114,887,0.12,0.89,0.94,0.32,6,5,12,1,1000,0.83,0.99,0.29,0.49
PF14521,PF16089:PF00708:PF08738:PF07464:PF07786,7,12,2,5,10,1001,0.17,0.99,0.29,0.21,0,0,7,0,1011,0,0.99,0.0,0
PF11774,PF10991:PF15243:PF08122:PF02466:PF00457,0,36,0,0,36,982,0.0,0.96,0,0,0,0,0,0,1018,0,1.0,0,0
PF09246,PF16533:PF17208:PF10534:PF14360:PF14847,2,18,1,1,17,999,0.06,0.98,0.5,0.16,1,1,1,0,1016,1.0,1.0,0.5,0.71
PF14911,PF14951:PF14910:PF08526:PF14950:PF03068,1,12,1,0,11,1006,0.08,0.99,1.0,0.29,0,0,1,0,1017,0,1.0,0.0,0
PF09359,PF03600:PF03124:PF12253:PF03105:PF10496,15,45,11,4,34,969,0.24,0.96,0.73,0.41,3,1,14,2,1001,0.33,0.98,0.07,0.14
PF16204,PF08072:PF09382:PF16202:PF02559:PF08061,7,18,7,0,11,1000,0.39,0.99,1.0,0.62,6,6,1,0,1011,1.0,1.0,0.86,0.93
PF13660,PF05161:PF07477:PF07488:PF03648:PF14918,12,11,7,5,4,1002,0.64,0.99,0.58,0.6,3,0,12,3,1003,0.0,0.99,0.0,-0.01
PF13597,PF12345:PF06969:PF06968:PF10105:PF15922,4,8,2,2,6,1008,0.25,0.99,0.5,0.35,2,2,2,0,1014,1.0,1.0,0.5,0.71
PF02326,PF09363:PF08369:PF09364:PF05436:PF11937,4,7,1,3,6,1008,0.14,0.99,0.25,0.18,0,0,4,0,1014,0,1.0,0.0,0
PF03950,PF04558:PF00749:PF04557:PF00458:PF09180,23,43,23,0,20,975,0.53,0.98,1.0,0.72,12,12,11,0,995,1.0,0.99,0.52,0.72
PF13550,PF17050:PF14534:PF10994:PF11493:PF17053,0,1,0,0,1,1017,0.0,1.0,0,0,0,0,0,0,1018,0,1.0,0,0
PF02696,PF04960:PF01241:PF16053:PF08315:PF09631,11,33,4,7,29,978,0.12,0.96,0.36,0.2,1,1,10,0,1007,1.0,0.99,0.09,0.3
PF02589,PF11870:PF13808:PF01706:PF10554:PF15750,6,4,0,6,4,1008,0.0,0.99,0.0,-0.0,0,0,6,0,1012,0,0.99,0.0,0
PF12883,PF13471:PF04335:PF04060:PF14685:PF00528,2,40,2,0,38,978,0.05,0.96,1.0,0.22,3,2,0,1,1015,0.67,1.0,1.0,0.82
PF03447,PF00742:PF01958:PF10000:PF13840:PF01817,16,33,16,0,17,985,0.48,0.98,1.0,0.69,3,3,13,0,1002,1.0,0.99,0.19,0.43
PF15171,PF06351:PF15370:PF00727:PF15071:PF02372,1,10,0,1,10,1007,0.0,0.99,0.0,-0.0,0,0,1,0,1017,0,1.0,0.0,0
PF02877,PF05406:PF08063:PF12174:PF11626:PF00644,19,55,19,0,36,963,0.35,0.96,1.0,0.58,7,7,12,0,999,1.0,0.99,0.37,0.6
PF11876,PF07495:PF03743:PF09874:PF03090:PF06082,0,9,0,0,9,1009,0.0,0.99,0,0,0,0,0,0,1018,0,1.0,0,0
PF02046,PF16053:PF10244:PF01470:PF12020:PF15013,3,24,1,2,23,992,0.04,0.98,0.33,0.11,1,1,2,0,1015,1.0,1.0,0.33,0.58
PF11145,PF04674:PF04525:PF04535:PF14853:PF03087,2,21,2,0,19,997,0.1,0.98,1.0,0.31,2,2,0,0,1016,1.0,1.0,1.0,1.0
PF00168,PF10540:PF08150:PF08165:PF01735:PF16165,133,29,23,110,6,879,0.79,0.89,0.17,0.34,3,3,130,0,885,1.0,0.87,0.02,0.14
PF04099,PF07061:PF01762:PF12326:PF00337:PF13334,16,54,8,8,46,956,0.15,0.95,0.5,0.25,8,4,12,4,998,0.5,0.98,0.25,0.35
PF00858,PF02320:PF03409:PF15880:PF06625:PF01215,57,29,12,45,17,944,0.41,0.94,0.21,0.27,1,1,56,0,961,1.0,0.94,0.02,0.13
PF14962,PF14721:PF14759:PF16020:PF01654:PF07681,2,14,2,0,12,1004,0.14,0.99,1.0,0.38,1,1,1,0,1016,1.0,1.0,0.5,0.71
PF00780,PF08826:PF09128:PF13281:PF13543:PF00786,38,39,17,21,22,958,0.44,0.96,0.45,0.42,3,3,35,0,980,1.0,0.97,0.08,0.28
PF04557,PF04558:PF03950:PF00749:PF02481:PF16313,11,36,11,0,25,982,0.31,0.98,1.0,0.55,12,11,0,1,1006,0.92,1.0,1.0,0.96
PF15965,PF15966:PF15146:PF00910:PF00073:PF00680,6,18,4,2,14,998,0.22,0.98,0.67,0.38,12,0,6,12,1000,0.0,0.98,0.0,-0.01
PF05298,PF15677:PF15707:PF09252:PF02087:PF16647,0,3,0,0,3,1015,0.0,1.0,0,0,0,0,0,0,1018,0,1.0,0,0
PF02226,PF08727:PF00548:PF00947:PF08461:PF02056,12,20,12,0,8,998,0.6,0.99,1.0,0.77,12,12,0,0,1006,1.0,1.0,1.0,1.0
PF06331,PF12806:PF09317:PF12418:PF08028:PF08657,11,3,3,8,0,1007,1.0,0.99,0.27,0.52,3,3,8,0,1007,1.0,0.99,0.27,0.52
PF07884,PF07896:PF15370:PF10218:PF10252:PF01241,6,8,1,5,7,1005,0.12,0.99,0.17,0.14,0,0,6,0,1012,0,0.99,0.0,0
PF02662,PF14322:PF02305:PF15049:PF17152:PF15623,0,2,0,0,2,1016,0.0,1.0,0,0,0,0,0,0,1018,0,1.0,0,0
PF03989,PF00521:PF16898:PF00986:PF08070:PF03477,12,27,10,2,17,989,0.37,0.98,0.83,0.55,6,5,7,1,1005,0.83,0.99,0.42,0.59
PF12807,PF13236:PF15044:PF05303:PF07721:PF13374,9,56,7,2,49,960,0.12,0.95,0.78,0.3,4,4,5,0,1009,1.0,1.0,0.44,0.67
PF15075,PF10127:PF07326:PF02951:PF07338:PF15079,1,9,0,1,9,1008,0.0,0.99,0.0,-0.0,0,0,1,0,1017,0,1.0,0.0,0
PF02057,PF10285:PF10284:PF12904:PF05111:PF01114,1,2,0,1,2,1015,0.0,1.0,0.0,-0.0,0,0,1,0,1017,0,1.0,0.0,0
PF06483,PF07382:PF14600:PF08520:PF03323:PF08329,0,12,0,0,12,1006,0.0,0.99,0,0,0,0,0,0,1018,0,1.0,0,0
PF08190,PF02163:PF03619:PF06258:PF09814:PF01255,26,52,12,14,40,952,0.23,0.95,0.46,0.3,7,4,22,3,989,0.57,0.98,0.15,0.29
PF16036,PF11652:PF15460:PF15553:PF03618:PF06485,4,7,0,4,7,1007,0.0,0.99,0.0,-0.01,0,0,4,0,1014,0,1.0,0.0,0
PF08337,PF01833:PF01403:PF16422:PF09271:PF03859,11,51,10,1,41,966,0.2,0.96,0.91,0.41,7,3,8,4,1003,0.43,0.99,0.27,0.34
PF00075,PF12259:PF01693:PF14529:PF00589:PF09337,45,77,26,19,51,922,0.34,0.93,0.58,0.41,8,8,37,0,973,1.0,0.96,0.18,0.41
PF06501,PF14685:PF04160:PF10118:PF05103:PF04225,1,12,0,1,12,1005,0.0,0.99,0.0,-0.0,0,0,1,0,1017,0,1.0,0.0,0
PF07853,PF03922:PF01752:PF17188:PF11967:PF11130,0,2,0,0,2,1016,0.0,1.0,0,0,0,0,0,0,1018,0,1.0,0,0
PF02041,PF12435:PF11338:PF15677:PF09227:PF07082,2,10,0,2,10,1006,0.0,0.99,0.0,-0.0,0,0,2,0,1016,0,1.0,0.0,0
PF00919,PF01938:PF01967:PF06969:PF13597:PF08608,20,30,15,5,15,983,0.5,0.98,0.75,0.6,3,3,17,0,998,1.0,0.98,0.15,0.38
PF05231,PF04917:PF12729:PF11751:PF12255:PF15168,2,5,0,2,5,1011,0.0,0.99,0.0,-0.0,0,0,2,0,1016,0,1.0,0.0,0
PF10340,PF03576:PF10868:PF01947:PF08738:PF09056,0,4,0,0,4,1014,0.0,1.0,0,0,0,0,0,0,1018,0,1.0,0,0
PF11214,PF05939:PF00669:PF06890:PF06798:PF04451,0,1,0,0,1,1017,0.0,1.0,0,0,0,0,0,0,1018,0,1.0,0,0
PF09230,PF09033:PF05422:PF10287:PF16979:PF16116,3,13,0,3,13,1002,0.0,0.98,0.0,-0.01,0,0,3,0,1015,0,1.0,0.0,0
PF11001,PF04090:PF08528:PF13002:PF10104:PF10332,7,16,4,3,12,999,0.25,0.99,0.57,0.37,0,0,7,0,1011,0,0.99,0.0,0
PF03730,PF02735:PF03731:PF08785:PF10172:PF13869,17,34,17,0,17,984,0.5,0.98,1.0,0.7,11,8,9,3,998,0.73,0.99,0.47,0.58
PF05603,PF15165:PF15302:PF10284:PF10166:PF09367,4,2,1,3,1,1013,0.5,1.0,0.25,0.35,0,0,4,0,1014,0,1.0,0.0,0
PF12643,PF12638:PF00537:PF06232:PF16716:PF06912,3,12,1,2,11,1004,0.08,0.99,0.33,0.16,0,0,3,0,1015,0,1.0,0.0,0
PF09404,PF12904:PF05111:PF15467:PF01114:PF15302,10,2,0,10,2,1006,0.0,0.99,0.0,-0.0,0,0,10,0,1008,0,0.99,0.0,0
PF15602,PF16108:PF00527:PF04973:PF01865:PF17172,0,8,0,0,8,1010,0.0,0.99,0,0,0,0,0,0,1018,0,1.0,0,0
PF02082,PF12242:PF06780:PF09614:PF03472:PF05128,1,2,1,0,1,1016,0.5,1.0,1.0,0.71,0,0,1,0,1017,0,1.0,0.0,0
PF11338,PF09510:PF08331:PF06681:PF17008:PF09684,4,1,0,4,1,1013,0.0,1.0,0.0,-0.0,0,0,4,0,1014,0,1.0,0.0,0
PF02739,PF11671:PF15374:PF14353:PF03023:PF14160,5,9,0,5,9,1004,0.0,0.99,0.0,-0.01,0,0,5,0,1013,0,1.0,0.0,0
PF05018,PF02586:PF08232:PF03920:PF09453:PF13925,15,29,11,4,18,985,0.38,0.98,0.73,0.52,3,2,13,1,1002,0.67,0.99,0.13,0.29
PF10210,PF02237:PF10437:PF09825:PF12680:PF15884,6,13,2,4,11,1001,0.15,0.99,0.33,0.22,1,0,6,1,1011,0.0,0.99,0.0,-0.0
PF03708,PF14421:PF09003:PF13101:PF02305:PF17152,2,4,0,2,4,1012,0.0,0.99,0.0,-0.0,0,0,2,0,1016,0,1.0,0.0,0
PF01904,PF04370:PF07484:PF15391:PF15023:PF15681,7,4,0,7,4,1007,0.0,0.99,0.0,-0.01,0,0,7,0,1011,0,0.99,0.0,0
PF08034,PF11282:PF16007:PF12926:PF11623:PF04852,0,8,0,0,8,1010,0.0,0.99,0,0,0,0,0,0,1018,0,1.0,0,0
PF00557,PF14826:PF01285:PF05195:PF03615:PF08512,53,33,26,27,7,958,0.79,0.97,0.49,0.61,6,6,47,0,965,1.0,0.95,0.11,0.33
PF03400,PF05634:PF04797:PF01750:PF07084:PF01219,2,13,0,2,13,1003,0.0,0.99,0.0,-0.01,0,0,2,0,1016,0,1.0,0.0,0
PF11710,PF04910:PF07967:PF08600:PF11928:PF03851,15,26,5,10,21,982,0.19,0.97,0.33,0.24,3,1,14,2,1001,0.33,0.98,0.07,0.14
PF12884,PF12886:PF14438:PF16794:PF06741:PF09779,1,23,1,0,22,995,0.04,0.98,1.0,0.21,2,0,1,2,1015,0.0,1.0,0.0,-0.0
PF02308,PF07392:PF14877:PF10563:PF15046:PF15050,2,10,1,1,9,1007,0.1,0.99,0.5,0.22,0,0,2,0,1016,0,1.0,0.0,0
PF09845,PF06136:PF02319:PF04098:PF15519:PF14304,0,46,0,0,46,972,0.0,0.95,0,0,3,0,0,3,1015,0.0,1.0,0,0
PF05434,PF04756:PF00277:PF04527:PF15008:PF05497,6,15,3,3,12,1000,0.2,0.99,0.5,0.31,0,0,6,0,1012,0,0.99,0.0,0
PF09405,PF10264:PF08729:PF09469:PF14545:PF04182,8,16,5,3,11,999,0.31,0.99,0.62,0.44,2,1,7,1,1009,0.5,0.99,0.12,0.25
PF09236,PF15838:PF15754:PF08093:PF05728:PF15771,1,5,0,1,5,1012,0.0,0.99,0.0,-0.0,0,0,1,0,1017,0,1.0,0.0,0
PF07911,PF06645:PF05676:PF09793:PF10310:PF10775,2,18,0,2,18,998,0.0,0.98,0.0,-0.01,2,0,2,2,1014,0.0,1.0,0.0,-0.0
PF01384,PF01597:PF05995:PF02284:PF05047:PF00793,16,47,5,11,42,960,0.11,0.95,0.31,0.16,3,1,15,2,1000,0.33,0.98,0.06,0.14
PF04263,PF04265:PF01259:PF01014:PF02222:PF14768,19,26,13,6,13,986,0.5,0.98,0.68,0.58,1,0,19,1,998,0.0,0.98,0.0,-0.0
PF01747,PF14306:PF00273:PF09164:PF06746:PF05378,9,34,9,0,25,984,0.26,0.98,1.0,0.51,0,0,9,0,1009,0,0.99,0.0,0
PF14479,PF14420:PF12773:PF17046:PF06479:PF14786,12,25,5,7,20,986,0.2,0.97,0.42,0.28,3,3,9,0,1006,1.0,0.99,0.25,0.5
PF14317,PF12608:PF00066:PF11936:PF06816:PF11904,0,21,0,0,21,997,0.0,0.98,0,0,3,0,0,3,1015,0.0,1.0,0,0
PF14611,PF11331:PF00649:PF08624:PF05030:PF15862,4,20,0,4,20,994,0.0,0.98,0.0,-0.01,0,0,4,0,1014,0,1.0,0.0,0
PF04290,PF12857:PF13478:PF16326:PF08352:PF01032,6,14,6,0,8,1004,0.43,0.99,1.0,0.65,2,2,4,0,1012,1.0,1.0,0.33,0.58
PF01514,PF01752:PF08479:PF10974:PF14841:PF08334,0,4,0,0,4,1014,0.0,1.0,0,0,0,0,0,0,1018,0,1.0,0,0
PF07985,PF00181:PF03947:PF08294:PF07542:PF03567,12,46,7,5,39,967,0.15,0.96,0.58,0.28,7,4,8,3,1003,0.57,0.99,0.33,0.43
PF05739,PF02269:PF00804:PF11416:PF04859:PF06858,35,50,23,12,27,956,0.46,0.96,0.66,0.53,3,3,32,0,983,1.0,0.97,0.09,0.29
PF13757,PF15057:PF06668:PF08487:PF02743:PF13768,0,34,0,0,34,984,0.0,0.97,0,0,6,0,0,6,1012,0.0,0.99,0,0
PF16712,PF16711:PF16709:PF16874:PF02065:PF16875,1,8,1,0,7,1010,0.12,0.99,1.0,0.35,1,0,1,1,1016,0.0,1.0,0.0,-0.0
PF12916,PF05552:PF11272:PF12101:PF13689:PF08258,1,0,0,1,0,1017,0,1.0,0.0,0,0,0,1,0,1017,0,1.0,0.0,0
PF04232,PF07963:PF00345:PF15750:PF07149:PF03710,3,9,1,2,8,1007,0.11,0.99,0.33,0.19,0,0,3,0,1015,0,1.0,0.0,0
PF14009,PF14368:PF03195:PF04720:PF05078:PF04690,8,27,1,7,26,984,0.04,0.97,0.12,0.05,4,0,8,4,1006,0.0,0.99,0.0,-0.01
PF15052,PF02425:PF03588:PF15553:PF17017:PF14877,3,5,0,3,5,1010,0.0,0.99,0.0,-0.0,0,0,3,0,1015,0,1.0,0.0,0
PF12631,PF10396:PF03648:PF07477:PF07488:PF16711,6,16,6,0,10,1002,0.38,0.99,1.0,0.61,3,0,6,3,1009,0.0,0.99,0.0,-0.0
PF03098,PF08030:PF08022:PF01794:PF00036:PF16901,28,79,18,10,61,929,0.23,0.93,0.64,0.36,40,14,14,26,964,0.35,0.96,0.5,0.4
PF10926,PF04166:PF15334:PF10073:PF06826:PF15725,0,7,0,0,7,1011,0.0,0.99,0,0,0,0,0,0,1018,0,1.0,0,0
PF08590,PF17146:PF07145:PF01713:PF06741:PF15017,14,30,12,2,18,986,0.4,0.98,0.86,0.58,5,4,10,1,1003,0.8,0.99,0.29,0.47
PF01991,PF16454:PF05296:PF12162:PF03665:PF14596,8,15,2,6,13,997,0.13,0.98,0.25,0.17,0,0,8,0,1010,0,0.99,0.0,0
PF01098,PF07361:PF04247:PF00358:PF09397:PF09678,10,18,2,8,16,992,0.11,0.98,0.2,0.14,0,0,10,0,1008,0,0.99,0.0,0
PF03456,PF02141:PF03455:PF12335:PF10240:PF02893,27,66,27,0,39,952,0.41,0.96,1.0,0.63,10,10,17,0,991,1.0,0.98,0.37,0.6
PF15387,PF05838:PF16259:PF06505:PF04351:PF01752,2,2,0,2,2,1014,0.0,1.0,0.0,-0.0,0,0,2,0,1016,0,1.0,0.0,0
PF15895,PF15553:PF17078:PF15379:PF03618:PF15460,0,4,0,0,4,1014,0.0,1.0,0,0,0,0,0,0,1018,0,1.0,0,0
PF13520,PF13906:PF00154:PF07969:PF06609:PF00332,74,58,35,39,23,921,0.6,0.94,0.47,0.5,8,8,66,0,944,1.0,0.94,0.11,0.32
PF08086,PF04099:PF13839:PF01967:PF01964:PF15922,1,38,0,1,38,979,0.0,0.96,0.0,-0.01,5,0,1,5,1012,0.0,0.99,0.0,-0.0
PF13477,PF05159:PF11997:PF10111:PF04413:PF00308,0,6,0,0,6,1012,0.0,0.99,0,0,0,0,0,0,1018,0,1.0,0,0
PF10411,PF12477:PF05109:PF04671:PF04222:PF07411,0,1,0,0,1,1017,0.0,1.0,0,0,0,0,0,0,1018,0,1.0,0,0
PF07910,PF07782:PF13890:PF03615:PF07810:PF08216,18,26,5,13,21,979,0.19,0.97,0.28,0.21,4,3,15,1,999,0.75,0.98,0.17,0.35
PF11803,PF04321:PF14524:PF00908:PF16363:PF01041,3,50,3,0,47,968,0.06,0.95,1.0,0.24,7,2,1,5,1010,0.29,0.99,0.67,0.43
PF01214,PF14798:PF13593:PF00956:PF15251:PF16054,19,28,7,12,21,978,0.25,0.97,0.37,0.29,1,0,19,1,998,0.0,0.98,0.0,-0.0
PF03023,PF08343:PF14220:PF17154:PF13657:PF11109,8,8,1,7,7,1003,0.12,0.99,0.12,0.12,0,0,8,0,1010,0,0.99,0.0,0
PF09646,PF09861:PF08453:PF08707:PF04671:PF09611,0,4,0,0,4,1014,0.0,1.0,0,0,0,0,0,0,1018,0,1.0,0,0
PF13244,PF17152:PF15577:PF15856:PF17014:PF01673,0,5,0,0,5,1013,0.0,1.0,0,0,0,0,0,0,1018,0,1.0,0,0
PF12002,PF16193:PF05496:PF16565:PF09079:PF16725,14,27,14,0,13,991,0.52,0.99,1.0,0.72,2,2,12,0,1004,1.0,0.99,0.14,0.38
PF10559,PF00344:PF00101:PF14853:PF11960:PF10660,8,26,8,0,18,992,0.31,0.98,1.0,0.55,0,0,8,0,1010,0,0.99,0.0,0
PF04144,PF00992:PF14802:PF04440:PF01730:PF09496,14,11,5,9,6,998,0.45,0.99,0.36,0.4,0,0,14,0,1004,0,0.99,0.0,0
PF02544,PF13506:PF01731:PF03088:PF01758:PF03062,26,58,11,15,47,945,0.19,0.94,0.42,0.26,3,2,24,1,991,0.67,0.98,0.08,0.22
PF14353,PF10380:PF07010:PF03640:PF07476:PF01669,0,2,0,0,2,1016,0.0,1.0,0,0,0,0,0,0,1018,0,1.0,0,0
PF15760,PF04691:PF05836:PF15770:PF14866:PF15683,0,1,0,0,1,1017,0.0,1.0,0,0,0,0,0,0,1018,0,1.0,0,0
PF03755,PF13005:PF10375:PF10490:PF02108:PF16872,0,5,0,0,5,1013,0.0,1.0,0,0,0,0,0,0,1018,0,1.0,0,0
PF00167,PF14798:PF05308:PF00048:PF04893:PF00446,9,28,4,5,24,985,0.14,0.97,0.44,0.24,2,1,8,1,1008,0.5,0.99,0.11,0.23
PF04508,PF12384:PF12596:PF05869:PF07530:PF14949,2,15,2,0,13,1003,0.13,0.99,1.0,0.36,3,2,0,1,1015,0.67,1.0,1.0,0.82
PF04848,PF00669:PF11124:PF09461:PF08453:PF15023,3,3,0,3,3,1012,0.0,0.99,0.0,-0.0,0,0,3,0,1015,0,1.0,0.0,0
PF06100,PF14519:PF15770:PF07327:PF05836:PF09232,2,1,0,2,1,1015,0.0,1.0,0.0,-0.0,0,0,2,0,1016,0,1.0,0.0,0
PF09612,PF14866:PF03553:PF02941:PF15680:PF08792,0,2,0,0,2,1016,0.0,1.0,0,0,0,0,0,0,1018,0,1.0,0,0
PF15307,PF13011:PF12658:PF00669:PF15730:PF07243,0,3,0,0,3,1015,0.0,1.0,0,0,0,0,0,0,1018,0,1.0,0,0
PF13417,PF02798:PF13409:PF13679:PF14497:PF00647,53,78,30,23,48,917,0.38,0.93,0.57,0.43,11,10,43,1,964,0.91,0.96,0.19,0.4
PF00054,PF02210:PF01049:PF06009:PF01463:PF00594,15,46,13,2,33,970,0.28,0.97,0.87,0.48,2,2,13,0,1003,1.0,0.99,0.13,0.36
PF01786,PF00301:PF04759:PF01871:PF04367:PF14249,12,14,4,8,10,996,0.29,0.98,0.33,0.3,0,0,12,0,1006,0,0.99,0.0,0
PF09922,PF11306:PF05835:PF05461:PF09588:PF15020,0,32,0,0,32,986,0.0,0.97,0,0,3,0,0,3,1015,0.0,1.0,0,0
PF12341,PF08953:PF13925:PF09453:PF11540:PF03451,12,30,6,6,24,982,0.2,0.97,0.5,0.3,2,2,10,0,1006,1.0,0.99,0.17,0.41
PF12838,PF10371:PF13187:PF01558:PF02906:PF17147,23,25,12,11,13,982,0.48,0.98,0.52,0.49,5,5,18,0,995,1.0,0.98,0.22,0.46
PF02798,PF13409:PF13417:PF00647:PF16780:PF13679,47,74,25,22,49,922,0.34,0.93,0.53,0.39,7,6,41,1,970,0.86,0.96,0.13,0.32
PF10403,PF10405:PF10404:PF03835:PF04721:PF16485,10,13,10,0,3,1005,0.77,1.0,1.0,0.88,7,7,3,0,1008,1.0,1.0,0.7,0.84
PF12030,PF16674:PF14836:PF13446:PF06418:PF00167,4,29,2,2,27,987,0.07,0.97,0.5,0.18,3,2,2,1,1013,0.67,1.0,0.5,0.58
PF04749,PF03162:PF00436:PF03595:PF02330:PF06749,25,47,8,17,39,954,0.17,0.94,0.32,0.21,4,3,22,1,992,0.75,0.98,0.12,0.29
PF02469,PF08648:PF16845:PF12947:PF00085:PF00962,30,123,25,5,98,890,0.2,0.9,0.83,0.38,6,5,25,1,987,0.83,0.97,0.17,0.37
PF08221,PF10644:PF05645:PF08158:PF16201:PF15979,8,35,7,1,28,982,0.2,0.97,0.88,0.41,1,1,7,0,1010,1.0,0.99,0.12,0.35
PF01465,PF10377:PF07989:PF03801:PF16034:PF04108,15,24,5,10,19,984,0.21,0.97,0.33,0.25,2,2,13,0,1003,1.0,0.99,0.13,0.36
PF07519,PF04479:PF11807:PF14027:PF06609:PF04199,19,44,13,6,31,968,0.3,0.96,0.68,0.43,13,5,14,8,991,0.38,0.98,0.26,0.31
PF15480,PF06890:PF02565:PF17193:PF15143:PF14865,1,0,0,1,0,1017,0,1.0,0.0,0,0,0,1,0,1017,0,1.0,0.0,0
PF05195,PF15801:PF01321:PF16188:PF14826:PF02449,18,35,8,10,27,973,0.23,0.96,0.44,0.3,2,2,16,0,1000,1.0,0.98,0.11,0.33
PF16562,PF15625:PF16056:PF08151:PF08150:PF09457,5,19,1,4,18,995,0.05,0.98,0.2,0.09,2,1,4,1,1012,0.5,1.0,0.2,0.31
PF15506,PF11697:PF01668:PF12318:PF12805:PF14512,0,2,0,0,2,1016,0.0,1.0,0,0,0,0,0,0,1018,0,1.0,0,0
PF05891,PF03091:PF01256:PF01093:PF15260:PF00465,15,44,10,5,34,969,0.23,0.96,0.67,0.37,4,2,13,2,1001,0.5,0.99,0.13,0.25
PF05088,PF02812:PF00208:PF06146:PF00393:PF00670,8,29,8,0,21,989,0.28,0.98,1.0,0.52,7,4,4,3,1007,0.57,0.99,0.5,0.53
PF06075,PF13537:PF02550:PF00215:PF07807:PF06974,6,48,3,3,45,967,0.06,0.95,0.5,0.16,3,0,6,3,1009,0.0,0.99,0.0,-0.0
PF16187,PF08367:PF00675:PF05193:PF04627:PF15098,20,69,20,0,49,949,0.29,0.95,1.0,0.52,9,3,17,6,992,0.33,0.98,0.15,0.21
PF03807,PF14748:PF01794:PF08022:PF08414:PF01619,12,54,8,4,46,960,0.15,0.95,0.67,0.3,18,5,7,13,993,0.28,0.98,0.42,0.33
PF10917,PF07411:PF05840:PF03428:PF14690:PF08345,1,1,0,1,1,1016,0.0,1.0,0.0,-0.0,0,0,1,0,1017,0,1.0,0.0,0
PF02609,PF05736:PF11862:PF07927:PF14028:PF10079,1,3,0,1,3,1014,0.0,1.0,0.0,-0.0,0,0,1,0,1017,0,1.0,0.0,0
PF07813,PF07421:PF15667:PF15775:PF08730:PF05857,0,1,0,0,1,1017,0.0,1.0,0,0,0,0,0,0,1018,0,1.0,0,0
PF12072,PF10470:PF08067:PF16551:PF09005:PF16274,1,13,1,0,12,1005,0.08,0.99,1.0,0.28,1,1,0,0,1017,1.0,1.0,1.0,1.0
PF07312,PF09614:PF15204:PF05418:PF15160:PF06725,0,2,0,0,2,1016,0.0,1.0,0,0,0,0,0,0,1018,0,1.0,0,0
PF04064,PF04063:PF16545:PF17104:PF04712:PF08029,2,17,2,0,15,1001,0.12,0.99,1.0,0.34,0,0,2,0,1016,0,1.0,0.0,0
PF14945,PF00770:PF15041:PF15809:PF15555:PF15119,1,4,0,1,4,1013,0.0,1.0,0.0,-0.0,0,0,1,0,1017,0,1.0,0.0,0
PF08325,PF12057:PF09668:PF16764:PF15279:PF08511,7,22,5,2,17,994,0.23,0.98,0.71,0.4,1,1,6,0,1011,1.0,0.99,0.14,0.38
PF13959,PF16124:PF03880:PF04795:PF03461:PF07652,22,39,9,13,30,966,0.23,0.96,0.41,0.29,2,2,20,0,996,1.0,0.98,0.09,0.3
PF10717,PF03265:PF01659:PF00327:PF04998:PF00151,0,71,0,0,71,947,0.0,0.93,0,0,9,0,0,9,1009,0.0,0.99,0,0
PF08444,PF06021:PF01114:PF02321:PF07014:PF02740,2,17,2,0,15,1001,0.12,0.99,1.0,0.34,0,0,2,0,1016,0,1.0,0.0,0
PF00634,PF09169:PF09121:PF09104:PF09103:PF00978,4,10,2,2,8,1006,0.2,0.99,0.5,0.31,2,2,2,0,1014,1.0,1.0,0.5,0.71
PF06809,PF03359:PF04087:PF12928:PF11538:PF04910,6,26,3,3,23,989,0.12,0.97,0.5,0.23,0,0,6,0,1012,0,0.99,0.0,0
PF04750,PF03972:PF01115:PF07096:PF05995:PF05047,5,26,4,1,22,991,0.15,0.98,0.8,0.34,4,2,3,2,1011,0.5,1.0,0.4,0.44
PF04966,PF10429:PF03498:PF15114:PF12192:PF07310,1,2,0,1,2,1015,0.0,1.0,0.0,-0.0,0,0,1,0,1017,0,1.0,0.0,0
PF17103,PF11380:PF17101:PF17102:PF00066:PF05572,5,26,5,0,21,992,0.19,0.98,1.0,0.43,4,4,1,0,1013,1.0,1.0,0.8,0.89
PF10238,PF07139:PF07260:PF15298:PF09755:PF00363,6,9,2,4,7,1005,0.22,0.99,0.33,0.27,0,0,6,0,1012,0,0.99,0.0,0
PF14294,PF05509:PF06864:PF05513:PF08299:PF11751,2,3,1,1,2,1014,0.33,1.0,0.5,0.41,0,0,2,0,1016,0,1.0,0.0,0
PF15027,PF13910:PF08168:PF10441:PF16748:PF17034,0,12,0,0,12,1006,0.0,0.99,0,0,0,0,0,0,1018,0,1.0,0,0
PF11105,PF15814:PF03488:PF09057:PF01947:PF15187,1,1,0,1,1,1016,0.0,1.0,0.0,-0.0,0,0,1,0,1017,0,1.0,0.0,0
PF03942,PF10780:PF00159:PF01987:PF01192:PF01097,17,14,6,11,8,993,0.43,0.98,0.35,0.38,0,0,17,0,1001,0,0.98,0.0,0
PF15794,PF01387:PF14946:PF07354:PF15814:PF15252,9,3,1,8,2,1007,0.33,0.99,0.11,0.19,0,0,9,0,1009,0,0.99,0.0,0
PF15262,PF12202:PF11629:PF12063:PF13281:PF16797,4,22,4,0,18,996,0.18,0.98,1.0,0.42,4,3,1,1,1013,0.75,1.0,0.75,0.75
PF07166,PF05453:PF15170:PF13677:PF04264:PF14573,0,2,0,0,2,1016,0.0,1.0,0,0,0,0,0,0,1018,0,1.0,0,0
PF12421,PF09327:PF03428:PF06864:PF01913:PF15518,0,3,0,0,3,1015,0.0,1.0,0,0,0,0,0,0,1018,0,1.0,0,0
PF04759,PF04367:PF07809:PF03350:PF14279:PF02576,4,3,0,4,3,1011,0.0,0.99,0.0,-0.0,0,0,4,0,1014,0,1.0,0.0,0
PF05527,PF08718:PF08174:PF05361:PF07347:PF15018,6,27,6,0,21,991,0.22,0.98,1.0,0.47,2,1,5,1,1011,0.5,0.99,0.17,0.29
PF00311,PF04802:PF01159:PF02946:PF01078:PF01798,6,47,3,3,44,968,0.06,0.95,0.5,0.17,2,0,6,2,1010,0.0,0.99,0.0,-0.0
PF15484,PF07805:PF16965:PF06805:PF10412:PF02277,2,5,0,2,5,1011,0.0,0.99,0.0,-0.0,0,0,2,0,1016,0,1.0,0.0,0
PF17023,PF01555:PF15608:PF02702:PF05951:PF04583,0,9,0,0,9,1009,0.0,0.99,0,0,0,0,0,0,1018,0,1.0,0,0
PF06339,PF14323:PF15272:PF15935:PF03401:PF13808,5,3,0,5,3,1010,0.0,0.99,0.0,-0.0,0,0,5,0,1013,0,1.0,0.0,0
PF17007,PF11751:PF05513:PF08479:PF08886:PF15518,0,2,0,0,2,1016,0.0,1.0,0,0,0,0,0,0,1018,0,1.0,0,0
PF07712,PF06404:PF00197:PF14476:PF03767:PF06749,0,16,0,0,16,1002,0.0,0.98,0,0,0,0,0,0,1018,0,1.0,0,0
PF16073,PF08354:PF14765:PF00698:PF00109:PF08242,20,75,20,0,55,943,0.27,0.95,1.0,0.5,37,18,2,19,979,0.49,0.98,0.9,0.65
PF12087,PF10061:PF12276:PF05523:PF04353:PF07339,0,0,0,0,0,1018,0,1.0,0,0,0,0,0,0,1018,0,1.0,0,0
PF02499,PF04196:PF06890:PF13722:PF07409:PF15518,0,1,0,0,1,1017,0.0,1.0,0,0,0,0,0,0,1018,0,1.0,0,0
PF17025,PF07472:PF08218:PF00551:PF13323:PF00586,0,31,0,0,31,987,0.0,0.97,0,0,1,0,0,1,1017,0.0,1.0,0,0
PF02659,PF07376:PF10534:PF15579:PF06923:PF00778,0,7,0,0,7,1011,0.0,0.99,0,0,0,0,0,0,1018,0,1.0,0,0
PF04310,PF03389:PF11767:PF02472:PF06586:PF09444,2,9,1,1,8,1008,0.11,0.99,0.5,0.23,0,0,2,0,1016,0,1.0,0.0,0
PF14791,PF14792:PF10391:PF14716:PF12821:PF00126,15,27,14,1,13,990,0.52,0.99,0.93,0.69,12,12,3,0,1003,1.0,1.0,0.8,0.89
PF13753,PF06745:PF04671:PF12081:PF17188:PF02336,0,3,0,0,3,1015,0.0,1.0,0,0,0,0,0,0,1018,0,1.0,0,0
PF09588,PF15299:PF16064:PF14291:PF04548:PF12017,15,55,12,3,43,960,0.22,0.95,0.8,0.4,8,7,8,1,1002,0.88,0.99,0.47,0.64
PF15348,PF02337:PF07533:PF10127:PF05458:PF16766,5,25,2,3,23,990,0.08,0.97,0.4,0.17,2,0,5,2,1011,0.0,0.99,0.0,-0.0
PF15745,PF15053:PF07464:PF15475:PF00451:PF06729,3,5,1,2,4,1011,0.2,0.99,0.33,0.26,0,0,3,0,1015,0,1.0,0.0,0
PF07210,PF08768:PF01549:PF05507:PF04942:PF03533,0,48,0,0,48,970,0.0,0.95,0,0,1,0,0,1,1017,0.0,1.0,0,0
PF14767,PF14766:PF14768:PF08961:PF14577:PF14576,0,5,0,0,5,1013,0.0,1.0,0,0,0,0,0,0,1018,0,1.0,0,0
PF07253,PF15786:PF09784:PF06907:PF02101:PF08228,0,12,0,0,12,1006,0.0,0.99,0,0,0,0,0,0,1018,0,1.0,0,0
PF10413,PF09193:PF03827:PF08983:PF12109:PF12369,3,4,2,1,2,1013,0.5,1.0,0.67,0.58,1,1,2,0,1015,1.0,1.0,0.33,0.58
PF07435,PF09648:PF10554:PF13876:PF03925:PF14903,0,2,0,0,2,1016,0.0,1.0,0,0,0,0,0,0,1018,0,1.0,0,0
PF08202,PF13230:PF14475:PF10253:PF10361:PF14474,9,10,2,7,8,1001,0.2,0.99,0.22,0.2,0,0,9,0,1009,0,0.99,0.0,0
PF05621,PF10563:PF08453:PF16510:PF12843:PF09951,0,3,0,0,3,1015,0.0,1.0,0,0,0,0,0,0,1018,0,1.0,0,0
PF03813,PF04935:PF11538:PF16875:PF03648:PF12971,9,22,1,8,21,988,0.05,0.97,0.11,0.06,0,0,9,0,1009,0,0.99,0.0,0
PF10998,PF10226:PF06428:PF05334:PF15266:PF14922,3,16,2,1,14,1001,0.12,0.99,0.67,0.28,0,0,3,0,1015,0,1.0,0.0,0
PF15485,PF17206:PF13094:PF08497:PF04562:PF11162,0,1,0,0,1,1017,0.0,1.0,0,0,0,0,0,0,1018,0,1.0,0,0
PF11675,PF15775:PF08808:PF15340:PF17076:PF11214,0,2,0,0,2,1016,0.0,1.0,0,0,0,0,0,0,1018,0,1.0,0,0
PF09607,PF04236:PF09026:PF04218:PF03221:PF05225,10,67,9,1,58,950,0.13,0.94,0.9,0.34,6,2,8,4,1004,0.33,0.99,0.2,0.25
PF05482,PF13810:PF11581:PF11179:PF08795:PF03235,2,7,0,2,7,1009,0.0,0.99,0.0,-0.0,0,0,2,0,1016,0,1.0,0.0,0
PF07207,PF15186:PF00796:PF15838:PF15224:PF05797,3,1,1,2,0,1015,1.0,1.0,0.33,0.58,0,0,3,0,1015,0,1.0,0.0,0
PF14715,PF08093:PF15758:PF15355:PF03238:PF08497,0,1,0,0,1,1017,0.0,1.0,0,0,0,0,0,0,1018,0,1.0,0,0
PF05994,PF07159:PF04704:PF01175:PF08302:PF09511,9,18,7,2,11,998,0.39,0.99,0.78,0.54,3,2,7,1,1008,0.67,0.99,0.22,0.38
PF12074,PF13251:PF12755:PF13001:PF10350:PF11916,6,30,4,2,26,986,0.13,0.97,0.67,0.29,2,1,5,1,1011,0.5,0.99,0.17,0.29
PF14982,PF15207:PF05962:PF08453:PF15334:PF04174,0,4,0,0,4,1014,0.0,1.0,0,0,0,0,0,0,1018,0,1.0,0,0
PF04855,PF16421:PF08781:PF12336:PF13443:PF13865,13,27,7,6,20,985,0.26,0.97,0.54,0.36,1,1,12,0,1005,1.0,0.99,0.08,0.28
PF00207,PF07703:PF10569:PF07677:PF01835:PF07678,18,17,14,4,3,997,0.82,0.99,0.78,0.8,12,12,6,0,1000,1.0,0.99,0.67,0.81
PF02207,PF02617:PF05048:PF13764:PF08638:PF12359,12,27,8,4,19,987,0.3,0.98,0.67,0.44,3,3,9,0,1006,1.0,0.99,0.25,0.5
PF01555,PF09461:PF03553:PF08945:PF17015:PF09109,7,1,0,7,1,1010,0.0,0.99,0.0,-0.0,0,0,7,0,1011,0,0.99,0.0,0
PF10283,PF10228:PF16759:PF06087:PF02868:PF10479,16,36,12,4,24,978,0.33,0.97,0.75,0.49,1,1,15,0,1002,1.0,0.99,0.06,0.25
PF08027,PF03784:PF12904:PF16720:PF01114:PF15722,1,2,1,0,1,1016,0.5,1.0,1.0,0.71,0,0,1,0,1017,0,1.0,0.0,0
PF01238,PF01775:PF06172:PF00810:PF05995:PF12239,19,32,11,8,21,978,0.34,0.97,0.58,0.43,2,1,18,1,998,0.5,0.98,0.05,0.16
PF12007,PF10106:PF09611:PF02530:PF12477:PF13644,0,3,0,0,3,1015,0.0,1.0,0,0,0,0,0,0,1018,0,1.0,0,0
PF04492,PF15482:PF05939:PF03616:PF03090:PF09818,2,2,0,2,2,1014,0.0,1.0,0.0,-0.0,0,0,2,0,1016,0,1.0,0.0,0
PF03916,PF13689:PF03317:PF15192:PF17152:PF15199,0,6,0,0,6,1012,0.0,0.99,0,0,0,0,0,0,1018,0,1.0,0,0
PF15368,PF11577:PF15784:PF16574:PF12757:PF10506,0,9,0,0,9,1009,0.0,0.99,0,0,0,0,0,0,1018,0,1.0,0,0
PF09727,PF17045:PF09762:PF07926:PF11577:PF07989,5,24,2,3,22,991,0.08,0.98,0.4,0.17,2,1,4,1,1012,0.5,1.0,0.2,0.31
PF07247,PF07350:PF12311:PF12239:PF11807:PF06884,15,26,5,10,21,982,0.19,0.97,0.33,0.24,3,2,13,1,1002,0.67,0.99,0.13,0.29
PF10306,PF12716:PF06912:PF09056:PF00545:PF01741,3,11,1,2,10,1005,0.09,0.99,0.33,0.17,0,0,3,0,1015,0,1.0,0.0,0
PF14779,PF07034:PF10022:PF14764:PF09822:PF10155,2,23,0,2,23,993,0.0,0.98,0.0,-0.01,1,0,2,1,1015,0.0,1.0,0.0,-0.0
PF16856,PF12125:PF04300:PF11566:PF09346:PF12014,1,18,1,0,17,1000,0.06,0.98,1.0,0.23,1,1,0,0,1017,1.0,1.0,1.0,1.0
PF15215,PF08398:PF10951:PF14344:PF11312:PF17017,0,2,0,0,2,1016,0.0,1.0,0,0,0,0,0,0,1018,0,1.0,0,0
PF13996,PF08926:PF02354:PF09045:PF13240:PF11629,0,13,0,0,13,1005,0.0,0.99,0,0,3,0,0,3,1015,0.0,1.0,0,0
PF14348,PF03135:PF05591:PF13722:PF05947:PF07499,1,6,1,0,5,1012,0.17,1.0,1.0,0.41,0,0,1,0,1017,0,1.0,0.0,0
PF15039,PF08002:PF06573:PF13588:PF15119:PF06403,0,6,0,0,6,1012,0.0,0.99,0,0,0,0,0,0,1018,0,1.0,0,0
PF16496,PF16498:PF07988:PF16495:PF08558:PF04433,7,28,7,0,21,990,0.25,0.98,1.0,0.49,5,4,3,1,1010,0.8,1.0,0.57,0.67
PF01108,PF09294:PF07140:PF06736:PF01733:PF03868,3,27,2,1,25,990,0.07,0.97,0.67,0.22,1,1,2,0,1015,1.0,1.0,0.33,0.58
PF08857,PF09962:PF03238:PF14862:PF05448:PF05962,0,4,0,0,4,1014,0.0,1.0,0,0,0,0,0,0,1018,0,1.0,0,0
PF02765,PF16686:PF07923:PF14637:PF12701:PF01858,9,27,5,4,22,987,0.19,0.97,0.56,0.31,1,1,8,0,1009,1.0,0.99,0.11,0.33
PF02777,PF00081:PF01731:PF00993:PF14693:PF01106,22,42,22,0,20,976,0.52,0.98,1.0,0.72,0,0,22,0,996,0,0.98,0.0,0
PF03661,PF11998:PF00515:PF02096:PF01920:PF15867,14,78,9,5,69,935,0.12,0.93,0.64,0.25,6,4,10,2,1002,0.67,0.99,0.29,0.43
PF04241,PF02284:PF08561:PF00321:PF06658:PF03980,12,15,2,10,13,993,0.13,0.98,0.17,0.14,0,0,12,0,1006,0,0.99,0.0,0
PF00755,PF16484:PF04430:PF01112:PF04587:PF16197,30,70,17,13,53,935,0.24,0.94,0.57,0.34,8,7,23,1,987,0.88,0.98,0.23,0.44
PF08944,PF16621:PF03700:PF12828:PF13924:PF12825,2,13,2,0,11,1005,0.15,0.99,1.0,0.39,2,1,1,1,1015,0.5,1.0,0.5,0.5
PF10520,PF07933:PF09288:PF07200:PF05529:PF00179,4,107,3,1,104,910,0.03,0.9,0.75,0.13,5,0,4,5,1009,0.0,0.99,0.0,-0.0
PF16448,PF12191:PF04552:PF11109:PF04738:PF08345,1,3,0,1,3,1014,0.0,1.0,0.0,-0.0,0,0,1,0,1017,0,1.0,0.0,0
PF12385,PF12843:PF04370:PF07243:PF11038:PF07209,0,1,0,0,1,1017,0.0,1.0,0,0,0,0,0,0,1018,0,1.0,0,0
PF10245,PF05219:PF03901:PF09754:PF02046:PF00828,8,52,4,4,48,962,0.08,0.95,0.5,0.18,3,1,7,2,1008,0.33,0.99,0.12,0.2
PF12701,PF09532:PF12949:PF04376:PF12310:PF03853,15,39,13,2,26,977,0.33,0.97,0.87,0.53,4,2,13,2,1001,0.5,0.99,0.13,0.25
PF02064,PF15811:PF04603:PF05033:PF01907:PF09273,10,46,7,3,39,969,0.15,0.96,0.7,0.31,4,4,6,0,1008,1.0,0.99,0.4,0.63
PF07225,PF04736:PF15171:PF10868:PF04402:PF09056,4,10,1,3,9,1005,0.1,0.99,0.25,0.15,0,0,4,0,1014,0,1.0,0.0,0
PF11044,PF15207:PF09365:PF15771:PF15754:PF15220,0,3,0,0,3,1015,0.0,1.0,0,0,0,0,0,0,1018,0,1.0,0,0
PF04802,PF04182:PF10264:PF10744:PF14545:PF12480,7,15,3,4,12,999,0.2,0.98,0.43,0.29,1,1,6,0,1011,1.0,0.99,0.14,0.38
PF04423,PF16034:PF07989:PF16574:PF12455:PF16830,4,21,1,3,20,994,0.05,0.98,0.25,0.1,0,0,4,0,1014,0,1.0,0.0,0
PF01499,PF03354:PF05571:PF00672:PF11352:PF10467,0,25,0,0,25,993,0.0,0.98,0,0,0,0,0,0,1018,0,1.0,0,0
PF04685,PF12215:PF04840:PF14699:PF06375:PF04841,5,21,5,0,16,997,0.24,0.98,1.0,0.48,4,2,3,2,1011,0.5,1.0,0.4,0.44
PF00832,PF06388:PF08883:PF14087:PF06825:PF02681,11,22,7,4,15,992,0.32,0.98,0.64,0.44,1,1,10,0,1007,1.0,0.99,0.09,0.3
PF08976,PF13833:PF14923:PF00036:PF02187:PF01023,5,75,5,0,70,943,0.07,0.93,1.0,0.25,9,3,2,6,1007,0.33,0.99,0.6,0.44
PF15170,PF14251:PF15775:PF00669:PF15662:PF05418,1,4,0,1,4,1013,0.0,1.0,0.0,-0.0,0,0,1,0,1017,0,1.0,0.0,0
PF12299,PF07157:PF03831:PF04865:PF14882:PF13722,0,0,0,0,0,1018,0,1.0,0,0,0,0,0,0,1018,0,1.0,0,0
PF07582,PF02058:PF10106:PF01292:PF03238:PF01668,0,10,0,0,10,1008,0.0,0.99,0,0,0,0,0,0,1018,0,1.0,0,0
PF04320,PF17164:PF04222:PF11130:PF08708:PF17206,1,1,0,1,1,1016,0.0,1.0,0.0,-0.0,0,0,1,0,1017,0,1.0,0.0,0
PF14819,PF14690:PF15029:PF13753:PF06745:PF11697,1,0,0,1,0,1017,0,1.0,0.0,0,0,0,1,0,1017,0,1.0,0.0,0
PF12274,PF09733:PF12820:PF07762:PF12678:PF02365,8,52,4,4,48,962,0.08,0.95,0.5,0.18,3,2,6,1,1009,0.67,0.99,0.25,0.41
PF15445,PF15447:PF12377:PF03011:PF07133:PF12361,1,1,1,0,0,1017,1.0,1.0,1.0,1.0,1,1,0,0,1017,1.0,1.0,1.0,1.0
PF01755,PF10155:PF14441:PF10505:PF11698:PF13886,11,35,3,8,32,975,0.09,0.96,0.27,0.14,0,0,11,0,1007,0,0.99,0.0,0
PF01863,PF06114:PF05016:PF11614:PF11800:PF12603,7,8,3,4,5,1006,0.38,0.99,0.43,0.4,0,0,7,0,1011,0,0.99,0.0,0
PF15876,PF15832:PF01668:PF05418:PF08497:PF14862,0,3,0,0,3,1015,0.0,1.0,0,0,0,0,0,0,1018,0,1.0,0,0
PF04964,PF11741:PF12571:PF09134:PF09312:PF10077,0,5,0,0,5,1013,0.0,1.0,0,0,0,0,0,0,1018,0,1.0,0,0
PF12160,PF08702:PF00147:PF05889:PF12287:PF14939,3,53,3,0,50,965,0.06,0.95,1.0,0.23,1,1,2,0,1015,1.0,1.0,0.33,0.58
PF14840,PF06144:PF01121:PF04390:PF03957:PF11785,3,18,3,0,15,1000,0.17,0.99,1.0,0.41,4,2,1,2,1013,0.5,1.0,0.67,0.58
PF05551,PF15673:PF07353:PF15050:PF15333:PF14986,0,5,0,0,5,1013,0.0,1.0,0,0,0,0,0,0,1018,0,1.0,0,0
PF12150,PF07956:PF14931:PF05436:PF03437:PF01875,2,16,0,2,16,1000,0.0,0.98,0.0,-0.01,1,0,2,1,1015,0.0,1.0,0.0,-0.0
PF08396,PF02950:PF09232:PF17124:PF09690:PF14866,0,1,0,0,1,1017,0.0,1.0,0,0,0,0,0,0,1018,0,1.0,0,0
PF15703,PF15872:PF15068:PF06937:PF15231:PF00997,0,1,0,0,1,1017,0.0,1.0,0,0,0,0,0,0,1018,0,1.0,0,0
PF01297,PF08299:PF07195:PF14882:PF02322:PF08345,4,3,0,4,3,1011,0.0,0.99,0.0,-0.0,0,0,4,0,1014,0,1.0,0.0,0
PF04303,PF03972:PF13577:PF08229:PF15014:PF08553,13,15,6,7,9,996,0.4,0.98,0.46,0.42,2,2,11,0,1005,1.0,0.99,0.15,0.39
PF09456,PF06761:PF08334:PF04466:PF11873:PF04223,3,2,0,3,2,1013,0.0,1.0,0.0,-0.0,0,0,3,0,1015,0,1.0,0.0,0
PF13259,PF01643:PF16320:PF01091:PF00101:PF11429,5,15,3,2,12,1001,0.2,0.99,0.6,0.34,1,0,5,1,1012,0.0,0.99,0.0,-0.0
PF10507,PF10239:PF00233:PF00812:PF12317:PF06607,5,33,2,3,31,982,0.06,0.97,0.4,0.15,1,1,4,0,1013,1.0,1.0,0.2,0.45
PF14215,PF09427:PF15951:PF08447:PF07527:PF12533,8,29,3,5,26,984,0.1,0.97,0.38,0.19,2,2,6,0,1010,1.0,0.99,0.25,0.5
PF10318,PF10319:PF10327:PF10317:PF10325:PF10326,14,32,9,5,23,981,0.28,0.97,0.64,0.41,1,1,13,0,1004,1.0,0.99,0.07,0.27
PF16874,PF16875:PF02065:PF16711:PF16709:PF08303,1,10,1,0,9,1008,0.1,0.99,1.0,0.31,0,0,1,0,1017,0,1.0,0.0,0
PF10960,PF13948:PF04680:PF15789:PF14843:PF00353,0,15,0,0,15,1003,0.0,0.99,0,0,0,0,0,0,1018,0,1.0,0,0
PF01528,PF11851:PF14762:PF15951:PF01851:PF00136,0,49,0,0,49,969,0.0,0.95,0,0,1,0,0,1,1017,0.0,1.0,0,0
PF11548,PF14948:PF09414:PF00102:PF12453:PF12567,4,56,4,0,52,962,0.07,0.95,1.0,0.26,2,1,3,1,1013,0.5,1.0,0.25,0.35
PF05778,PF05754:PF14885:PF01316:PF01668:PF03238,1,5,0,1,5,1012,0.0,0.99,0.0,-0.0,0,0,1,0,1017,0,1.0,0.0,0
PF03468,PF03801:PF04108:PF15905:PF17045:PF03470,6,11,3,3,8,1004,0.27,0.99,0.5,0.36,1,0,6,1,1011,0.0,0.99,0.0,-0.0
PF11237,PF06412:PF05872:PF13254:PF00063:PF16735,0,74,0,0,74,944,0.0,0.93,0,0,0,0,0,0,1018,0,1.0,0,0
PF09216,PF08642:PF14494:PF16311:PF04892:PF15062,0,0,0,0,0,1018,0,1.0,0,0,0,0,0,0,1018,0,1.0,0,0
PF06417,PF02936:PF03587:PF04923:PF02983:PF08610,8,25,4,4,21,989,0.16,0.98,0.5,0.27,2,2,6,0,1010,1.0,0.99,0.25,0.5
PF00444,PF10244:PF11779:PF10780:PF01097:PF08561,7,18,2,5,16,995,0.11,0.98,0.29,0.17,1,0,7,1,1010,0.0,0.99,0.0,-0.0
PF13841,PF01099:PF09777:PF06373:PF00048:PF00159,0,16,0,0,16,1002,0.0,0.98,0,0,0,0,0,0,1018,0,1.0,0,0
PF16195,PF16191:PF16190:PF10585:PF09358:PF05690,2,20,1,1,19,997,0.05,0.98,0.5,0.15,3,1,1,2,1014,0.33,1.0,0.5,0.41
PF15127,PF10616:PF08936:PF15088:PF07203:PF12919,1,2,0,1,2,1015,0.0,1.0,0.0,-0.0,0,0,1,0,1017,0,1.0,0.0,0
PF12938,PF16608:PF10427:PF15861:PF06495:PF05383,4,26,2,2,24,990,0.08,0.97,0.5,0.19,1,1,3,0,1014,1.0,1.0,0.25,0.5
PF03069,PF00265:PF06276:PF08553:PF16959:PF17119,12,17,3,9,14,992,0.18,0.98,0.25,0.2,1,0,12,1,1005,0.0,0.99,0.0,-0.0
PF02581,PF02110:PF01288:PF03070:PF16711:PF16709,6,28,3,3,25,987,0.11,0.97,0.5,0.22,2,0,6,2,1010,0.0,0.99,0.0,-0.0
PF03020,PF08198:PF00554:PF16553:PF15808:PF15898,6,21,3,3,18,994,0.14,0.98,0.5,0.26,0,0,6,0,1012,0,0.99,0.0,0
PF05317,PF17062:PF11044:PF12388:PF05853:PF15207,0,2,0,0,2,1016,0.0,1.0,0,0,0,0,0,0,1018,0,1.0,0,0
PF12494,PF02448:PF06541:PF15055:PF15559:PF15063,4,0,0,4,0,1014,0,1.0,0.0,0,0,0,4,0,1014,0,1.0,0.0,0
PF06294,PF16034:PF04423:PF12606:PF09787:PF11831,6,24,3,3,21,991,0.12,0.98,0.5,0.24,0,0,6,0,1012,0,0.99,0.0,0
PF04381,PF00887:PF00378:PF16113:PF04260:PF04573,1,96,1,0,95,922,0.01,0.91,1.0,0.1,12,1,0,11,1006,0.08,0.99,1.0,0.29
PF03272,PF05034:PF08886:PF02572:PF01580:PF14842,0,6,0,0,6,1012,0.0,0.99,0,0,0,0,0,0,1018,0,1.0,0,0
PF02605,PF09057:PF07464:PF15699:PF10868:PF00727,0,5,0,0,5,1013,0.0,1.0,0,0,0,0,0,0,1018,0,1.0,0,0
PF17186,PF07143:PF10116:PF05494:PF04314:PF03718,0,3,0,0,3,1015,0.0,1.0,0,0,0,0,0,0,1018,0,1.0,0,0
PF06376,PF04520:PF00321:PF05915:PF06127:PF05479,2,7,0,2,7,1009,0.0,0.99,0.0,-0.0,0,0,2,0,1016,0,1.0,0.0,0
PF01867,PF12544:PF07799:PF02511:PF02677:PF17026,3,4,0,3,4,1011,0.0,0.99,0.0,-0.0,0,0,3,0,1015,0,1.0,0.0,0
PF01931,PF04681:PF15550:PF12328:PF06954:PF05419,1,10,0,1,10,1007,0.0,0.99,0.0,-0.0,0,0,1,0,1017,0,1.0,0.0,0
PF04562,PF15485:PF07192:PF08795:PF08744:PF15032,0,0,0,0,0,1018,0,1.0,0,0,0,0,0,0,1018,0,1.0,0,0
PF04293,PF01624:PF00361:PF00542:PF05188:PF16108,0,51,0,0,51,967,0.0,0.95,0,0,11,0,0,11,1007,0.0,0.99,0,0
PF04111,PF15285:PF07800:PF04422:PF02186:PF03479,12,24,5,7,19,987,0.21,0.97,0.42,0.28,0,0,12,0,1006,0,0.99,0.0,0
PF09019,PF15427:PF04451:PF14925:PF05135:PF02305,2,4,0,2,4,1012,0.0,0.99,0.0,-0.0,0,0,2,0,1016,0,1.0,0.0,0
PF12520,PF04576:PF12830:PF15275:PF12253:PF13251,4,29,3,1,26,988,0.1,0.97,0.75,0.27,1,1,3,0,1014,1.0,1.0,0.25,0.5
PF10447,PF15985:PF07286:PF04756:PF11937:PF14382,8,26,6,2,20,990,0.23,0.98,0.75,0.41,4,2,6,2,1008,0.5,0.99,0.25,0.35
PF12046,PF05419:PF08576:PF02531:PF17032:PF02427,0,4,0,0,4,1014,0.0,1.0,0,0,0,0,0,0,1018,0,1.0,0,0
PF06355,PF15662:PF01292:PF11402:PF15049:PF05962,2,7,1,1,6,1010,0.14,0.99,0.5,0.26,0,0,2,0,1016,0,1.0,0.0,0
PF04977,PF00387:PF02759:PF07534:PF00303:PF00640,0,73,0,0,73,945,0.0,0.93,0,0,6,0,0,6,1012,0.0,0.99,0,0
PF16735,PF10580:PF06614:PF00784:PF16521:PF05902,3,30,3,0,27,988,0.1,0.97,1.0,0.31,1,1,2,0,1015,1.0,1.0,0.33,0.58
PF02044,PF01279:PF15063:PF04852:PF10310:PF01291,0,8,0,0,8,1010,0.0,0.99,0,0,0,0,0,0,1018,0,1.0,0,0
PF08269,PF16836:PF14985:PF01337:PF09074:PF17010,0,2,0,0,2,1016,0.0,1.0,0,0,0,0,0,0,1018,0,1.0,0,0
PF08015,PF13266:PF09922:PF09923:PF01221:PF01340,2,20,1,1,19,997,0.05,0.98,0.5,0.15,0,0,2,0,1016,0,1.0,0.0,0
PF09425,PF06200:PF03479:PF05140:PF04788:PF03759,7,23,6,1,17,994,0.26,0.98,0.86,0.47,3,0,7,3,1008,0.0,0.99,0.0,-0.0
PF04398,PF06749:PF04674:PF06404:PF14476:PF00197,9,13,2,7,11,998,0.15,0.98,0.22,0.18,1,1,8,0,1009,1.0,0.99,0.11,0.33
PF15689,PF15690:PF15688:PF15687:PF09049:PF09051,0,0,0,0,0,1018,0,1.0,0,0,0,0,0,0,1018,0,1.0,0,0
PF04421,PF14996:PF15161:PF15938:PF05153:PF04081,6,19,2,4,17,995,0.11,0.98,0.33,0.18,2,2,4,0,1012,1.0,1.0,0.33,0.58
PF06388,PF10244:PF00321:PF14935:PF07114:PF06108,1,16,0,1,16,1001,0.0,0.98,0.0,-0.0,0,0,1,0,1017,0,1.0,0.0,0
PF07933,PF10520:PF05529:PF09288:PF00179:PF07200,11,106,9,2,97,910,0.08,0.9,0.82,0.24,5,4,7,1,1006,0.8,0.99,0.36,0.54
PF13586,PF08737:PF03357:PF00033:PF04578:PF02137,0,79,0,0,79,939,0.0,0.92,0,0,8,0,0,8,1010,0.0,0.99,0,0
PF07057,PF08291:PF17148:PF15729:PF17164:PF05707,4,1,0,4,1,1013,0.0,1.0,0.0,-0.0,0,0,4,0,1014,0,1.0,0.0,0
PF14648,PF14647:PF09494:PF16876:PF08005:PF08235,3,20,3,0,17,998,0.15,0.98,1.0,0.38,4,1,2,3,1012,0.25,1.0,0.33,0.29
PF07479,PF02317:PF01210:PF04862:PF16881:PF14365,26,39,24,2,15,977,0.62,0.98,0.92,0.75,4,3,23,1,991,0.75,0.98,0.12,0.29
PF10726,PF01735:PF01957:PF08264:PF05698:PF10458,0,52,0,0,52,966,0.0,0.95,0,0,1,0,0,1,1017,0.0,1.0,0,0
PF16588,PF10490:PF05164:PF02108:PF13005:PF15453,3,4,0,3,4,1011,0.0,0.99,0.0,-0.0,0,0,3,0,1015,0,1.0,0.0,0
PF04299,PF06912:PF06766:PF10161:PF12900:PF15370,11,12,4,7,8,999,0.33,0.99,0.36,0.34,0,0,11,0,1007,0,0.99,0.0,0
PF15829,PF15576:PF15120:PF03823:PF15839:PF07458,1,5,1,0,4,1013,0.2,1.0,1.0,0.45,0,0,1,0,1017,0,1.0,0.0,0
PF09528,PF04954:PF11751:PF04917:PF15823:PF01289,0,2,0,0,2,1016,0.0,1.0,0,0,0,0,0,0,1018,0,1.0,0,0
PF09483,PF17152:PF00381:PF01752:PF13588:PF07157,0,5,0,0,5,1013,0.0,1.0,0,0,0,0,0,0,1018,0,1.0,0,0
PF01307,PF13186:PF05190:PF00370:PF16881:PF06969,0,52,0,0,52,966,0.0,0.95,0,0,4,0,0,4,1014,0.0,1.0,0,0
PF03895,PF14396:PF01032:PF12399:PF16326:PF09383,4,15,3,1,12,1002,0.2,0.99,0.75,0.38,2,2,2,0,1014,1.0,1.0,0.5,0.71
PF15841,PF15340:PF17014:PF08808:PF00519:PF15480,0,7,0,0,7,1011,0.0,0.99,0,0,0,0,0,0,1018,0,1.0,0,0
PF00157,PF03792:PF16878:PF12284:PF16719:PF13293,8,18,6,2,12,998,0.33,0.99,0.75,0.49,2,2,6,0,1010,1.0,0.99,0.25,0.5
PF07250,PF09118:PF00703:PF01822:PF10528:PF05593,7,69,6,1,63,948,0.09,0.94,0.86,0.26,5,4,3,1,1010,0.8,1.0,0.57,0.67
PF02720,PF07016:PF08345:PF03428:PF16411:PF03050,2,2,0,2,2,1014,0.0,1.0,0.0,-0.0,0,0,2,0,1016,0,1.0,0.0,0
PF03917,PF03199:PF13553:PF01080:PF00619:PF13371,8,38,6,2,32,978,0.16,0.97,0.75,0.33,1,1,7,0,1010,1.0,0.99,0.12,0.35
PF01744,PF11617:PF02983:PF15494:PF15722:PF06683,9,12,3,6,9,1000,0.25,0.99,0.33,0.28,0,0,9,0,1009,0,0.99,0.0,0
PF15149,PF15395:PF16748:PF15027:PF13320:PF06165,1,3,0,1,3,1014,0.0,1.0,0.0,-0.0,0,0,1,0,1017,0,1.0,0.0,0
PF00175,PF00970:PF00667:PF00258:PF09791:PF02898,62,68,53,9,15,941,0.78,0.98,0.85,0.8,18,18,44,0,956,1.0,0.96,0.29,0.53
PF15139,PF15555:PF06876:PF14534:PF16590:PF15068,1,3,0,1,3,1014,0.0,1.0,0.0,-0.0,0,0,1,0,1017,0,1.0,0.0,0
PF17096,PF15392:PF07610:PF12178:PF15168:PF15082,0,8,0,0,8,1010,0.0,0.99,0,0,0,0,0,0,1018,0,1.0,0,0
PF01076,PF10979:PF15400:PF04354:PF15515:PF16670,1,2,0,1,2,1015,0.0,1.0,0.0,-0.0,0,0,1,0,1017,0,1.0,0.0,0
PF00421,PF00124:PF00507:PF12238:PF00223:PF00499,17,14,6,11,8,993,0.43,0.98,0.35,0.38,0,0,17,0,1001,0,0.98,0.0,0
PF03659,PF13472:PF10503:PF00457:PF03443:PF07969,19,67,10,9,57,942,0.15,0.94,0.53,0.26,8,3,16,5,994,0.38,0.98,0.16,0.23
PF00891,PF08100:PF02545:PF01066:PF00120:PF00892,33,77,22,11,55,930,0.29,0.94,0.67,0.41,12,8,25,4,981,0.67,0.97,0.24,0.39
PF12605,PF08332:PF14593:PF11629:PF12063:PF16579,4,22,3,1,19,995,0.14,0.98,0.75,0.31,4,3,1,1,1013,0.75,1.0,0.75,0.75
PF04672,PF09479:PF02495:PF08827:PF10796:PF09067,0,2,0,0,2,1016,0.0,1.0,0,0,0,0,0,0,1018,0,1.0,0,0
PF00094,PF08742:PF09175:PF12714:PF03782:PF06448,36,36,34,2,2,980,0.94,1.0,0.94,0.94,7,7,29,0,982,1.0,0.97,0.19,0.43
PF06916,PF10173:PF10217:PF05615:PF07052:PF10595,10,23,3,7,20,988,0.13,0.97,0.3,0.19,1,0,10,1,1007,0.0,0.99,0.0,-0.0
PF12640,PF17043:PF06852:PF02070:PF11581:PF12153,2,0,0,2,0,1016,0,1.0,0.0,0,0,0,2,0,1016,0,1.0,0.0,0
PF15308,PF13325:PF15276:PF16508:PF15778:PF16697,8,12,3,5,9,1001,0.25,0.99,0.38,0.3,2,2,6,0,1010,1.0,0.99,0.25,0.5
PF16892,PF16893:PF09309:PF12258:PF03119:PF01834,2,11,2,0,9,1007,0.18,0.99,1.0,0.42,0,0,2,0,1016,0,1.0,0.0,0
PF05427,PF10254:PF05587:PF01484:PF14816:PF12402,6,49,5,1,44,968,0.1,0.96,0.83,0.28,1,1,5,0,1012,1.0,1.0,0.17,0.41
PF16983,PF02219:PF10022:PF16401:PF09797:PF00605,4,29,3,1,26,988,0.1,0.97,0.75,0.27,1,0,4,1,1013,0.0,1.0,0.0,-0.0
PF00622,PF13765:PF00643:PF06328:PF07686:PF08205,67,96,37,30,59,892,0.39,0.91,0.55,0.42,20,16,51,4,947,0.8,0.95,0.24,0.42
PF02936,PF06417:PF05995:PF02284:PF00210:PF04176,9,31,5,4,26,983,0.16,0.97,0.56,0.29,4,1,8,3,1006,0.25,0.99,0.11,0.16
PF08377,PF00418:PF17020:PF07715:PF04965:PF00593,1,11,1,0,10,1007,0.09,0.99,1.0,0.3,1,0,1,1,1016,0.0,1.0,0.0,-0.0
PF12318,PF03090:PF15662:PF08497:PF11245:PF08017,0,7,0,0,7,1011,0.0,0.99,0,0,0,0,0,0,1018,0,1.0,0,0
PF06060,PF14674:PF14677:PF14678:PF10351:PF14680,2,10,0,2,10,1006,0.0,0.99,0.0,-0.0,1,0,2,1,1015,0.0,1.0,0.0,-0.0
PF15553,PF08642:PF05874:PF17078:PF15337:PF03601,0,5,0,0,5,1013,0.0,1.0,0,0,0,0,0,0,1018,0,1.0,0,0
PF04417,PF05100:PF15888:PF15856:PF08291:PF15577,2,4,0,2,4,1012,0.0,0.99,0.0,-0.0,0,0,2,0,1016,0,1.0,0.0,0
PF07165,PF02284:PF14935:PF08584:PF12020:PF10244,2,16,0,2,16,1000,0.0,0.98,0.0,-0.01,1,0,2,1,1015,0.0,1.0,0.0,-0.0
PF04611,PF03867:PF10525:PF12413:PF12407:PF04617,1,4,1,0,3,1014,0.25,1.0,1.0,0.5,1,1,0,0,1017,1.0,1.0,1.0,1.0
PF01920,PF16053:PF03661:PF14943:PF08534:PF14542,17,45,11,6,34,967,0.24,0.96,0.65,0.38,4,4,13,0,1001,1.0,0.99,0.24,0.48
PF08608,PF13597:PF06969:PF12345:PF06968:PF01967,12,15,4,8,11,995,0.27,0.98,0.33,0.29,2,2,10,0,1006,1.0,0.99,0.17,0.41
PF12190,PF08026:PF09611:PF15186:PF12686:PF15727,0,1,0,0,1,1017,0.0,1.0,0,0,0,0,0,0,1018,0,1.0,0,0
PF11084,PF09732:PF02304:PF11128:PF05600:PF08173,0,17,0,0,17,1001,0.0,0.98,0,0,0,0,0,0,1018,0,1.0,0,0
PF10185,PF12020:PF04176:PF04901:PF10244:PF15013,2,17,1,1,16,1000,0.06,0.98,0.5,0.17,0,0,2,0,1016,0,1.0,0.0,0
PF11932,PF11992:PF06288:PF16864:PF16803:PF08028,0,21,0,0,21,997,0.0,0.98,0,0,0,0,0,0,1018,0,1.0,0,0
PF09285,PF01132:PF08207:PF14693:PF04927:PF10785,6,15,6,0,9,1003,0.4,0.99,1.0,0.63,1,1,5,0,1012,1.0,1.0,0.17,0.41
PF00946,PF14318:PF12255:PF02748:PF11767:PF03534,5,13,5,0,8,1005,0.38,0.99,1.0,0.62,0,0,5,0,1013,0,1.0,0.0,0
PF11967,PF01514:PF01752:PF16449:PF17188:PF02565,0,2,0,0,2,1016,0.0,1.0,0,0,0,0,0,0,1018,0,1.0,0,0
PF00399,PF09285:PF02747:PF08523:PF01643:PF01132,3,21,0,3,21,994,0.0,0.98,0.0,-0.01,2,0,3,2,1013,0.0,1.0,0.0,-0.0
PF02408,PF12733:PF03385:PF14764:PF06662:PF00517,2,14,2,0,12,1004,0.14,0.99,1.0,0.38,0,0,2,0,1016,0,1.0,0.0,0
PF01049,PF00028:PF00054:PF01463:PF02210:PF12661,7,81,7,0,74,937,0.09,0.93,1.0,0.28,17,3,4,14,997,0.18,0.98,0.43,0.27
PF08022,PF08030:PF01794:PF08414:PF00036:PF03807,42,81,42,0,39,937,0.52,0.96,1.0,0.71,18,18,24,0,976,1.0,0.98,0.43,0.65
PF03494,PF10515:PF02177:PF12925:PF12924:PF16782,4,10,3,1,7,1007,0.3,0.99,0.75,0.47,8,3,1,5,1009,0.38,0.99,0.75,0.53
PF10262,PF00159:PF01987:PF08695:PF01097:PF14774,8,18,1,7,17,993,0.06,0.98,0.12,0.07,1,0,8,1,1009,0.0,0.99,0.0,-0.0
PF04791,PF04859:PF00029:PF00262:PF01435:PF10156,17,45,8,9,37,964,0.18,0.95,0.47,0.27,3,2,15,1,1000,0.67,0.98,0.12,0.28
PF01199,PF04690:PF01294:PF05512:PF05254:PF01907,13,21,5,8,16,989,0.24,0.98,0.38,0.29,1,1,12,0,1005,1.0,0.99,0.08,0.28
PF01311,PF01752:PF17049:PF15207:PF10974:PF01514,0,4,0,0,4,1014,0.0,1.0,0,0,0,0,0,0,1018,0,1.0,0,0
PF03836,PF15780:PF12510:PF03271:PF10358:PF15147,5,36,3,2,33,980,0.08,0.97,0.6,0.21,1,1,4,0,1013,1.0,1.0,0.2,0.45
PF02809,PF03127:PF15300:PF00790:PF02099:PF04699,25,35,11,14,24,969,0.31,0.96,0.44,0.35,4,4,21,0,993,1.0,0.98,0.16,0.4
PF15266,PF06428:PF12606:PF14922:PF16043:PF11831,3,24,1,2,23,992,0.04,0.98,0.33,0.11,0,0,3,0,1015,0,1.0,0.0,0
PF02431,PF03386:PF01176:PF08536:PF03242:PF05676,2,22,1,1,21,995,0.05,0.98,0.5,0.15,0,0,2,0,1016,0,1.0,0.0,0
PF12330,PF08311:PF12202:PF16797:PF12063:PF14593,11,23,5,6,18,989,0.22,0.98,0.45,0.3,3,3,8,0,1007,1.0,0.99,0.27,0.52
PF00788,PF16517:PF09235:PF08947:PF00620:PF00618,49,102,37,12,65,904,0.36,0.92,0.76,0.49,4,4,45,0,969,1.0,0.96,0.08,0.28
PF03868,PF01159:PF04265:PF01729:PF02749:PF01386,13,35,9,4,26,979,0.26,0.97,0.69,0.41,6,4,9,2,1003,0.67,0.99,0.31,0.45
PF06466,PF17105:PF16199:PF12064:PF10513:PF12157,9,37,6,3,31,978,0.16,0.97,0.67,0.32,2,2,7,0,1009,1.0,0.99,0.22,0.47
PF04140,PF01632:PF10218:PF10252:PF01789:PF06159,17,14,2,15,12,989,0.14,0.97,0.12,0.12,0,0,17,0,1001,0,0.98,0.0,0
PF04968,PF14050:PF04969:PF05002:PF16273:PF09032,13,50,10,3,40,965,0.2,0.96,0.77,0.38,2,0,13,2,1003,0.0,0.99,0.0,-0.01
PF12830,PF05041:PF12422:PF15996:PF14611:PF12765,9,28,8,1,20,989,0.29,0.98,0.89,0.5,0,0,9,0,1009,0,0.99,0.0,0
PF06882,PF09829:PF08724:PF11026:PF06834:PF14052,2,0,0,2,0,1016,0,1.0,0.0,0,0,0,2,0,1016,0,1.0,0.0,0
PF09371,PF16921:PF14633:PF14878:PF08529:PF08206,3,17,3,0,14,1001,0.18,0.99,1.0,0.42,2,2,1,0,1015,1.0,1.0,0.67,0.82
PF08340,PF04222:PF08345:PF08299:PF07195:PF03406,0,2,0,0,2,1016,0.0,1.0,0,0,0,0,0,0,1018,0,1.0,0,0
PF15976,PF07434:PF16967:PF06798:PF03241:PF11874,0,0,0,0,0,1018,0,1.0,0,0,0,0,0,0,1018,0,1.0,0,0
PF11081,PF04355:PF02565:PF05838:PF03050:PF01673,0,0,0,0,0,1018,0,1.0,0,0,0,0,0,0,1018,0,1.0,0,0
PF06912,PF12716:PF07544:PF06108:PF07335:PF10839,3,12,0,3,12,1003,0.0,0.99,0.0,-0.01,0,0,3,0,1015,0,1.0,0.0,0
PF15419,PF13441:PF06547:PF04363:PF03869:PF13705,2,8,2,0,6,1010,0.25,0.99,1.0,0.5,2,2,0,0,1016,1.0,1.0,1.0,1.0
PF02230,PF08975:PF00045:PF03980:PF07247:PF05757,24,37,11,13,26,968,0.3,0.96,0.46,0.35,2,2,22,0,994,1.0,0.98,0.08,0.29
PF00903,PF00120:PF00891:PF13813:PF04116:PF08100,36,68,22,14,46,936,0.32,0.94,0.61,0.42,11,9,27,2,980,0.82,0.97,0.25,0.44
PF13344,PF04577:PF01066:PF02517:PF03062:PF14226,26,87,17,9,70,922,0.2,0.92,0.65,0.33,17,10,16,7,985,0.59,0.98,0.38,0.46
PF14365,PF03080:PF05634:PF03951:PF04127:PF04862,2,34,2,0,32,984,0.06,0.97,1.0,0.24,1,0,2,1,1015,0.0,1.0,0.0,-0.0
PF02721,PF16900:PF08646:PF01336:PF04057:PF14214,12,71,10,2,61,945,0.14,0.94,0.83,0.33,12,8,4,4,1002,0.67,0.99,0.67,0.66
PF05526,PF06868:PF15547:PF14573:PF04370:PF07960,0,2,0,0,2,1016,0.0,1.0,0,0,0,0,0,0,1018,0,1.0,0,0
PF08917,PF14786:PF06760:PF11629:PF02019:PF08515,4,11,2,2,9,1005,0.18,0.99,0.5,0.3,2,2,2,0,1014,1.0,1.0,0.5,0.71
PF00835,PF13097:PF08286:PF14988:PF15313:PF07137,1,16,0,1,16,1001,0.0,0.98,0.0,-0.0,0,0,1,0,1017,0,1.0,0.0,0
PF13183,PF17221:PF10303:PF02754:PF10356:PF17186,9,11,7,2,4,1005,0.64,0.99,0.78,0.7,0,0,9,0,1009,0,0.99,0.0,0
PF09446,PF17125:PF01029:PF11709:PF08649:PF01189,4,34,3,1,31,983,0.09,0.97,0.75,0.25,3,1,3,2,1012,0.33,1.0,0.25,0.29
PF07924,PF08287:PF13093:PF14616:PF06897:PF04892,0,8,0,0,8,1010,0.0,0.99,0,0,0,0,0,0,1018,0,1.0,0,0
PF15253,PF12887:PF12090:PF08729:PF14661:PF09429,3,14,1,2,13,1002,0.07,0.99,0.33,0.15,0,0,3,0,1015,0,1.0,0.0,0
PF15608,PF12081:PF06082:PF08886:PF12477:PF02211,0,3,0,0,3,1015,0.0,1.0,0,0,0,0,0,0,1018,0,1.0,0,0
PF08654,PF15770:PF15380:PF15771:PF15055:PF03379,2,1,0,2,1,1015,0.0,1.0,0.0,-0.0,0,0,2,0,1016,0,1.0,0.0,0
PF03691,PF12843:PF07927:PF05425:PF03389:PF12194,0,3,0,0,3,1015,0.0,1.0,0,0,0,0,0,0,1018,0,1.0,0,0
PF06533,PF02753:PF15768:PF00482:PF06773:PF15750,1,5,0,1,5,1012,0.0,0.99,0.0,-0.0,0,0,1,0,1017,0,1.0,0.0,0
PF11039,PF06347:PF14344:PF08808:PF10951:PF09510,0,5,0,0,5,1013,0.0,1.0,0,0,0,0,0,0,1018,0,1.0,0,0
PF15144,PF17075:PF06160:PF13286:PF07516:PF05343,0,18,0,0,18,1000,0.0,0.98,0,0,0,0,0,0,1018,0,1.0,0,0
PF06728,PF10246:PF10266:PF03932:PF15260:PF02046,10,33,3,7,30,978,0.09,0.96,0.3,0.15,1,0,10,1,1007,0.0,0.99,0.0,-0.0
PF02677,PF01312:PF08707:PF03244:PF06890:PF15207,2,2,0,2,2,1014,0.0,1.0,0.0,-0.0,0,0,2,0,1016,0,1.0,0.0,0
PF08059,PF02099:PF11470:PF04000:PF04695:PF13864,10,37,6,4,31,977,0.16,0.97,0.6,0.3,3,2,8,1,1007,0.67,0.99,0.2,0.36
PF01628,PF08411:PF14882:PF01325:PF07411:PF06798,2,4,1,1,3,1013,0.25,1.0,0.5,0.35,0,0,2,0,1016,0,1.0,0.0,0
PF01446,PF10174:PF06160:PF00736:PF04930:PF01974,1,49,1,0,48,969,0.02,0.95,1.0,0.14,5,0,1,5,1012,0.0,0.99,0.0,-0.0
PF05517,PF03607:PF12474:PF02755:PF10176:PF05808,9,26,4,5,22,987,0.15,0.97,0.44,0.25,3,2,7,1,1008,0.67,0.99,0.22,0.38
PF14536,PF15770:PF01668:PF01316:PF12158:PF03238,0,4,0,0,4,1014,0.0,1.0,0,0,0,0,0,0,1018,0,1.0,0,0
PF01585,PF12457:PF07842:PF07713:PF13821:PF11952,63,26,19,44,7,948,0.73,0.95,0.3,0.45,5,5,58,0,955,1.0,0.94,0.08,0.27
PF10545,PF02944:PF07776:PF05485:PF12017:PF13890,43,99,30,13,69,906,0.3,0.92,0.7,0.43,11,7,36,4,971,0.64,0.96,0.16,0.31
PF11891,PF03479:PF02234:PF11489:PF04939:PF12319,6,21,0,6,21,991,0.0,0.97,0.0,-0.01,0,0,6,0,1012,0,0.99,0.0,0
PF03553,PF11214:PF15680:PF00669:PF09498:PF11124,1,1,0,1,1,1016,0.0,1.0,0.0,-0.0,0,0,1,0,1017,0,1.0,0.0,0
PF03114,PF08824:PF08397:PF12026:PF07815:PF04088,28,15,5,23,10,980,0.33,0.97,0.18,0.23,2,2,26,0,990,1.0,0.97,0.07,0.26
PF01132,PF09285:PF08207:PF14693:PF04927:PF01287,6,20,6,0,14,998,0.3,0.99,1.0,0.54,4,4,2,0,1012,1.0,1.0,0.67,0.82
PF00070,PF07681:PF01654:PF14163:PF14962:PF06445,4,11,2,2,9,1005,0.18,0.99,0.5,0.3,1,1,3,0,1014,1.0,1.0,0.25,0.5
PF17076,PF15281:PF02277:PF01312:PF04451:PF03244,0,7,0,0,7,1011,0.0,0.99,0,0,0,0,0,0,1018,0,1.0,0,0
PF01388,PF12031:PF08169:PF08429:PF02928:PF02257,31,35,20,11,15,972,0.57,0.97,0.65,0.59,3,3,28,0,987,1.0,0.97,0.1,0.31
PF13846,PF12449:PF10334:PF16801:PF15804:PF13598,1,17,0,1,17,1000,0.0,0.98,0.0,-0.0,0,0,1,0,1017,0,1.0,0.0,0
PF10415,PF08328:PF14698:PF10397:PF00206:PF02233,19,46,19,0,27,972,0.41,0.97,1.0,0.63,3,2,17,1,998,0.67,0.98,0.11,0.26
PF04542,PF04539:PF04545:PF00140:PF08281:PF03979,21,26,18,3,8,989,0.69,0.99,0.86,0.77,5,5,16,0,997,1.0,0.98,0.24,0.48
PF06586,PF05309:PF07178:PF05509:PF05513:PF11751,1,1,1,0,0,1017,1.0,1.0,1.0,1.0,1,1,0,0,1017,1.0,1.0,1.0,1.0
PF10395,PF14952:PF12432:PF12231:PF12169:PF15793,1,10,1,0,9,1008,0.1,0.99,1.0,0.31,0,0,1,0,1017,0,1.0,0.0,0
PF04349,PF01514:PF03944:PF03616:PF08479:PF03922,0,3,0,0,3,1015,0.0,1.0,0,0,0,0,0,0,1018,0,1.0,0,0
PF06475,PF15207:PF15175:PF14690:PF06403:PF03883,0,4,0,0,4,1014,0.0,1.0,0,0,0,0,0,0,1018,0,1.0,0,0
PF08999,PF11636:PF02180:PF13335:PF02394:PF17221,2,5,0,2,5,1011,0.0,0.99,0.0,-0.0,0,0,2,0,1016,0,1.0,0.0,0
PF10459,PF14871:PF16967:PF15976:PF11593:PF09361,2,3,0,2,3,1013,0.0,1.0,0.0,-0.0,0,0,2,0,1016,0,1.0,0.0,0
PF03094,PF00244:PF03759:PF11955:PF14009:PF00375,11,47,8,3,39,968,0.17,0.96,0.73,0.34,3,3,8,0,1007,1.0,0.99,0.27,0.52
PF01113,PF05173:PF03986:PF10381:PF12350:PF01729,8,25,5,3,20,990,0.2,0.98,0.62,0.35,2,0,8,2,1008,0.0,0.99,0.0,-0.0
PF04466,PF01580:PF17206:PF03592:PF11863:PF08334,0,6,0,0,6,1012,0.0,0.99,0,0,0,0,0,0,1018,0,1.0,0,0
PF00031,PF16845:PF00112:PF15371:PF08246:PF11705,9,68,8,1,60,949,0.12,0.94,0.89,0.31,7,2,7,5,1004,0.29,0.99,0.22,0.25
PF09716,PF11093:PF05387:PF15673:PF01878:PF08228,0,13,0,0,13,1005,0.0,0.99,0,0,0,0,0,0,1018,0,1.0,0,0
PF13556,PF17007:PF11751:PF04740:PF15168:PF07409,1,3,0,1,3,1014,0.0,1.0,0.0,-0.0,0,0,1,0,1017,0,1.0,0.0,0
PF03373,PF08657:PF15165:PF12150:PF05436:PF03437,1,7,0,1,7,1010,0.0,0.99,0.0,-0.0,0,0,1,0,1017,0,1.0,0.0,0
PF12706,PF13691:PF00753:PF03669:PF07522:PF16123,35,91,24,11,67,916,0.26,0.92,0.69,0.39,10,9,26,1,982,0.9,0.97,0.26,0.47
PF10569,PF07678:PF07703:PF01835:PF07677:PF00207,13,21,13,0,8,997,0.62,0.99,1.0,0.78,12,12,1,0,1005,1.0,1.0,0.92,0.96
PF03074,PF07971:PF04833:PF06237:PF07162:PF01432,6,50,3,3,47,965,0.06,0.95,0.5,0.16,1,0,6,1,1011,0.0,0.99,0.0,-0.0
PF15337,PF15553:PF11162:PF12628:PF15774:PF07199,3,0,0,3,0,1015,0,1.0,0.0,0,0,0,3,0,1015,0,1.0,0.0,0
PF06777,PF06733:PF13307:PF00273:PF09164:PF17187,15,23,15,0,8,995,0.65,0.99,1.0,0.8,1,1,14,0,1003,1.0,0.99,0.07,0.26
PF04295,PF08275:PF16976:PF00816:PF00455:PF12461,7,8,0,7,8,1003,0.0,0.99,0.0,-0.01,0,0,7,0,1011,0,0.99,0.0,0
PF01752,PF08453:PF17188:PF01514:PF05513:PF00669,2,4,2,0,2,1014,0.5,1.0,1.0,0.71,0,0,2,0,1016,0,1.0,0.0,0
PF03153,PF01521:PF02744:PF12016:PF05726:PF14365,11,32,6,5,26,981,0.19,0.97,0.55,0.31,2,1,10,1,1006,0.5,0.99,0.09,0.21
PF01367,PF06959:PF07109:PF02132:PF07750:PF05690,6,11,3,3,8,1004,0.27,0.99,0.5,0.36,0,0,6,0,1012,0,0.99,0.0,0
PF05325,PF09154:PF16657:PF13183:PF11941:PF02947,0,13,0,0,13,1005,0.0,0.99,0,0,1,0,0,1,1017,0.0,1.0,0,0
PF09104,PF09103:PF09169:PF09121:PF00634:PF12295,1,12,1,0,11,1006,0.08,0.99,1.0,0.29,3,1,0,2,1015,0.33,1.0,1.0,0.58
PF02834,PF14573:PF17017:PF06868:PF16804:PF08808,0,0,0,0,0,1018,0,1.0,0,0,0,0,0,0,1018,0,1.0,0,0
PF04104,PF01702:PF06991:PF06814:PF15183:PF04536,18,33,6,12,27,973,0.18,0.96,0.33,0.23,2,2,16,0,1000,1.0,0.98,0.11,0.33
PF07339,PF02934:PF16334:PF08760:PF06303:PF13336,0,28,0,0,28,990,0.0,0.97,0,0,1,0,0,1,1017,0.0,1.0,0,0
PF13094,PF05728:PF15485:PF15478:PF13013:PF15680,1,6,0,1,6,1011,0.0,0.99,0.0,-0.0,0,0,1,0,1017,0,1.0,0.0,0
PF16508,PF15276:PF13325:PF08605:PF01834:PF15308,7,16,3,4,13,998,0.19,0.98,0.43,0.28,1,1,6,0,1011,1.0,0.99,0.14,0.38
PF09412,PF00889:PF01033:PF00045:PF10338:PF01510,12,45,10,2,35,971,0.22,0.96,0.83,0.42,2,1,11,1,1005,0.5,0.99,0.08,0.2
PF08737,PF12735:PF08743:PF05450:PF05652:PF03074,6,30,3,3,27,985,0.1,0.97,0.5,0.21,2,2,4,0,1012,1.0,1.0,0.33,0.58
PF00797,PF12239:PF10455:PF01774:PF00793:PF03972,13,32,6,7,26,979,0.19,0.97,0.46,0.28,1,1,12,0,1005,1.0,0.99,0.08,0.28
PF00229,PF03523:PF00386:PF01868:PF07039:PF00243,8,41,4,4,37,973,0.1,0.96,0.5,0.21,2,0,8,2,1008,0.0,0.99,0.0,-0.0
PF14310,PF01915:PF00933:PF08530:PF14498:PF07969,31,50,29,2,21,966,0.58,0.98,0.94,0.73,18,17,14,1,986,0.94,0.99,0.55,0.71
PF08803,PF10460:PF08850:PF10867:PF06295:PF05773,0,32,0,0,32,986,0.0,0.97,0,0,0,0,0,0,1018,0,1.0,0,0
PF09995,PF07542:PF03583:PF07470:PF03417:PF00953,10,45,8,2,37,971,0.18,0.96,0.8,0.37,1,1,9,0,1008,1.0,0.99,0.1,0.31
PF08110,PF07440:PF16048:PF08018:PF08023:PF16047,0,0,0,0,0,1018,0,1.0,0,0,0,0,0,0,1018,0,1.0,0,0
PF02733,PF02734:PF13684:PF00276:PF17184:PF10147,14,39,13,1,26,978,0.33,0.97,0.93,0.55,2,1,13,1,1003,0.5,0.99,0.07,0.19
PF01592,PF01774:PF02284:PF00444:PF06172:PF01680,10,23,5,5,18,990,0.22,0.98,0.5,0.32,0,0,10,0,1008,0,0.99,0.0,0
PF04668,PF00159:PF01470:PF01279:PF04667:PF14774,3,22,1,2,21,994,0.05,0.98,0.33,0.12,0,0,3,0,1015,0,1.0,0.0,0
PF08192,PF17017:PF15046:PF10563:PF15743:PF09365,0,6,0,0,6,1012,0.0,0.99,0,0,0,0,0,0,1018,0,1.0,0,0
PF00928,PF09786:PF01217:PF10574:PF09174:PF02788,38,51,28,10,23,957,0.55,0.97,0.74,0.62,1,1,37,0,980,1.0,0.96,0.03,0.16
PF07061,PF04099:PF13334:PF12326:PF00337:PF01762,9,58,5,4,53,956,0.09,0.94,0.56,0.2,9,3,6,6,1003,0.33,0.99,0.33,0.33
PF12325,PF16574:PF07558:PF10650:PF14818:PF12443,10,12,2,8,10,998,0.17,0.98,0.2,0.17,1,0,10,1,1007,0.0,0.99,0.0,-0.0
PF04245,PF11832:PF07924:PF01717:PF16504:PF08188,0,15,0,0,15,1003,0.0,0.99,0,0,0,0,0,0,1018,0,1.0,0,0
PF12340,PF12359:PF12449:PF15994:PF10493:PF13329,8,20,8,0,12,998,0.4,0.99,1.0,0.63,1,1,7,0,1010,1.0,0.99,0.12,0.35
PF04314,PF09611:PF06007:PF17092:PF03964:PF02830,0,3,0,0,3,1015,0.0,1.0,0,0,0,0,0,0,1018,0,1.0,0,0
PF00811,PF00965:PF12020:PF00143:PF04901:PF14935,9,11,1,8,10,999,0.09,0.98,0.11,0.09,0,0,9,0,1009,0,0.99,0.0,0
PF00319,PF12346:PF12347:PF02665:PF10384:PF09783,20,26,10,10,16,982,0.38,0.97,0.5,0.43,2,1,19,1,997,0.5,0.98,0.05,0.15
PF01716,PF05039:PF06351:PF02285:PF06232:PF07281,1,13,0,1,13,1004,0.0,0.99,0.0,-0.0,0,0,1,0,1017,0,1.0,0.0,0
PF17112,PF15207:PF05836:PF15186:PF08497:PF17049,0,3,0,0,3,1015,0.0,1.0,0,0,0,0,0,0,1018,0,1.0,0,0
PF05083,PF01514:PF01752:PF17076:PF06798:PF07409,0,2,0,0,2,1016,0.0,1.0,0,0,0,0,0,0,1018,0,1.0,0,0
PF01301,PF13364:PF10435:PF02140:PF13363:PF02449,31,40,20,11,20,967,0.5,0.97,0.65,0.55,6,6,25,0,987,1.0,0.98,0.19,0.43
PF13162,PF14015:PF02508:PF10380:PF02253:PF15727,0,4,0,0,4,1014,0.0,1.0,0,0,0,0,0,0,1018,0,1.0,0,0
PF02206,PF11548:PF14948:PF09414:PF16770:PF00533,8,59,6,2,53,957,0.1,0.95,0.75,0.26,5,1,7,4,1006,0.2,0.99,0.12,0.15
PF07249,PF01241:PF06581:PF07444:PF16716:PF10716,3,1,0,3,1,1014,0.0,1.0,0.0,-0.0,0,0,3,0,1015,0,1.0,0.0,0
PF13878,PF13880:PF02421:PF10444:PF11958:PF15374,5,18,4,1,14,999,0.22,0.99,0.8,0.42,0,0,5,0,1013,0,1.0,0.0,0
PF02264,PF00367:PF10410:PF16416:PF10108:PF15078,2,13,2,0,11,1005,0.15,0.99,1.0,0.39,0,0,2,0,1016,0,1.0,0.0,0
PF09304,PF15147:PF14564:PF07055:PF05016:PF06761,1,2,1,0,1,1016,0.5,1.0,1.0,0.71,0,0,1,0,1017,0,1.0,0.0,0
PF09863,PF08220:PF12461:PF01706:PF13580:PF06834,0,7,0,0,7,1011,0.0,0.99,0,0,0,0,0,0,1018,0,1.0,0,0
PF14973,PF15249:PF14722:PF09429:PF08123:PF05041,5,37,1,4,36,977,0.03,0.96,0.2,0.06,2,1,4,1,1012,0.5,1.0,0.2,0.31
PF05347,PF04281:PF07491:PF10270:PF00335:PF15320,29,62,12,17,50,939,0.19,0.93,0.41,0.25,0,0,29,0,989,0,0.97,0.0,0
PF11785,PF11786:PF11787:PF12498:PF08601:PF03957,3,7,3,0,4,1011,0.43,1.0,1.0,0.65,2,2,1,0,1015,1.0,1.0,0.67,0.82
PF12145,PF06333:PF11597:PF15950:PF12509:PF04589,6,14,2,4,12,1000,0.14,0.98,0.33,0.21,1,0,6,1,1011,0.0,0.99,0.0,-0.0
PF04353,PF04553:PF12357:PF05664:PF06650:PF11793,0,38,0,0,38,980,0.0,0.96,0,0,4,0,0,4,1014,0.0,1.0,0,0
PF08547,PF13460:PF10294:PF01370:PF06094:PF11807,15,126,11,4,115,888,0.09,0.88,0.73,0.23,16,7,8,9,994,0.44,0.98,0.47,0.44
PF14326,PF17164:PF15097:PF05567:PF12840:PF13151,0,1,0,0,1,1017,0.0,1.0,0,0,0,0,0,0,1018,0,1.0,0,0
PF15257,PF04988:PF05337:PF16043:PF15923:PF05841,2,9,1,1,8,1008,0.11,0.99,0.5,0.23,0,0,2,0,1016,0,1.0,0.0,0
PF02176,PF16673:PF02263:PF08941:PF06803:PF00917,15,46,11,4,35,968,0.24,0.96,0.73,0.41,6,5,10,1,1002,0.83,0.99,0.33,0.52
PF00886,PF00499:PF00507:PF00430:PF00124:PF01058,8,24,5,3,19,991,0.21,0.98,0.62,0.35,1,0,8,1,1009,0.0,0.99,0.0,-0.0
PF08747,PF02759:PF11830:PF05336:PF01710:PF11080,0,38,0,0,38,980,0.0,0.96,0,0,0,0,0,0,1018,0,1.0,0,0
PF17021,PF10380:PF10368:PF15169:PF02253:PF05932,0,3,0,0,3,1015,0.0,1.0,0,0,0,0,0,0,1018,0,1.0,0,0
PF02497,PF10380:PF07927:PF06379:PF16411:PF10368,2,5,1,1,4,1012,0.2,1.0,0.5,0.31,0,0,2,0,1016,0,1.0,0.0,0
PF15019,PF08598:PF01160:PF10332:PF11735:PF15346,1,15,0,1,15,1002,0.0,0.98,0.0,-0.0,1,0,1,1,1016,0.0,1.0,0.0,-0.0
PF15163,PF06798:PF03739:PF01706:PF08345:PF14842,3,5,0,3,5,1010,0.0,0.99,0.0,-0.0,1,0,3,1,1014,0.0,1.0,0.0,-0.0
PF06782,PF15185:PF02336:PF08964:PF07308:PF05662,0,7,0,0,7,1011,0.0,0.99,0,0,0,0,0,0,1018,0,1.0,0,0
PF02290,PF07911:PF06645:PF15879:PF06825:PF10310,14,17,4,10,13,991,0.24,0.98,0.29,0.25,0,0,14,0,1004,0,0.99,0.0,0
PF01200,PF15216:PF08092:PF02943:PF13795:PF09236,12,5,0,12,5,1001,0.0,0.98,0.0,-0.01,0,0,12,0,1006,0,0.99,0.0,0
PF05184,PF03489:PF02199:PF03227:PF02363:PF16656,11,41,8,3,33,974,0.2,0.96,0.73,0.37,2,1,10,1,1006,0.5,0.99,0.09,0.21
PF00969,PF00993:PF16196:PF10420:PF07258:PF00243,3,19,1,2,18,997,0.05,0.98,0.33,0.13,0,0,3,0,1015,0,1.0,0.0,0
PF00357,PF00882:PF01788:PF08441:PF06668:PF01839,2,20,2,0,18,998,0.1,0.98,1.0,0.31,2,0,2,2,1014,0.0,1.0,0.0,-0.0
PF12679,PF12040:PF12080:PF10566:PF07157:PF13205,0,3,0,0,3,1015,0.0,1.0,0,0,0,0,0,0,1018,0,1.0,0,0
PF07891,PF15235:PF15093:PF09038:PF12178:PF05990,1,5,1,0,4,1013,0.2,1.0,1.0,0.45,0,0,1,0,1017,0,1.0,0.0,0
PF08288,PF15924:PF12038:PF13579:PF13439:PF04413,11,29,4,7,25,982,0.14,0.97,0.36,0.21,1,1,10,0,1007,1.0,0.99,0.09,0.3
PF15929,PF10188:PF04664:PF09789:PF15264:PF16072,0,7,0,0,7,1011,0.0,0.99,0,0,0,0,0,0,1018,0,1.0,0,0
PF01653,PF03119:PF03120:PF08605:PF09309:PF11626,8,11,6,2,5,1005,0.55,0.99,0.75,0.64,1,1,7,0,1010,1.0,0.99,0.12,0.35
PF06978,PF08170:PF12733:PF06662:PF10383:PF13251,7,13,7,0,6,1005,0.54,0.99,1.0,0.73,2,2,5,0,1011,1.0,1.0,0.29,0.53
PF11468,PF07980:PF12897:PF08468:PF17026:PF06267,1,4,0,1,4,1013,0.0,1.0,0.0,-0.0,0,0,1,0,1017,0,1.0,0.0,0
PF05857,PF13247:PF11751:PF08483:PF05513:PF02277,0,5,0,0,5,1013,0.0,1.0,0,0,0,0,0,0,1018,0,1.0,0,0
PF00992,PF04144:PF10173:PF15237:PF14997:PF01146,5,28,3,2,25,988,0.11,0.97,0.6,0.25,2,2,3,0,1013,1.0,1.0,0.4,0.63
PF14539,PF05962:PF15680:PF03713:PF17049:PF15107,0,2,0,0,2,1016,0.0,1.0,0,0,0,0,0,0,1018,0,1.0,0,0
PF02896,PF00391:PF01326:PF05524:PF01315:PF04455,16,42,14,2,28,974,0.33,0.97,0.88,0.53,4,3,13,1,1001,0.75,0.99,0.19,0.37
PF16881,PF06463:PF06969:PF06968:PF13597:PF12345,11,16,4,7,12,995,0.25,0.98,0.36,0.29,2,2,9,0,1007,1.0,0.99,0.18,0.42
PF08284,PF00077:PF03732:PF12384:PF13655:PF12259,23,65,17,6,48,947,0.26,0.95,0.74,0.42,3,3,20,0,995,1.0,0.98,0.13,0.36
PF04097,PF03074:PF07778:PF04833:PF06237:PF05450,17,22,7,10,15,986,0.32,0.98,0.41,0.35,0,0,17,0,1001,0,0.98,0.0,0
PF02975,PF03241:PF07434:PF16861:PF12081:PF01289,3,4,0,3,4,1011,0.0,0.99,0.0,-0.0,0,0,3,0,1015,0,1.0,0.0,0
PF08117,PF06134:PF08267:PF03116:PF02718:PF12457,1,12,0,1,12,1005,0.0,0.99,0.0,-0.0,0,0,1,0,1017,0,1.0,0.0,0
PF01363,PF11409:PF11464:PF11979:PF03528:PF16696,78,18,14,64,4,936,0.78,0.93,0.18,0.35,1,1,77,0,940,1.0,0.92,0.01,0.11
PF04261,PF02690:PF12323:PF08692:PF01117:PF02271,13,18,6,7,12,993,0.33,0.98,0.46,0.38,0,0,13,0,1005,0,0.99,0.0,0
PF05284,PF01750:PF08120:PF07905:PF10807:PF10717,0,4,0,0,4,1014,0.0,1.0,0,0,0,0,0,0,1018,0,1.0,0,0
PF13895,PF00047:PF08205:PF03921:PF07686:PF11465,27,79,25,2,54,937,0.32,0.94,0.93,0.52,14,10,17,4,987,0.71,0.98,0.37,0.51
PF17019,PF11863:PF04671:PF09951:PF14871:PF01752,0,4,0,0,4,1014,0.0,1.0,0,0,0,0,0,0,1018,0,1.0,0,0
PF00754,PF09458:PF14200:PF05592:PF08531:PF09118,49,34,19,30,15,954,0.56,0.96,0.39,0.44,5,4,45,1,968,0.8,0.95,0.08,0.25
PF00125,PF16211:PF01661:PF02926:PF01201:PF09366,46,56,27,19,29,943,0.48,0.95,0.59,0.51,8,7,39,1,971,0.88,0.96,0.15,0.36
PF11712,PF07412:PF10276:PF15910:PF10471:PF08034,8,10,2,6,8,1002,0.2,0.99,0.25,0.22,0,0,8,0,1010,0,0.99,0.0,0
PF07801,PF02672:PF13965:PF03483:PF05826:PF06312,5,33,3,2,30,983,0.09,0.97,0.6,0.23,1,0,5,1,1012,0.0,0.99,0.0,-0.0
PF15546,PF12241:PF02399:PF16216:PF04350:PF14467,1,3,0,1,3,1014,0.0,1.0,0.0,-0.0,0,0,1,0,1017,0,1.0,0.0,0
PF13820,PF01335:PF17213:PF16501:PF14738:PF12075,2,22,2,0,20,996,0.09,0.98,1.0,0.3,1,1,1,0,1016,1.0,1.0,0.5,0.71
PF01414,PF07657:PF00386:PF01731:PF06858:PF11598,11,41,6,5,35,972,0.15,0.96,0.55,0.27,2,2,9,0,1007,1.0,0.99,0.18,0.42
PF03669,PF11336:PF01253:PF12706:PF09648:PF09183,7,47,4,3,43,968,0.09,0.95,0.57,0.21,1,0,7,1,1010,0.0,0.99,0.0,-0.0
PF15312,PF15482:PF15762:PF03238:PF09428:PF02070,0,1,0,0,1,1017,0.0,1.0,0,0,0,0,0,0,1018,0,1.0,0,0
PF03643,PF09751:PF16969:PF04418:PF16206:PF01922,13,29,6,7,23,982,0.21,0.97,0.46,0.3,2,2,11,0,1005,1.0,0.99,0.15,0.39
PF12769,PF02233:PF05222:PF01262:PF04455:PF16653,6,25,6,0,19,993,0.24,0.98,1.0,0.49,9,6,0,3,1009,0.67,1.0,1.0,0.82
PF01138,PF03725:PF03726:PF08067:PF10469:PF10470,61,39,34,27,5,952,0.87,0.97,0.56,0.68,3,3,58,0,957,1.0,0.94,0.05,0.22
PF09432,PF10279:PF03729:PF09904:PF07409:PF06403,0,1,0,0,1,1017,0.0,1.0,0,0,0,0,0,0,1018,0,1.0,0,0
PF08493,PF16846:PF11951:PF10703:PF04082:PF03851,4,181,3,1,178,836,0.02,0.82,0.75,0.09,9,3,1,6,1008,0.33,0.99,0.75,0.5
PF11375,PF04567:PF00787:PF00333:PF10385:PF06883,0,90,0,0,90,928,0.0,0.91,0,0,6,0,0,6,1012,0.0,0.99,0,0
PF06625,PF00214:PF00714:PF14473:PF00537:PF10839,4,3,0,4,3,1011,0.0,0.99,0.0,-0.0,0,0,4,0,1014,0,1.0,0.0,0
PF12885,PF12886:PF05624:PF05640:PF16788:PF15620,3,8,3,0,5,1010,0.38,1.0,1.0,0.61,1,1,2,0,1015,1.0,1.0,0.33,0.58
PF11363,PF02277:PF06074:PF11794:PF00669:PF01312,0,4,0,0,4,1014,0.0,1.0,0,0,0,0,0,0,1018,0,1.0,0,0
PF13568,PF06798:PF03971:PF12241:PF08940:PF04350,0,2,0,0,2,1016,0.0,1.0,0,0,0,0,0,0,1018,0,1.0,0,0
PF15713,PF03203:PF08792:PF15047:PF12658:PF14862,2,1,0,2,1,1015,0.0,1.0,0.0,-0.0,0,0,2,0,1016,0,1.0,0.0,0
PF07971,PF03074:PF01757:PF07162:PF16545:PF04515,16,59,7,9,52,950,0.12,0.94,0.44,0.21,5,2,14,3,999,0.4,0.98,0.12,0.22
PF09298,PF01557:PF08530:PF10370:PF02129:PF04431,25,50,23,2,27,966,0.46,0.97,0.92,0.64,15,12,13,3,990,0.8,0.98,0.48,0.61
PF07382,PF14600:PF06483:PF13148:PF03244:PF01913,3,1,0,3,1,1014,0.0,1.0,0.0,-0.0,0,0,3,0,1015,0,1.0,0.0,0
PF03820,PF03248:PF03690:PF14941:PF06951:PF05434,16,27,6,10,21,981,0.22,0.97,0.38,0.27,2,2,14,0,1002,1.0,0.99,0.12,0.35
PF03265,PF05148:PF01833:PF00240:PF10504:PF01991,18,109,13,5,96,904,0.12,0.9,0.72,0.27,10,8,10,2,998,0.8,0.99,0.44,0.59
PF08528,PF04090:PF10104:PF02116:PF11001:PF10361,5,14,2,3,12,1001,0.14,0.99,0.4,0.23,2,0,5,2,1011,0.0,0.99,0.0,-0.0
PF08403,PF03522:PF00324:PF07875:PF16870:PF13355,1,60,1,0,59,958,0.02,0.94,1.0,0.13,3,0,1,3,1014,0.0,1.0,0.0,-0.0
PF07745,PF15173:PF15071:PF06521:PF11264:PF03576,7,2,1,6,1,1010,0.5,0.99,0.14,0.26,0,0,7,0,1011,0,0.99,0.0,0
PF08335,PF03710:PF01807:PF04865:PF13808:PF13746,3,13,3,0,10,1005,0.23,0.99,1.0,0.48,0,0,3,0,1015,0,1.0,0.0,0
PF09972,PF09988:PF04461:PF10962:PF10319:PF03594,0,3,0,0,3,1015,0.0,1.0,0,0,0,0,0,0,1018,0,1.0,0,0
PF12752,PF13902:PF17219:PF13002:PF07223:PF16764,12,14,3,9,11,995,0.21,0.98,0.25,0.22,1,1,11,0,1006,1.0,0.99,0.08,0.29
PF03573,PF04392:PF06798:PF10566:PF03090:PF08479,2,2,1,1,1,1015,0.5,1.0,0.5,0.5,0,0,2,0,1016,0,1.0,0.0,0
PF02817,PF00198:PF10937:PF00364:PF07998:PF02436,15,48,15,0,33,970,0.31,0.97,1.0,0.55,4,3,12,1,1002,0.75,0.99,0.2,0.38
PF07042,PF06433:PF08096:PF01949:PF01206:PF00742,0,12,0,0,12,1006,0.0,0.99,0,0,0,0,0,0,1018,0,1.0,0,0
PF02665,PF08856:PF11946:PF15878:PF10951:PF01455,0,0,0,0,0,1018,0,1.0,0,0,0,0,0,0,1018,0,1.0,0,0
PF10410,PF01807:PF08345:PF04865:PF12299:PF14882,4,6,4,0,2,1012,0.67,1.0,1.0,0.82,0,0,4,0,1014,0,1.0,0.0,0
PF14508,PF08708:PF01752:PF03729:PF13296:PF03090,0,3,0,0,3,1015,0.0,1.0,0,0,0,0,0,0,1018,0,1.0,0,0
PF16155,PF06445:PF09397:PF09587:PF12242:PF15163,3,15,1,2,14,1001,0.07,0.98,0.33,0.14,1,0,3,1,1014,0.0,1.0,0.0,-0.0
PF10754,PF14886:PF01737:PF08398:PF08026:PF05558,0,6,0,0,6,1012,0.0,0.99,0,0,0,0,0,0,1018,0,1.0,0,0
PF16543,PF01205:PF06544:PF10453:PF16131:PF11250,18,40,7,11,33,967,0.17,0.96,0.39,0.24,7,3,15,4,996,0.43,0.98,0.17,0.26
PF10256,PF04716:PF00159:PF09769:PF08561:PF10244,18,24,5,13,19,981,0.21,0.97,0.28,0.22,2,2,16,0,1000,1.0,0.98,0.11,0.33
PF04610,PF11751:PF13722:PF02554:PF01580:PF15548,3,7,2,1,5,1010,0.29,0.99,0.67,0.43,0,0,3,0,1015,0,1.0,0.0,0
PF00294,PF04227:PF01081:PF01328:PF01380:PF02449,41,38,13,28,25,952,0.34,0.95,0.32,0.3,2,2,39,0,977,1.0,0.96,0.05,0.22
PF00208,PF02812:PF05088:PF14365:PF03080:PF07250,21,28,19,2,9,988,0.68,0.99,0.9,0.78,3,3,18,0,997,1.0,0.98,0.14,0.37
PF06594,PF10554:PF06506:PF13876:PF06406:PF09327,1,5,0,1,5,1012,0.0,0.99,0.0,-0.0,0,0,1,0,1017,0,1.0,0.0,0
PF03636,PF03633:PF03632:PF06165:PF16875:PF09511,4,21,4,0,17,997,0.19,0.98,1.0,0.43,0,0,4,0,1014,0,1.0,0.0,0
PF16632,PF16600:PF16553:PF15808:PF15898:PF09372,1,6,1,0,5,1012,0.17,1.0,1.0,0.41,1,1,0,0,1017,1.0,1.0,1.0,1.0
PF08515,PF01064:PF08917:PF14786:PF08488:PF08332,8,28,8,0,20,990,0.29,0.98,1.0,0.53,2,2,6,0,1010,1.0,0.99,0.25,0.5
PF01478,PF07203:PF01316:PF15192:PF17050:PF17049,1,5,0,1,5,1012,0.0,0.99,0.0,-0.0,0,0,1,0,1017,0,1.0,0.0,0
PF14803,PF15916:PF09297:PF05026:PF09296:PF10169,4,20,3,1,17,997,0.15,0.98,0.75,0.33,3,1,3,2,1012,0.33,1.0,0.25,0.29
PF01875,PF03842:PF14931:PF05296:PF15252:PF10166,8,5,1,7,4,1006,0.2,0.99,0.12,0.15,0,0,8,0,1010,0,0.99,0.0,0
PF04884,PF07542:PF03088:PF01758:PF03662:PF05191,17,43,6,11,37,964,0.14,0.95,0.35,0.2,5,4,13,1,1000,0.8,0.99,0.24,0.43
PF14400,PF01342:PF07445:PF10923:PF03172:PF15040,0,10,0,0,10,1008,0.0,0.99,0,0,0,0,0,0,1018,0,1.0,0,0
PF09419,PF07939:PF10018:PF04367:PF08137:PF09366,11,22,2,9,20,987,0.09,0.97,0.18,0.12,1,0,11,1,1006,0.0,0.99,0.0,-0.0
PF17012,PF04290:PF08352:PF02694:PF08402:PF12857,0,12,0,0,12,1006,0.0,0.99,0,0,2,0,0,2,1016,0.0,1.0,0,0
PF02355,PF07549:PF13721:PF08299:PF02056:PF08411,4,14,3,1,11,1003,0.21,0.99,0.75,0.4,0,0,4,0,1014,0,1.0,0.0,0
PF10304,PF12765:PF08620:PF10363:PF10493:PF12397,2,27,2,0,25,991,0.07,0.98,1.0,0.27,3,1,1,2,1014,0.33,1.0,0.5,0.41
PF14392,PF14111:PF02337:PF00607:PF07962:PF12384,29,65,24,5,41,948,0.37,0.95,0.83,0.53,3,3,26,0,989,1.0,0.97,0.1,0.32
PF15230,PF15888:PF04988:PF09596:PF12478:PF15232,0,10,0,0,10,1008,0.0,0.99,0,0,0,0,0,0,1018,0,1.0,0,0
PF03460,PF01077:PF13806:PF01855:PF04324:PF02898,15,31,15,0,16,987,0.48,0.98,1.0,0.69,12,12,3,0,1003,1.0,1.0,0.8,0.89
PF02978,PF00448:PF02881:PF04086:PF17215:PF01179,28,59,27,1,32,958,0.46,0.97,0.96,0.65,13,10,18,3,987,0.77,0.98,0.36,0.52
PF12801,PF02074:PF02551:PF12729:PF15823:PF11412,4,2,0,4,2,1012,0.0,0.99,0.0,-0.0,0,0,4,0,1014,0,1.0,0.0,0
PF07664,PF01773:PF07670:PF07662:PF03185:PF14951,2,27,2,0,25,991,0.07,0.98,1.0,0.27,4,0,2,4,1012,0.0,0.99,0.0,-0.0
PF04248,PF12853:PF10785:PF01259:PF11937:PF02222,4,27,1,3,26,988,0.04,0.97,0.25,0.09,0,0,4,0,1014,0,1.0,0.0,0
PF08459,PF04313:PF11408:PF16202:PF08072:PF12008,12,9,4,8,5,1001,0.44,0.99,0.33,0.38,4,3,9,1,1005,0.75,0.99,0.25,0.43
PF14478,PF01122:PF12934:PF16173:PF07837:PF04961,2,11,2,0,9,1007,0.18,0.99,1.0,0.42,1,0,2,1,1015,0.0,1.0,0.0,-0.0
PF01299,PF04145:PF01138:PF03725:PF13383:PF12406,21,78,13,8,65,932,0.17,0.93,0.62,0.3,12,10,11,2,995,0.83,0.99,0.48,0.62
PF12848,PF03649:PF13732:PF08352:PF09821:PF08402,21,13,5,16,8,989,0.38,0.98,0.24,0.29,2,2,19,0,997,1.0,0.98,0.1,0.31
PF03717,PF00905:PF15710:PF00768:PF12121:PF07440,17,20,16,1,4,997,0.8,1.0,0.94,0.87,0,0,17,0,1001,0,0.98,0.0,0
PF05990,PF04632:PF15235:PF15337:PF15391:PF08291,1,3,1,0,2,1015,0.33,1.0,1.0,0.58,1,1,0,0,1017,1.0,1.0,1.0,1.0
PF15729,PF02601:PF08291:PF15856:PF04965:PF02917,1,5,0,1,5,1012,0.0,0.99,0.0,-0.0,0,0,1,0,1017,0,1.0,0.0,0
PF08318,PF04437:PF16061:PF11571:PF10496:PF05450,14,35,9,5,26,978,0.26,0.97,0.64,0.39,1,1,13,0,1004,1.0,0.99,0.07,0.27
PF09666,PF08744:PF14251:PF10445:PF14124:PF08642,0,3,0,0,3,1015,0.0,1.0,0,0,0,0,0,0,1018,0,1.0,0,0
PF08787,PF06108:PF06912:PF06232:PF11264:PF05479,4,14,1,3,13,1001,0.07,0.98,0.25,0.13,0,0,4,0,1014,0,1.0,0.0,0
PF14939,PF15997:PF08578:PF10336:PF15862:PF02200,7,7,2,5,5,1006,0.29,0.99,0.29,0.28,0,0,7,0,1011,0,0.99,0.0,0
PF02113,PF02277:PF06890:PF14882:PF12241:PF07411,1,4,0,1,4,1013,0.0,1.0,0.0,-0.0,0,0,1,0,1017,0,1.0,0.0,0
PF07109,PF03882:PF15925:PF12897:PF17192:PF04288,2,3,1,1,2,1014,0.33,1.0,0.5,0.41,0,0,2,0,1016,0,1.0,0.0,0
PF10645,PF16861:PF09677:PF03616:PF17164:PF17188,2,4,0,2,4,1012,0.0,0.99,0.0,-0.0,0,0,2,0,1016,0,1.0,0.0,0
PF10649,PF11418:PF00233:PF08446:PF00672:PF13188,0,43,0,0,43,975,0.0,0.96,0,0,5,0,0,5,1013,0.0,1.0,0,0
PF15667,PF03244:PF15340:PF14534:PF05754:PF15776,0,4,0,0,4,1014,0.0,1.0,0,0,0,0,0,0,1018,0,1.0,0,0
PF04487,PF16036:PF15621:PF11652:PF15767:PF15552,3,7,0,3,7,1008,0.0,0.99,0.0,-0.0,0,0,3,0,1015,0,1.0,0.0,0
PF09331,PF03384:PF02902:PF16944:PF05030:PF14611,4,77,3,1,74,940,0.04,0.93,0.75,0.16,0,0,4,0,1014,0,1.0,0.0,0
PF05379,PF16463:PF13753:PF07804:PF06832:PF03135,2,7,0,2,7,1009,0.0,0.99,0.0,-0.0,0,0,2,0,1016,0,1.0,0.0,0
PF00249,PF14379:PF08558:PF16772:PF16495:PF04433,89,31,22,67,9,920,0.71,0.93,0.25,0.39,2,2,87,0,929,1.0,0.91,0.02,0.14
PF10483,PF05129:PF07344:PF06382:PF09748:PF14378,3,25,3,0,22,993,0.12,0.98,1.0,0.34,1,0,3,1,1014,0.0,1.0,0.0,-0.0
PF13765,PF00622:PF00643:PF10607:PF08205:PF09291,19,108,18,1,90,909,0.17,0.91,0.95,0.38,18,9,10,9,990,0.5,0.98,0.47,0.48
PF02019,PF06760:PF08917:PF14786:PF10430:PF03623,4,8,3,1,5,1009,0.38,0.99,0.75,0.53,2,2,2,0,1014,1.0,1.0,0.5,0.71
PF05681,PF05683:PF06742:PF07171:PF07364:PF10290,3,12,3,0,9,1006,0.25,0.99,1.0,0.5,1,0,3,1,1014,0.0,1.0,0.0,-0.0
PF16909,PF06650:PF12624:PF16910:PF09333:PF16908,24,38,22,2,16,978,0.58,0.98,0.92,0.72,18,14,10,4,990,0.78,0.99,0.58,0.67
PF07821,PF16028:PF02922:PF02806:PF11941:PF09154,9,24,4,5,20,989,0.17,0.98,0.44,0.26,2,1,8,1,1008,0.5,0.99,0.11,0.23
PF15333,PF05399:PF14986:PF02950:PF14862:PF14866,0,1,0,0,1,1017,0.0,1.0,0,0,0,0,0,0,1018,0,1.0,0,0
PF14971,PF11052:PF16173:PF11035:PF06401:PF14654,1,5,0,1,5,1012,0.0,0.99,0.0,-0.0,0,0,1,0,1017,0,1.0,0.0,0
PF11671,PF12278:PF15362:PF15374:PF08023:PF16047,0,1,0,0,1,1017,0.0,1.0,0,0,0,0,0,0,1018,0,1.0,0,0
PF02938,PF09924:PF09170:PF10451:PF12659:PF00691,7,11,4,3,7,1004,0.36,0.99,0.57,0.45,0,0,7,0,1011,0,0.99,0.0,0
PF14077,PF15512:PF17005:PF09384:PF08614:PF10647,4,13,2,2,11,1003,0.15,0.99,0.5,0.27,3,1,3,2,1012,0.33,1.0,0.25,0.29
PF15716,PF08093:PF05853:PF15175:PF05611:PF15207,0,3,0,0,3,1015,0.0,1.0,0,0,0,0,0,0,1018,0,1.0,0,0
PF09683,PF05418:PF08093:PF12805:PF07209:PF15052,0,6,0,0,6,1012,0.0,0.99,0,0,0,0,0,0,1018,0,1.0,0,0
PF00909,PF03595:PF13023:PF02133:PF05208:PF11700,29,53,12,17,41,948,0.23,0.94,0.41,0.28,4,2,27,2,987,0.5,0.97,0.07,0.18
PF03923,PF16210:PF16524:PF16448:PF00816:PF06719,2,6,1,1,5,1011,0.17,0.99,0.5,0.29,0,0,2,0,1016,0,1.0,0.0,0
PF14197,PF12757:PF15368:PF17045:PF11496:PF11500,6,10,1,5,9,1003,0.1,0.99,0.17,0.12,0,0,6,0,1012,0,0.99,0.0,0
PF06395,PF15720:PF09128:PF09036:PF15441:PF16523,8,12,4,4,8,1002,0.33,0.99,0.5,0.4,2,2,6,0,1010,1.0,0.99,0.25,0.5
PF02225,PF04258:PF01532:PF04389:PF04253:PF01103,47,91,36,11,55,916,0.4,0.94,0.77,0.52,17,14,33,3,968,0.82,0.96,0.3,0.48
PF00041,PF12453:PF12567:PF07965:PF12772:PF05473,91,8,7,84,1,926,0.88,0.92,0.08,0.25,1,1,90,0,927,1.0,0.91,0.01,0.1
PF15832,PF15876:PF15107:PF14985:PF10106:PF05418,0,4,0,0,4,1014,0.0,1.0,0,0,0,0,0,0,1018,0,1.0,0,0
PF17191,PF12105:PF05223:PF08848:PF05962:PF05299,5,7,5,0,2,1011,0.71,1.0,1.0,0.84,0,0,5,0,1013,0,1.0,0.0,0
PF12228,PF03241:PF16055:PF09677:PF11130:PF12477,0,0,0,0,0,1018,0,1.0,0,0,0,0,0,0,1018,0,1.0,0,0
PF00724,PF00756:PF00180:PF07110:PF11807:PF14027,35,66,16,19,50,933,0.24,0.93,0.46,0.3,7,5,30,2,981,0.71,0.97,0.14,0.31
PF15109,PF15715:PF15559:PF02448:PF15055:PF02427,0,0,0,0,0,1018,0,1.0,0,0,0,0,0,0,1018,0,1.0,0,0
PF01336,PF00152:PF16900:PF10451:PF02938:PF04057,50,79,43,7,36,932,0.54,0.96,0.86,0.66,6,6,44,0,968,1.0,0.96,0.12,0.34
PF15778,PF12516:PF15249:PF12478:PF09596:PF15090,3,14,0,3,14,1001,0.0,0.98,0.0,-0.01,0,0,3,0,1015,0,1.0,0.0,0
PF13746,PF11614:PF14882:PF07805:PF01136:PF01706,4,7,4,0,3,1011,0.57,1.0,1.0,0.75,0,0,4,0,1014,0,1.0,0.0,0
PF16771,PF05947:PF14015:PF11245:PF01292:PF06798,0,6,0,0,6,1012,0.0,0.99,0,0,0,0,0,0,1018,0,1.0,0,0
PF07703,PF00207:PF01835:PF07677:PF07678:PF10569,13,21,13,0,8,997,0.62,0.99,1.0,0.78,12,11,2,1,1004,0.92,1.0,0.85,0.88
PF06214,PF11162:PF15089:PF10749:PF15259:PF06493,1,1,0,1,1,1016,0.0,1.0,0.0,-0.0,0,0,1,0,1017,0,1.0,0.0,0
PF12142,PF12143:PF14830:PF00264:PF12326:PF00691,2,44,2,0,42,974,0.05,0.96,1.0,0.21,1,1,1,0,1016,1.0,1.0,0.5,0.71
PF04278,PF15311:PF14922:PF11727:PF10998:PF06428,5,16,2,3,14,999,0.12,0.98,0.4,0.22,1,0,5,1,1012,0.0,0.99,0.0,-0.0
PF01067,PF00648:PF09149:PF13833:PF02666:PF01735,35,92,33,2,59,924,0.36,0.94,0.94,0.56,12,10,25,2,981,0.83,0.97,0.29,0.48
PF17049,PF15856:PF14885:PF15141:PF15776:PF03238,1,4,0,1,4,1013,0.0,1.0,0.0,-0.0,0,0,1,0,1017,0,1.0,0.0,0
PF07084,PF07956:PF04710:PF15993:PF09806:PF03784,2,14,2,0,12,1004,0.14,0.99,1.0,0.38,1,0,2,1,1015,0.0,1.0,0.0,-0.0
PF15763,PF01668:PF01312:PF14251:PF17193:PF07881,0,5,0,0,5,1013,0.0,1.0,0,0,0,0,0,0,1018,0,1.0,0,0
PF02790,PF06481:PF00116:PF13442:PF11729:PF08611,12,22,12,0,10,996,0.55,0.99,1.0,0.73,3,3,9,0,1006,1.0,0.99,0.25,0.5
PF14759,PF14962:PF14721:PF04224:PF16020:PF14691,7,15,2,5,13,998,0.13,0.98,0.29,0.19,2,1,6,1,1010,0.5,0.99,0.14,0.26
PF10020,PF09365:PF02217:PF10567:PF11863:PF04451,0,7,0,0,7,1011,0.0,0.99,0,0,0,0,0,0,1018,0,1.0,0,0
PF06607,PF16516:PF04440:PF14988:PF08234:PF10217,2,9,0,2,9,1007,0.0,0.99,0.0,-0.0,0,0,2,0,1016,0,1.0,0.0,0
PF04816,PF16824:PF09677:PF00516:PF06834:PF15766,1,0,0,1,0,1017,0,1.0,0.0,0,0,0,1,0,1017,0,1.0,0.0,0
PF02594,PF12716:PF06108:PF10244:PF10252:PF09056,10,14,4,6,10,998,0.29,0.98,0.4,0.33,1,0,10,1,1007,0.0,0.99,0.0,-0.0
PF16923,PF03200:PF16350:PF08302:PF09511:PF08158,8,30,8,0,22,988,0.27,0.98,1.0,0.51,3,3,5,0,1010,1.0,1.0,0.38,0.61
PF15669,PF06989:PF16171:PF07904:PF08653:PF06485,0,7,0,0,7,1011,0.0,0.99,0,0,0,0,0,0,1018,0,1.0,0,0
PF04112,PF12359:PF11935:PF12340:PF15917:PF16399,8,25,2,6,23,987,0.08,0.97,0.25,0.13,3,0,8,3,1007,0.0,0.99,0.0,-0.0
PF13681,PF08950:PF15848:PF07192:PF08093:PF17185,0,1,0,0,1,1017,0.0,1.0,0,0,0,0,0,0,1018,0,1.0,0,0
PF01474,PF07168:PF07993:PF10195:PF15011:PF04922,17,56,7,10,49,952,0.12,0.94,0.41,0.2,1,1,16,0,1001,1.0,0.98,0.06,0.24
PF03379,PF02950:PF07327:PF01316:PF08847:PF15085,1,6,0,1,6,1011,0.0,0.99,0.0,-0.0,0,0,1,0,1017,0,1.0,0.0,0
PF16087,PF11427:PF13936:PF14949:PF06772:PF01757,21,45,8,13,37,960,0.18,0.95,0.38,0.24,5,4,17,1,996,0.8,0.98,0.19,0.39
PF01424,PF11952:PF13902:PF12752:PF07528:PF00035,37,66,21,16,45,936,0.32,0.94,0.57,0.4,5,5,32,0,981,1.0,0.97,0.14,0.36
PF05645,PF08221:PF00940:PF14881:PF02002:PF11521,6,27,5,1,22,990,0.19,0.98,0.83,0.39,4,3,3,1,1011,0.75,1.0,0.5,0.61
PF11752,PF10118:PF09685:PF09095:PF14487:PF08437,0,9,0,0,9,1009,0.0,0.99,0,0,0,0,0,0,1018,0,1.0,0,0
PF17042,PF07005:PF01116:PF14833:PF00393:PF03446,6,51,6,0,45,967,0.12,0.96,1.0,0.34,13,6,0,7,1005,0.46,0.99,1.0,0.68
PF12571,PF15726:PF01314:PF14882:PF12241:PF14467,0,4,0,0,4,1014,0.0,1.0,0,0,0,0,0,0,1018,0,1.0,0,0
PF11767,PF03864:PF04310:PF10481:PF16574:PF09444,7,10,2,5,8,1003,0.2,0.99,0.29,0.23,0,0,7,0,1011,0,0.99,0.0,0
PF02636,PF07896:PF07816:PF11927:PF03350:PF03647,10,26,3,7,23,985,0.12,0.97,0.3,0.17,0,0,10,0,1008,0,0.99,0.0,0
PF13391,PF01868:PF11735:PF10332:PF09687:PF15019,14,19,2,12,17,987,0.11,0.97,0.14,0.11,0,0,14,0,1004,0,0.99,0.0,0
PF05432,PF07343:PF00799:PF08283:PF14232:PF09051,2,2,0,2,2,1014,0.0,1.0,0.0,-0.0,0,0,2,0,1016,0,1.0,0.0,0
PF15799,PF12904:PF05914:PF07085:PF11958:PF15302,1,11,1,0,10,1007,0.09,0.99,1.0,0.3,0,0,1,0,1017,0,1.0,0.0,0
PF08581,PF17005:PF10647:PF14077:PF17108:PF15512,3,7,2,1,5,1010,0.29,0.99,0.67,0.43,1,1,2,0,1015,1.0,1.0,0.33,0.58
PF14473,PF06541:PF00214:PF10839:PF00714:PF04538,0,3,0,0,3,1015,0.0,1.0,0,0,0,0,0,0,1018,0,1.0,0,0
PF05239,PF03468:PF15905:PF17045:PF03800:PF09762,2,10,0,2,10,1006,0.0,0.99,0.0,-0.0,1,0,2,1,1015,0.0,1.0,0.0,-0.0
PF01743,PF01144:PF05827:PF10022:PF16401:PF10155,12,34,4,8,30,976,0.12,0.96,0.33,0.18,1,0,12,1,1005,0.0,0.99,0.0,-0.0
PF00520,PF03521:PF03520:PF11956:PF08454:PF08412,88,25,21,67,4,926,0.84,0.93,0.24,0.43,2,2,86,0,930,1.0,0.92,0.02,0.14
PF11681,PF05974:PF03428:PF08497:PF15214:PF15826,0,2,0,0,2,1016,0.0,1.0,0,0,0,0,0,0,1018,0,1.0,0,0
PF08064,PF08163:PF11865:PF02259:PF11640:PF15785,8,39,8,0,31,979,0.21,0.97,1.0,0.45,5,3,5,2,1008,0.6,0.99,0.38,0.47
PF08274,PF08345:PF03428:PF04963:PF07195:PF05509,0,2,0,0,2,1016,0.0,1.0,0,0,0,0,0,0,1018,0,1.0,0,0
PF06455,PF01010:PF00662:PF13910:PF12612:PF14959,2,18,2,0,16,1000,0.11,0.98,1.0,0.33,0,0,2,0,1016,0,1.0,0.0,0
PF11594,PF10173:PF10248:PF12926:PF09802:PF10217,4,10,0,4,10,1004,0.0,0.99,0.0,-0.01,0,0,4,0,1014,0,1.0,0.0,0
PF10139,PF07520:PF07805:PF08345:PF14882:PF01706,0,2,0,0,2,1016,0.0,1.0,0,0,0,0,0,0,1018,0,1.0,0,0
PF06454,PF12906:PF12428:PF01044:PF03094:PF00932,8,46,3,5,43,967,0.07,0.95,0.38,0.14,3,2,6,1,1009,0.67,0.99,0.25,0.41
PF00059,PF08016:PF00801:PF15481:PF02010:PF01437,80,50,23,57,27,911,0.46,0.92,0.29,0.32,6,6,74,0,938,1.0,0.93,0.07,0.26
PF01640,PF13505:PF00700:PF06744:PF14403:PF17164,1,1,0,1,1,1016,0.0,1.0,0.0,-0.0,0,0,1,0,1017,0,1.0,0.0,0
PF12280,PF08561:PF12020:PF00965:PF10244:PF02284,5,20,1,4,19,994,0.05,0.98,0.2,0.09,1,0,5,1,1012,0.0,0.99,0.0,-0.0
PF06178,PF11855:PF16741:PF03446:PF05989:PF00864,0,45,0,0,45,973,0.0,0.96,0,0,2,0,0,2,1016,0.0,1.0,0,0
PF11625,PF10999:PF08642:PF15460:PF03588:PF17078,0,3,0,0,3,1015,0.0,1.0,0,0,0,0,0,0,1018,0,1.0,0,0
PF14946,PF15252:PF01415:PF15551:PF15068:PF15741,2,4,0,2,4,1012,0.0,0.99,0.0,-0.0,0,0,2,0,1016,0,1.0,0.0,0
PF05565,PF06819:PF03175:PF00270:PF01672:PF04055,0,202,0,0,202,816,0.0,0.8,0,0,5,0,0,5,1013,0.0,1.0,0,0
PF12283,PF05901:PF02217:PF11697:PF15876:PF08093,0,4,0,0,4,1014,0.0,1.0,0,0,0,0,0,0,1018,0,1.0,0,0
PF08624,PF10307:PF08733:PF10336:PF05030:PF16944,4,12,0,4,12,1002,0.0,0.98,0.0,-0.01,0,0,4,0,1014,0,1.0,0.0,0
PF00644,PF12174:PF05406:PF02877:PF02825:PF14847,44,45,26,18,19,955,0.58,0.96,0.59,0.57,8,7,37,1,973,0.88,0.96,0.16,0.36
PF17060,PF08411:PF08479:PF00947:PF01913:PF11751,1,13,0,1,13,1004,0.0,0.99,0.0,-0.0,0,0,1,0,1017,0,1.0,0.0,0
PF09715,PF15460:PF14494:PF03601:PF12628:PF17078,0,2,0,0,2,1016,0.0,1.0,0,0,0,0,0,0,1018,0,1.0,0,0
PF08672,PF10557:PF00888:PF03256:PF11515:PF00290,12,52,11,1,41,965,0.21,0.96,0.92,0.43,9,4,8,5,1001,0.44,0.99,0.33,0.38
PF14865,PF10974:PF15480:PF11027:PF13247:PF15134,0,4,0,0,4,1014,0.0,1.0,0,0,0,0,0,0,1018,0,1.0,0,0
PF02840,PF07039:PF08954:PF01092:PF12024:PF12298,11,28,7,4,21,986,0.25,0.98,0.64,0.39,2,2,9,0,1007,1.0,0.99,0.18,0.42
PF04928,PF04926:PF16979:PF00178:PF03828:PF04457,19,61,17,2,44,955,0.28,0.95,0.89,0.49,9,7,12,2,997,0.78,0.99,0.37,0.53
PF05179,PF16050:PF01634:PF14642:PF04775:PF14654,5,16,5,0,11,1002,0.31,0.99,1.0,0.56,0,0,5,0,1013,0,1.0,0.0,0
PF01488,PF08501:PF01487:PF05201:PF00745:PF00275,17,32,17,0,15,986,0.53,0.99,1.0,0.72,10,5,12,5,996,0.5,0.98,0.29,0.38
PF07724,PF10431:PF02577:PF02861:PF05496:PF02151,27,42,25,2,17,974,0.6,0.98,0.93,0.73,4,4,23,0,991,1.0,0.98,0.15,0.38
PF14383,PF12552:PF14309:PF08729:PF14075:PF12887,3,12,3,0,9,1006,0.25,0.99,1.0,0.5,1,0,3,1,1014,0.0,1.0,0.0,-0.0
PF01118,PF02774:PF04768:PF13840:PF09290:PF03447,13,41,12,1,29,976,0.29,0.97,0.92,0.51,3,3,10,0,1005,1.0,0.99,0.23,0.48
PF10259,PF03980:PF09631:PF03657:PF06127:PF10244,10,26,5,5,21,987,0.19,0.97,0.5,0.3,2,2,8,0,1008,1.0,0.99,0.2,0.45
PF03150,PF00950:PF06808:PF01032:PF03459:PF05936,8,13,5,3,8,1002,0.38,0.99,0.62,0.49,2,2,6,0,1010,1.0,0.99,0.25,0.5
PF06962,PF11842:PF10105:PF11230:PF12345:PF04794,2,3,2,0,1,1015,0.67,1.0,1.0,0.82,2,2,0,0,1016,1.0,1.0,1.0,1.0
PF05078,PF05910:PF04720:PF04690:PF08137:PF08536,3,20,1,2,19,996,0.05,0.98,0.33,0.12,1,1,2,0,1015,1.0,1.0,0.33,0.58
PF04624,PF10856:PF04625:PF03710:PF08411:PF04865,1,5,1,0,4,1013,0.2,1.0,1.0,0.45,0,0,1,0,1017,0,1.0,0.0,0
PF03151,PF04230:PF05019:PF00244:PF14368:PF14009,31,44,12,19,32,955,0.27,0.95,0.39,0.3,5,4,27,1,986,0.8,0.97,0.13,0.31
PF10401,PF00605:PF13336:PF03189:PF02219:PF06657,9,36,8,1,28,981,0.22,0.97,0.89,0.44,2,0,9,2,1007,0.0,0.99,0.0,-0.0
PF06936,PF14340:PF10961:PF07912:PF07449:PF05218,5,11,2,3,9,1004,0.18,0.99,0.4,0.26,0,0,5,0,1013,0,1.0,0.0,0
PF09011,PF08347:PF13775:PF12444:PF00505:PF14887,16,61,15,1,46,956,0.25,0.95,0.94,0.47,0,0,16,0,1002,0,0.98,0.0,0
PF12100,PF11214:PF04451:PF10109:PF01913:PF13750,0,2,0,0,2,1016,0.0,1.0,0,0,0,0,0,0,1018,0,1.0,0,0
PF08550,PF11702:PF07573:PF10491:PF13919:PF05066,13,13,7,6,6,999,0.54,0.99,0.54,0.53,2,2,11,0,1005,1.0,0.99,0.15,0.39
PF03633,PF03636:PF03632:PF03413:PF06165:PF16874,1,16,1,0,15,1002,0.06,0.99,1.0,0.25,0,0,1,0,1017,0,1.0,0.0,0
PF02033,PF07939:PF04839:PF06271:PF04949:PF04982,6,18,0,6,18,994,0.0,0.98,0.0,-0.01,0,0,6,0,1012,0,0.99,0.0,0
PF06346,PF06345:PF06371:PF06367:PF02181:PF10481,3,45,2,1,43,972,0.04,0.96,0.67,0.16,21,2,1,19,996,0.1,0.98,0.67,0.25
PF02950,PF03379:PF11771:PF15333:PF14866:PF15343,1,1,0,1,1,1016,0.0,1.0,0.0,-0.0,0,0,1,0,1017,0,1.0,0.0,0
PF15038,PF08034:PF12926:PF04852:PF10273:PF15245,1,10,1,0,9,1008,0.1,0.99,1.0,0.31,0,0,1,0,1017,0,1.0,0.0,0
PF02915,PF13225:PF00468:PF04839:PF07816:PF13092,2,13,0,2,13,1003,0.0,0.99,0.0,-0.01,1,0,2,1,1015,0.0,1.0,0.0,-0.0
PF00381,PF12477:PF06798:PF03241:PF06082:PF08808,0,0,0,0,0,1018,0,1.0,0,0,0,0,0,0,1018,0,1.0,0,0
PF00347,PF03719:PF00166:PF00861:PF03464:PF00333,23,43,14,9,29,966,0.33,0.96,0.61,0.43,9,7,16,2,993,0.78,0.98,0.3,0.48
PF13405,PF00036:PF13202:PF13833:PF13499:PF16166,35,156,30,5,126,857,0.19,0.87,0.86,0.37,36,20,15,16,967,0.56,0.97,0.57,0.55
PF09250,PF17007:PF15518:PF08411:PF03534:PF04196,1,2,0,1,2,1015,0.0,1.0,0.0,-0.0,0,0,1,0,1017,0,1.0,0.0,0
PF01989,PF04412:PF00073:PF00680:PF01447:PF12381,1,14,1,0,13,1004,0.07,0.99,1.0,0.27,4,0,1,4,1013,0.0,1.0,0.0,-0.0
PF11074,PF09677:PF12477:PF11775:PF03135:PF01289,0,6,0,0,6,1012,0.0,0.99,0,0,0,0,0,0,1018,0,1.0,0,0
PF00295,PF12708:PF04231:PF01063:PF03168:PF05637,33,50,13,20,37,948,0.26,0.94,0.39,0.29,4,4,29,0,985,1.0,0.97,0.12,0.34
PF03382,PF11260:PF11765:PF12499:PF15622:PF11265,3,5,0,3,5,1010,0.0,0.99,0.0,-0.0,0,0,3,0,1015,0,1.0,0.0,0
PF00119,PF00124:PF00115:PF00499:PF00507:PF00430,9,22,7,2,15,994,0.32,0.98,0.78,0.49,2,1,8,1,1008,0.5,0.99,0.11,0.23
PF02801,PF00109:PF00698:PF16197:PF08242:PF16073,58,74,58,0,16,944,0.78,0.98,1.0,0.88,39,39,19,0,960,1.0,0.98,0.67,0.81
PF03106,PF07887:PF10533:PF05553:PF02701:PF03407,18,33,13,5,20,980,0.39,0.98,0.72,0.52,2,2,16,0,1000,1.0,0.98,0.11,0.33
PF15304,PF01430:PF05100:PF09444:PF12178:PF15748,1,3,0,1,3,1014,0.0,1.0,0.0,-0.0,0,0,1,0,1017,0,1.0,0.0,0
PF08964,PF03710:PF10856:PF03775:PF15843:PF01840,0,3,0,0,3,1015,0.0,1.0,0,0,0,0,0,0,1018,0,1.0,0,0
PF03008,PF15471:PF12477:PF05309:PF04740:PF04965,1,1,0,1,1,1016,0.0,1.0,0.0,-0.0,0,0,1,0,1017,0,1.0,0.0,0
PF02298,PF06749:PF04535:PF02519:PF04720:PF05910,19,26,8,11,18,981,0.31,0.97,0.42,0.35,3,3,16,0,999,1.0,0.98,0.16,0.39
PF07304,PF09453:PF08232:PF12234:PF13925:PF14538,5,38,3,2,35,978,0.08,0.96,0.6,0.21,3,1,4,2,1011,0.33,0.99,0.2,0.26
PF08589,PF14519:PF01741:PF03576:PF14469:PF07081,4,8,0,4,8,1006,0.0,0.99,0.0,-0.01,0,0,4,0,1014,0,1.0,0.0,0
PF03776,PF02427:PF15063:PF06581:PF15115:PF15305,4,2,0,4,2,1012,0.0,0.99,0.0,-0.0,0,0,4,0,1014,0,1.0,0.0,0
PF01936,PF14418:PF17182:PF11608:PF12872:PF13871,11,17,5,6,12,995,0.29,0.98,0.45,0.36,1,1,10,0,1007,1.0,0.99,0.09,0.3
PF07353,PF08093:PF05611:PF10563:PF09365:PF15680,2,4,0,2,4,1012,0.0,0.99,0.0,-0.0,0,0,2,0,1016,0,1.0,0.0,0
PF03630,PF01937:PF06888:PF14535:PF14698:PF02374,14,31,9,5,22,982,0.29,0.97,0.64,0.42,2,2,12,0,1004,1.0,0.99,0.14,0.38
PF00631,PF08833:PF00778:PF16646:PF05228:PF16697,22,9,5,17,4,992,0.56,0.98,0.23,0.35,0,0,22,0,996,0,0.98,0.0,0
PF09678,PF08274:PF08886:PF06007:PF09677:PF01935,1,2,0,1,2,1015,0.0,1.0,0.0,-0.0,0,0,1,0,1017,0,1.0,0.0,0
PF01217,PF09786:PF00928:PF12016:PF09174:PF07942,45,46,29,16,17,956,0.63,0.97,0.64,0.62,2,2,43,0,973,1.0,0.96,0.04,0.21
PF01934,PF13427:PF10634:PF03090:PF04552:PF04954,1,2,1,0,1,1016,0.5,1.0,1.0,0.71,0,0,1,0,1017,0,1.0,0.0,0
PF00128,PF02922:PF11852:PF02806:PF07821:PF16028,39,28,25,14,3,976,0.89,0.98,0.64,0.75,5,5,34,0,979,1.0,0.97,0.13,0.35
PF15910,PF01279:PF00214:PF15063:PF11947:PF07939,0,6,0,0,6,1012,0.0,0.99,0,0,0,0,0,0,1018,0,1.0,0,0
PF08833,PF16646:PF00778:PF00631:PF02377:PF05228,2,28,2,0,26,990,0.07,0.97,1.0,0.26,1,0,2,1,1015,0.0,1.0,0.0,-0.0
PF17029,PF13994:PF04883:PF06476:PF08850:PF02556,0,6,0,0,6,1012,0.0,0.99,0,0,0,0,0,0,1018,0,1.0,0,0
PF06930,PF08373:PF03485:PF05746:PF06743:PF08368,0,40,0,0,40,978,0.0,0.96,0,0,10,0,0,10,1008,0.0,0.99,0,0
PF07958,PF05658:PF17085:PF11975:PF10554:PF03845,5,8,0,5,8,1005,0.0,0.99,0.0,-0.01,0,0,5,0,1013,0,1.0,0.0,0
PF05168,PF08579:PF16756:PF12255:PF12178:PF15392,3,2,0,3,2,1013,0.0,1.0,0.0,-0.0,0,0,3,0,1015,0,1.0,0.0,0
PF11560,PF14877:PF05556:PF17015:PF14474:PF15553,4,13,2,2,11,1003,0.15,0.99,0.5,0.27,0,0,4,0,1014,0,1.0,0.0,0
PF00507,PF00499:PF00124:PF01058:PF00430:PF00119,5,28,5,0,23,990,0.18,0.98,1.0,0.42,1,0,5,1,1012,0.0,0.99,0.0,-0.0
PF12595,PF04114:PF10427:PF14923:PF08976:PF11470,5,27,4,1,23,990,0.15,0.98,0.8,0.34,1,0,5,1,1012,0.0,0.99,0.0,-0.0
PF16350,PF01571:PF10170:PF07892:PF16901:PF08669,12,37,12,0,25,981,0.32,0.98,1.0,0.56,3,2,10,1,1005,0.67,0.99,0.17,0.33
PF16716,PF02024:PF06446:PF00727:PF00537:PF10839,0,6,0,0,6,1012,0.0,0.99,0,0,0,0,0,0,1018,0,1.0,0,0
PF04747,PF15818:PF08762:PF15130:PF07263:PF15398,0,6,0,0,6,1012,0.0,0.99,0,0,0,0,0,0,1018,0,1.0,0,0
PF01774,PF02284:PF06172:PF05995:PF01680:PF06658,7,21,2,5,19,992,0.1,0.98,0.29,0.16,1,0,7,1,1010,0.0,0.99,0.0,-0.0
PF01182,PF02585:PF02872:PF00479:PF02781:PF03637,18,44,10,8,34,966,0.23,0.96,0.56,0.34,6,3,15,3,997,0.5,0.98,0.17,0.28
PF16196,PF00993:PF00969:PF08204:PF16497:PF14517,0,5,0,0,5,1013,0.0,1.0,0,0,0,0,0,0,1018,0,1.0,0,0
PF14216,PF11223:PF15337:PF07199:PF04965:PF10138,1,6,0,1,6,1011,0.0,0.99,0.0,-0.0,0,0,1,0,1017,0,1.0,0.0,0
PF03831,PF05513:PF11751:PF05509:PF07157:PF13722,0,1,0,0,1,1017,0.0,1.0,0,0,0,0,0,0,1018,0,1.0,0,0
PF04843,PF14214:PF02689:PF05970:PF13427:PF13538,3,49,1,2,48,967,0.02,0.95,0.33,0.07,8,1,2,7,1008,0.12,0.99,0.33,0.2
PF07337,PF10988:PF08808:PF08744:PF12241:PF02554,0,1,0,0,1,1017,0.0,1.0,0,0,0,0,0,0,1018,0,1.0,0,0
PF09047,PF15232:PF15392:PF08101:PF15082:PF12178,1,6,1,0,5,1012,0.17,1.0,1.0,0.41,0,0,1,0,1017,0,1.0,0.0,0
PF04107,PF00468:PF07298:PF03350:PF14159:PF04759,5,12,0,5,12,1001,0.0,0.98,0.0,-0.01,0,0,5,0,1013,0,1.0,0.0,0
PF06645,PF01279:PF02044:PF10775:PF10310:PF04852,8,7,2,6,5,1005,0.29,0.99,0.25,0.26,0,0,8,0,1010,0,0.99,0.0,0
PF12062,PF00685:PF16332:PF10559:PF03087:PF01151,8,55,7,1,48,962,0.13,0.95,0.88,0.32,3,1,7,2,1008,0.33,0.99,0.12,0.2
PF01161,PF15430:PF13664:PF15860:PF00810:PF02430,28,26,7,21,19,971,0.27,0.96,0.25,0.24,1,1,27,0,990,1.0,0.97,0.04,0.19
PF11255,PF02576:PF11460:PF06989:PF13270:PF06420,0,4,0,0,4,1014,0.0,1.0,0,0,0,0,0,0,1018,0,1.0,0,0
PF16470,PF01483:PF09286:PF12583:PF15913:PF12580,14,33,10,4,23,981,0.3,0.97,0.71,0.45,4,4,10,0,1004,1.0,0.99,0.29,0.53
PF08539,PF05841:PF08634:PF12927:PF13810:PF10361,2,6,1,1,5,1011,0.17,0.99,0.5,0.29,0,0,2,0,1016,0,1.0,0.0,0
PF05445,PF03044:PF01219:PF07829:PF15034:PF11002,2,4,0,2,4,1012,0.0,0.99,0.0,-0.0,0,0,2,0,1016,0,1.0,0.0,0
PF01194,PF02531:PF03805:PF11909:PF12095:PF09216,4,4,0,4,4,1010,0.0,0.99,0.0,-0.0,0,0,4,0,1014,0,1.0,0.0,0
PF15762,PF15312:PF02070:PF15482:PF03745:PF05448,0,2,0,0,2,1016,0.0,1.0,0,0,0,0,0,0,1018,0,1.0,0,0
PF08374,PF16492:PF15974:PF07953:PF08758:PF16483,1,10,1,0,9,1008,0.1,0.99,1.0,0.31,1,1,0,0,1017,1.0,1.0,1.0,1.0
PF11987,PF08364:PF16658:PF14492:PF16004:PF04760,28,43,14,14,29,961,0.33,0.96,0.5,0.38,5,5,23,0,990,1.0,0.98,0.18,0.42
PF04371,PF06609:PF05648:PF13577:PF11471:PF04414,1,26,0,1,26,991,0.0,0.97,0.0,-0.01,1,0,1,1,1016,0.0,1.0,0.0,-0.0
PF01000,PF03118:PF13656:PF00411:PF01193:PF16952,7,40,6,1,34,977,0.15,0.97,0.86,0.35,8,4,3,4,1007,0.5,0.99,0.57,0.53
PF09722,PF04451:PF00669:PF08453:PF01752:PF15775,0,3,0,0,3,1015,0.0,1.0,0,0,0,0,0,0,1018,0,1.0,0,0
PF12381,PF08762:PF00548:PF15395:PF00073:PF01660,4,16,4,0,12,1002,0.25,0.99,1.0,0.5,4,4,0,0,1014,1.0,1.0,1.0,1.0
PF07082,PF05055:PF06206:PF10693:PF04690:PF01264,2,10,2,0,8,1008,0.2,0.99,1.0,0.45,0,0,2,0,1016,0,1.0,0.0,0
PF10571,PF12049:PF06989:PF06420:PF10330:PF11267,0,4,0,0,4,1014,0.0,1.0,0,0,0,0,0,0,1018,0,1.0,0,0
PF10828,PF08119:PF09827:PF00801:PF11743:PF11752,0,11,0,0,11,1007,0.0,0.99,0,0,0,0,0,0,1018,0,1.0,0,0
PF10258,PF04004:PF10180:PF11250:PF09687:PF04090,9,19,4,5,15,994,0.21,0.98,0.44,0.3,3,0,9,3,1006,0.0,0.99,0.0,-0.01
PF01970,PF14690:PF15662:PF08497:PF04174:PF08708,0,0,0,0,0,1018,0,1.0,0,0,0,0,0,0,1018,0,1.0,0,0
PF14766,PF14768:PF14767:PF01386:PF17169:PF14576,3,2,0,3,2,1013,0.0,1.0,0.0,-0.0,0,0,3,0,1015,0,1.0,0.0,0
PF00734,PF02013:PF16990:PF03442:PF02156:PF01341,39,18,13,26,5,974,0.72,0.97,0.33,0.48,4,4,35,0,979,1.0,0.97,0.1,0.31
PF11616,PF15811:PF11764:PF16822:PF13861:PF03925,2,12,1,1,11,1005,0.08,0.99,0.5,0.2,0,0,2,0,1016,0,1.0,0.0,0
PF02731,PF10188:PF04189:PF09789:PF15067:PF06428,8,25,1,7,24,986,0.04,0.97,0.12,0.06,1,1,7,0,1010,1.0,0.99,0.12,0.35
PF07005,PF17042:PF01116:PF14833:PF03446:PF00393,6,51,6,0,45,967,0.12,0.96,1.0,0.34,13,6,0,7,1005,0.46,0.99,1.0,0.68
PF04182,PF10264:PF14545:PF13945:PF04802:PF02040,6,22,2,4,20,992,0.09,0.98,0.33,0.17,1,0,6,1,1011,0.0,0.99,0.0,-0.0
PF10368,PF14512:PF14251:PF15334:PF02217:PF16325,0,6,0,0,6,1012,0.0,0.99,0,0,0,0,0,0,1018,0,1.0,0,0
PF01293,PF03350:PF07896:PF01680:PF04148:PF00902,4,23,1,3,22,992,0.04,0.98,0.25,0.1,1,0,4,1,1013,0.0,1.0,0.0,-0.0
PF03244,PF06890:PF01312:PF15281:PF02277:PF17076,0,6,0,0,6,1012,0.0,0.99,0,0,0,0,0,0,1018,0,1.0,0,0
PF04202,PF16469:PF02637:PF07837:PF16757:PF05793,0,30,0,0,30,988,0.0,0.97,0,0,0,0,0,0,1018,0,1.0,0,0
PF11825,PF02159:PF12743:PF02155:PF12577:PF02161,5,12,4,1,8,1005,0.33,0.99,0.8,0.51,5,4,1,1,1012,0.8,1.0,0.8,0.8
PF02498,PF05272:PF06761:PF15976:PF02501:PF13588,0,4,0,0,4,1014,0.0,1.0,0,0,0,0,0,0,1018,0,1.0,0,0
PF00574,PF13664:PF04535:PF06749:PF00436:PF06244,18,43,11,7,32,968,0.26,0.96,0.61,0.38,4,3,15,1,999,0.75,0.98,0.17,0.35
PF02744,PF01087:PF14768:PF01450:PF14766:PF01729,9,27,9,0,18,991,0.33,0.98,1.0,0.57,1,1,8,0,1009,1.0,0.99,0.11,0.33
PF11605,PF16988:PF04157:PF05026:PF10334:PF02092,5,34,5,0,29,984,0.15,0.97,1.0,0.38,2,0,5,2,1011,0.0,0.99,0.0,-0.0
PF01093,PF02267:PF15008:PF01296:PF12301:PF00711,0,6,0,0,6,1012,0.0,0.99,0,0,0,0,0,0,1018,0,1.0,0,0
PF16064,PF04500:PF15299:PF13873:PF03004:PF15423,7,52,5,2,47,964,0.1,0.95,0.71,0.25,6,4,3,2,1009,0.67,1.0,0.57,0.61
PF03538,PF16967:PF07434:PF01752:PF15976:PF13700,0,3,0,0,3,1015,0.0,1.0,0,0,0,0,0,0,1018,0,1.0,0,0
PF17088,PF15036:PF15125:PF05558:PF05355:PF15055,0,8,0,0,8,1010,0.0,0.99,0,0,0,0,0,0,1018,0,1.0,0,0
PF09844,PF15588:PF04559:PF06834:PF14376:PF05939,0,3,0,0,3,1015,0.0,1.0,0,0,0,0,0,0,1018,0,1.0,0,0
PF09330,PF02873:PF09129:PF02754:PF13557:PF02378,4,18,2,2,16,998,0.11,0.98,0.5,0.23,2,2,2,0,1014,1.0,1.0,0.5,0.71
PF04560,PF10385:PF04561:PF06883:PF04563:PF07774,18,31,18,0,13,987,0.58,0.99,1.0,0.76,5,5,13,0,1000,1.0,0.99,0.28,0.52
PF00854,PF07819:PF12036:PF12274:PF02536:PF07035,30,54,16,14,38,950,0.3,0.95,0.53,0.37,1,1,29,0,988,1.0,0.97,0.03,0.18
PF11318,PF10782:PF06719:PF02113:PF05157:PF12241,0,5,0,0,5,1013,0.0,1.0,0,0,0,0,0,0,1018,0,1.0,0,0
PF00141,PF11895:PF02949:PF00685:PF00657:PF10604,37,86,21,16,65,916,0.24,0.92,0.57,0.34,12,10,27,2,979,0.83,0.97,0.27,0.47
PF04902,PF04904:PF04905:PF14763:PF14761:PF16485,0,7,0,0,7,1011,0.0,0.99,0,0,0,0,0,0,1018,0,1.0,0,0
PF15110,PF15849:PF15120:PF15829:PF07392:PF15576,4,2,1,3,1,1013,0.5,1.0,0.25,0.35,0,0,4,0,1014,0,1.0,0.0,0
PF11620,PF04621:PF00178:PF15661:PF12310:PF02198,2,33,2,0,31,985,0.06,0.97,1.0,0.24,2,2,0,0,1016,1.0,1.0,1.0,1.0
PF03140,PF02519:PF04535:PF00314:PF02298:PF00504,18,44,9,9,35,965,0.2,0.96,0.5,0.3,8,4,14,4,996,0.5,0.98,0.22,0.33
PF11793,PF09765:PF07453:PF07460:PF00874:PF08564,7,26,7,0,19,992,0.27,0.98,1.0,0.51,2,1,6,1,1010,0.5,0.99,0.14,0.26
PF02091,PF02092:PF09370:PF17167:PF07943:PF04510,5,17,4,1,13,1000,0.24,0.99,0.8,0.43,2,1,4,1,1012,0.5,1.0,0.2,0.31
PF12936,PF05178:PF16041:PF15279:PF07217:PF04037,8,21,8,0,13,997,0.38,0.99,1.0,0.61,1,1,7,0,1010,1.0,0.99,0.12,0.35
PF04904,PF04902:PF04905:PF15025:PF14761:PF00073,2,19,2,0,17,999,0.11,0.98,1.0,0.32,0,0,2,0,1016,0,1.0,0.0,0
PF03521,PF16799:PF11933:PF03520:PF11404:PF08412,4,15,1,3,14,1000,0.07,0.98,0.25,0.12,1,1,3,0,1014,1.0,1.0,0.25,0.5
PF11175,PF03553:PF06056:PF15134:PF03883:PF15757,1,5,0,1,5,1012,0.0,0.99,0.0,-0.0,0,0,1,0,1017,0,1.0,0.0,0
PF09937,PF02141:PF15270:PF07714:PF12739:PF03456,0,196,0,0,196,822,0.0,0.81,0,0,20,0,0,20,998,0.0,0.98,0,0
PF01857,PF11934:PF08934:PF01858:PF02091:PF00940,1,16,1,0,15,1002,0.06,0.99,1.0,0.25,0,0,1,0,1017,0,1.0,0.0,0
PF12056,PF05562:PF03331:PF07712:PF09778:PF06376,4,6,2,2,4,1010,0.33,0.99,0.5,0.41,0,0,4,0,1014,0,1.0,0.0,0
PF00698,PF16197:PF16073:PF02801:PF14765:PF00109,46,63,43,3,20,952,0.68,0.98,0.93,0.79,41,39,7,2,970,0.95,0.99,0.85,0.89
PF00215,PF04275:PF13793:PF00156:PF06974:PF13537,26,55,17,9,38,954,0.31,0.95,0.65,0.43,6,5,21,1,991,0.83,0.98,0.19,0.39
PF14330,PF07287:PF08635:PF16573:PF02774:PF09166,3,30,3,0,27,988,0.1,0.97,1.0,0.31,2,1,2,1,1014,0.5,1.0,0.33,0.41
PF16527,PF12729:PF05231:PF08805:PF12633:PF13675,2,6,2,0,4,1012,0.33,1.0,1.0,0.58,0,0,2,0,1016,0,1.0,0.0,0
PF12819,PF11721:PF12799:PF15904:PF08917:PF06760,16,54,8,8,46,956,0.15,0.95,0.5,0.25,3,3,13,0,1002,1.0,0.99,0.19,0.43
PF01872,PF08211:PF08719:PF00383:PF01249:PF01523,15,68,11,4,57,946,0.16,0.94,0.73,0.33,8,3,12,5,998,0.38,0.98,0.2,0.27
PF02397,PF02719:PF08186:PF15100:PF01455:PF05797,2,5,2,0,3,1013,0.4,1.0,1.0,0.63,0,0,2,0,1016,0,1.0,0.0,0
PF02167,PF10259:PF01791:PF01625:PF02284:PF15860,9,44,7,2,37,972,0.16,0.96,0.78,0.34,1,1,8,0,1009,1.0,0.99,0.11,0.33
PF14645,PF05399:PF15333:PF15158:PF15107:PF15664,2,0,0,2,0,1016,0,1.0,0.0,0,0,0,2,0,1016,0,1.0,0.0,0
PF15292,PF15090:PF15309:PF15232:PF15491:PF12516,0,4,0,0,4,1014,0.0,1.0,0,0,0,0,0,0,1018,0,1.0,0,0
PF16534,PF16557:PF02376:PF00157:PF16719:PF12045,3,16,3,0,13,1002,0.19,0.99,1.0,0.43,2,2,1,0,1015,1.0,1.0,0.67,0.82
PF09379,PF09380:PF08736:PF11819:PF05902:PF04382,40,33,30,10,3,975,0.91,0.99,0.75,0.82,10,9,31,1,977,0.9,0.97,0.23,0.44
PF07635,PF03548:PF15707:PF01514:PF08497:PF09980,0,3,0,0,3,1015,0.0,1.0,0,0,0,0,0,0,1018,0,1.0,0,0
PF04546,PF03979:PF00140:PF13490:PF00712:PF08281,4,12,4,0,8,1006,0.33,0.99,1.0,0.58,4,3,1,1,1013,0.75,1.0,0.75,0.75
PF03944,PF04349:PF07434:PF11019:PF07499:PF17188,2,2,0,2,2,1014,0.0,1.0,0.0,-0.0,0,0,2,0,1016,0,1.0,0.0,0
PF00786,PF05210:PF13281:PF08776:PF12202:PF14593,32,22,10,22,12,974,0.45,0.97,0.31,0.36,3,3,29,0,986,1.0,0.97,0.09,0.3
PF11881,PF08573:PF09740:PF10495:PF08651:PF13097,2,13,1,1,12,1004,0.08,0.99,0.5,0.19,0,0,2,0,1016,0,1.0,0.0,0
PF04432,PF04422:PF15805:PF15285:PF15803:PF09598,0,2,0,0,2,1016,0.0,1.0,0,0,0,0,0,0,1018,0,1.0,0,0
PF15400,PF15482:PF05065:PF15312:PF03090:PF14251,0,3,0,0,3,1015,0.0,1.0,0,0,0,0,0,0,1018,0,1.0,0,0
PF16330,PF12128:PF08466:PF07324:PF03055:PF05953,2,26,1,1,25,991,0.04,0.97,0.5,0.13,0,0,2,0,1016,0,1.0,0.0,0
PF07967,PF08600:PF03715:PF04139:PF02112:PF11710,11,39,8,3,31,976,0.21,0.97,0.73,0.38,3,2,9,1,1006,0.67,0.99,0.18,0.34
PF08563,PF07710:PF00870:PF11619:PF11620:PF04516,2,12,2,0,10,1006,0.17,0.99,1.0,0.41,2,2,0,0,1016,1.0,1.0,1.0,1.0
PF13302,PF11807:PF12311:PF04229:PF11991:PF12296,31,24,10,21,14,973,0.42,0.97,0.32,0.35,0,0,31,0,987,0,0.97,0.0,0
PF02156,PF16990:PF02013:PF01341:PF12891:PF00734,7,43,7,0,36,975,0.16,0.96,1.0,0.4,4,4,3,0,1011,1.0,1.0,0.57,0.75
PF12254,PF08996:PF03104:PF00136:PF14260:PF08490,11,38,11,0,27,980,0.29,0.97,1.0,0.53,30,11,0,19,988,0.37,0.98,1.0,0.6
PF10550,PF15186:PF15224:PF06876:PF00796:PF15325,0,2,0,0,2,1016,0.0,1.0,0,0,0,0,0,0,1018,0,1.0,0,0
PF15801,PF05195:PF01321:PF16188:PF14826:PF02102,6,34,5,1,29,983,0.15,0.97,0.83,0.34,3,2,4,1,1011,0.67,1.0,0.33,0.47
PF08074,PF06461:PF08073:PF06465:PF13907:PF07529,12,33,12,0,21,985,0.36,0.98,1.0,0.6,10,10,2,0,1006,1.0,1.0,0.83,0.91
PF15153,PF13421:PF07411:PF03241:PF03793:PF14258,0,3,0,0,3,1015,0.0,1.0,0,0,0,0,0,0,1018,0,1.0,0,0
PF17098,PF15311:PF04090:PF02116:PF15264:PF10104,6,14,1,5,13,999,0.07,0.98,0.17,0.1,2,0,6,2,1010,0.0,0.99,0.0,-0.0
PF02557,PF06724:PF02277:PF03525:PF17206:PF03241,2,4,0,2,4,1012,0.0,0.99,0.0,-0.0,0,0,2,0,1016,0,1.0,0.0,0
PF04535,PF06749:PF04720:PF06376:PF05910:PF00197,5,18,4,1,14,999,0.22,0.99,0.8,0.42,2,1,4,1,1012,0.5,1.0,0.2,0.31
PF07834,PF15486:PF13943:PF04308:PF04689:PF07055,2,10,1,1,9,1007,0.1,0.99,0.5,0.22,1,1,1,0,1016,1.0,1.0,0.5,0.71
PF11834,PF08412:PF11601:PF16526:PF11933:PF13545,14,18,5,9,13,991,0.28,0.98,0.36,0.3,1,1,13,0,1004,1.0,0.99,0.07,0.27
PF05180,PF05019:PF08698:PF05510:PF10276:PF09340,6,27,5,1,22,990,0.19,0.98,0.83,0.39,1,1,5,0,1012,1.0,1.0,0.17,0.41
PF14806,PF07718:PF09066:PF16381:PF08752:PF02296,12,18,8,4,10,996,0.44,0.99,0.67,0.54,2,2,10,0,1006,1.0,0.99,0.17,0.41
PF11152,PF06549:PF16851:PF10868:PF15556:PF10454,2,1,1,1,0,1016,1.0,1.0,0.5,0.71,0,0,2,0,1016,0,1.0,0.0,0
PF03875,PF06042:PF15555:PF15681:PF09962:PF02632,1,12,0,1,12,1005,0.0,0.99,0.0,-0.0,0,0,1,0,1017,0,1.0,0.0,0
PF03208,PF00430:PF04667:PF02704:PF06244:PF06749,8,27,3,5,24,986,0.11,0.97,0.38,0.19,2,2,6,0,1010,1.0,0.99,0.25,0.5
PF03227,PF03489:PF02199:PF10853:PF05184:PF05609,12,18,4,8,14,992,0.22,0.98,0.33,0.26,1,0,12,1,1005,0.0,0.99,0.0,-0.0
PF09598,PF16174:PF04432:PF15285:PF15397:PF12471,1,8,0,1,8,1009,0.0,0.99,0.0,-0.0,0,0,1,0,1017,0,1.0,0.0,0
PF04235,PF10406:PF05119:PF10607:PF02182:PF01795,0,50,0,0,50,968,0.0,0.95,0,0,4,0,0,4,1014,0.0,1.0,0,0
PF03544,PF05874:PF03601:PF12628:PF15482:PF05939,4,1,0,4,1,1013,0.0,1.0,0.0,-0.0,0,0,4,0,1014,0,1.0,0.0,0
PF06046,PF08312:PF01980:PF03577:PF08224:PF04114,13,33,5,8,28,977,0.15,0.96,0.38,0.23,1,0,13,1,1004,0.0,0.99,0.0,-0.0
PF02300,PF00574:PF01425:PF04072:PF00110:PF00230,0,104,0,0,104,914,0.0,0.9,0,0,10,0,0,10,1008,0.0,0.99,0,0
PF12835,PF04375:PF04740:PF05509:PF14842:PF10411,1,3,1,0,2,1015,0.33,1.0,1.0,0.58,0,0,1,0,1017,0,1.0,0.0,0
PF02459,PF00153:PF09423:PF07993:PF13041:PF14543,1,212,1,0,211,806,0.0,0.79,1.0,0.06,33,1,0,32,985,0.03,0.97,1.0,0.17
PF04237,PF03840:PF15943:PF06543:PF08537:PF01750,0,3,0,0,3,1015,0.0,1.0,0,0,0,0,0,0,1018,0,1.0,0,0
PF13403,PF08093:PF09361:PF05453:PF16168:PF17013,0,2,0,0,2,1016,0.0,1.0,0,0,0,0,0,0,1018,0,1.0,0,0
PF15188,PF15556:PF15212:PF05638:PF17049:PF00796,0,2,0,0,2,1016,0.0,1.0,0,0,0,0,0,0,1018,0,1.0,0,0
PF06959,PF02107:PF16833:PF12753:PF03710:PF06429,2,6,0,2,6,1010,0.0,0.99,0.0,-0.0,0,0,2,0,1016,0,1.0,0.0,0
PF09149,PF03724:PF00648:PF01067:PF06554:PF13548,3,51,2,1,49,966,0.04,0.95,0.67,0.15,1,1,2,0,1015,1.0,1.0,0.33,0.58
PF15854,PF12571:PF06670:PF05025:PF14348:PF12299,1,7,0,1,7,1010,0.0,0.99,0.0,-0.0,0,0,1,0,1017,0,1.0,0.0,0
PF04048,PF08638:PF14649:PF14952:PF12372:PF10441,11,24,4,7,20,987,0.17,0.97,0.36,0.23,0,0,11,0,1007,0,0.99,0.0,0
PF01184,PF01300:PF02284:PF00810:PF01960:PF05724,21,42,13,8,29,968,0.31,0.96,0.62,0.42,2,2,19,0,997,1.0,0.98,0.1,0.31
PF03769,PF03768:PF08140:PF12853:PF14654:PF17054,1,12,0,1,12,1005,0.0,0.99,0.0,-0.0,0,0,1,0,1017,0,1.0,0.0,0
PF09748,PF05254:PF03386:PF04418:PF05512:PF01779,14,24,8,6,16,988,0.33,0.98,0.57,0.43,0,0,14,0,1004,0,0.99,0.0,0
PF12349,PF16414:PF02460:PF03176:PF00368:PF13323,21,58,18,3,40,957,0.31,0.96,0.86,0.5,7,4,17,3,994,0.57,0.98,0.19,0.32
PF01340,PF12320:PF02718:PF10092:PF08015:PF01603,1,22,0,1,22,995,0.0,0.98,0.0,-0.0,0,0,1,0,1017,0,1.0,0.0,0
PF11093,PF08649:PF02202:PF13933:PF15831:PF15576,0,3,0,0,3,1015,0.0,1.0,0,0,0,0,0,0,1018,0,1.0,0,0
PF07969,PF01979:PF05721:PF03659:PF04199:PF11807,17,87,8,9,79,922,0.09,0.91,0.47,0.18,16,7,10,9,992,0.44,0.98,0.41,0.41
PF02603,PF05036:PF07475:PF03668:PF13486:PF02097,4,8,4,0,4,1010,0.5,1.0,1.0,0.71,4,4,0,0,1014,1.0,1.0,1.0,1.0
PF00849,PF12656:PF00163:PF00579:PF00467:PF00466,40,74,22,18,52,926,0.3,0.93,0.55,0.37,8,6,34,2,976,0.75,0.96,0.15,0.33
PF17086,PF11227:PF07719:PF08097:PF11901:PF03105,0,62,0,0,62,956,0.0,0.94,0,0,6,0,0,6,1012,0.0,0.99,0,0
PF16566,PF04818:PF09750:PF01805:PF12230:PF08312,12,60,10,2,50,956,0.17,0.95,0.83,0.36,11,3,9,8,998,0.27,0.98,0.25,0.25
PF08118,PF14942:PF05460:PF09073:PF12659:PF15803,1,6,0,1,6,1011,0.0,0.99,0.0,-0.0,0,0,1,0,1017,0,1.0,0.0,0
PF04615,PF01280:PF11309:PF05129:PF01779:PF03386,17,31,5,12,26,975,0.16,0.96,0.29,0.2,0,0,17,0,1001,0,0.98,0.0,0
PF15712,PF03963:PF02501:PF08361:PF09327:PF13421,0,4,0,0,4,1014,0.0,1.0,0,0,0,0,0,0,1018,0,1.0,0,0
PF06031,PF07545:PF01868:PF09816:PF13864:PF10332,5,18,2,3,16,997,0.11,0.98,0.4,0.2,1,0,5,1,1012,0.0,0.99,0.0,-0.0
PF08478,PF05467:PF07045:PF02621:PF04657:PF15490,0,7,0,0,7,1011,0.0,0.99,0,0,0,0,0,0,1018,0,1.0,0,0
PF06964,PF14498:PF16862:PF08427:PF10350:PF07035,14,37,5,9,32,972,0.14,0.96,0.36,0.2,5,2,12,3,1001,0.4,0.99,0.14,0.23
PF17008,PF11162:PF15485:PF15337:PF17164:PF05707,0,3,0,0,3,1015,0.0,1.0,0,0,0,0,0,0,1018,0,1.0,0,0
PF00768,PF07943:PF15751:PF12161:PF04232:PF10410,7,15,6,1,9,1002,0.4,0.99,0.86,0.58,0,0,7,0,1011,0,0.99,0.0,0
PF00483,PF00132:PF06426:PF14602:PF01050:PF12804,30,65,23,7,42,946,0.35,0.95,0.77,0.5,13,7,23,6,982,0.54,0.97,0.23,0.34
PF01040,PF09335:PF07542:PF02636:PF01789:PF03195,36,46,13,23,33,949,0.28,0.94,0.36,0.29,4,3,33,1,981,0.75,0.97,0.08,0.24
PF06779,PF09444:PF15304:PF06586:PF09967:PF15456,0,7,0,0,7,1011,0.0,0.99,0,0,0,0,0,0,1018,0,1.0,0,0
PF05637,PF01786:PF02636:PF14159:PF03350:PF03634,19,25,7,12,18,981,0.28,0.97,0.37,0.31,0,0,19,0,999,0,0.98,0.0,0
PF08433,PF14712:PF13778:PF09014:PF09272:PF14077,13,19,3,10,16,989,0.16,0.97,0.23,0.18,0,0,13,0,1005,0,0.99,0.0,0
PF15043,PF03819:PF06805:PF02522:PF14865:PF15119,1,3,0,1,3,1014,0.0,1.0,0.0,-0.0,0,0,1,0,1017,0,1.0,0.0,0
PF01074,PF09261:PF07748:PF12780:PF12777:PF09258,24,64,24,0,40,954,0.38,0.96,1.0,0.6,11,7,17,4,990,0.64,0.98,0.29,0.42
PF04553,PF13451:PF08922:PF08485:PF09163:PF06379,3,5,1,2,4,1011,0.2,0.99,0.33,0.26,0,0,3,0,1015,0,1.0,0.0,0
PF14228,PF14222:PF14225:PF16206:PF09324:PF16213,7,27,7,0,20,991,0.26,0.98,1.0,0.5,6,3,4,3,1008,0.5,0.99,0.43,0.46
PF08336,PF13640:PF10288:PF04406:PF01753:PF05827,10,93,9,1,84,924,0.1,0.92,0.9,0.28,9,3,7,6,1002,0.33,0.99,0.3,0.31
PF14952,PF12372:PF12231:PF15912:PF10395:PF10441,2,15,0,2,15,1001,0.0,0.98,0.0,-0.01,1,0,2,1,1015,0.0,1.0,0.0,-0.0
PF05477,PF15552:PF13232:PF08194:PF11584:PF07405,7,1,1,6,0,1011,1.0,0.99,0.14,0.38,0,0,7,0,1011,0,0.99,0.0,0
PF06391,PF17121:PF16954:PF00590:PF10447:PF15008,7,26,4,3,22,989,0.15,0.98,0.57,0.29,0,0,7,0,1011,0,0.99,0.0,0
PF05003,PF01343:PF13015:PF04871:PF13824:PF06584,2,37,1,1,36,980,0.03,0.96,0.5,0.11,2,0,2,2,1014,0.0,1.0,0.0,-0.0
PF15018,PF15063:PF04852:PF12926:PF02044:PF06541,1,5,0,1,5,1012,0.0,0.99,0.0,-0.0,0,0,1,0,1017,0,1.0,0.0,0
PF00730,PF00633:PF13002:PF15264:PF08574:PF08528,30,19,9,21,10,978,0.47,0.97,0.3,0.36,0,0,30,0,988,0,0.97,0.0,0
PF04616,PF06439:PF03422:PF13813:PF08652:PF04828,35,44,20,15,24,959,0.45,0.96,0.57,0.49,4,4,31,0,983,1.0,0.97,0.11,0.33
PF03319,PF15046:PF08945:PF15207:PF17051:PF15175,0,4,0,0,4,1014,0.0,1.0,0,0,0,0,0,0,1018,0,1.0,0,0
PF03439,PF11942:PF00467:PF02357:PF12656:PF06011,14,33,11,3,22,982,0.33,0.98,0.79,0.5,1,1,13,0,1004,1.0,0.99,0.07,0.27
PF05011,PF04152:PF16891:PF10360:PF02872:PF14008,14,47,9,5,38,966,0.19,0.96,0.64,0.34,7,4,10,3,1001,0.57,0.99,0.29,0.4
PF06210,PF05065:PF15482:PF08453:PF05947:PF03616,0,4,0,0,4,1014,0.0,1.0,0,0,0,0,0,0,1018,0,1.0,0,0
PF15678,PF13836:PF00649:PF10482:PF07001:PF14545,0,13,0,0,13,1005,0.0,0.99,0,0,0,0,0,0,1018,0,1.0,0,0
PF02482,PF16829:PF15722:PF00323:PF16321:PF02740,2,5,2,0,3,1013,0.4,1.0,1.0,0.63,0,0,2,0,1016,0,1.0,0.0,0
PF03615,PF15280:PF10177:PF15862:PF09736:PF09949,5,15,3,2,12,1001,0.2,0.99,0.6,0.34,1,1,4,0,1013,1.0,1.0,0.2,0.45
PF01486,PF12347:PF01625:PF01192:PF03942:PF07106,10,38,6,4,32,976,0.16,0.96,0.6,0.3,6,3,7,3,1005,0.5,0.99,0.3,0.38
PF12310,PF02198:PF04621:PF11620:PF16563:PF12701,2,33,2,0,31,985,0.06,0.97,1.0,0.24,3,2,0,1,1015,0.67,1.0,1.0,0.82
PF01083,PF00457:PF01670:PF03664:PF10503:PF02015,16,22,8,8,14,988,0.36,0.98,0.5,0.42,2,2,14,0,1002,1.0,0.99,0.12,0.35
PF03212,PF17007:PF07409:PF06995:PF04984:PF07157,0,0,0,0,0,1018,0,1.0,0,0,0,0,0,0,1018,0,1.0,0,0
PF06682,PF14941:PF04452:PF02422:PF11759:PF05428,7,5,0,7,5,1006,0.0,0.99,0.0,-0.01,0,0,7,0,1011,0,0.99,0.0,0
PF04697,PF04783:PF03017:PF12887:PF14818:PF15557,1,13,0,1,13,1004,0.0,0.99,0.0,-0.0,0,0,1,0,1017,0,1.0,0.0,0
PF14712,PF00159:PF01279:PF12597:PF00446:PF01470,10,23,3,7,20,988,0.13,0.97,0.3,0.19,1,0,10,1,1007,0.0,0.99,0.0,-0.0
PF15748,PF11402:PF08026:PF10514:PF08744:PF17053,0,0,0,0,0,1018,0,1.0,0,0,0,0,0,0,1018,0,1.0,0,0
PF11402,PF08093:PF05962:PF15547:PF06868:PF03548,0,5,0,0,5,1013,0.0,1.0,0,0,0,0,0,0,1018,0,1.0,0,0
PF01781,PF08269:PF06773:PF03243:PF08570:PF08591,9,4,1,8,3,1006,0.25,0.99,0.11,0.16,0,0,9,0,1009,0,0.99,0.0,0
PF01649,PF02195:PF15339:PF02087:PF04402:PF00489,11,16,2,9,14,993,0.12,0.98,0.18,0.14,0,0,11,0,1007,0,0.99,0.0,0
PF07899,PF09730:PF01980:PF03469:PF15301:PF05911,6,18,2,4,16,996,0.11,0.98,0.33,0.18,0,0,6,0,1012,0,0.99,0.0,0
PF02682,PF02626:PF00289:PF02785:PF02436:PF08326,11,37,11,0,26,981,0.3,0.97,1.0,0.54,20,8,3,12,995,0.4,0.99,0.73,0.53
PF09643,PF09281:PF14063:PF12780:PF14065:PF10095,0,39,0,0,39,979,0.0,0.96,0,0,0,0,0,0,1018,0,1.0,0,0
PF08763,PF16885:PF16905:PF11404:PF03521:PF16799,8,10,4,4,6,1004,0.4,0.99,0.5,0.44,1,1,7,0,1010,1.0,0.99,0.12,0.35
PF04120,PF05953:PF00871:PF16740:PF09363:PF07950,0,15,0,0,15,1003,0.0,0.99,0,0,0,0,0,0,1018,0,1.0,0,0
PF04266,PF06886:PF11970:PF04139:PF09368:PF04601,10,20,4,6,16,992,0.2,0.98,0.4,0.27,1,1,9,0,1008,1.0,0.99,0.1,0.31
PF12140,PF17208:PF12618:PF02820:PF01530:PF09246,7,28,7,0,21,990,0.25,0.98,1.0,0.49,2,1,6,1,1010,0.5,0.99,0.14,0.26
PF15877,PF14775:PF10375:PF13166:PF08647:PF11291,0,14,0,0,14,1004,0.0,0.99,0,0,0,0,0,0,1018,0,1.0,0,0
PF04012,PF10868:PF15699:PF06521:PF10705:PF04736,0,2,0,0,2,1016,0.0,1.0,0,0,0,0,0,0,1018,0,1.0,0,0
PF08683,PF17095:PF15246:PF10358:PF16018:PF11971,8,27,7,1,20,990,0.26,0.98,0.88,0.47,1,1,7,0,1010,1.0,0.99,0.12,0.35
PF16417,PF16418:PF04054:PF12842:PF16415:PF16419,11,14,10,1,4,1003,0.71,1.0,0.91,0.8,10,10,1,0,1007,1.0,1.0,0.91,0.95
PF02325,PF14610:PF15810:PF11282:PF06271:PF07939,1,7,0,1,7,1010,0.0,0.99,0.0,-0.0,0,0,1,0,1017,0,1.0,0.0,0
PF00425,PF04715:PF00977:PF00958:PF00697:PF00218,17,42,13,4,29,972,0.31,0.97,0.76,0.47,2,2,15,0,1001,1.0,0.99,0.12,0.34
PF01059,PF06444:PF04241:PF12155:PF03100:PF02284,0,17,0,0,17,1001,0.0,0.98,0,0,0,0,0,0,1018,0,1.0,0,0
PF05717,PF03613:PF08036:PF10079:PF04966:PF05947,0,1,0,0,1,1017,0.0,1.0,0,0,0,0,0,0,1018,0,1.0,0,0
PF04311,PF04533:PF15835:PF07270:PF01454:PF01340,0,14,0,0,14,1004,0.0,0.99,0,0,0,0,0,0,1018,0,1.0,0,0
PF05159,PF13477:PF11997:PF03960:PF05838:PF12241,0,2,0,0,2,1016,0.0,1.0,0,0,0,0,0,0,1018,0,1.0,0,0
PF04358,PF16205:PF03491:PF09358:PF12213:PF04054,0,32,0,0,32,986,0.0,0.97,0,0,2,0,0,2,1016,0.0,1.0,0,0
PF01751,PF01131:PF00521:PF13368:PF16898:PF00204,30,37,30,0,7,981,0.81,0.99,1.0,0.9,9,9,21,0,988,1.0,0.98,0.3,0.54
PF07999,PF07077:PF02559:PF08494:PF12029:PF07882,2,5,2,0,3,1013,0.4,1.0,1.0,0.63,2,2,0,0,1016,1.0,1.0,1.0,1.0
PF09353,PF06376:PF04520:PF12734:PF06232:PF01097,4,10,1,3,9,1005,0.1,0.99,0.25,0.15,0,0,4,0,1014,0,1.0,0.0,0
PF08153,PF08701:PF05128:PF10662:PF15086:PF01018,6,14,3,3,11,1001,0.21,0.99,0.5,0.32,1,1,5,0,1012,1.0,1.0,0.17,0.41
PF08066,PF01927:PF00570:PF01612:PF07750:PF08907,11,63,11,0,52,955,0.17,0.95,1.0,0.41,3,2,9,1,1006,0.67,0.99,0.18,0.34
PF05651,PF05280:PF02554:PF12241:PF13502:PF11130,0,6,0,0,6,1012,0.0,0.99,0,0,0,0,0,0,1018,0,1.0,0,0
PF07282,PF12600:PF08297:PF15073:PF16967:PF01057,2,4,1,1,3,1013,0.25,1.0,0.5,0.35,0,0,2,0,1016,0,1.0,0.0,0
PF09769,PF04667:PF09597:PF04716:PF00159:PF10780,3,20,2,1,18,997,0.1,0.98,0.67,0.25,0,0,3,0,1015,0,1.0,0.0,0
PF06039,PF05564:PF13164:PF15578:PF01638:PF03974,2,5,1,1,4,1012,0.2,1.0,0.5,0.31,0,0,2,0,1016,0,1.0,0.0,0
PF15247,PF06413:PF10180:PF15264:PF07904:PF07797,7,23,2,5,21,990,0.09,0.97,0.29,0.15,0,0,7,0,1011,0,0.99,0.0,0
PF02740,PF01114:PF00323:PF15722:PF15710:PF09051,1,1,1,0,0,1017,1.0,1.0,1.0,1.0,0,0,1,0,1017,0,1.0,0.0,0
PF04187,PF03759:PF06136:PF15285:PF11891:PF09598,1,19,1,0,18,999,0.05,0.98,1.0,0.23,0,0,1,0,1017,0,1.0,0.0,0
PF01120,PF16757:PF04041:PF14687:PF08527:PF11380,19,23,10,9,13,986,0.43,0.98,0.53,0.47,0,0,19,0,999,0,0.98,0.0,0
PF04899,PF10056:PF08632:PF06626:PF09441:PF13482,0,9,0,0,9,1009,0.0,0.99,0,0,0,0,0,0,1018,0,1.0,0,0
PF03011,PF15447:PF15445:PF12377:PF12361:PF11556,1,1,1,0,0,1017,1.0,1.0,1.0,1.0,1,1,0,0,1017,1.0,1.0,1.0,1.0
PF00528,PF08402:PF08352:PF13732:PF12399:PF02653,34,17,8,26,9,975,0.47,0.97,0.24,0.32,5,5,29,0,984,1.0,0.97,0.15,0.38
PF14726,PF15914:PF12372:PF15912:PF07001:PF10482,4,14,0,4,14,1000,0.0,0.98,0.0,-0.01,1,0,4,1,1013,0.0,1.0,0.0,-0.0
PF07690,PF00083:PF06609:PF06813:PF11700:PF05978,241,139,93,148,46,731,0.67,0.81,0.39,0.4,5,5,236,0,777,1.0,0.77,0.02,0.13
PF09949,PF16401:PF16692:PF03615:PF15280:PF08297,9,12,2,7,10,999,0.17,0.98,0.22,0.18,0,0,9,0,1009,0,0.99,0.0,0
PF08193,PF07544:PF10161:PF10340:PF01947:PF06912,1,10,0,1,10,1007,0.0,0.99,0.0,-0.0,0,0,1,0,1017,0,1.0,0.0,0
PF14830,PF12143:PF12142:PF02237:PF04558:PF14432,1,47,1,0,46,971,0.02,0.95,1.0,0.14,1,1,0,0,1017,1.0,1.0,1.0,1.0
PF11500,PF15456:PF16501:PF03344:PF12757:PF15368,1,4,0,1,4,1013,0.0,1.0,0.0,-0.0,0,0,1,0,1017,0,1.0,0.0,0
PF08229,PF15014:PF03918:PF15475:PF07464:PF15053,4,6,1,3,5,1009,0.17,0.99,0.25,0.2,0,0,4,0,1014,0,1.0,0.0,0
PF04087,PF05334:PF08634:PF15279:PF12253:PF10496,0,19,0,0,19,999,0.0,0.98,0,0,0,0,0,0,1018,0,1.0,0,0
PF08079,PF12076:PF03986:PF00081:PF01014:PF00281,11,50,5,6,45,962,0.1,0.95,0.45,0.2,3,2,9,1,1006,0.67,0.99,0.18,0.34
PF07469,PF16279:PF08832:PF08815:PF12114:PF11413,3,15,3,0,12,1003,0.2,0.99,1.0,0.44,6,3,0,3,1012,0.5,1.0,1.0,0.71
PF08792,PF15211:PF15047:PF15713:PF12658:PF16649,0,4,0,0,4,1014,0.0,1.0,0,0,0,0,0,0,1018,0,1.0,0,0
PF01425,PF01328:PF00515:PF13813:PF07719:PF02682,66,85,28,38,57,895,0.33,0.91,0.42,0.32,9,8,58,1,951,0.89,0.94,0.12,0.32
PF14588,PF15775:PF10109:PF07157:PF17152:PF15340,2,3,0,2,3,1013,0.0,1.0,0.0,-0.0,0,0,2,0,1016,0,1.0,0.0,0
PF12135,PF07430:PF08027:PF10630:PF09367:PF16829,0,1,0,0,1,1017,0.0,1.0,0,0,0,0,0,0,1018,0,1.0,0,0
PF08490,PF08996:PF12254:PF03104:PF00136:PF14260,13,38,13,0,25,980,0.34,0.98,1.0,0.58,26,9,4,17,988,0.35,0.98,0.69,0.48
PF11515,PF03256:PF06701:PF00888:PF00569:PF07738,9,96,9,0,87,922,0.09,0.91,1.0,0.29,12,6,3,6,1003,0.5,0.99,0.67,0.57
PF16418,PF16417:PF04054:PF12842:PF16415:PF16419,9,15,9,0,6,1003,0.6,0.99,1.0,0.77,10,9,0,1,1008,0.9,1.0,1.0,0.95
PF08759,PF08856:PF16168:PF13644:PF05736:PF17077,0,2,0,0,2,1016,0.0,1.0,0,0,0,0,0,0,1018,0,1.0,0,0
PF13630,PF16325:PF08497:PF14841:PF03428:PF10908,0,2,0,0,2,1016,0.0,1.0,0,0,0,0,0,0,1018,0,1.0,0,0
PF01294,PF00048:PF04690:PF14798:PF04190:PF06825,5,27,4,1,23,990,0.15,0.98,0.8,0.34,1,1,4,0,1013,1.0,1.0,0.2,0.45
PF04493,PF03155:PF01722:PF05719:PF10200:PF07096,8,36,3,5,33,977,0.08,0.96,0.38,0.16,3,0,8,3,1007,0.0,0.99,0.0,-0.0
PF02285,PF15071:PF15359:PF07281:PF05039:PF01716,4,7,1,3,6,1008,0.14,0.99,0.25,0.18,0,0,4,0,1014,0,1.0,0.0,0
PF17205,PF07965:PF00362:PF08725:PF15636:PF06484,5,11,4,1,7,1006,0.36,0.99,0.8,0.54,4,4,1,0,1013,1.0,1.0,0.8,0.89
PF06911,PF10505:PF04059:PF03467:PF13886:PF11309,21,34,10,11,24,973,0.29,0.97,0.48,0.36,2,2,19,0,997,1.0,0.98,0.1,0.31
PF01097,PF16541:PF05039:PF15359:PF10780:PF06446,3,3,0,3,3,1012,0.0,0.99,0.0,-0.0,0,0,3,0,1015,0,1.0,0.0,0
PF09201,PF03320:PF14842:PF15272:PF05034:PF01136,4,6,0,4,6,1008,0.0,0.99,0.0,-0.0,0,0,4,0,1014,0,1.0,0.0,0
PF11989,PF06248:PF17005:PF07352:PF10647:PF17108,1,10,1,0,9,1008,0.1,0.99,1.0,0.31,1,1,0,0,1017,1.0,1.0,1.0,1.0
PF00148,PF08369:PF11937:PF09364:PF09363:PF16954,1,8,1,0,7,1010,0.12,0.99,1.0,0.35,0,0,1,0,1017,0,1.0,0.0,0
PF13422,PF14052:PF06082:PF17185:PF10995:PF11775,8,0,0,8,0,1010,0,0.99,0.0,0,0,0,8,0,1010,0,0.99,0.0,0
PF08744,PF03525:PF04965:PF10933:PF14251:PF00669,0,3,0,0,3,1015,0.0,1.0,0,0,0,0,0,0,1018,0,1.0,0,0
PF13356,PF09003:PF14659:PF14657:PF04285:PF06761,3,2,1,2,1,1014,0.5,1.0,0.33,0.41,1,1,2,0,1015,1.0,1.0,0.33,0.58
PF14519,PF03379:PF04691:PF02950:PF14866:PF07327,0,4,0,0,4,1014,0.0,1.0,0,0,0,0,0,0,1018,0,1.0,0,0
PF08743,PF10253:PF14970:PF14784:PF10444:PF08737,10,18,3,7,15,993,0.17,0.98,0.3,0.21,1,0,10,1,1007,0.0,0.99,0.0,-0.0
PF16524,PF07695:PF16448:PF08918:PF00816:PF02768,2,11,2,0,9,1007,0.18,0.99,1.0,0.42,0,0,2,0,1016,0,1.0,0.0,0
PF09431,PF07815:PF08397:PF03983:PF02208:PF08824,10,20,2,8,18,990,0.1,0.97,0.2,0.13,1,1,9,0,1008,1.0,0.99,0.1,0.31
PF03647,PF00301:PF02234:PF04367:PF12319:PF04759,13,17,2,11,15,990,0.12,0.97,0.15,0.12,0,0,13,0,1005,0,0.99,0.0,0
PF10597,PF10596:PF08082:PF10598:PF12134:PF08083,15,18,15,0,3,1000,0.83,1.0,1.0,0.91,13,13,2,0,1003,1.0,1.0,0.87,0.93
PF04757,PF06803:PF05495:PF13705:PF08941:PF05241,29,28,10,19,18,971,0.36,0.96,0.34,0.33,5,5,24,0,989,1.0,0.98,0.17,0.41
PF05999,PF08780:PF01219:PF14065:PF00109:PF03327,0,61,0,0,61,957,0.0,0.94,0,0,0,0,0,0,1018,0,1.0,0,0
PF00855,PF10513:PF11467:PF05965:PF06752:PF12064,35,42,17,18,25,958,0.4,0.96,0.49,0.42,2,2,33,0,983,1.0,0.97,0.06,0.24
PF01105,PF15011:PF03006:PF04930:PF01596:PF01185,37,39,11,26,28,953,0.28,0.95,0.3,0.26,5,4,33,1,980,0.8,0.97,0.11,0.29
PF13414,PF00515:PF13181:PF07719:PF03661:PF13844,40,131,35,5,96,882,0.27,0.9,0.88,0.45,32,22,18,10,968,0.69,0.97,0.55,0.6
PF10374,PF13638:PF10373:PF02091:PF11699:PF15025,8,30,8,0,22,988,0.27,0.98,1.0,0.51,3,2,6,1,1009,0.67,0.99,0.25,0.41
PF14884,PF14931:PF05856:PF06382:PF01387:PF10166,2,9,1,1,8,1008,0.11,0.99,0.5,0.23,0,0,2,0,1016,0,1.0,0.0,0
PF16213,PF16206:PF12783:PF09324:PF01369:PF11919,22,51,16,6,35,961,0.31,0.96,0.73,0.46,16,13,9,3,993,0.81,0.99,0.59,0.69
PF15203,PF11435:PF11210:PF11111:PF06573:PF15825,1,4,0,1,4,1013,0.0,1.0,0.0,-0.0,0,0,1,0,1017,0,1.0,0.0,0
PF01411,PF07973:PF02272:PF03129:PF00587:PF00647,27,73,19,8,54,937,0.26,0.94,0.7,0.4,20,11,16,9,982,0.55,0.98,0.41,0.46
PF16732,PF03613:PF06744:PF10279:PF11863:PF09093,0,1,0,0,1,1017,0.0,1.0,0,0,0,0,0,0,1018,0,1.0,0,0
PF03564,PF07245:PF05380:PF05585:PF12259:PF03732,36,78,26,10,52,930,0.33,0.94,0.72,0.46,10,10,26,0,982,1.0,0.97,0.28,0.52
PF08920,PF05672:PF14738:PF12329:PF08144:PF13251,10,23,2,8,21,987,0.09,0.97,0.2,0.12,1,0,10,1,1007,0.0,0.99,0.0,-0.0
PF16822,PF08497:PF10908:PF14882:PF11245:PF16824,0,0,0,0,0,1018,0,1.0,0,0,0,0,0,0,1018,0,1.0,0,0
PF11817,PF07919:PF12742:PF10487:PF08427:PF14702,5,20,4,1,16,997,0.2,0.98,0.8,0.4,1,1,4,0,1013,1.0,1.0,0.2,0.45
PF05989,PF05357:PF04301:PF09200:PF12631:PF03189,0,13,0,0,13,1005,0.0,0.99,0,0,0,0,0,0,1018,0,1.0,0,0
PF15087,PF02106:PF10630:PF15398:PF15302:PF17085,1,1,0,1,1,1016,0.0,1.0,0.0,-0.0,0,0,1,0,1017,0,1.0,0.0,0
PF11801,PF17171:PF10806:PF05491:PF08727:PF03938,0,31,0,0,31,987,0.0,0.97,0,0,0,0,0,0,1018,0,1.0,0,0
PF13015,PF12999:PF05003:PF04871:PF12542:PF09332,12,37,10,2,27,979,0.27,0.97,0.83,0.47,3,2,10,1,1005,0.67,0.99,0.17,0.33
PF12856,PF09109:PF03241:PF08497:PF14690:PF14987,1,3,0,1,3,1014,0.0,1.0,0.0,-0.0,0,0,1,0,1017,0,1.0,0.0,0
PF09268,PF01394:PF10143:PF04340:PF15671:PF14353,5,13,3,2,10,1003,0.23,0.99,0.6,0.37,0,0,5,0,1013,0,1.0,0.0,0
PF16547,PF11919:PF16507:PF10347:PF10293:PF16399,3,24,3,0,21,994,0.12,0.98,1.0,0.35,3,1,2,2,1013,0.33,1.0,0.33,0.33
PF01451,PF01981:PF10302:PF06432:PF10154:PF05755,12,32,7,5,25,981,0.22,0.97,0.58,0.35,1,1,11,0,1006,1.0,0.99,0.08,0.29
PF16679,PF08839:PF09369:PF09382:PF04849:PF06579,3,26,2,1,24,991,0.08,0.98,0.67,0.22,5,0,3,5,1010,0.0,0.99,0.0,-0.0
PF14305,PF11057:PF03548:PF01943:PF17112:PF08203,0,4,0,0,4,1014,0.0,1.0,0,0,0,0,0,0,1018,0,1.0,0,0
PF10807,PF11231:PF09675:PF09704:PF10118:PF16980,0,4,0,0,4,1014,0.0,1.0,0,0,0,0,0,0,1018,0,1.0,0,0
PF02958,PF07914:PF06477:PF02995:PF14027:PF01348,29,42,12,17,30,959,0.29,0.95,0.41,0.32,3,2,27,1,988,0.67,0.97,0.07,0.21
PF04967,PF09669:PF00796:PF01312:PF15482:PF04391,0,1,0,0,1,1017,0.0,1.0,0,0,0,0,0,0,1018,0,1.0,0,0
PF00813,PF01313:PF08361:PF06798:PF13722:PF05943,0,1,0,0,1,1017,0.0,1.0,0,0,0,0,0,0,1018,0,1.0,0,0
PF08226,PF12761:PF08824:PF05640:PF16099:PF15717,12,10,2,10,8,998,0.2,0.98,0.17,0.17,1,1,11,0,1006,1.0,0.99,0.08,0.29
PF01339,PF12431:PF04397:PF12010:PF08667:PF12532,6,2,1,5,1,1011,0.5,0.99,0.17,0.29,0,0,6,0,1012,0,0.99,0.0,0
PF00204,PF00986:PF16898:PF00521:PF08070:PF01751,19,35,19,0,16,983,0.54,0.98,1.0,0.73,13,12,7,1,998,0.92,0.99,0.63,0.76
PF03232,PF00708:PF06760:PF15009:PF01641:PF03645,9,31,3,6,28,981,0.1,0.97,0.33,0.17,3,2,7,1,1008,0.67,0.99,0.22,0.38
PF09907,PF07769:PF04264:PF15203:PF07409:PF14885,1,2,0,1,2,1015,0.0,1.0,0.0,-0.0,0,0,1,0,1017,0,1.0,0.0,0
PF14575,PF01404:PF12398:PF06760:PF07699:PF03232,6,29,5,1,24,988,0.17,0.98,0.83,0.37,3,3,3,0,1012,1.0,1.0,0.5,0.71
PF02734,PF02733:PF14831:PF10660:PF02150:PF05196,17,29,13,4,16,985,0.45,0.98,0.76,0.58,1,1,16,0,1001,1.0,0.98,0.06,0.24
PF03190,PF07539:PF10350:PF12612:PF17034:PF08427,8,35,3,5,32,978,0.09,0.96,0.38,0.17,3,1,7,2,1008,0.33,0.99,0.12,0.2
PF12171,PF08648:PF01715:PF07776:PF16837:PF11931,42,66,25,17,41,935,0.38,0.94,0.6,0.45,4,4,38,0,976,1.0,0.96,0.1,0.3
PF03442,PF03425:PF00734:PF02013:PF16990:PF02156,6,41,5,1,36,976,0.12,0.96,0.83,0.31,6,2,4,4,1008,0.33,0.99,0.33,0.33
PF01253,PF02201:PF03669:PF03126:PF10245:PF01472,26,55,17,9,38,954,0.31,0.95,0.65,0.43,5,5,21,0,992,1.0,0.98,0.19,0.43
PF14596,PF12162:PF12188:PF14983:PF14564:PF07149,1,5,1,0,4,1013,0.2,1.0,1.0,0.45,0,0,1,0,1017,0,1.0,0.0,0
PF06974,PF03007:PF02789:PF13336:PF00215:PF13292,8,57,8,0,49,961,0.14,0.95,1.0,0.37,3,3,5,0,1010,1.0,1.0,0.38,0.61
PF01522,PF09347:PF01607:PF07502:PF00704:PF01823,33,88,13,20,75,910,0.15,0.91,0.39,0.2,13,6,27,7,978,0.46,0.97,0.18,0.28
PF17185,PF16888:PF09498:PF03241:PF04351:PF04170,0,0,0,0,0,1018,0,1.0,0,0,0,0,0,0,1018,0,1.0,0,0
PF03578,PF10284:PF10285:PF07276:PF06753:PF03991,0,1,0,0,1,1017,0.0,1.0,0,0,0,0,0,0,1018,0,1.0,0,0
PF11336,PF09648:PF08681:PF03610:PF14255:PF02086,0,6,0,0,6,1012,0.0,0.99,0,0,0,0,0,0,1018,0,1.0,0,0
PF10302,PF13373:PF16843:PF01020:PF16455:PF09055,4,24,4,0,20,994,0.17,0.98,1.0,0.4,2,1,3,1,1013,0.5,1.0,0.25,0.35
PF01280,PF05129:PF10203:PF01779:PF03386:PF01907,16,27,6,10,21,981,0.22,0.97,0.38,0.27,1,1,15,0,1002,1.0,0.99,0.06,0.25
PF04683,PF03299:PF04801:PF15929:PF16550:PF03085,4,24,3,1,21,993,0.12,0.98,0.75,0.3,0,0,4,0,1014,0,1.0,0.0,0
PF09118,PF07250:PF06588:PF10102:PF02676:PF03636,7,21,6,1,15,996,0.29,0.98,0.86,0.49,1,1,6,0,1011,1.0,0.99,0.14,0.38
PF13784,PF08091:PF16804:PF14814:PF15984:PF10434,0,0,0,0,0,1018,0,1.0,0,0,0,0,0,0,1018,0,1.0,0,0
PF08837,PF16071:PF04233:PF10933:PF08744:PF08707,0,1,0,0,1,1017,0.0,1.0,0,0,0,0,0,0,1018,0,1.0,0,0
PF14857,PF05308:PF14822:PF07406:PF15242:PF04831,4,11,0,4,11,1003,0.0,0.99,0.0,-0.01,0,0,4,0,1014,0,1.0,0.0,0
PF09874,PF06007:PF11876:PF07495:PF06082:PF03592,1,3,0,1,3,1014,0.0,1.0,0.0,-0.0,0,0,1,0,1017,0,1.0,0.0,0
PF08772,PF15017:PF17146:PF01713:PF16858:PF12886,8,21,7,1,14,996,0.33,0.99,0.88,0.53,2,2,6,0,1010,1.0,0.99,0.25,0.5
PF02050,PF03710:PF11800:PF04625:PF01420:PF11304,0,6,0,0,6,1012,0.0,0.99,0,0,0,0,0,0,1018,0,1.0,0,0
PF07659,PF11272:PF05504:PF03592:PF17206:PF17006,0,8,0,0,8,1010,0.0,0.99,0,0,0,0,0,0,1018,0,1.0,0,0
PF12126,PF15451:PF09418:PF03915:PF10631:PF06803,5,13,3,2,10,1003,0.23,0.99,0.6,0.37,2,2,3,0,1013,1.0,1.0,0.4,0.63
PF00029,PF03508:PF03509:PF16791:PF04000:PF06428,8,23,5,3,18,992,0.22,0.98,0.62,0.36,0,0,8,0,1010,0,0.99,0.0,0
PF10003,PF07584:PF05103:PF04361:PF01862:PF06103,0,3,0,0,3,1015,0.0,1.0,0,0,0,0,0,0,1018,0,1.0,0,0
PF11819,PF05902:PF04382:PF09379:PF05044:PF08736,10,43,8,2,35,973,0.19,0.96,0.8,0.38,7,1,9,6,1002,0.14,0.99,0.1,0.11
PF13234,PF11648:PF08061:PF03368:PF03461:PF09110,10,29,6,4,23,985,0.21,0.97,0.6,0.34,5,4,6,1,1007,0.8,0.99,0.4,0.56
PF14972,PF00714:PF10705:PF02427:PF15109:PF02448,2,1,0,2,1,1015,0.0,1.0,0.0,-0.0,0,0,2,0,1016,0,1.0,0.0,0
PF07711,PF16833:PF01239:PF08256:PF04122:PF12659,4,27,4,0,23,991,0.15,0.98,1.0,0.38,0,0,4,0,1014,0,1.0,0.0,0
PF15358,PF15162:PF15134:PF15623:PF10793:PF14865,0,1,0,0,1,1017,0.0,1.0,0,0,0,0,0,0,1018,0,1.0,0,0
PF08566,PF09348:PF02575:PF12046:PF09252:PF14087,5,16,5,0,11,1002,0.31,0.99,1.0,0.56,0,0,5,0,1013,0,1.0,0.0,0
PF02179,PF09055:PF16843:PF15157:PF16455:PF01599,17,17,5,12,12,989,0.29,0.98,0.29,0.28,1,1,16,0,1001,1.0,0.98,0.06,0.24
PF06529,PF12498:PF11785:PF08601:PF03957:PF07777,2,6,2,0,4,1012,0.33,1.0,1.0,0.58,2,2,0,0,1016,1.0,1.0,1.0,1.0
PF02451,PF07326:PF00997:PF11759:PF15234:PF11642,0,0,0,0,0,1018,0,1.0,0,0,0,0,0,0,1018,0,1.0,0,0
PF06108,PF06912:PF12716:PF09597:PF12900:PF10224,6,13,0,6,13,999,0.0,0.98,0.0,-0.01,0,0,6,0,1012,0,0.99,0.0,0
PF02276,PF15220:PF07209:PF12805:PF07960:PF05935,3,5,0,3,5,1010,0.0,0.99,0.0,-0.0,0,0,3,0,1015,0,1.0,0.0,0
PF11111,PF01668:PF15207:PF15343:PF15175:PF03379,1,4,0,1,4,1013,0.0,1.0,0.0,-0.0,0,0,1,0,1017,0,1.0,0.0,0
PF05572,PF11380:PF17103:PF17102:PF17101:PF13948,10,14,0,10,14,994,0.0,0.98,0.0,-0.01,4,0,10,4,1004,0.0,0.99,0.0,-0.01
PF06693,PF09296:PF04008:PF16656:PF02812:PF04193,0,48,0,0,48,970,0.0,0.95,0,0,7,0,0,7,1011,0.0,0.99,0,0
PF08727,PF00947:PF02226:PF08411:PF01552:PF02056,12,21,12,0,9,997,0.57,0.99,1.0,0.75,12,12,0,0,1006,1.0,1.0,1.0,1.0
PF10248,PF09340:PF04852:PF09805:PF01922:PF07939,3,21,1,2,20,995,0.05,0.98,0.33,0.12,3,0,3,3,1012,0.0,0.99,0.0,-0.0
PF12161,PF13588:PF00419:PF07149:PF06890:PF08411,2,4,2,0,2,1014,0.5,1.0,1.0,0.71,0,0,2,0,1016,0,1.0,0.0,0
PF02737,PF00725:PF00378:PF02803:PF14779:PF00016,29,89,27,2,62,927,0.3,0.94,0.93,0.51,14,14,15,0,989,1.0,0.99,0.48,0.69
PF00917,PF03000:PF09494:PF12436:PF02176:PF09237,27,35,15,12,20,971,0.43,0.97,0.56,0.47,6,6,21,0,991,1.0,0.98,0.22,0.47
PF10801,PF02907:PF11523:PF01590:PF06299:PF08446,0,42,0,0,42,976,0.0,0.96,0,0,3,0,0,3,1015,0.0,1.0,0,0
PF02646,PF05065:PF04984:PF02108:PF13005:PF04085,4,1,1,3,0,1014,1.0,1.0,0.25,0.5,0,0,4,0,1014,0,1.0,0.0,0
PF00286,PF11638:PF00895:PF08131:PF15281:PF12019,1,7,0,1,7,1010,0.0,0.99,0.0,-0.0,0,0,1,0,1017,0,1.0,0.0,0
PF11200,PF08759:PF06629:PF13699:PF17108:PF10429,0,1,0,0,1,1017,0.0,1.0,0,0,0,0,0,0,1018,0,1.0,0,0
PF06449,PF08140:PF11693:PF12139:PF09363:PF09364,4,5,0,4,5,1009,0.0,0.99,0.0,-0.0,0,0,4,0,1014,0,1.0,0.0,0
PF13421,PF06744:PF14842:PF03241:PF06798:PF07499,0,2,0,0,2,1016,0.0,1.0,0,0,0,0,0,0,1018,0,1.0,0,0
PF03974,PF09461:PF01668:PF10999:PF05234:PF15680,1,3,0,1,3,1014,0.0,1.0,0.0,-0.0,0,0,1,0,1017,0,1.0,0.0,0
PF02882,PF01268:PF00763:PF17135:PF01014:PF01357,30,40,25,5,15,973,0.62,0.98,0.83,0.71,7,7,23,0,988,1.0,0.98,0.23,0.48
PF05808,PF12855:PF08693:PF16060:PF04359:PF15673,1,10,1,0,9,1008,0.1,0.99,1.0,0.31,0,0,1,0,1017,0,1.0,0.0,0
PF00338,PF10259:PF09696:PF03942:PF01198:PF10780,24,48,10,14,38,956,0.21,0.95,0.42,0.27,2,2,22,0,994,1.0,0.98,0.08,0.29
PF08411,PF08461:PF16449:PF15518:PF11751:PF01706,1,2,0,1,2,1015,0.0,1.0,0.0,-0.0,0,0,1,0,1017,0,1.0,0.0,0
PF15062,PF06695:PF07961:PF09428:PF15503:PF11016,0,2,0,0,2,1016,0.0,1.0,0,0,0,0,0,0,1018,0,1.0,0,0
PF12778,PF17206:PF04466:PF03831:PF08808:PF01580,1,5,0,1,5,1012,0.0,0.99,0.0,-0.0,0,0,1,0,1017,0,1.0,0.0,0
PF01168,PF14031:PF00842:PF07975:PF01232:PF03102,15,17,10,5,7,996,0.59,0.99,0.67,0.62,0,0,15,0,1003,0,0.99,0.0,0
PF13806,PF04324:PF16020:PF14721:PF01077:PF14962,14,19,11,3,8,996,0.58,0.99,0.79,0.67,2,1,13,1,1003,0.5,0.99,0.07,0.19
PF11568,PF15085:PF15372:PF09232:PF08398:PF02393,2,4,1,1,3,1013,0.25,1.0,0.5,0.35,0,0,2,0,1016,0,1.0,0.0,0
PF15034,PF08501:PF01487:PF01488:PF01902:PF01042,0,42,0,0,42,976,0.0,0.96,0,0,11,0,0,11,1007,0.0,0.99,0,0
PF17097,PF07834:PF13474:PF08509:PF04689:PF05633,0,16,0,0,16,1002,0.0,0.98,0,0,1,0,0,1,1017,0.0,1.0,0,0
PF14251,PF15775:PF15856:PF13742:PF04392:PF10951,2,5,0,2,5,1011,0.0,0.99,0.0,-0.0,0,0,2,0,1016,0,1.0,0.0,0
PF10371,PF01558:PF17147:PF01855:PF02775:PF12838,5,46,5,0,41,972,0.11,0.96,1.0,0.32,7,5,0,2,1011,0.71,1.0,1.0,0.84
PF05506,PF13007:PF13746:PF03180:PF06445:PF07549,2,16,0,2,16,1000,0.0,0.98,0.0,-0.01,0,0,2,0,1016,0,1.0,0.0,0
PF12776,PF13359:PF13613:PF14392:PF04601:PF08325,27,62,18,9,44,947,0.29,0.95,0.67,0.42,8,6,21,2,989,0.75,0.98,0.22,0.4
PF14586,PF15667:PF08591:PF15828:PF05456:PF11027,1,7,1,0,6,1011,0.14,0.99,1.0,0.38,0,0,1,0,1017,0,1.0,0.0,0
PF08799,PF08145:PF08149:PF04494:PF10313:PF08581,13,20,5,8,15,990,0.25,0.98,0.38,0.3,1,1,12,0,1005,1.0,0.99,0.08,0.28
PF12541,PF09365:PF15050:PF03065:PF15033:PF10514,0,7,0,0,7,1011,0.0,0.99,0,0,0,0,0,0,1018,0,1.0,0,0
PF13247,PF17206:PF05857:PF14841:PF02399:PF11435,0,4,0,0,4,1014,0.0,1.0,0,0,0,0,0,0,1018,0,1.0,0,0
PF08940,PF03428:PF14842:PF10139:PF04865:PF08345,0,1,0,0,1,1017,0.0,1.0,0,0,0,0,0,0,1018,0,1.0,0,0
PF14435,PF07954:PF15334:PF14251:PF08291:PF07996,0,6,0,0,6,1012,0.0,0.99,0,0,0,0,0,0,1018,0,1.0,0,0
PF08811,PF07394:PF15912:PF15326:PF15146:PF05203,4,14,4,0,10,1004,0.29,0.99,1.0,0.53,0,0,4,0,1014,0,1.0,0.0,0
PF09415,PF11032:PF16054:PF13301:PF11805:PF14825,3,13,2,1,11,1004,0.15,0.99,0.67,0.32,2,2,1,0,1015,1.0,1.0,0.67,0.82
PF15849,PF07259:PF15120:PF15839:PF15576:PF15829,0,4,0,0,4,1014,0.0,1.0,0,0,0,0,0,0,1018,0,1.0,0,0
PF02063,PF02399:PF15476:PF08432:PF04196:PF02074,3,4,0,3,4,1011,0.0,0.99,0.0,-0.0,0,0,3,0,1015,0,1.0,0.0,0
PF13695,PF00468:PF16009:PF04839:PF00127:PF09419,4,19,0,4,19,995,0.0,0.98,0.0,-0.01,0,0,4,0,1014,0,1.0,0.0,0
PF16818,PF09832:PF05611:PF15202:PF15332:PF15158,0,1,0,0,1,1017,0.0,1.0,0,0,0,0,0,0,1018,0,1.0,0,0
PF01365,PF08709:PF02026:PF08454:PF02815:PF06459,9,32,9,0,23,986,0.28,0.98,1.0,0.52,11,9,0,2,1007,0.82,1.0,1.0,0.9
PF16756,PF15774:PF08744:PF15391:PF15235:PF15337,0,3,0,0,3,1015,0.0,1.0,0,0,1,0,0,1,1017,0.0,1.0,0,0
PF13968,PF04578:PF07762:PF07422:PF00722:PF00251,19,63,18,1,45,954,0.29,0.95,0.95,0.51,7,7,12,0,999,1.0,0.99,0.37,0.6
PF14329,PF05119:PF10417:PF07413:PF00331:PF16010,0,49,0,0,49,969,0.0,0.95,0,0,2,0,0,2,1016,0.0,1.0,0,0
PF07204,PF11465:PF02158:PF03921:PF02480:PF02124,4,9,2,2,7,1007,0.22,0.99,0.5,0.33,2,2,2,0,1014,1.0,1.0,0.5,0.71
PF02629,PF08442:PF00285:PF00549:PF16114:PF06971,16,44,16,0,28,974,0.36,0.97,1.0,0.59,6,5,11,1,1001,0.83,0.99,0.31,0.51
PF10843,PF13750:PF05294:PF04076:PF15483:PF01312,0,1,0,0,1,1017,0.0,1.0,0,0,0,0,0,0,1018,0,1.0,0,0
PF11764,PF11616:PF15811:PF05965:PF05033:PF10440,7,41,5,2,36,975,0.12,0.96,0.71,0.29,4,2,5,2,1009,0.5,0.99,0.29,0.37
PF08548,PF13946:PF03241:PF03944:PF13247:PF04328,1,3,1,0,2,1015,0.33,1.0,1.0,0.58,0,0,1,0,1017,0,1.0,0.0,0
PF04018,PF11811:PF12878:PF16980:PF17011:PF08235,0,11,0,0,11,1007,0.0,0.99,0,0,0,0,0,0,1018,0,1.0,0,0
PF15251,PF09805:PF12926:PF04729:PF11711:PF07939,2,16,0,2,16,1000,0.0,0.98,0.0,-0.01,1,0,2,1,1015,0.0,1.0,0.0,-0.0
PF00581,PF06617:PF00566:PF12368:PF14671:PF15733,53,88,32,21,56,909,0.36,0.92,0.6,0.43,0,0,53,0,965,0,0.95,0.0,0
PF14654,PF05647:PF14920:PF14919:PF16485:PF14918,0,1,0,0,1,1017,0.0,1.0,0,0,0,0,0,0,1018,0,1.0,0,0
PF10292,PF02115:PF03125:PF08617:PF10853:PF09778,12,29,2,10,27,979,0.07,0.96,0.17,0.09,2,2,10,0,1006,1.0,0.99,0.17,0.41
PF12906,PF06454:PF08313:PF16563:PF15276:PF02622,32,27,7,25,20,966,0.26,0.96,0.22,0.22,2,2,30,0,986,1.0,0.97,0.06,0.25
PF08521,PF00672:PF00990:PF02518:PF01584:PF00196,3,82,3,0,79,936,0.04,0.92,1.0,0.18,13,2,1,11,1004,0.15,0.99,0.67,0.32
PF01114,PF12904:PF02740:PF15722:PF15302:PF00323,1,1,1,0,0,1017,1.0,1.0,1.0,1.0,0,0,1,0,1017,0,1.0,0.0,0
PF03135,PF07499:PF05974:PF11751:PF13722:PF03090,5,2,1,4,1,1012,0.5,1.0,0.2,0.31,0,0,5,0,1013,0,1.0,0.0,0
PF09667,PF16090:PF13775:PF12444:PF14887:PF12067,0,11,0,0,11,1007,0.0,0.99,0,0,0,0,0,0,1018,0,1.0,0,0
PF11921,PF10428:PF15904:PF12534:PF16920:PF01462,1,12,1,0,11,1006,0.08,0.99,1.0,0.29,2,1,0,1,1016,0.5,1.0,1.0,0.71
PF04109,PF15279:PF14909:PF05624:PF03359:PF16019,10,14,4,6,10,998,0.29,0.98,0.4,0.33,0,0,10,0,1008,0,0.99,0.0,0
PF06217,PF02531:PF06876:PF11909:PF08591:PF04691,0,4,0,0,4,1014,0.0,1.0,0,0,0,0,0,0,1018,0,1.0,0,0
PF03336,PF04014:PF15703:PF15672:PF07338:PF03244,0,6,0,0,6,1012,0.0,0.99,0,0,0,0,0,0,1018,0,1.0,0,0
PF06119,PF03782:PF07474:PF00094:PF10511:PF13330,15,47,13,2,34,969,0.28,0.96,0.87,0.48,6,4,11,2,1001,0.67,0.99,0.27,0.42
PF05436,PF04648:PF09367:PF01387:PF00879:PF04643,1,3,1,0,2,1015,0.33,1.0,1.0,0.58,0,0,1,0,1017,0,1.0,0.0,0
PF03461,PF03880:PF10927:PF07652:PF08061:PF12137,3,11,2,1,9,1006,0.18,0.99,0.67,0.34,1,1,2,0,1015,1.0,1.0,0.33,0.58
PF05841,PF13810:PF10295:PF15696:PF10361:PF04988,0,9,0,0,9,1009,0.0,0.99,0,0,0,0,0,0,1018,0,1.0,0,0
PF03253,PF03285:PF15237:PF04144:PF06294:PF01146,6,26,5,1,21,991,0.19,0.98,0.83,0.39,1,1,5,0,1012,1.0,1.0,0.17,0.41
PF01584,PF06580:PF04397:PF00158:PF12010:PF02954,7,18,5,2,13,998,0.28,0.99,0.71,0.44,3,1,6,2,1009,0.33,0.99,0.14,0.21
PF07347,PF11029:PF15884:PF04736:PF15171:PF15071,9,6,0,9,6,1003,0.0,0.99,0.0,-0.01,0,0,9,0,1009,0,0.99,0.0,0
PF08448,PF13188:PF00990:PF00672:PF00015:PF07730,11,30,9,2,21,986,0.3,0.98,0.82,0.49,10,6,5,4,1003,0.6,0.99,0.55,0.57
PF14638,PF14636:PF14637:PF11597:PF06333:PF04589,6,13,6,0,7,1005,0.46,0.99,1.0,0.68,2,2,4,0,1012,1.0,1.0,0.33,0.58
PF00856,PF10440:PF05964:PF09273:PF03353:PF01753,109,87,53,56,34,875,0.61,0.91,0.49,0.5,5,5,104,0,909,1.0,0.9,0.05,0.2
PF07016,PF01514:PF03428:PF01752:PF12191:PF04466,0,2,0,0,2,1016,0.0,1.0,0,0,0,0,0,0,1018,0,1.0,0,0
PF17010,PF01668:PF03238:PF06681:PF08404:PF05666,0,2,0,0,2,1016,0.0,1.0,0,0,0,0,0,0,1018,0,1.0,0,0
PF14676,PF14680:PF14679:PF14675:PF14677:PF14674,1,1,1,0,0,1017,1.0,1.0,1.0,1.0,1,1,0,0,1017,1.0,1.0,1.0,1.0
PF12155,PF03237:PF01059:PF12139:PF06444:PF16263,0,2,0,0,2,1016,0.0,1.0,0,0,0,0,0,0,1018,0,1.0,0,0
PF12530,PF11229:PF10487:PF08158:PF02368:PF16507,2,24,2,0,22,994,0.08,0.98,1.0,0.29,1,1,1,0,1016,1.0,1.0,0.5,0.71
PF14700,PF00940:PF01858:PF11934:PF12505:PF02690,10,21,10,0,11,997,0.48,0.99,1.0,0.69,1,1,9,0,1008,1.0,0.99,0.1,0.31
PF09065,PF02788:PF00016:PF00330:PF01397:PF00082,0,89,0,0,89,929,0.0,0.91,0,0,6,0,0,6,1012,0.0,0.99,0,0
PF06903,PF04963:PF05443:PF06834:PF16822:PF07511,0,2,0,0,2,1016,0.0,1.0,0,0,0,0,0,0,1018,0,1.0,0,0
PF12478,PF15888:PF15997:PF09596:PF15923:PF02200,5,3,0,5,3,1010,0.0,0.99,0.0,-0.0,0,0,5,0,1013,0,1.0,0.0,0
PF08517,PF13775:PF08347:PF16090:PF12336:PF12067,6,9,1,5,8,1004,0.11,0.99,0.17,0.13,0,0,6,0,1012,0,0.99,0.0,0
PF15293,PF15068:PF15053:PF15814:PF06729:PF15703,1,3,0,1,3,1014,0.0,1.0,0.0,-0.0,0,0,1,0,1017,0,1.0,0.0,0
PF15776,PF15343:PF17049:PF01312:PF06890:PF15175,2,1,0,2,1,1015,0.0,1.0,0.0,-0.0,0,0,2,0,1016,0,1.0,0.0,0
PF06702,PF15051:PF12251:PF04516:PF05652:PF14909,11,22,7,4,15,992,0.32,0.98,0.64,0.44,3,1,10,2,1005,0.33,0.99,0.09,0.17
PF02637,PF02934:PF14687:PF16709:PF02065:PF16711,9,26,9,0,17,992,0.35,0.98,1.0,0.58,0,0,9,0,1009,0,0.99,0.0,0
PF16012,PF07530:PF12259:PF07245:PF12384:PF02994,9,25,2,7,23,986,0.08,0.97,0.22,0.12,4,1,8,3,1006,0.25,0.99,0.11,0.16
PF02448,PF15559:PF02427:PF15109:PF14986:PF15172,0,1,0,0,1,1017,0.0,1.0,0,0,0,0,0,0,1018,0,1.0,0,0
PF13378,PF16582:PF10329:PF02775:PF02776:PF12697,26,78,15,11,63,929,0.19,0.93,0.58,0.3,12,8,18,4,988,0.67,0.98,0.31,0.44
PF04571,PF16876:PF11597:PF06972:PF04825:PF04118,11,30,10,1,20,987,0.33,0.98,0.91,0.54,2,2,9,0,1007,1.0,0.99,0.18,0.42
PF09734,PF04664:PF09789:PF15929:PF04139:PF10188,7,14,2,5,12,999,0.14,0.98,0.29,0.19,0,0,7,0,1011,0,0.99,0.0,0
PF08165,PF16165:PF08150:PF08151:PF10540:PF15625,2,18,2,0,16,1000,0.11,0.98,1.0,0.33,4,1,1,3,1013,0.25,1.0,0.5,0.35
PF08320,PF06293:PF02114:PF03134:PF01215:PF09812,14,40,8,6,32,972,0.2,0.96,0.57,0.32,2,2,12,0,1004,1.0,0.99,0.14,0.38
PF17068,PF15334:PF11402:PF14519:PF08026:PF07192,0,0,0,0,0,1018,0,1.0,0,0,0,0,0,0,1018,0,1.0,0,0
PF15755,PF15046:PF15175:PF08945:PF07392:PF15120,2,4,0,2,4,1012,0.0,0.99,0.0,-0.0,0,0,2,0,1016,0,1.0,0.0,0
PF03953,PF12327:PF00091:PF02491:PF05652:PF06414,50,68,46,4,22,946,0.68,0.97,0.92,0.78,3,2,48,1,967,0.67,0.95,0.04,0.16
PF01918,PF02704:PF12023:PF10018:PF16541:PF07816,11,22,3,8,19,988,0.14,0.97,0.27,0.18,2,1,10,1,1006,0.5,0.99,0.09,0.21
PF05793,PF10200:PF08661:PF07477:PF15350:PF03648,10,16,4,6,12,996,0.25,0.98,0.4,0.31,0,0,10,0,1008,0,0.99,0.0,0
PF05870,PF03576:PF10340:PF09056:PF07544:PF08738,2,9,0,2,9,1007,0.0,0.99,0.0,-0.0,0,0,2,0,1016,0,1.0,0.0,0
PF16100,PF05754:PF14985:PF06876:PF02972:PF08591,3,2,0,3,2,1013,0.0,1.0,0.0,-0.0,0,0,3,0,1015,0,1.0,0.0,0
PF13390,PF09829:PF05974:PF15281:PF03090:PF03605,0,4,0,0,4,1014,0.0,1.0,0,0,0,0,0,0,1018,0,1.0,0,0
PF02917,PF09109:PF11124:PF11593:PF15775:PF13148,2,2,0,2,2,1014,0.0,1.0,0.0,-0.0,0,0,2,0,1016,0,1.0,0.0,0
PF04725,PF05479:PF02372:PF15884:PF00321:PF11264,2,6,0,2,6,1010,0.0,0.99,0.0,-0.0,0,0,2,0,1016,0,1.0,0.0,0
PF04788,PF03195:PF04107:PF14159:PF04759:PF08643,5,18,3,2,15,998,0.17,0.98,0.6,0.31,1,0,5,1,1012,0.0,0.99,0.0,-0.0
PF13902,PF12752:PF01422:PF01424:PF07528:PF14622,9,56,7,2,49,960,0.12,0.95,0.78,0.3,8,3,6,5,1004,0.38,0.99,0.33,0.35
PF07642,PF04958:PF09694:PF03402:PF11227:PF06623,0,7,0,0,7,1011,0.0,0.99,0,0,0,0,0,0,1018,0,1.0,0,0
PF16275,PF08067:PF16274:PF16544:PF10469:PF07962,9,24,7,2,17,992,0.29,0.98,0.78,0.47,2,2,7,0,1009,1.0,0.99,0.22,0.47
PF01799,PF02738:PF01315:PF03450:PF00941:PF14498,21,29,21,0,8,989,0.72,0.99,1.0,0.85,22,21,0,1,996,0.95,1.0,1.0,0.98
PF12271,PF04418:PF08649:PF04729:PF15879:PF13741,7,17,3,4,14,997,0.18,0.98,0.43,0.27,1,1,6,0,1011,1.0,0.99,0.14,0.38
PF01974,PF02778:PF01648:PF16123:PF00753:PF07521,20,100,18,2,82,916,0.18,0.92,0.9,0.38,14,9,11,5,993,0.64,0.98,0.45,0.53
PF11309,PF01226:PF15245:PF07797:PF13805:PF16545,0,25,0,0,25,993,0.0,0.98,0,0,0,0,0,0,1018,0,1.0,0,0
PF09113,PF09112:PF02951:PF15661:PF13735:PF12779,0,8,0,0,8,1010,0.0,0.99,0,0,0,0,0,0,1018,0,1.0,0,0
PF10218,PF01632:PF04716:PF09597:PF08561:PF10244,0,27,0,0,27,991,0.0,0.97,0,0,1,0,0,1,1017,0.0,1.0,0,0
PF02384,PF06250:PF12161:PF06122:PF15834:PF15021,5,2,2,3,0,1013,1.0,1.0,0.4,0.63,0,0,5,0,1013,0,1.0,0.0,0
PF16259,PF17188:PF01752:PF12019:PF06070:PF03831,0,4,0,0,4,1014,0.0,1.0,0,0,0,0,0,0,1018,0,1.0,0,0
PF03700,PF12825:PF12828:PF08944:PF13924:PF16621,1,13,1,0,12,1005,0.08,0.99,1.0,0.28,3,1,0,2,1015,0.33,1.0,1.0,0.58
PF07602,PF16977:PF00341:PF16915:PF14554:PF04692,1,14,1,0,13,1004,0.07,0.99,1.0,0.27,1,0,1,1,1016,0.0,1.0,0.0,-0.0
PF15240,PF05238:PF15710:PF14654:PF08444:PF01114,2,3,0,2,3,1013,0.0,1.0,0.0,-0.0,0,0,2,0,1016,0,1.0,0.0,0
PF16423,PF16422:PF09270:PF09271:PF11928:PF11510,3,18,3,0,15,1000,0.17,0.99,1.0,0.41,4,2,1,2,1013,0.5,1.0,0.67,0.58
PF00095,PF00086:PF10511:PF02961:PF00014:PF09307,30,57,15,15,42,946,0.26,0.94,0.5,0.34,4,4,26,0,988,1.0,0.97,0.13,0.36
PF13724,PF14364:PF05508:PF14909:PF16944:PF08655,1,13,0,1,13,1004,0.0,0.99,0.0,-0.0,0,0,1,0,1017,0,1.0,0.0,0
PF05662,PF07409:PF14690:PF02465:PF13722:PF02211,3,3,0,3,3,1012,0.0,0.99,0.0,-0.0,0,0,3,0,1015,0,1.0,0.0,0
PF06963,PF07063:PF07911:PF06090:PF01294:PF00471,13,21,5,8,16,989,0.24,0.98,0.38,0.29,2,1,12,1,1004,0.5,0.99,0.08,0.19
PF09768,PF05915:PF03587:PF14935:PF01597:PF02284,10,33,8,2,25,983,0.24,0.97,0.8,0.43,1,1,9,0,1008,1.0,0.99,0.1,0.31
PF02600,PF07464:PF02087:PF15158:PF06876:PF11430,1,3,0,1,3,1014,0.0,1.0,0.0,-0.0,0,0,1,0,1017,0,1.0,0.0,0
PF06414,PF10179:PF10672:PF12576:PF05652:PF06830,11,17,1,10,16,991,0.06,0.97,0.09,0.06,0,0,11,0,1007,0,0.99,0.0,0
PF03028,PF12777:PF12780:PF08393:PF08385:PF07728,38,56,37,1,19,961,0.66,0.98,0.97,0.79,34,32,6,2,978,0.94,0.99,0.84,0.89
PF00006,PF00128:PF04389:PF02874:PF14959:PF12333,46,96,42,4,54,918,0.44,0.94,0.91,0.61,10,9,37,1,971,0.9,0.96,0.2,0.41
PF00194,PF10263:PF14521:PF00354:PF16066:PF13472,27,65,12,15,53,938,0.18,0.93,0.44,0.26,4,3,24,1,990,0.75,0.98,0.11,0.28
PF03980,PF08561:PF06127:PF01097:PF07114:PF04716,4,25,3,1,22,992,0.12,0.98,0.75,0.29,0,0,4,0,1014,0,1.0,0.0,0
PF02165,PF04549:PF00865:PF15893:PF06736:PF08204,0,1,0,0,1,1017,0.0,1.0,0,0,0,0,0,0,1018,0,1.0,0,0
PF02430,PF02915:PF00499:PF06083:PF16541:PF07816,1,9,1,0,8,1009,0.11,0.99,1.0,0.33,0,0,1,0,1017,0,1.0,0.0,0
PF13335,PF03090:PF11751:PF08805:PF13505:PF05272,0,1,0,0,1,1017,0.0,1.0,0,0,0,0,0,0,1018,0,1.0,0,0
PF00677,PF05173:PF14693:PF10356:PF16196:PF10303,4,11,0,4,11,1003,0.0,0.99,0.0,-0.01,0,0,4,0,1014,0,1.0,0.0,0
PF05678,PF07939:PF03195:PF02234:PF04367:PF04949,9,22,6,3,16,993,0.27,0.98,0.67,0.42,1,1,8,0,1009,1.0,0.99,0.11,0.33
PF03623,PF06760:PF09027:PF02019:PF08917:PF14786,3,6,1,2,5,1010,0.17,0.99,0.33,0.23,2,1,2,1,1014,0.5,1.0,0.33,0.41
PF08982,PF13876:PF01913:PF16861:PF01364:PF10567,3,8,0,3,8,1007,0.0,0.99,0.0,-0.0,0,0,3,0,1015,0,1.0,0.0,0
PF10278,PF02605:PF07160:PF07464:PF11105:PF09057,7,5,0,7,5,1006,0.0,0.99,0.0,-0.01,0,0,7,0,1011,0,0.99,0.0,0
PF15739,PF07989:PF15651:PF04423:PF06918:PF16531,5,21,3,2,18,995,0.14,0.98,0.6,0.29,0,0,5,0,1013,0,1.0,0.0,0
PF11326,PF01987:PF11264:PF10780:PF01097:PF06232,4,12,1,3,11,1003,0.08,0.99,0.25,0.14,0,0,4,0,1014,0,1.0,0.0,0
PF13495,PF00524:PF05065:PF05685:PF09979:PF06887,1,6,1,0,5,1012,0.17,1.0,1.0,0.41,0,0,1,0,1017,0,1.0,0.0,0
PF04166,PF15623:PF06798:PF00997:PF12615:PF15817,6,1,0,6,1,1011,0.0,0.99,0.0,-0.0,0,0,6,0,1012,0,0.99,0.0,0
PF09929,PF13211:PF08270:PF04384:PF15155:PF10117,0,4,0,0,4,1014,0.0,1.0,0,0,0,0,0,0,1018,0,1.0,0,0
PF01880,PF11245:PF15281:PF10412:PF02277:PF06798,2,6,0,2,6,1010,0.0,0.99,0.0,-0.0,0,0,2,0,1016,0,1.0,0.0,0
PF07705,PF00419:PF11304:PF04453:PF09327:PF04917,0,2,0,0,2,1016,0.0,1.0,0,0,0,0,0,0,1018,0,1.0,0,0
PF01291,PF15055:PF15063:PF06541:PF02202:PF15715,1,0,0,1,0,1017,0,1.0,0.0,0,0,0,1,0,1017,0,1.0,0.0,0
PF08291,PF05962:PF15775:PF05894:PF02601:PF15856,0,4,0,0,4,1014,0.0,1.0,0,0,0,0,0,0,1018,0,1.0,0,0
PF08584,PF02284:PF00143:PF00793:PF01774:PF06658,4,26,1,3,25,989,0.04,0.97,0.25,0.09,0,0,4,0,1014,0,1.0,0.0,0
PF01637,PF17008:PF15485:PF14573:PF08744:PF16051,2,0,0,2,0,1016,0,1.0,0.0,0,0,0,2,0,1016,0,1.0,0.0,0
PF12550,PF16787:PF10979:PF11496:PF15066:PF08647,5,29,4,1,25,988,0.14,0.97,0.8,0.33,1,0,5,1,1012,0.0,0.99,0.0,-0.0
PF09134,PF13946:PF02572:PF08479:PF00915:PF07494,0,5,0,0,5,1013,0.0,1.0,0,0,0,0,0,0,1018,0,1.0,0,0
PF15548,PF04610:PF10618:PF11751:PF13722:PF04740,2,3,0,2,3,1013,0.0,1.0,0.0,-0.0,0,0,2,0,1016,0,1.0,0.0,0
PF00819,PF09990:PF04993:PF17049:PF05418:PF15748,0,2,0,0,2,1016,0.0,1.0,0,0,0,0,0,0,1018,0,1.0,0,0
PF02465,PF08497:PF16325:PF03428:PF10908:PF11245,0,1,0,0,1,1017,0.0,1.0,0,0,0,0,0,0,1018,0,1.0,0,0
PF12842,PF16415:PF16417:PF04054:PF16418:PF06333,11,21,11,0,10,997,0.52,0.99,1.0,0.72,10,10,1,0,1007,1.0,1.0,0.91,0.95
PF06429,PF03963:PF02107:PF07559:PF00460:PF02501,2,5,2,0,3,1013,0.4,1.0,1.0,0.63,1,1,1,0,1016,1.0,1.0,0.5,0.71
PF13174,PF05279:PF08492:PF17004:PF07719:PF16669,14,44,11,3,33,971,0.25,0.96,0.79,0.43,4,3,11,1,1003,0.75,0.99,0.21,0.4
PF08445,PF06021:PF08444:PF08622:PF14784:PF17187,10,6,4,6,2,1006,0.67,0.99,0.4,0.51,1,0,10,1,1007,0.0,0.99,0.0,-0.0
PF16910,PF12624:PF06650:PF09333:PF13329:PF16908,14,38,14,0,24,980,0.37,0.98,1.0,0.6,17,9,5,8,996,0.53,0.99,0.64,0.58
PF09497,PF08729:PF10744:PF04182:PF12509:PF10264,9,18,5,4,13,996,0.28,0.98,0.56,0.39,2,2,7,0,1009,1.0,0.99,0.22,0.47
PF16297,PF07962:PF14893:PF07530:PF04046:PF12384,3,17,3,0,14,1001,0.18,0.99,1.0,0.42,4,3,0,1,1014,0.75,1.0,1.0,0.87
PF06381,PF03592:PF11863:PF02465:PF16325:PF14882,0,1,0,0,1,1017,0.0,1.0,0,0,0,0,0,0,1018,0,1.0,0,0
PF08887,PF03525:PF02557:PF15485:PF07192:PF08093,0,3,0,0,3,1015,0.0,1.0,0,0,0,0,0,0,1018,0,1.0,0,0
PF05735,PF02412:PF07452:PF10577:PF08343:PF14695,3,11,3,0,8,1007,0.27,0.99,1.0,0.52,1,1,2,0,1015,1.0,1.0,0.33,0.58
PF15430,PF02098:PF04176:PF01327:PF01674:PF03587,5,29,4,1,25,988,0.14,0.97,0.8,0.33,1,1,4,0,1013,1.0,1.0,0.2,0.45
PF07993,PF03015:PF13360:PF00501:PF02801:PF13570,48,154,43,5,111,859,0.28,0.89,0.9,0.46,17,14,34,3,967,0.82,0.96,0.29,0.48
PF01044,PF00932:PF06454:PF00244:PF13725:PF10042,8,39,2,6,37,973,0.05,0.96,0.25,0.1,3,2,6,1,1009,0.67,0.99,0.25,0.41
PF12515,PF12409:PF09040:PF08282:PF12424:PF16209,8,69,7,1,62,948,0.1,0.94,0.88,0.29,6,4,4,2,1008,0.67,0.99,0.5,0.57
PF10348,PF10355:PF16978:PF09729:PF09463:PF11754,7,27,7,0,20,991,0.26,0.98,1.0,0.5,3,2,5,1,1010,0.67,0.99,0.29,0.43
PF03413,PF07504:PF02128:PF00548:PF00073:PF04412,4,15,2,2,13,1001,0.13,0.99,0.5,0.25,1,1,3,0,1014,1.0,1.0,0.25,0.5
PF14987,PF01330:PF07157:PF06798:PF13722:PF11874,3,2,1,2,1,1014,0.5,1.0,0.33,0.41,0,0,3,0,1015,0,1.0,0.0,0
PF16094,PF14829:PF07366:PF01709:PF08806:PF15065,6,28,3,3,25,987,0.11,0.97,0.5,0.22,3,1,5,2,1010,0.33,0.99,0.17,0.23
PF08666,PF03102:PF14918:PF16116:PF14920:PF16173,8,2,0,8,2,1008,0.0,0.99,0.0,-0.0,0,0,8,0,1010,0,0.99,0.0,0
PF11934,PF01857:PF08934:PF01858:PF06148:PF12859,2,15,1,1,14,1002,0.07,0.99,0.5,0.18,0,0,2,0,1016,0,1.0,0.0,0
PF06102,PF13092:PF11833:PF07107:PF10252:PF13225,9,14,1,8,13,996,0.07,0.98,0.11,0.08,1,1,8,0,1009,1.0,0.99,0.11,0.33
PF08436,PF13288:PF02670:PF00674:PF05023:PF09328,12,21,12,0,9,997,0.57,0.99,1.0,0.75,0,0,12,0,1006,0,0.99,0.0,0
PF10599,PF09950:PF12603:PF10035:PF02399:PF15548,5,7,1,4,6,1007,0.14,0.99,0.2,0.16,0,0,5,0,1013,0,1.0,0.0,0
PF03281,PF07693:PF00710:PF04960:PF10505:PF16700,13,29,8,5,21,984,0.28,0.97,0.62,0.4,1,1,12,0,1005,1.0,0.99,0.08,0.28
PF06007,PF06070:PF09611:PF01913:PF03428:PF01752,2,4,0,2,4,1012,0.0,0.99,0.0,-0.0,0,0,2,0,1016,0,1.0,0.0,0
PF00784,PF16735:PF00063:PF05902:PF00373:PF16705,24,97,20,4,77,917,0.21,0.92,0.83,0.39,5,3,21,2,992,0.6,0.98,0.12,0.27
PF13677,PF13205:PF01914:PF10566:PF13750:PF01943,0,3,0,0,3,1015,0.0,1.0,0,0,0,0,0,0,1018,0,1.0,0,0
PF15975,PF16200:PF02036:PF09822:PF11698:PF00215,6,52,2,4,50,962,0.04,0.95,0.33,0.1,5,1,5,4,1008,0.2,0.99,0.17,0.18
PF11641,PF12827:PF05728:PF01316:PF15186:PF17206,0,8,0,0,8,1010,0.0,0.99,0,0,0,0,0,0,1018,0,1.0,0,0
PF06540,PF01296:PF00323:PF01091:PF08023:PF02451,1,3,1,0,2,1015,0.33,1.0,1.0,0.58,0,0,1,0,1017,0,1.0,0.0,0
PF01330,PF07157:PF13722:PF07409:PF14987:PF05202,2,3,1,1,2,1014,0.33,1.0,0.5,0.41,0,0,2,0,1016,0,1.0,0.0,0
PF03874,PF05676:PF01779:PF01279:PF03386:PF07911,11,19,4,7,15,992,0.21,0.98,0.36,0.27,0,0,11,0,1007,0,0.99,0.0,0
PF08362,PF07157:PF13722:PF01752:PF15143:PF11751,1,2,0,1,2,1015,0.0,1.0,0.0,-0.0,0,0,1,0,1017,0,1.0,0.0,0
PF01845,PF03460:PF01077:PF11707:PF10363:PF10415,1,34,0,1,34,983,0.0,0.97,0.0,-0.01,3,0,1,3,1014,0.0,1.0,0.0,-0.0
PF09781,PF09057:PF06679:PF03488:PF10868:PF00489,1,2,0,1,2,1015,0.0,1.0,0.0,-0.0,0,0,1,0,1017,0,1.0,0.0,0
PF07778,PF16061:PF03074:PF09848:PF12735:PF05023,6,25,2,4,23,989,0.08,0.97,0.33,0.15,0,0,6,0,1012,0,0.99,0.0,0
PF05699,PF14291:PF02892:PF04937:PF14372:PF12017,67,67,35,32,32,919,0.52,0.94,0.52,0.49,15,14,53,1,950,0.93,0.95,0.21,0.43
PF07296,PF04453:PF11304:PF03944:PF15775:PF02572,0,4,0,0,4,1014,0.0,1.0,0,0,0,0,0,0,1018,0,1.0,0,0
PF06221,PF04087:PF05334:PF11928:PF08634:PF12253,12,6,2,10,4,1002,0.33,0.99,0.17,0.23,0,0,12,0,1006,0,0.99,0.0,0
PF08208,PF13094:PF13013:PF15553:PF14866:PF08642,5,2,0,5,2,1011,0.0,0.99,0.0,-0.0,0,0,5,0,1013,0,1.0,0.0,0
PF11851,PF15951:PF01056:PF02344:PF09427:PF06621,1,17,1,0,16,1001,0.06,0.98,1.0,0.24,2,1,0,1,1016,0.5,1.0,1.0,0.71
PF15668,PF15843:PF13550:PF09690:PF17053:PF11288,2,0,0,2,0,1016,0,1.0,0.0,0,0,0,2,0,1016,0,1.0,0.0,0
PF09310,PF15898:PF09372:PF15487:PF16553:PF07693,0,11,0,0,11,1007,0.0,0.99,0,0,1,0,0,1,1017,0.0,1.0,0,0
PF07162,PF01757:PF07971:PF01755:PF10155:PF03074,14,57,2,12,55,949,0.04,0.93,0.14,0.04,3,0,14,3,1001,0.0,0.98,0.0,-0.01
PF13694,PF15400:PF16670:PF06724:PF10698:PF13559,0,2,0,0,2,1016,0.0,1.0,0,0,0,0,0,0,1018,0,1.0,0,0
PF16071,PF10933:PF08744:PF04562:PF12479:PF01057,0,2,0,0,2,1016,0.0,1.0,0,0,0,0,0,0,1018,0,1.0,0,0
PF03596,PF10330:PF06485:PF08653:PF06420:PF06989,0,8,0,0,8,1010,0.0,0.99,0,0,0,0,0,0,1018,0,1.0,0,0
PF16897,PF16360:PF02824:PF13167:PF15086:PF09269,10,31,10,0,21,987,0.32,0.98,1.0,0.56,1,1,9,0,1008,1.0,0.99,0.1,0.31
PF01237,PF08174:PF01412:PF12430:PF08718:PF08916,41,59,19,22,40,937,0.32,0.94,0.46,0.36,3,2,39,1,976,0.67,0.96,0.05,0.17
PF02654,PF01752:PF05939:PF01514:PF08453:PF04559,3,2,0,3,2,1013,0.0,1.0,0.0,-0.0,0,0,3,0,1015,0,1.0,0.0,0
PF04113,PF04006:PF05091:PF05254:PF05693:PF16969,11,42,5,6,37,970,0.12,0.96,0.45,0.22,3,2,9,1,1006,0.67,0.99,0.18,0.34
PF16559,PF08518:PF12205:PF01412:PF16553:PF06675,2,50,2,0,48,968,0.04,0.95,1.0,0.2,3,2,0,1,1015,0.67,1.0,1.0,0.82
PF08532,PF07117:PF16967:PF07494:PF16889:PF08724,8,2,0,8,2,1008,0.0,0.99,0.0,-0.0,0,0,8,0,1010,0,0.99,0.0,0
PF02673,PF08795:PF04349:PF02601:PF01580:PF05838,1,7,0,1,7,1010,0.0,0.99,0.0,-0.0,0,0,1,0,1017,0,1.0,0.0,0
PF11356,PF07157:PF13722:PF07409:PF00915:PF07149,2,1,0,2,1,1015,0.0,1.0,0.0,-0.0,0,0,2,0,1016,0,1.0,0.0,0
PF12180,PF13851:PF13870:PF12845:PF06211:PF11831,1,23,1,0,22,995,0.04,0.98,1.0,0.21,0,0,1,0,1017,0,1.0,0.0,0
PF09026,PF04236:PF09607:PF04218:PF12225:PF12116,5,24,4,1,20,993,0.17,0.98,0.8,0.36,1,1,4,0,1013,1.0,1.0,0.2,0.45
PF10927,PF07652:PF14229:PF12137:PF03880:PF03461,0,12,0,0,12,1006,0.0,0.99,0,0,2,0,0,2,1016,0.0,1.0,0,0
PF11387,PF05621:PF00555:PF09074:PF07392:PF04717,0,2,0,0,2,1016,0.0,1.0,0,0,0,0,0,0,1018,0,1.0,0,0
PF04613,PF13720:PF06426:PF01050:PF12804:PF12464,9,32,2,7,30,979,0.06,0.96,0.22,0.1,2,1,8,1,1008,0.5,0.99,0.11,0.23
PF07806,PF01114:PF00799:PF15722:PF10284:PF06683,0,3,0,0,3,1015,0.0,1.0,0,0,0,0,0,0,1018,0,1.0,0,0
PF04564,PF14847:PF10408:PF08606:PF00582:PF14360,56,57,31,25,26,936,0.54,0.95,0.55,0.52,5,5,51,0,962,1.0,0.95,0.09,0.29
PF00033,PF00115:PF13631:PF00119:PF08561:PF00499,11,23,10,1,13,994,0.43,0.99,0.91,0.62,0,0,11,0,1007,0,0.99,0.0,0
PF08945,PF15175:PF15046:PF11371:PF07392:PF03203,0,3,0,0,3,1015,0.0,1.0,0,0,0,0,0,0,1018,0,1.0,0,0
PF02669,PF03814:PF06798:PF02277:PF15856:PF11202,1,5,1,0,4,1013,0.2,1.0,1.0,0.45,0,0,1,0,1017,0,1.0,0.0,0
PF01454,PF12440:PF03074:PF03040:PF03071:PF16545,13,28,5,8,23,982,0.18,0.97,0.38,0.25,0,0,13,0,1005,0,0.99,0.0,0
PF06560,PF06295:PF09932:PF02404:PF01509:PF16136,1,20,0,1,20,997,0.0,0.98,0.0,-0.0,0,0,1,0,1017,0,1.0,0.0,0
PF01210,PF07479:PF03023:PF02317:PF04862:PF10521,27,45,26,1,19,972,0.58,0.98,0.96,0.74,1,1,26,0,991,1.0,0.97,0.04,0.19
PF02791,PF15612:PF15613:PF10537:PF12157:PF17105,21,29,20,1,9,988,0.69,0.99,0.95,0.81,8,8,13,0,997,1.0,0.99,0.38,0.61
PF15496,PF17078:PF11652:PF15621:PF08848:PF09962,1,3,1,0,2,1015,0.33,1.0,1.0,0.58,0,0,1,0,1017,0,1.0,0.0,0
PF02624,PF06798:PF10856:PF07157:PF02951:PF15281,0,7,0,0,7,1011,0.0,0.99,0,0,0,0,0,0,1018,0,1.0,0,0
PF08280,PF08453:PF03241:PF00669:PF05167:PF04466,0,4,0,0,4,1014,0.0,1.0,0,0,0,0,0,0,1018,0,1.0,0,0
PF08623,PF04048:PF08638:PF14649:PF12231:PF14665,10,24,1,9,23,985,0.04,0.97,0.1,0.05,0,0,10,0,1008,0,0.99,0.0,0
PF08620,PF12765:PF10304:PF13888:PF10334:PF15961,4,26,0,4,26,988,0.0,0.97,0.0,-0.01,1,0,4,1,1013,0.0,1.0,0.0,-0.0
PF07763,PF06083:PF00811:PF15383:PF11303:PF09419,1,27,0,1,27,990,0.0,0.97,0.0,-0.01,1,0,1,1,1016,0.0,1.0,0.0,-0.0
PF03245,PF15380:PF10951:PF05513:PF05509:PF07805,0,2,0,0,2,1016,0.0,1.0,0,0,0,0,0,0,1018,0,1.0,0,0
PF14025,PF02217:PF16325:PF04740:PF11245:PF11019,0,4,0,0,4,1014,0.0,1.0,0,0,0,0,0,0,1018,0,1.0,0,0
PF12159,PF15055:PF16594:PF02202:PF09996:PF02527,0,9,0,0,9,1009,0.0,0.99,0,0,0,0,0,0,1018,0,1.0,0,0
PF15557,PF07001:PF10482:PF15624:PF14818:PF05397,0,25,0,0,25,993,0.0,0.98,0,0,0,0,0,0,1018,0,1.0,0,0
PF04479,PF12296:PF11807:PF06609:PF07519:PF14027,25,37,16,9,21,972,0.43,0.97,0.64,0.51,10,8,17,2,991,0.8,0.98,0.32,0.5
PF16326,PF01032:PF09383:PF12857:PF12399:PF09821,5,11,2,3,9,1004,0.18,0.99,0.4,0.26,2,2,3,0,1013,1.0,1.0,0.4,0.63
PF15359,PF05039:PF15370:PF02285:PF01097:PF06351,2,11,1,1,10,1006,0.09,0.99,0.5,0.21,0,0,2,0,1016,0,1.0,0.0,0
PF05069,PF10077:PF01292:PF07661:PF15380:PF01455,0,11,0,0,11,1007,0.0,0.99,0,0,0,0,0,0,1018,0,1.0,0,0
PF06792,PF02092:PF09370:PF14817:PF15620:PF17167,3,16,2,1,14,1001,0.12,0.99,0.67,0.28,0,0,3,0,1015,0,1.0,0.0,0
PF06314,PF07976:PF12831:PF13761:PF08491:PF07110,11,31,7,4,24,983,0.23,0.97,0.64,0.37,2,2,9,0,1007,1.0,0.99,0.18,0.42
PF06826,PF10554:PF13722:PF03090:PF15518:PF04865,1,1,0,1,1,1016,0.0,1.0,0.0,-0.0,0,0,1,0,1017,0,1.0,0.0,0
PF00542,PF16320:PF14768:PF17119:PF13867:PF14735,10,19,9,1,10,998,0.47,0.99,0.9,0.65,1,1,9,0,1008,1.0,0.99,0.1,0.31
PF13836,PF15678:PF09649:PF11261:PF14661:PF09429,0,16,0,0,16,1002,0.0,0.98,0,0,0,0,0,0,1018,0,1.0,0,0
PF05730,PF08613:PF03443:PF11768:PF01341:PF09184,16,58,9,7,49,953,0.16,0.94,0.56,0.28,3,2,14,1,1001,0.67,0.99,0.12,0.28
PF02311,PF06249:PF06339:PF02502:PF12852:PF06719,8,15,2,6,13,997,0.13,0.98,0.25,0.17,1,1,7,0,1010,1.0,0.99,0.12,0.35
PF03117,PF04347:PF15195:PF14347:PF02742:PF04687,0,5,0,0,5,1013,0.0,1.0,0,0,0,0,0,0,1018,0,1.0,0,0
PF03891,PF15052:PF04681:PF06756:PF15224:PF12098,0,7,0,0,7,1011,0.0,0.99,0,0,0,0,0,0,1018,0,1.0,0,0
PF04695,PF14922:PF10998:PF06428:PF10226:PF15558,12,14,3,9,11,995,0.21,0.98,0.25,0.22,0,0,12,0,1006,0,0.99,0.0,0
PF02117,PF01387:PF10319:PF10322:PF05075:PF02175,2,2,0,2,2,1014,0.0,1.0,0.0,-0.0,0,0,2,0,1016,0,1.0,0.0,0
PF01808,PF02729:PF00185:PF00988:PF02142:PF02786,13,67,9,4,58,947,0.13,0.94,0.69,0.29,15,2,11,13,992,0.13,0.98,0.15,0.13
PF00252,PF00329:PF16906:PF05047:PF09439:PF01058,25,38,13,12,25,968,0.34,0.96,0.52,0.4,8,6,19,2,991,0.75,0.98,0.24,0.42
PF15813,PF02200:PF09038:PF14977:PF08624:PF10307,4,11,1,3,10,1004,0.09,0.99,0.25,0.15,0,0,4,0,1014,0,1.0,0.0,0
PF11815,PF11856:PF09551:PF17106:PF17046:PF13545,9,9,2,7,7,1002,0.22,0.99,0.22,0.22,0,0,9,0,1009,0,0.99,0.0,0
PF14862,PF15754:PF15333:PF05418:PF05355:PF02025,0,6,0,0,6,1012,0.0,0.99,0,0,0,0,0,0,1018,0,1.0,0,0
PF10472,PF10488:PF14047:PF14049:PF03458:PF15374,0,2,0,0,2,1016,0.0,1.0,0,0,0,0,0,0,1018,0,1.0,0,0
PF14360,PF09246:PF07786:PF04516:PF16533:PF15982,10,15,4,6,11,997,0.27,0.98,0.4,0.32,1,1,9,0,1008,1.0,0.99,0.1,0.31
PF08956,PF10933:PF15337:PF09361:PF02601:PF16071,0,5,0,0,5,1013,0.0,1.0,0,0,0,0,0,0,1018,0,1.0,0,0
PF14698,PF08328:PF10415:PF10397:PF00206:PF04836,8,47,8,0,39,971,0.17,0.96,1.0,0.4,5,2,6,3,1007,0.4,0.99,0.25,0.31
PF10032,PF15378:PF12294:PF01303:PF07209:PF15160,4,1,1,3,0,1014,1.0,1.0,0.25,0.5,0,0,4,0,1014,0,1.0,0.0,0
PF05374,PF01392:PF02934:PF02309:PF00104:PF01344,1,125,0,1,125,892,0.0,0.88,0.0,-0.01,13,0,1,13,1004,0.0,0.99,0.0,-0.0
PF12576,PF06414:PF10156:PF15996:PF10179:PF11977,2,26,0,2,26,990,0.0,0.97,0.0,-0.01,2,0,2,2,1014,0.0,1.0,0.0,-0.0
PF02767,PF02768:PF00712:PF08805:PF02369:PF02305,7,8,7,0,1,1010,0.88,1.0,1.0,0.93,1,1,6,0,1011,1.0,0.99,0.14,0.38
PF14124,PF04848:PF15776:PF15141:PF08453:PF00669,0,8,0,0,8,1010,0.0,0.99,0,0,0,0,0,0,1018,0,1.0,0,0
PF14825,PF06541:PF15109:PF11032:PF04856:PF15055,8,3,0,8,3,1007,0.0,0.99,0.0,-0.0,0,0,8,0,1010,0,0.99,0.0,0
PF04752,PF05910:PF01327:PF02391:PF04720:PF05078,11,30,5,6,25,982,0.17,0.97,0.45,0.26,2,1,10,1,1006,0.5,0.99,0.09,0.21
PF03881,PF10282:PF11807:PF08881:PF00248:PF14388,13,89,11,2,78,927,0.12,0.92,0.85,0.31,9,5,8,4,1001,0.56,0.99,0.38,0.46
PF16981,PF16839:PF01723:PF05912:PF07464:PF03488,0,6,0,0,6,1012,0.0,0.99,0,0,0,0,0,0,1018,0,1.0,0,0
PF16646,PF08833:PF07001:PF06972:PF05228:PF12257,0,19,0,0,19,999,0.0,0.98,0,0,0,0,0,0,1018,0,1.0,0,0
PF05110,PF14763:PF14761:PF14762:PF14783:PF14781,5,8,1,4,7,1006,0.12,0.99,0.2,0.15,0,0,5,0,1013,0,1.0,0.0,0
PF00373,PF09379:PF03623:PF00784:PF04382:PF09380,53,56,48,5,8,957,0.86,0.99,0.91,0.87,13,12,41,1,964,0.92,0.96,0.23,0.45
PF00231,PF05497:PF02284:PF01775:PF04176:PF02104,17,27,7,10,20,981,0.26,0.97,0.41,0.31,3,2,15,1,1000,0.67,0.98,0.12,0.28
PF02270,PF17223:PF16972:PF11069:PF08910:PF09726,17,11,3,14,8,993,0.27,0.98,0.18,0.21,0,0,17,0,1001,0,0.98,0.0,0
PF01782,PF04871:PF03470:PF05239:PF16704:PF15908,3,23,3,0,20,995,0.13,0.98,1.0,0.36,1,1,2,0,1015,1.0,1.0,0.33,0.58
PF10867,PF05817:PF05049:PF01229:PF07759:PF03175,0,31,0,0,31,987,0.0,0.97,0,0,1,0,0,1,1017,0.0,1.0,0,0
PF00778,PF02377:PF08833:PF12316:PF09007:PF00631,6,29,5,1,24,988,0.17,0.98,0.83,0.37,1,1,5,0,1012,1.0,1.0,0.17,0.41
PF09904,PF07409:PF11751:PF07157:PF04671:PF08708,0,1,0,0,1,1017,0.0,1.0,0,0,0,0,0,0,1018,0,1.0,0,0
PF12417,PF02023:PF09514:PF01352:PF14291:PF09607,5,64,3,2,61,952,0.05,0.94,0.6,0.16,9,3,2,6,1007,0.33,0.99,0.6,0.44
PF15881,PF09494:PF10102:PF02676:PF09237:PF06588,2,23,1,1,22,994,0.04,0.98,0.5,0.14,2,1,1,1,1015,0.5,1.0,0.5,0.5
PF04155,PF15973:PF03103:PF10239:PF11587:PF01620,12,13,1,11,12,994,0.08,0.98,0.08,0.07,0,0,12,0,1006,0,0.99,0.0,0
PF07701,PF00211:PF08376:PF12849:PF07700:PF13458,19,65,19,0,46,953,0.29,0.95,1.0,0.53,6,6,13,0,999,1.0,0.99,0.32,0.56
PF00667,PF00258:PF00175:PF00067:PF02898:PF17147,36,196,36,0,160,822,0.18,0.84,1.0,0.39,31,27,9,4,978,0.87,0.99,0.75,0.8
PF00384,PF09326:PF10588:PF04879:PF01568:PF14710,23,24,21,2,3,992,0.88,1.0,0.91,0.89,2,2,21,0,995,1.0,0.98,0.09,0.29
PF12392,PF01514:PF01136:PF03406:PF09861:PF14328,1,1,1,0,0,1017,1.0,1.0,1.0,1.0,0,0,1,0,1017,0,1.0,0.0,0
PF11300,PF16872:PF00524:PF02108:PF05164:PF11291,1,4,1,0,3,1014,0.25,1.0,1.0,0.5,0,0,1,0,1017,0,1.0,0.0,0
PF00975,PF16197:PF08659:PF00668:PF00698:PF14765,21,60,20,1,40,957,0.33,0.96,0.95,0.55,38,18,3,20,977,0.47,0.98,0.86,0.63
PF12955,PF15798:PF08297:PF15089:PF13929:PF00700,4,2,0,4,2,1012,0.0,0.99,0.0,-0.0,0,0,4,0,1014,0,1.0,0.0,0
PF15343,PF15776:PF02950:PF15207:PF17062:PF15119,0,5,0,0,5,1013,0.0,1.0,0,0,0,0,0,0,1018,0,1.0,0,0
PF10475,PF10474:PF06148:PF07928:PF06662:PF15965,4,21,4,0,17,997,0.19,0.98,1.0,0.43,2,2,2,0,1014,1.0,1.0,0.5,0.71
PF02719,PF03831:PF05509:PF01913:PF15727:PF12477,4,2,0,4,2,1012,0.0,0.99,0.0,-0.0,0,0,4,0,1014,0,1.0,0.0,0
PF13629,PF16976:PF01943:PF06934:PF13007:PF07195,1,1,1,0,0,1017,1.0,1.0,1.0,1.0,0,0,1,0,1017,0,1.0,0.0,0
PF11878,PF14429:PF06920:PF16172:PF16523:PF16910,8,29,7,1,22,988,0.24,0.98,0.88,0.45,3,2,6,1,1009,0.67,0.99,0.25,0.41
PF00147,PF07546:PF05889:PF12160:PF08702:PF00386,51,29,19,32,10,957,0.66,0.96,0.37,0.47,1,1,50,0,967,1.0,0.95,0.02,0.14
PF02620,PF03703:PF12646:PF09991:PF05991:PF14279,8,4,1,7,3,1007,0.25,0.99,0.12,0.17,0,0,8,0,1010,0,0.99,0.0,0
PF15838,PF05151:PF03379:PF15754:PF15333:PF01303,0,1,0,0,1,1017,0.0,1.0,0,0,0,0,0,0,1018,0,1.0,0,0
PF02353,PF01593:PF02027:PF07103:PF04433:PF01042,13,82,9,4,73,932,0.11,0.92,0.69,0.26,7,6,7,1,1004,0.86,0.99,0.46,0.63
PF06277,PF11921:PF16094:PF12369:PF12044:PF01219,0,11,0,0,11,1007,0.0,0.99,0,0,1,0,0,1,1017,0.0,1.0,0,0
PF08368,PF06743:PF08373:PF15074:PF02233:PF12769,7,26,7,0,19,992,0.27,0.98,1.0,0.51,2,2,5,0,1011,1.0,1.0,0.29,0.53
PF06093,PF02284:PF04176:PF05995:PF01680:PF11779,2,28,2,0,26,990,0.07,0.97,1.0,0.26,3,1,1,2,1014,0.33,1.0,0.5,0.41
PF00862,PF13439:PF12038:PF15924:PF13579:PF04413,10,29,4,6,25,983,0.14,0.97,0.4,0.22,1,1,9,0,1008,1.0,0.99,0.1,0.31
PF13636,PF08298:PF05401:PF14258:PF01944:PF14294,1,3,0,1,3,1014,0.0,1.0,0.0,-0.0,0,0,1,0,1017,0,1.0,0.0,0
PF00593,PF00950:PF12837:PF07123:PF06808:PF13808,4,15,3,1,12,1002,0.2,0.99,0.75,0.38,2,2,2,0,1014,1.0,1.0,0.5,0.71
PF11636,PF00992:PF08999:PF00832:PF00836:PF15237,0,24,0,0,24,994,0.0,0.98,0,0,2,0,0,2,1016,0.0,1.0,0,0
PF03941,PF13836:PF14661:PF06972:PF13945:PF09649,11,6,0,11,6,1001,0.0,0.98,0.0,-0.01,0,0,11,0,1007,0,0.99,0.0,0
PF05935,PF11316:PF08453:PF17164:PF04562:PF08707,2,3,0,2,3,1013,0.0,1.0,0.0,-0.0,0,0,2,0,1016,0,1.0,0.0,0
PF15899,PF15021:PF15851:PF10279:PF16586:PF06744,2,0,0,2,0,1016,0,1.0,0.0,0,0,0,2,0,1016,0,1.0,0.0,0
PF07310,PF01913:PF07805:PF01752:PF05939:PF12080,1,4,0,1,4,1013,0.0,1.0,0.0,-0.0,0,0,1,0,1017,0,1.0,0.0,0
PF00395,PF15066:PF03008:PF03800:PF09190:PF04437,11,19,3,8,16,991,0.16,0.98,0.27,0.2,1,1,10,0,1007,1.0,0.99,0.09,0.3
PF06711,PF05336:PF02452:PF10106:PF06718:PF05756,0,5,0,0,5,1013,0.0,1.0,0,0,0,0,0,0,1018,0,1.0,0,0
PF10226,PF10998:PF11831:PF14922:PF04880:PF12180,3,19,2,1,17,998,0.11,0.98,0.67,0.26,1,0,3,1,1014,0.0,1.0,0.0,-0.0
PF14702,PF06202:PF14701:PF14699:PF05285:PF12530,2,18,2,0,16,1000,0.11,0.98,1.0,0.33,1,0,2,1,1015,0.0,1.0,0.0,-0.0
PF10392,PF08640:PF08216:PF17034:PF08161:PF13251,7,20,3,4,17,994,0.15,0.98,0.43,0.25,3,3,4,0,1011,1.0,1.0,0.43,0.65
PF10570,PF09291:PF02124:PF02439:PF12104:PF02480,1,4,0,1,4,1013,0.0,1.0,0.0,-0.0,0,0,1,0,1017,0,1.0,0.0,0
PF09765,PF11793:PF00874:PF08564:PF01381:PF03234,6,23,6,0,17,995,0.26,0.98,1.0,0.51,4,1,5,3,1009,0.25,0.99,0.17,0.2
PF09103,PF09169:PF09121:PF09104:PF00634:PF15927,6,12,5,1,7,1005,0.42,0.99,0.83,0.59,1,1,5,0,1012,1.0,1.0,0.17,0.41
PF01109,PF03745:PF03238:PF15856:PF10974:PF15340,2,3,0,2,3,1013,0.0,1.0,0.0,-0.0,0,0,2,0,1016,0,1.0,0.0,0
PF03385,PF02219:PF02408:PF10155:PF10022:PF14764,1,23,0,1,23,994,0.0,0.98,0.0,-0.0,0,0,1,0,1017,0,1.0,0.0,0
PF03171,PF14226:PF01066:PF13344:PF06414:PF08652,49,80,42,7,38,931,0.53,0.96,0.86,0.65,6,6,43,0,969,1.0,0.96,0.12,0.34
PF16098,PF16097:PF12235:PF16096:PF05266:PF03726,4,14,4,0,10,1004,0.29,0.99,1.0,0.53,1,1,3,0,1014,1.0,1.0,0.25,0.5
PF15280,PF08624:PF09736:PF15862:PF14977:PF10336,2,16,1,1,15,1001,0.06,0.98,0.5,0.17,1,0,2,1,1015,0.0,1.0,0.0,-0.0
PF03822,PF12605:PF08332:PF16579:PF00139:PF14593,4,33,3,1,30,984,0.09,0.97,0.75,0.25,4,2,2,2,1012,0.5,1.0,0.5,0.5
PF12390,PF14376:PF03548:PF16861:PF12080:PF03428,0,8,0,0,8,1010,0.0,0.99,0,0,0,0,0,0,1018,0,1.0,0,0
PF08184,PF10692:PF09922:PF06936:PF11277:PF12661,1,47,0,1,47,970,0.0,0.95,0.0,-0.01,0,0,1,0,1017,0,1.0,0.0,0
PF13657,PF02399:PF10554:PF14323:PF04917:PF09327,4,2,1,3,1,1013,0.5,1.0,0.25,0.35,0,0,4,0,1014,0,1.0,0.0,0
PF10450,PF17206:PF17193:PF10106:PF09498:PF06651,0,2,0,0,2,1016,0.0,1.0,0,0,0,0,0,0,1018,0,1.0,0,0
PF01343,PF08496:PF05003:PF10108:PF13824:PF08512,15,23,7,8,16,987,0.3,0.98,0.47,0.37,0,0,15,0,1003,0,0.99,0.0,0
PF16761,PF06165:PF10395:PF12231:PF10441:PF12432,6,13,4,2,9,1003,0.31,0.99,0.67,0.45,1,1,5,0,1012,1.0,1.0,0.17,0.41
PF15822,PF05299:PF02072:PF00555:PF07409:PF00841,1,3,0,1,3,1014,0.0,1.0,0.0,-0.0,0,0,1,0,1017,0,1.0,0.0,0
PF10215,PF11093:PF15831:PF02202:PF10310:PF13933,5,2,0,5,2,1011,0.0,0.99,0.0,-0.0,0,0,5,0,1013,0,1.0,0.0,0
PF04972,PF13580:PF11739:PF00908:PF02397:PF05506,5,10,2,3,8,1005,0.2,0.99,0.4,0.28,0,0,5,0,1013,0,1.0,0.0,0
PF14382,PF14875:PF10447:PF08327:PF09349:PF15985,11,37,11,0,26,981,0.3,0.97,1.0,0.54,2,2,9,0,1007,1.0,0.99,0.18,0.42
PF03556,PF01160:PF04819:PF01245:PF11735:PF05678,16,27,8,8,19,983,0.3,0.97,0.5,0.37,2,2,14,0,1002,1.0,0.99,0.12,0.35
PF14457,PF01323:PF03860:PF14634:PF00144:PF02487,0,87,0,0,87,931,0.0,0.91,0,0,6,0,0,6,1012,0.0,0.99,0,0
PF10253,PF11510:PF14958:PF13559:PF14475:PF13230,5,10,2,3,8,1005,0.2,0.99,0.4,0.28,0,0,5,0,1013,0,1.0,0.0,0
PF09533,PF15212:PF05234:PF15119:PF05962:PF02025,0,5,0,0,5,1013,0.0,1.0,0,0,0,0,0,0,1018,0,1.0,0,0
PF11743,PF13811:PF14078:PF05616:PF14065:PF00878,0,4,0,0,4,1014,0.0,1.0,0,0,0,0,0,0,1018,0,1.0,0,0
PF08609,PF10179:PF05334:PF04087:PF06414:PF04981,5,17,2,3,15,998,0.12,0.98,0.4,0.21,0,0,5,0,1013,0,1.0,0.0,0
PF10683,PF14372:PF04937:PF02892:PF15992:PF14291,2,57,2,0,55,961,0.04,0.95,1.0,0.18,12,2,0,10,1006,0.17,0.99,1.0,0.41
PF09577,PF10399:PF13009:PF04308:PF01628:PF15252,0,5,0,0,5,1013,0.0,1.0,0,0,0,0,0,0,1018,0,1.0,0,0
PF10096,PF08545:PF00970:PF13405:PF00903:PF00153,0,156,0,0,156,862,0.0,0.85,0,0,24,0,0,24,994,0.0,0.98,0,0
PF07396,PF01484:PF03209:PF04784:PF07690:PF00790,0,255,0,0,255,763,0.0,0.75,0,0,11,0,0,11,1007,0.0,0.99,0,0
PF14609,PF11130:PF07405:PF09374:PF13644:PF06074,1,1,0,1,1,1016,0.0,1.0,0.0,-0.0,0,0,1,0,1017,0,1.0,0.0,0
PF05552,PF04586:PF04671:PF11775:PF04717:PF09611,0,2,0,0,2,1016,0.0,1.0,0,0,0,0,0,0,1018,0,1.0,0,0
PF12261,PF00582:PF14076:PF02181:PF05761:PF03690,0,64,0,0,64,954,0.0,0.94,0,0,6,0,0,6,1012,0.0,0.99,0,0
PF04852,PF03760:PF02044:PF16594:PF12926:PF15003,5,3,2,3,1,1012,0.67,1.0,0.4,0.51,0,0,5,0,1013,0,1.0,0.0,0
PF00067,PF00667:PF00258:PF13813:PF03795:PF03098,177,67,52,125,15,826,0.78,0.86,0.29,0.42,15,15,162,0,841,1.0,0.84,0.08,0.27
PF16211,PF00125:PF01170:PF01661:PF02926:PF00166,24,76,21,3,55,939,0.28,0.94,0.88,0.47,13,8,16,5,989,0.62,0.98,0.33,0.44
PF02295,PF16797:PF12474:PF08587:PF12851:PF13240,11,24,3,8,21,986,0.12,0.97,0.27,0.17,2,2,9,0,1007,1.0,0.99,0.18,0.42
PF08647,PF10375:PF15453:PF08505:PF15821:PF11831,9,13,1,8,12,997,0.08,0.98,0.11,0.08,0,0,9,0,1009,0,0.99,0.0,0
PF17219,PF08604:PF16764:PF00641:PF06831:PF07223,1,56,1,0,55,962,0.02,0.95,1.0,0.13,4,1,0,3,1014,0.25,1.0,1.0,0.5
PF14085,PF16953:PF02297:PF12832:PF13445:PF17177,0,98,0,0,98,920,0.0,0.9,0,0,10,0,0,10,1008,0.0,0.99,0,0
PF12388,PF15207:PF02413:PF14290:PF14467:PF11751,0,1,0,0,1,1017,0.0,1.0,0,0,0,0,0,0,1018,0,1.0,0,0
PF15906,PF11571:PF04641:PF10496:PF06803:PF04437,9,37,6,3,31,978,0.16,0.97,0.67,0.32,5,2,7,3,1006,0.4,0.99,0.22,0.29
PF07406,PF15038:PF10248:PF12926:PF14822:PF09805,2,13,0,2,13,1003,0.0,0.99,0.0,-0.01,0,0,2,0,1016,0,1.0,0.0,0
PF09314,PF07310:PF05969:PF07022:PF10618:PF10707,0,2,0,0,2,1016,0.0,1.0,0,0,0,0,0,0,1018,0,1.0,0,0
PF15290,PF14722:PF10309:PF12516:PF15257:PF16043,1,19,1,0,18,999,0.05,0.98,1.0,0.23,0,0,1,0,1017,0,1.0,0.0,0
PF01437,PF01403:PF00059:PF08337:PF06588:PF17205,18,94,16,2,78,922,0.17,0.92,0.89,0.37,8,7,11,1,999,0.88,0.99,0.39,0.58
PF13972,PF09122:PF06617:PF11127:PF02556:PF12368,1,15,0,1,15,1002,0.0,0.98,0.0,-0.0,0,0,1,0,1017,0,1.0,0.0,0
PF11735,PF09687:PF13092:PF08598:PF13225:PF08559,9,16,2,7,14,995,0.12,0.98,0.22,0.16,0,0,9,0,1009,0,0.99,0.0,0
PF03025,PF14121:PF10335:PF06252:PF09704:PF05940,0,2,0,0,2,1016,0.0,1.0,0,0,0,0,0,0,1018,0,1.0,0,0
PF00201,PF00328:PF03033:PF04859:PF03478:PF06237,66,79,37,29,42,910,0.47,0.93,0.56,0.48,8,8,58,0,952,1.0,0.94,0.12,0.34
PF15922,PF13597:PF12345:PF06968:PF10105:PF06969,2,10,2,0,8,1008,0.2,0.99,1.0,0.45,2,2,0,0,1016,1.0,1.0,1.0,1.0
PF08714,PF02277:PF02742:PF00419:PF15271:PF11124,2,7,0,2,7,1009,0.0,0.99,0.0,-0.0,0,0,2,0,1016,0,1.0,0.0,0
PF07145,PF06741:PF14438:PF07742:PF14327:PF05383,16,47,11,5,36,966,0.23,0.96,0.69,0.39,6,4,12,2,1000,0.67,0.99,0.25,0.4
PF13954,PF00345:PF13953:PF02056:PF02753:PF08461,3,12,3,0,9,1006,0.25,0.99,1.0,0.5,3,3,0,0,1015,1.0,1.0,1.0,1.0
PF08824,PF12026:PF08397:PF07815:PF04088:PF03983,1,21,1,0,20,997,0.05,0.98,1.0,0.22,2,1,0,1,1016,0.5,1.0,1.0,0.71
PF08313,PF03110:PF08729:PF15996:PF00649:PF09429,13,26,7,6,19,986,0.27,0.98,0.54,0.37,3,2,11,1,1004,0.67,0.99,0.15,0.32
PF08534,PF04667:PF12734:PF02284:PF06127:PF04520,25,16,5,20,11,982,0.31,0.97,0.2,0.24,0,0,25,0,993,0,0.98,0.0,0
PF16061,PF04437:PF08318:PF12309:PF05450:PF16013,3,37,2,1,35,980,0.05,0.96,0.67,0.18,3,0,3,3,1012,0.0,0.99,0.0,-0.0
PF04023,PF10547:PF00018:PF09932:PF04088:PF04461,1,99,0,1,99,918,0.0,0.9,0.0,-0.01,0,0,1,0,1017,0,1.0,0.0,0
PF13879,PF04641:PF08231:PF00160:PF15742:PF12185,10,89,7,3,82,926,0.08,0.92,0.7,0.22,3,3,7,0,1008,1.0,0.99,0.3,0.55
PF08003,PF07210:PF01451:PF09351:PF03886:PF05422,0,23,0,0,23,995,0.0,0.98,0,0,0,0,0,0,1018,0,1.0,0,0
PF07350,PF02284:PF11779:PF12296:PF10224:PF04667,2,24,1,1,23,993,0.04,0.98,0.5,0.14,0,0,2,0,1016,0,1.0,0.0,0
PF15623,PF06890:PF06798:PF06403:PF15843:PF03963,0,2,0,0,2,1016,0.0,1.0,0,0,0,0,0,0,1018,0,1.0,0,0
PF10692,PF00560:PF13855:PF12799:PF00728:PF02758,0,162,0,0,162,856,0.0,0.84,0,0,32,0,0,32,986,0.0,0.97,0,0
PF15383,PF00127:PF15503:PF11016:PF07809:PF15062,9,4,0,9,4,1005,0.0,0.99,0.0,-0.01,0,0,9,0,1009,0,0.99,0.0,0
PF09668,PF09280:PF12057:PF08325:PF16843:PF12148,19,18,7,12,11,988,0.39,0.98,0.37,0.37,1,1,18,0,999,1.0,0.98,0.05,0.23
PF03676,PF02312:PF14831:PF03069:PF16550:PF04574,11,22,5,6,17,990,0.23,0.98,0.45,0.31,0,0,11,0,1007,0,0.99,0.0,0
PF08755,PF13369:PF09346:PF04379:PF13371:PF11566,11,21,10,1,11,996,0.48,0.99,0.91,0.65,1,1,10,0,1007,1.0,0.99,0.09,0.3
PF03773,PF06756:PF03616:PF17193:PF06890:PF09510,0,1,0,0,1,1017,0.0,1.0,0,0,0,0,0,0,1018,0,1.0,0,0
PF15491,PF15082:PF15235:PF07610:PF15392:PF08579,0,5,0,0,5,1013,0.0,1.0,0,0,0,0,0,0,1018,0,1.0,0,0
PF06920,PF14429:PF11878:PF16172:PF12768:PF14498,13,21,7,6,14,991,0.33,0.98,0.54,0.41,2,2,11,0,1005,1.0,0.99,0.15,0.39
PF15749,PF01666:PF13810:PF08208:PF03749:PF07444,4,8,0,4,8,1006,0.0,0.99,0.0,-0.01,0,0,4,0,1014,0,1.0,0.0,0
PF15459,PF16874:PF16875:PF06165:PF02065:PF17167,3,8,0,3,8,1007,0.0,0.99,0.0,-0.0,1,0,3,1,1014,0.0,1.0,0.0,-0.0
PF04219,PF15835:PF15859:PF07413:PF07445:PF08266,0,5,0,0,5,1013,0.0,1.0,0,0,0,0,0,0,1018,0,1.0,0,0
PF07805,PF08497:PF01706:PF03050:PF14841:PF04552,1,2,0,1,2,1015,0.0,1.0,0.0,-0.0,0,0,1,0,1017,0,1.0,0.0,0
PF05916,PF00484:PF06376:PF01016:PF10224:PF06749,21,33,10,11,23,974,0.3,0.97,0.48,0.36,4,4,17,0,997,1.0,0.98,0.19,0.43
PF12539,PF06887:PF01580:PF17206:PF15515:PF10411,8,5,1,7,4,1006,0.2,0.99,0.12,0.15,0,0,8,0,1010,0,0.99,0.0,0
PF11176,PF08649:PF13564:PF04419:PF06645:PF02044,7,21,3,4,18,993,0.14,0.98,0.43,0.24,3,2,5,1,1010,0.67,0.99,0.29,0.43
PF05497,PF14935:PF15008:PF00965:PF06658:PF10853,5,13,0,5,13,1000,0.0,0.98,0.0,-0.01,0,0,5,0,1013,0,1.0,0.0,0
PF13769,PF11617:PF03764:PF13475:PF01588:PF07712,0,43,0,0,43,975,0.0,0.96,0,0,5,0,0,5,1013,0.0,1.0,0,0
PF07335,PF06912:PF07544:PF10681:PF15071:PF06351,1,13,1,0,12,1005,0.08,0.99,1.0,0.28,0,0,1,0,1017,0,1.0,0.0,0
PF04244,PF14814:PF07494:PF13721:PF04932:PF13700,0,5,0,0,5,1013,0.0,1.0,0,0,0,0,0,0,1018,0,1.0,0,0
PF15447,PF03011:PF15445:PF12377:PF07133:PF15448,1,1,1,0,0,1017,1.0,1.0,1.0,1.0,1,1,0,0,1017,1.0,1.0,1.0,1.0
PF05894,PF08291:PF10618:PF05100:PF15082:PF07610,0,4,0,0,4,1014,0.0,1.0,0,0,0,0,0,0,1018,0,1.0,0,0
PF08561,PF04716:PF01632:PF03980:PF15860:PF05915,5,26,2,3,24,989,0.08,0.97,0.4,0.17,1,1,4,0,1013,1.0,1.0,0.2,0.45
PF17207,PF00493:PF14551:PF04117:PF12619:PF11968,48,74,47,1,27,943,0.64,0.97,0.98,0.78,26,26,22,0,970,1.0,0.98,0.54,0.73
PF15167,PF04363:PF03869:PF07321:PF09611:PF14871,2,4,2,0,2,1014,0.5,1.0,1.0,0.71,0,0,2,0,1016,0,1.0,0.0,0
PF08648,PF01715:PF15990:PF08617:PF12171:PF12414,8,54,4,4,50,960,0.07,0.95,0.5,0.18,4,2,6,2,1008,0.5,0.99,0.25,0.35
PF01810,PF06756:PF07964:PF10951:PF08848:PF03238,8,1,0,8,1,1009,0.0,0.99,0.0,-0.0,0,0,8,0,1010,0,0.99,0.0,0
PF15726,PF15851:PF06251:PF14690:PF04954:PF02211,0,3,0,0,3,1015,0.0,1.0,0,0,0,0,0,0,1018,0,1.0,0,0
PF14845,PF02838:PF00728:PF03174:PF03173:PF14498,20,38,20,0,18,980,0.53,0.98,1.0,0.72,5,3,17,2,996,0.6,0.98,0.15,0.29
PF11731,PF16064:PF01510:PF14360:PF01827:PF09724,0,36,0,0,36,982,0.0,0.96,0,0,4,0,0,4,1014,0.0,1.0,0,0
PF05558,PF15125:PF02202:PF15046:PF15055:PF15839,1,7,0,1,7,1010,0.0,0.99,0.0,-0.0,0,0,1,0,1017,0,1.0,0.0,0
PF16872,PF02108:PF05164:PF13005:PF05065:PF11300,0,2,0,0,2,1016,0.0,1.0,0,0,0,0,0,0,1018,0,1.0,0,0
PF14912,PF06401:PF14910:PF02165:PF14951:PF15710,4,7,0,4,7,1007,0.0,0.99,0.0,-0.01,0,0,4,0,1014,0,1.0,0.0,0
PF02530,PF17206:PF10106:PF06725:PF08497:PF12477,1,3,0,1,3,1014,0.0,1.0,0.0,-0.0,0,0,1,0,1017,0,1.0,0.0,0
PF01197,PF15724:PF05825:PF06377:PF05912:PF11947,4,9,1,3,8,1006,0.11,0.99,0.25,0.16,0,0,4,0,1014,0,1.0,0.0,0
PF00665,PF05585:PF05380:PF03732:PF14529:PF12009,113,106,63,50,43,862,0.59,0.91,0.56,0.52,15,15,98,0,905,1.0,0.9,0.13,0.35
PF01520,PF03244:PF08334:PF08411:PF06890:PF08299,3,4,0,3,4,1011,0.0,0.99,0.0,-0.0,0,0,3,0,1015,0,1.0,0.0,0
PF00947,PF08727:PF01706:PF01552:PF17060:PF11863,12,14,12,0,2,1004,0.86,1.0,1.0,0.92,0,0,12,0,1006,0,0.99,0.0,0
PF01745,PF16958:PF01715:PF14849:PF04279:PF12916,2,19,2,0,17,999,0.11,0.98,1.0,0.32,0,0,2,0,1016,0,1.0,0.0,0
PF03918,PF15104:PF14985:PF17124:PF07327:PF11493,1,3,0,1,3,1014,0.0,1.0,0.0,-0.0,0,0,1,0,1017,0,1.0,0.0,0
PF00205,PF02775:PF02776:PF11903:PF00676:PF07247,26,63,26,0,37,955,0.41,0.96,1.0,0.63,10,10,16,0,992,1.0,0.98,0.38,0.62
PF04901,PF12020:PF02372:PF05039:PF15370:PF14935,2,6,0,2,6,1010,0.0,0.99,0.0,-0.0,0,0,2,0,1016,0,1.0,0.0,0
PF03772,PF13567:PF04247:PF09648:PF09397:PF11880,4,10,4,0,6,1008,0.4,0.99,1.0,0.63,0,0,4,0,1014,0,1.0,0.0,0
PF10681,PF07544:PF07335:PF06377:PF15071:PF14273,2,15,0,2,15,1001,0.0,0.98,0.0,-0.01,1,0,2,1,1015,0.0,1.0,0.0,-0.0
PF04675,PF01068:PF04679:PF10345:PF14743:PF03164,18,29,18,0,11,989,0.62,0.99,1.0,0.78,8,7,11,1,999,0.88,0.99,0.39,0.58
PF08287,PF05419:PF08656:PF15109:PF15055:PF15715,3,2,0,3,2,1013,0.0,1.0,0.0,-0.0,0,0,3,0,1015,0,1.0,0.0,0
PF09078,PF08437:PF04225:PF14685:PF13426:PF08448,1,42,1,0,41,976,0.02,0.96,1.0,0.15,1,0,1,1,1016,0.0,1.0,0.0,-0.0
PF09779,PF06972:PF12129:PF07001:PF10264:PF14545,2,16,1,1,15,1001,0.06,0.98,0.5,0.17,1,1,1,0,1016,1.0,1.0,0.5,0.71
PF08312,PF06046:PF01805:PF12230:PF04098:PF04818,15,62,10,5,52,951,0.16,0.94,0.67,0.31,7,4,11,3,1000,0.57,0.99,0.27,0.38
PF02789,PF00883:PF06974:PF10396:PF04431:PF14687,18,47,18,0,29,971,0.38,0.97,1.0,0.61,2,1,17,1,999,0.5,0.98,0.06,0.16
PF03017,PF03004:PF12180:PF13870:PF15934:PF03384,3,25,2,1,23,992,0.08,0.98,0.67,0.23,0,0,3,0,1015,0,1.0,0.0,0
PF10544,PF04383:PF04665:PF03288:PF09687:PF17043,12,7,4,8,3,1003,0.57,0.99,0.33,0.43,0,0,12,0,1006,0,0.99,0.0,0
PF08376,PF04940:PF16214:PF07700:PF06327:PF07701,4,28,4,0,24,990,0.14,0.98,1.0,0.37,3,3,1,0,1014,1.0,1.0,0.75,0.87
PF14635,PF14639:PF14641:PF14632:PF14878:PF14633,13,14,13,0,1,1004,0.93,1.0,1.0,0.96,13,13,0,0,1005,1.0,1.0,1.0,1.0
PF10581,PF02078:PF02750:PF15805:PF15661:PF15397,0,11,0,0,11,1007,0.0,0.99,0,0,0,0,0,0,1018,0,1.0,0,0
PF06187,PF08846:PF01627:PF05721:PF00227:PF14027,0,111,0,0,111,907,0.0,0.89,0,0,11,0,0,11,1007,0.0,0.99,0,0
PF14743,PF04679:PF01068:PF11411:PF04675:PF14311,3,19,3,0,16,999,0.16,0.98,1.0,0.39,18,2,1,16,999,0.11,0.98,0.67,0.27
PF07265,PF12044:PF07735:PF00984:PF03721:PF03720,0,21,0,0,21,997,0.0,0.98,0,0,6,0,0,6,1012,0.0,0.99,0,0
PF11953,PF12837:PF12800:PF00950:PF12798:PF03412,0,5,0,0,5,1013,0.0,1.0,0,0,2,0,0,2,1016,0.0,1.0,0,0
PF15452,PF15912:PF15326:PF15914:PF07001:PF15624,5,14,1,4,13,1000,0.07,0.98,0.2,0.11,0,0,5,0,1013,0,1.0,0.0,0
PF14639,PF14635:PF14641:PF14632:PF14878:PF09371,13,15,13,0,2,1003,0.87,1.0,1.0,0.93,13,13,0,0,1005,1.0,1.0,1.0,1.0
PF16845,PF00031:PF00061:PF15243:PF00014:PF04107,4,64,3,1,61,953,0.05,0.94,0.75,0.18,4,2,2,2,1012,0.5,1.0,0.5,0.5
PF14680,PF14676:PF14679:PF14675:PF14677:PF14674,1,1,1,0,0,1017,1.0,1.0,1.0,1.0,1,1,0,0,1017,1.0,1.0,1.0,1.0
PF04676,PF04677:PF10443:PF02607:PF01288:PF00809,23,39,23,0,16,979,0.59,0.98,1.0,0.76,5,5,18,0,995,1.0,0.98,0.22,0.46
PF17126,PF13636:PF04523:PF06744:PF04671:PF08298,3,2,1,2,1,1014,0.5,1.0,0.33,0.41,0,0,3,0,1015,0,1.0,0.0,0
PF13929,PF13722:PF05947:PF02572:PF08744:PF08453,0,4,0,0,4,1014,0.0,1.0,0,0,0,0,0,0,1018,0,1.0,0,0
PF06464,PF12047:PF13570:PF01011:PF14535:PF16177,11,30,9,2,21,986,0.3,0.98,0.82,0.49,4,2,9,2,1005,0.5,0.99,0.18,0.3
PF01321,PF16188:PF05195:PF15801:PF14826:PF04799,12,29,5,7,24,982,0.17,0.97,0.42,0.25,4,2,10,2,1004,0.5,0.99,0.17,0.28
PF12205,PF08518:PF16559:PF14806:PF09066:PF02296,3,23,3,0,20,995,0.13,0.98,1.0,0.36,2,2,1,0,1015,1.0,1.0,0.67,0.82
PF01112,PF00755:PF03619:PF08615:PF01230:PF03211,23,71,14,9,57,938,0.2,0.94,0.61,0.32,11,5,18,6,989,0.45,0.98,0.22,0.3
PF00821,PF08925:PF16062:PF03932:PF05823:PF02118,3,32,1,2,31,984,0.03,0.97,0.33,0.09,1,0,3,1,1014,0.0,1.0,0.0,-0.0
PF12465,PF10584:PF00227:PF14953:PF05233:PF06955,3,90,3,0,87,928,0.03,0.91,1.0,0.17,5,1,2,4,1011,0.2,0.99,0.33,0.26
PF09664,PF09983:PF03533:PF16216:PF00308:PF07804,3,8,3,0,5,1010,0.38,1.0,1.0,0.61,1,1,2,0,1015,1.0,1.0,0.33,0.58
PF12399,PF13732:PF08402:PF08352:PF16326:PF01032,9,16,5,4,11,998,0.31,0.99,0.56,0.41,2,2,7,0,1009,1.0,0.99,0.22,0.47
PF12128,PF01630:PF02485:PF08441:PF09380:PF00021,0,57,0,0,57,961,0.0,0.94,0,0,6,0,0,6,1012,0.0,0.99,0,0
PF12714,PF08742:PF00094:PF01826:PF09206:PF09175,13,51,13,0,38,967,0.25,0.96,1.0,0.5,27,13,0,14,991,0.48,0.99,1.0,0.69
PF01960,PF01680:PF06172:PF01774:PF05995:PF09592,11,22,3,8,19,988,0.14,0.97,0.27,0.18,1,1,10,0,1007,1.0,0.99,0.09,0.3
PF03861,PF08093:PF15001:PF04370:PF08848:PF15482,1,2,0,1,2,1015,0.0,1.0,0.0,-0.0,0,0,1,0,1017,0,1.0,0.0,0
PF03552,PF14569:PF13632:PF04043:PF06974:PF04030,13,51,10,3,41,964,0.2,0.96,0.77,0.37,2,1,12,1,1004,0.5,0.99,0.08,0.19
PF01075,PF10446:PF10924:PF03832:PF13929:PF15471,3,5,0,3,5,1010,0.0,0.99,0.0,-0.0,0,0,3,0,1015,0,1.0,0.0,0
PF15872,PF15703:PF15060:PF15231:PF10856:PF17085,0,0,0,0,0,1018,0,1.0,0,0,0,0,0,0,1018,0,1.0,0,0
PF00948,PF01206:PF13769:PF05929:PF04381:PF01210,4,28,1,3,27,987,0.04,0.97,0.25,0.09,0,0,4,0,1014,0,1.0,0.0,0
PF10409,PF14671:PF09192:PF13543:PF00786:PF00581,26,75,13,13,62,930,0.17,0.93,0.5,0.26,4,4,22,0,992,1.0,0.98,0.15,0.39
PF05653,PF03619:PF14719:PF02301:PF07093:PF08613,21,53,9,12,44,953,0.17,0.94,0.43,0.25,2,2,19,0,997,1.0,0.98,0.1,0.31
PF12329,PF10377:PF07765:PF11500:PF14662:PF12297,11,12,2,9,10,997,0.17,0.98,0.18,0.16,1,0,11,1,1006,0.0,0.99,0.0,-0.0
PF12790,PF05836:PF10906:PF15340:PF15343:PF15760,0,4,0,0,4,1014,0.0,1.0,0,0,0,0,0,0,1018,0,1.0,0,0
PF04783,PF14818:PF06972:PF12129:PF09405:PF07001,7,23,5,2,18,993,0.22,0.98,0.71,0.39,0,0,7,0,1011,0,0.99,0.0,0
PF05421,PF14289:PF10417:PF15490:PF15001:PF12916,2,34,2,0,32,984,0.06,0.97,1.0,0.24,0,0,2,0,1016,0,1.0,0.0,0
PF00445,PF04603:PF02284:PF01775:PF08534:PF06749,20,36,9,11,27,971,0.25,0.96,0.45,0.32,4,3,17,1,997,0.75,0.98,0.15,0.33
PF08659,PF14765:PF08242:PF00109:PF00550:PF02801,41,93,40,1,53,924,0.43,0.95,0.98,0.63,49,39,2,10,967,0.8,0.99,0.95,0.86
PF06459,PF08454:PF01365:PF02026:PF11933:PF03521,8,20,8,0,12,998,0.4,0.99,1.0,0.63,5,5,3,0,1010,1.0,1.0,0.62,0.79
PF09299,PF14659:PF16850:PF04085:PF02625:PF07411,0,3,0,0,3,1015,0.0,1.0,0,0,0,0,0,0,1018,0,1.0,0,0
PF00544,PF12146:PF03634:PF02517:PF10142:PF13508,25,67,16,9,51,942,0.24,0.94,0.64,0.37,1,1,24,0,993,1.0,0.98,0.04,0.2
PF11871,PF17058:PF16980:PF07645:PF05917:PF05645,0,63,0,0,63,955,0.0,0.94,0,0,0,0,0,0,1018,0,1.0,0,0
PF06513,PF03344:PF09038:PF15030:PF03389:PF09444,0,3,0,0,3,1015,0.0,1.0,0,0,0,0,0,0,1018,0,1.0,0,0
PF08846,PF08850:PF04883:PF06187:PF05637:PF01518,0,21,0,0,21,997,0.0,0.98,0,0,0,0,0,0,1018,0,1.0,0,0
PF04778,PF15856:PF15141:PF15482:PF07505:PF06505,0,1,0,0,1,1017,0.0,1.0,0,0,0,0,0,0,1018,0,1.0,0,0
PF15957,PF09085:PF03856:PF14279:PF00468:PF15810,1,12,1,0,11,1006,0.08,0.99,1.0,0.29,0,0,1,0,1017,0,1.0,0.0,0
PF07672,PF04212:PF15040:PF08571:PF05953:PF05659,0,45,0,0,45,973,0.0,0.96,0,0,1,0,0,1,1017,0.0,1.0,0,0
PF10237,PF06839:PF07962:PF01131:PF01396:PF14111,14,83,11,3,72,932,0.13,0.93,0.79,0.3,7,6,8,1,1003,0.86,0.99,0.43,0.6
PF12158,PF01316:PF15107:PF03379:PF15085:PF15380,0,5,0,0,5,1013,0.0,1.0,0,0,0,0,0,0,1018,0,1.0,0,0
PF09192,PF14671:PF07655:PF00649:PF07001:PF02040,3,20,1,2,19,996,0.05,0.98,0.33,0.12,1,0,3,1,1014,0.0,1.0,0.0,-0.0
PF04131,PF04552:PF14196:PF13421:PF15976:PF06832,1,2,0,1,2,1015,0.0,1.0,0.0,-0.0,0,0,1,0,1017,0,1.0,0.0,0
PF04279,PF13145:PF13568:PF07195:PF04350:PF12241,1,8,1,0,7,1010,0.12,0.99,1.0,0.35,0,0,1,0,1017,0,1.0,0.0,0
PF11912,PF15333:PF03203:PF15771:PF10664:PF15125,0,4,0,0,4,1014,0.0,1.0,0,0,0,0,0,0,1018,0,1.0,0,0
PF03718,PF07080:PF08189:PF15725:PF14534:PF07075,1,5,0,1,5,1012,0.0,0.99,0.0,-0.0,0,0,1,0,1017,0,1.0,0.0,0
PF07313,PF16731:PF10737:PF14985:PF15107:PF09498,0,2,0,0,2,1016,0.0,1.0,0,0,0,0,0,0,1018,0,1.0,0,0
PF14239,PF03742:PF03260:PF06672:PF02973:PF14512,0,2,0,0,2,1016,0.0,1.0,0,0,0,0,0,0,1018,0,1.0,0,0
PF10124,PF03264:PF09722:PF08093:PF07799:PF06431,0,4,0,0,4,1014,0.0,1.0,0,0,0,0,0,0,1018,0,1.0,0,0
PF07744,PF07533:PF03159:PF02337:PF07500:PF08243,15,48,10,5,38,965,0.21,0.96,0.67,0.36,7,3,12,4,999,0.43,0.98,0.2,0.29
PF07912,PF07749:PF07449:PF15928:PF04721:PF06936,3,14,2,1,12,1003,0.14,0.99,0.67,0.3,1,0,3,1,1014,0.0,1.0,0.0,-0.0
PF02423,PF03619:PF02015:PF08613:PF09184:PF05730,5,63,3,2,60,953,0.05,0.94,0.6,0.16,5,2,3,3,1010,0.4,0.99,0.4,0.4
PF06617,PF09122:PF11127:PF12368:PF13972:PF00581,2,57,2,0,55,961,0.04,0.95,1.0,0.18,0,0,2,0,1016,0,1.0,0.0,0
PF03759,PF04729:PF03479:PF06136:PF01126:PF14159,7,25,4,3,21,990,0.16,0.98,0.57,0.29,2,1,6,1,1010,0.5,0.99,0.14,0.26
PF15376,PF12509:PF14444:PF15273:PF15230:PF12478,1,11,1,0,10,1007,0.09,0.99,1.0,0.3,1,0,1,1,1016,0.0,1.0,0.0,-0.0
PF06369,PF09056:PF07464:PF16851:PF06875:PF01741,1,6,0,1,6,1011,0.0,0.99,0.0,-0.0,0,0,1,0,1017,0,1.0,0.0,0
PF00101,PF12338:PF00283:PF14853:PF01642:PF06298,5,13,4,1,9,1004,0.31,0.99,0.8,0.49,0,0,5,0,1013,0,1.0,0.0,0
PF00008,PF12661:PF00028:PF01382:PF01049:PF07645,77,96,59,18,37,904,0.61,0.95,0.77,0.66,16,16,61,0,941,1.0,0.94,0.21,0.44
PF02347,PF01212:PF08427:PF11817:PF14498:PF08064,9,39,7,2,32,977,0.18,0.97,0.78,0.36,5,1,8,4,1005,0.2,0.99,0.11,0.14
PF03007,PF06974:PF02065:PF06863:PF09265:PF02789,8,35,5,3,30,980,0.14,0.97,0.62,0.29,1,0,8,1,1009,0.0,0.99,0.0,-0.0
PF07157,PF07409:PF13722:PF11751:PF06890:PF03090,0,0,0,0,0,1018,0,1.0,0,0,0,0,0,0,1018,0,1.0,0,0
PF05390,PF12243:PF14232:PF07950:PF12350:PF10785,2,10,0,2,10,1006,0.0,0.99,0.0,-0.0,0,0,2,0,1016,0,1.0,0.0,0
PF14625,PF01683:PF02822:PF11543:PF00368:PF11865,13,46,9,4,37,968,0.2,0.96,0.69,0.35,4,4,9,0,1005,1.0,0.99,0.31,0.55
PF11998,PF03661:PF16546:PF00515:PF07219:PF10516,5,67,3,2,64,949,0.04,0.94,0.6,0.15,4,2,3,2,1011,0.5,1.0,0.4,0.44
PF07245,PF05585:PF09337:PF03564:PF05380:PF13276,5,60,5,0,55,958,0.08,0.95,1.0,0.28,14,3,2,11,1002,0.21,0.99,0.6,0.35
PF00945,PF14534:PF08002:PF16001:PF02253:PF04932,4,2,1,3,1,1013,0.5,1.0,0.25,0.35,0,0,4,0,1014,0,1.0,0.0,0
PF01095,PF04043:PF01397:PF00215:PF00156:PF03936,29,63,19,10,44,945,0.3,0.95,0.66,0.42,12,8,21,4,985,0.67,0.98,0.28,0.42
PF07726,PF03626:PF12592:PF06044:PF09490:PF03135,5,7,2,3,5,1008,0.29,0.99,0.4,0.33,2,2,3,0,1013,1.0,1.0,0.4,0.63
PF07045,PF06890:PF08707:PF06651:PF03745:PF03592,1,1,0,1,1,1016,0.0,1.0,0.0,-0.0,0,0,1,0,1017,0,1.0,0.0,0
PF15788,PF02740:PF00323:PF04643:PF10583:PF00184,0,5,0,0,5,1013,0.0,1.0,0,0,0,0,0,0,1018,0,1.0,0,0
PF04212,PF16565:PF09336:PF06480:PF08332:PF12605,35,34,10,25,24,959,0.29,0.95,0.29,0.26,4,3,32,1,982,0.75,0.97,0.09,0.25
PF00164,PF00177:PF01058:PF04716:PF00507:PF00965,10,52,6,4,46,962,0.12,0.95,0.6,0.25,1,1,9,0,1008,1.0,0.99,0.1,0.31
PF10143,PF06415:PF07195:PF13280:PF13247:PF08483,4,7,2,2,5,1009,0.29,0.99,0.5,0.37,0,0,4,0,1014,0,1.0,0.0,0
PF09750,PF12230:PF01805:PF16566:PF04818:PF07713,18,55,13,5,42,958,0.24,0.95,0.72,0.4,8,5,13,3,997,0.62,0.98,0.28,0.41
PF11227,PF17086:PF01042:PF13906:PF11951:PF00248,0,129,0,0,129,889,0.0,0.87,0,0,20,0,0,20,998,0.0,0.98,0,0
PF14489,PF06403:PF07804:PF08708:PF17206:PF08404,1,3,0,1,3,1014,0.0,1.0,0.0,-0.0,0,0,1,0,1017,0,1.0,0.0,0
PF06458,PF07523:PF08479:PF15518:PF06826:PF04196,0,2,0,0,2,1016,0.0,1.0,0,0,0,0,0,0,1018,0,1.0,0,0
PF11841,PF16457:PF04727:PF04446:PF01213:PF14413,7,31,7,0,24,987,0.23,0.98,1.0,0.47,7,4,3,3,1008,0.57,0.99,0.57,0.57
PF03896,PF05676:PF00831:PF03386:PF05197:PF02431,12,21,4,8,17,989,0.19,0.98,0.33,0.24,1,0,12,1,1005,0.0,0.99,0.0,-0.0
PF08401,PF01913:PF01752:PF01514:PF17188:PF08453,0,3,0,0,3,1015,0.0,1.0,0,0,0,0,0,0,1018,0,1.0,0,0
PF16200,PF15975:PF16503:PF10637:PF16545:PF12221,7,24,4,3,20,991,0.17,0.98,0.57,0.3,1,1,6,0,1011,1.0,0.99,0.14,0.38
PF00993,PF16196:PF00969:PF16497:PF14517:PF10420,0,6,0,0,6,1012,0.0,0.99,0,0,0,0,0,0,1018,0,1.0,0,0
PF16030,PF12032:PF09272:PF00553:PF02983:PF15494,9,22,4,5,18,991,0.18,0.98,0.44,0.27,1,1,8,0,1009,1.0,0.99,0.11,0.33
PF00053,PF00028:PF16489:PF12661:PF02210:PF00054,38,84,29,9,55,925,0.35,0.94,0.76,0.49,21,19,19,2,978,0.9,0.98,0.5,0.66
PF10156,PF04087:PF05334:PF12576:PF09816:PF10253,3,11,1,2,10,1005,0.09,0.99,0.33,0.17,0,0,3,0,1015,0,1.0,0.0,0
PF15392,PF15082:PF10407:PF17096:PF07610:PF10618,0,4,0,0,4,1014,0.0,1.0,0,0,0,0,0,0,1018,0,1.0,0,0
PF10941,PF11351:PF06394:PF00274:PF03332:PF14974,0,36,0,0,36,982,0.0,0.96,0,0,1,0,0,1,1017,0.0,1.0,0,0
PF08437,PF04225:PF10118:PF14685:PF13471:PF09078,2,15,0,2,15,1001,0.0,0.98,0.0,-0.01,0,0,2,0,1016,0,1.0,0.0,0
PF17128,PF16967:PF08479:PF08453:PF04466:PF05947,1,2,0,1,2,1015,0.0,1.0,0.0,-0.0,0,0,1,0,1017,0,1.0,0.0,0
PF04363,PF03869:PF07505:PF06505:PF09611:PF17206,2,3,2,0,1,1015,0.67,1.0,1.0,0.82,0,0,2,0,1016,0,1.0,0.0,0
PF04900,PF04729:PF10276:PF10173:PF09805:PF08627,15,19,5,10,14,989,0.26,0.98,0.33,0.28,0,0,15,0,1003,0,0.99,0.0,0
PF12746,PF08186:PF05756:PF04485:PF11044:PF12392,0,2,0,0,2,1016,0.0,1.0,0,0,0,0,0,0,1018,0,1.0,0,0
PF10423,PF05299:PF04471:PF04320:PF16411:PF12686,1,5,1,0,4,1013,0.2,1.0,1.0,0.45,0,0,1,0,1017,0,1.0,0.0,0
PF05400,PF09087:PF06024:PF10438:PF07243:PF14449,1,1,1,0,0,1017,1.0,1.0,1.0,1.0,1,1,0,0,1017,1.0,1.0,1.0,1.0
PF00456,PF13292:PF02780:PF02779:PF16870:PF02449,11,49,8,3,41,966,0.16,0.96,0.73,0.33,13,2,9,11,996,0.15,0.98,0.18,0.16
PF17192,PF03882:PF17193:PF10106:PF12477:PF03831,0,1,0,0,1,1017,0.0,1.0,0,0,0,0,0,0,1018,0,1.0,0,0
PF03480,PF06808:PF00950:PF00771:PF13746:PF03180,8,15,7,1,8,1002,0.47,0.99,0.88,0.64,0,0,8,0,1010,0,0.99,0.0,0
PF12452,PF05683:PF03385:PF02885:PF07831:PF01288,1,22,1,0,21,996,0.05,0.98,1.0,0.21,0,0,1,0,1017,0,1.0,0.0,0
PF07498,PF07497:PF11421:PF16886:PF10336:PF10446,12,21,5,7,16,990,0.24,0.98,0.42,0.3,1,1,11,0,1006,1.0,0.99,0.08,0.29
PF06196,PF03144:PF06299:PF06045:PF14683:PF06421,0,78,0,0,78,940,0.0,0.92,0,0,6,0,0,6,1012,0.0,0.99,0,0
PF14145,PF11035:PF05111:PF15060:PF15872:PF07085,0,8,0,0,8,1010,0.0,0.99,0,0,0,0,0,0,1018,0,1.0,0,0
PF15510,PF04965:PF09108:PF08744:PF15753:PF04562,1,3,0,1,3,1014,0.0,1.0,0.0,-0.0,0,0,1,0,1017,0,1.0,0.0,0
PF08026,PF15085:PF07327:PF15186:PF03379:PF01303,0,5,0,0,5,1013,0.0,1.0,0,0,0,0,0,0,1018,0,1.0,0,0
PF00974,PF02465:PF08497:PF11019:PF03241:PF03090,0,0,0,0,0,1018,0,1.0,0,0,0,0,0,0,1018,0,1.0,0,0
PF12921,PF17177:PF13812:PF13762:PF12253:PF08634,1,66,0,1,66,951,0.0,0.93,0.0,-0.01,2,0,1,2,1015,0.0,1.0,0.0,-0.0
PF13093,PF08228:PF08656:PF13933:PF16594:PF15831,1,6,0,1,6,1011,0.0,0.99,0.0,-0.0,0,0,1,0,1017,0,1.0,0.0,0
PF15442,PF08014:PF15670:PF15275:PF14603:PF12402,2,10,1,1,9,1007,0.1,0.99,0.5,0.22,1,1,1,0,1016,1.0,1.0,0.5,0.71
PF00596,PF13419:PF01738:PF00475:PF07350:PF03211,33,76,19,14,57,928,0.25,0.93,0.58,0.35,6,6,27,0,985,1.0,0.97,0.18,0.42
PF10021,PF08588:PF15346:PF11255:PF10104:PF14769,12,14,8,4,6,1000,0.57,0.99,0.67,0.61,0,0,12,0,1006,0,0.99,0.0,0
PF15386,PF13270:PF12855:PF11460:PF06989:PF03618,1,6,0,1,6,1011,0.0,0.99,0.0,-0.0,0,0,1,0,1017,0,1.0,0.0,0
PF15004,PF15841:PF15834:PF05100:PF04625:PF10445,1,2,0,1,2,1015,0.0,1.0,0.0,-0.0,0,0,1,0,1017,0,1.0,0.0,0
PF00237,PF00902:PF00329:PF01084:PF04442:PF01058,23,44,12,11,32,963,0.27,0.96,0.52,0.36,6,3,20,3,992,0.5,0.98,0.13,0.25
PF11951,PF04082:PF08493:PF16846:PF13434:PF00172,80,187,68,12,119,819,0.36,0.87,0.85,0.5,15,15,65,0,938,1.0,0.94,0.19,0.42
PF01021,PF13929:PF08744:PF04233:PF11363:PF09108,1,0,0,1,0,1017,0,1.0,0.0,0,0,0,1,0,1017,0,1.0,0.0,0
PF08583,PF00159:PF07106:PF00142:PF10780:PF01097,14,13,2,12,11,993,0.15,0.98,0.14,0.14,0,0,14,0,1004,0,0.99,0.0,0
PF08611,PF07510:PF01669:PF02070:PF12153:PF03745,6,2,0,6,2,1010,0.0,0.99,0.0,-0.0,0,0,6,0,1012,0,0.99,0.0,0
PF07545,PF10332:PF09816:PF04090:PF04004:PF10104,1,19,1,0,18,999,0.05,0.98,1.0,0.23,3,0,1,3,1014,0.0,1.0,0.0,-0.0
PF14652,PF10347:PF01503:PF14678:PF10351:PF14665,1,23,0,1,23,994,0.0,0.98,0.0,-0.0,2,0,1,2,1015,0.0,1.0,0.0,-0.0
PF15761,PF15856:PF08291:PF15729:PF08795:PF15847,1,5,0,1,5,1012,0.0,0.99,0.0,-0.0,0,0,1,0,1017,0,1.0,0.0,0
PF14964,PF15293:PF16218:PF15462:PF15115:PF06729,5,2,0,5,2,1011,0.0,0.99,0.0,-0.0,0,0,5,0,1013,0,1.0,0.0,0
PF07429,PF13808:PF02056:PF15272:PF15935:PF16216,1,9,0,1,9,1008,0.0,0.99,0.0,-0.0,0,0,1,0,1017,0,1.0,0.0,0
PF09346,PF11566:PF08755:PF03048:PF08495:PF12014,2,19,2,0,17,999,0.11,0.98,1.0,0.32,1,1,1,0,1016,1.0,1.0,0.5,0.71
PF11068,PF00014:PF14085:PF14046:PF17009:PF12577,0,50,0,0,50,968,0.0,0.95,0,0,0,0,0,0,1018,0,1.0,0,0
PF05608,PF10559:PF11728:PF00011:PF06500:PF02560,3,39,2,1,37,978,0.05,0.96,0.67,0.18,3,1,2,2,1013,0.33,1.0,0.33,0.33
PF00571,PF01595:PF00654:PF00291:PF00478:PF04739,59,99,46,13,53,906,0.46,0.94,0.78,0.57,7,7,52,0,959,1.0,0.95,0.12,0.34
PF01895,PF15272:PF02056:PF06761:PF12299:PF08548,2,9,0,2,9,1007,0.0,0.99,0.0,-0.0,0,0,2,0,1016,0,1.0,0.0,0
PF06373,PF06446:PF01099:PF00537:PF16716:PF00758,0,5,0,0,5,1013,0.0,1.0,0,0,0,0,0,0,1018,0,1.0,0,0
PF13009,PF03590:PF01455:PF01706:PF14993:PF10127,0,5,0,0,5,1013,0.0,1.0,0,0,0,0,0,0,1018,0,1.0,0,0
PF05754,PF02972:PF08591:PF03238:PF05778:PF14985,0,3,0,0,3,1015,0.0,1.0,0,0,0,0,0,0,1018,0,1.0,0,0
PF13827,PF12946:PF01000:PF05434:PF06146:PF12525,0,13,0,0,13,1005,0.0,0.99,0,0,1,0,0,1,1017,0.0,1.0,0,0
PF02289,PF09551:PF06816:PF03496:PF07684:PF16553,1,8,0,1,8,1009,0.0,0.99,0.0,-0.0,2,0,1,2,1015,0.0,1.0,0.0,-0.0
PF10555,PF02719:PF03726:PF10119:PF03831:PF12753,7,13,7,0,6,1005,0.54,0.99,1.0,0.73,0,0,7,0,1011,0,0.99,0.0,0
PF04770,PF03479:PF02234:PF07052:PF02291:PF15998,6,29,5,1,24,988,0.17,0.98,0.83,0.37,3,2,4,1,1011,0.67,1.0,0.33,0.47
PF10336,PF09463:PF10198:PF10446:PF10307:PF08624,1,9,0,1,9,1008,0.0,0.99,0.0,-0.0,0,0,1,0,1017,0,1.0,0.0,0
PF01126,PF09805:PF10276:PF10248:PF08536:PF01250,10,28,5,5,23,985,0.18,0.97,0.5,0.29,0,0,10,0,1008,0,0.99,0.0,0
PF01553,PF00924:PF01699:PF02536:PF01764:PF13640,63,116,34,29,82,873,0.29,0.89,0.54,0.34,18,17,46,1,954,0.94,0.95,0.27,0.49
PF15465,PF15775:PF02565:PF05083:PF08002:PF14987,1,3,0,1,3,1014,0.0,1.0,0.0,-0.0,0,0,1,0,1017,0,1.0,0.0,0
PF14736,PF01775:PF09778:PF00197:PF05995:PF06172,3,18,0,3,18,997,0.0,0.98,0.0,-0.01,1,0,3,1,1014,0.0,1.0,0.0,-0.0
PF00056,PF02866:PF07258:PF01731:PF13774:PF01357,24,57,21,3,36,958,0.37,0.96,0.88,0.55,4,3,21,1,993,0.75,0.98,0.12,0.3
PF00111,PF03450:PF00941:PF01315:PF02738:PF06999,40,40,23,17,17,961,0.57,0.97,0.57,0.56,22,20,20,2,976,0.91,0.98,0.5,0.67
PF00497,PF10613:PF01547:PF00003:PF00060:PF07562,29,80,21,8,59,930,0.26,0.93,0.72,0.41,14,9,20,5,984,0.64,0.98,0.31,0.44
PF07892,PF16350:PF04324:PF16901:PF01571:PF10170,1,40,1,0,39,978,0.03,0.96,1.0,0.16,2,1,0,1,1016,0.5,1.0,1.0,0.71
PF14441,PF10155:PF13824:PF01755:PF06584:PF01285,4,26,1,3,25,989,0.04,0.97,0.25,0.09,0,0,4,0,1014,0,1.0,0.0,0
PF15059,PF15622:PF06566:PF17169:PF15374:PF11035,3,3,0,3,3,1012,0.0,0.99,0.0,-0.0,0,0,3,0,1015,0,1.0,0.0,0
PF08378,PF10333:PF02361:PF06369:PF09428:PF06875,1,7,0,1,7,1010,0.0,0.99,0.0,-0.0,0,0,1,0,1017,0,1.0,0.0,0
PF05996,PF03652:PF07333:PF14770:PF06232:PF15370,3,14,0,3,14,1001,0.0,0.98,0.0,-0.01,0,0,3,0,1015,0,1.0,0.0,0
PF00568,PF14957:PF08776:PF05210:PF05030:PF07522,22,36,12,10,24,972,0.33,0.97,0.55,0.41,2,2,20,0,996,1.0,0.98,0.09,0.3
PF06952,PF04754:PF03050:PF06573:PF15776:PF13663,0,7,0,0,7,1011,0.0,0.99,0,0,0,0,0,0,1018,0,1.0,0,0
PF17204,PF02931:PF11861:PF11515:PF01399:PF13600,0,115,0,0,115,903,0.0,0.89,0,0,15,0,0,15,1003,0.0,0.99,0,0
PF03374,PF04451:PF02413:PF09669:PF02305:PF05272,1,2,1,0,1,1016,0.5,1.0,1.0,0.71,0,0,1,0,1017,0,1.0,0.0,0
PF15340,PF15772:PF01312:PF17049:PF11210:PF02025,2,3,0,2,3,1013,0.0,1.0,0.0,-0.0,0,0,2,0,1016,0,1.0,0.0,0
PF13192,PF14721:PF14962:PF04224:PF14759:PF16020,3,12,1,2,11,1004,0.08,0.99,0.33,0.16,2,1,2,1,1014,0.5,1.0,0.33,0.41
PF00637,PF12816:PF17122:PF10367:PF12451:PF10366,29,25,15,14,10,979,0.6,0.98,0.52,0.55,7,7,22,0,989,1.0,0.98,0.24,0.49
PF08366,PF09453:PF12931:PF07304:PF03451:PF12234,12,32,5,7,27,979,0.16,0.97,0.42,0.24,4,2,10,2,1004,0.5,0.99,0.17,0.28
PF11352,PF04461:PF01412:PF03099:PF03594:PF04341,0,59,0,0,59,959,0.0,0.94,0,0,0,0,0,0,1018,0,1.0,0,0
PF10707,PF15727:PF10618:PF15756:PF10109:PF04392,0,3,0,0,3,1015,0.0,1.0,0,0,0,0,0,0,1018,0,1.0,0,0
PF14304,PF08777:PF12220:PF08081:PF06495:PF12353,11,25,3,8,22,985,0.12,0.97,0.27,0.17,3,2,9,1,1006,0.67,0.99,0.18,0.34
PF04481,PF02195:PF00545:PF04736:PF15475:PF14495,3,14,0,3,14,1001,0.0,0.98,0.0,-0.01,0,0,3,0,1015,0,1.0,0.0,0
PF16497,PF14517:PF00993:PF16196:PF08204:PF01382,2,4,0,2,4,1012,0.0,0.99,0.0,-0.0,0,0,2,0,1016,0,1.0,0.0,0
PF09452,PF04370:PF01303:PF15754:PF15033:PF14251,1,4,0,1,4,1013,0.0,1.0,0.0,-0.0,0,0,1,0,1017,0,1.0,0.0,0
PF05154,PF09350:PF00684:PF01556:PF09320:PF07743,15,57,11,4,46,957,0.19,0.95,0.73,0.36,3,2,13,1,1002,0.67,0.99,0.13,0.29
PF08267,PF01717:PF14577:PF08207:PF05390:PF14767,3,23,3,0,20,995,0.13,0.98,1.0,0.36,1,0,3,1,1014,0.0,1.0,0.0,-0.0
PF13864,PF04004:PF07223:PF15342:PF04090:PF07545,6,17,3,3,14,998,0.18,0.98,0.5,0.29,0,0,6,0,1012,0,0.99,0.0,0
PF07995,PF02012:PF03118:PF03024:PF10179:PF06484,14,18,6,8,12,992,0.33,0.98,0.43,0.37,0,0,14,0,1004,0,0.99,0.0,0
PF11141,PF00906:PF13313:PF11863:PF16411:PF09860,0,2,0,0,2,1016,0.0,1.0,0,0,0,0,0,0,1018,0,1.0,0,0
PF11142,PF10241:PF05153:PF08997:PF06551:PF09757,0,27,0,0,27,991,0.0,0.97,0,0,0,0,0,0,1018,0,1.0,0,0
PF04598,PF15718:PF15148:PF00837:PF09806:PF05782,3,12,1,2,11,1004,0.08,0.99,0.33,0.16,0,0,3,0,1015,0,1.0,0.0,0
PF13445,PF00097:PF14634:PF00643:PF03915:PF13639,60,173,51,9,122,836,0.29,0.87,0.85,0.45,26,20,40,6,952,0.77,0.95,0.33,0.49
PF14299,PF07723:PF08268:PF08495:PF07734:PF04300,10,34,5,5,29,979,0.15,0.97,0.5,0.26,3,2,8,1,1007,0.67,0.99,0.2,0.36
PF04089,PF12483:PF13225:PF13092:PF05191:PF10252,7,23,6,1,17,994,0.26,0.98,0.86,0.47,1,1,6,0,1011,1.0,0.99,0.14,0.38
PF07983,PF00332:PF03198:PF00154:PF04086:PF03094,13,55,11,2,44,961,0.2,0.95,0.85,0.4,7,6,7,1,1004,0.86,0.99,0.46,0.63
PF01268,PF00763:PF02882:PF06298:PF08083:PF17135,13,44,12,1,32,973,0.27,0.97,0.92,0.49,9,7,6,2,1003,0.78,0.99,0.54,0.64
PF06463,PF16881:PF06969:PF01967:PF13597:PF06968,9,22,8,1,14,995,0.36,0.99,0.89,0.56,2,2,7,0,1009,1.0,0.99,0.22,0.47
PF05422,PF16979:PF16978:PF12448:PF13438:PF15661,3,19,3,0,16,999,0.16,0.98,1.0,0.39,0,0,3,0,1015,0,1.0,0.0,0
PF11958,PF16871:PF07085:PF00073:PF14307:PF07963,5,18,1,4,17,996,0.06,0.98,0.2,0.1,0,0,5,0,1013,0,1.0,0.0,0
PF04827,PF03407:PF04884:PF12899:PF14476:PF03767,31,32,10,21,22,965,0.31,0.96,0.32,0.3,4,4,27,0,987,1.0,0.97,0.13,0.35
PF13451,PF07195:PF10951:PF13753:PF11697:PF06082,2,0,0,2,0,1016,0,1.0,0.0,0,0,0,2,0,1016,0,1.0,0.0,0
PF01469,PF09289:PF00050:PF07648:PF03146:PF07692,4,35,2,2,33,981,0.06,0.97,0.5,0.16,3,1,3,2,1012,0.33,1.0,0.25,0.29
PF02864,PF02865:PF01017:PF12610:PF09267:PF15148,4,5,3,1,2,1012,0.6,1.0,0.75,0.67,0,0,4,0,1014,0,1.0,0.0,0
PF07542,PF03583:PF06159:PF01758:PF13092:PF13225,12,22,5,7,17,989,0.23,0.98,0.42,0.3,0,0,12,0,1006,0,0.99,0.0,0
PF06979,PF11927:PF04148:PF07859:PF00436:PF01185,4,87,4,0,83,931,0.05,0.92,1.0,0.21,4,1,3,3,1011,0.25,0.99,0.25,0.25
PF00048,PF13841:PF01294:PF14798:PF02422:PF00159,13,9,3,10,6,999,0.33,0.98,0.23,0.27,1,1,12,0,1005,1.0,0.99,0.08,0.28
PF01149,PF09292:PF06831:PF04422:PF17219:PF16675,9,17,9,0,8,1001,0.53,0.99,1.0,0.72,1,1,8,0,1009,1.0,0.99,0.11,0.33
PF14995,PF15041:PF04691:PF05836:PF15676:PF06573,6,4,1,5,3,1009,0.25,0.99,0.17,0.2,0,0,6,0,1012,0,0.99,0.0,0
PF09347,PF07086:PF01522:PF03427:PF02811:PF15002,5,49,4,1,45,968,0.08,0.95,0.8,0.25,2,0,5,2,1011,0.0,0.99,0.0,-0.0
PF12034,PF13400:PF16754:PF06305:PF10912:PF03845,0,12,0,0,12,1006,0.0,0.99,0,0,0,0,0,0,1018,0,1.0,0,0
PF00170,PF07716:PF11538:PF02701:PF00250:PF05920,33,85,20,13,65,920,0.24,0.92,0.61,0.35,9,8,25,1,984,0.89,0.97,0.24,0.46
PF05391,PF07807:PF10378:PF15861:PF14449:PF07808,1,15,1,0,14,1003,0.07,0.99,1.0,0.26,1,1,0,0,1017,1.0,1.0,1.0,1.0
PF08689,PF15749:PF13396:PF11510:PF01057:PF15999,5,12,1,4,11,1002,0.08,0.99,0.2,0.12,1,1,4,0,1013,1.0,1.0,0.2,0.45
PF02472,PF06586:PF05974:PF03389:PF09444:PF09967,1,3,0,1,3,1014,0.0,1.0,0.0,-0.0,0,0,1,0,1017,0,1.0,0.0,0
PF01144,PF02886:PF10022:PF01273:PF02550:PF13336,19,31,6,13,25,974,0.19,0.96,0.32,0.23,1,1,18,0,999,1.0,0.98,0.05,0.23
PF09197,PF08914:PF11626:PF06732:PF08605:PF16727,1,21,1,0,20,997,0.05,0.98,1.0,0.22,0,0,1,0,1017,0,1.0,0.0,0
PF15061,PF09690:PF09232:PF04860:PF06729:PF02025,2,3,0,2,3,1013,0.0,1.0,0.0,-0.0,0,0,2,0,1016,0,1.0,0.0,0
PF16009,PF04839:PF00468:PF07939:PF10018:PF09419,1,29,0,1,29,988,0.0,0.97,0.0,-0.01,1,0,1,1,1016,0.0,1.0,0.0,-0.0
PF05616,PF14634:PF13445:PF04072:PF00025:PF10387,0,110,0,0,110,908,0.0,0.89,0,0,11,0,0,11,1007,0.0,0.99,0,0
PF12766,PF12049:PF03193:PF06420:PF11489:PF15346,4,8,1,3,7,1007,0.12,0.99,0.25,0.17,0,0,4,0,1014,0,1.0,0.0,0
PF06082,PF03090:PF06251:PF03428:PF12081:PF07308,0,0,0,0,0,1018,0,1.0,0,0,0,0,0,0,1018,0,1.0,0,0
PF13699,PF04476:PF10412:PF07243:PF10618:PF06114,0,3,0,0,3,1015,0.0,1.0,0,0,0,0,0,0,1018,0,1.0,0,0
PF06970,PF04625:PF10279:PF07916:PF11070:PF06826,0,2,0,0,2,1016,0.0,1.0,0,0,0,0,0,0,1018,0,1.0,0,0
PF11865,PF02260:PF08064:PF08771:PF03378:PF02259,9,41,8,1,33,976,0.2,0.97,0.89,0.41,14,8,1,6,1003,0.57,0.99,0.89,0.71
PF07445,PF04489:PF14400:PF04473:PF06147:PF06532,0,0,0,0,0,1018,0,1.0,0,0,0,0,0,0,1018,0,1.0,0,0
PF05701,PF09730:PF15458:PF09744:PF07899:PF04388,7,27,4,3,23,988,0.15,0.97,0.57,0.28,1,0,7,1,1010,0.0,0.99,0.0,-0.0
PF03458,PF16829:PF15234:PF17085:PF10630:PF14047,1,0,0,1,0,1017,0,1.0,0.0,0,0,0,1,0,1017,0,1.0,0.0,0
PF06461,PF08074:PF06465:PF08073:PF07529:PF15790,12,26,12,0,14,992,0.46,0.99,1.0,0.67,10,10,2,0,1006,1.0,1.0,0.83,0.91
PF10525,PF04617:PF12407:PF04731:PF03867:PF12413,4,2,1,3,1,1013,0.5,1.0,0.25,0.35,1,1,3,0,1014,1.0,1.0,0.25,0.5
PF07795,PF04536:PF08536:PF08656:PF09805:PF16594,2,16,2,0,14,1002,0.12,0.99,1.0,0.35,1,1,1,0,1016,1.0,1.0,0.5,0.71
PF16575,PF06807:PF16573:PF10179:PF04870:PF04516,21,28,14,7,14,983,0.5,0.98,0.67,0.57,2,2,19,0,997,1.0,0.98,0.1,0.31
PF16782,PF11291:PF09834:PF10490:PF09447:PF05448,1,7,0,1,7,1010,0.0,0.99,0.0,-0.0,0,0,1,0,1017,0,1.0,0.0,0
PF00876,PF04658:PF03297:PF05197:PF06098:PF03036,24,25,7,17,18,976,0.28,0.97,0.29,0.27,2,2,22,0,994,1.0,0.98,0.08,0.29
PF15123,PF07458:PF02202:PF15333:PF14986:PF15055,0,0,0,0,0,1018,0,1.0,0,0,0,0,0,0,1018,0,1.0,0,0
PF02843,PF02844:PF01071:PF00586:PF02769:PF00551,13,40,13,0,27,978,0.33,0.97,1.0,0.56,9,8,5,1,1004,0.89,0.99,0.62,0.74
PF11779,PF08561:PF04716:PF01680:PF02284:PF06127,6,30,3,3,27,985,0.1,0.97,0.5,0.21,2,1,5,1,1011,0.5,0.99,0.17,0.29
PF09615,PF04931:PF07147:PF01579:PF11952:PF05872,0,22,0,0,22,996,0.0,0.98,0,0,2,0,0,2,1016,0.0,1.0,0,0
PF15767,PF13270:PF11460:PF06989:PF04359:PF15503,2,5,0,2,5,1011,0.0,0.99,0.0,-0.0,0,0,2,0,1016,0,1.0,0.0,0
PF06961,PF17017:PF09365:PF17015:PF15378:PF06934,0,2,0,0,2,1016,0.0,1.0,0,0,0,0,0,0,1018,0,1.0,0,0
PF02149,PF08332:PF12605:PF14593:PF11629:PF12063,13,15,6,7,9,996,0.4,0.98,0.46,0.42,4,4,9,0,1005,1.0,0.99,0.31,0.55
PF09688,PF02427:PF07961:PF02393:PF07444:PF15062,0,0,0,0,0,1018,0,1.0,0,0,0,0,0,0,1018,0,1.0,0,0
PF02970,PF01987:PF06232:PF10780:PF15359:PF05361,6,12,0,6,12,1000,0.0,0.98,0.0,-0.01,1,0,6,1,1011,0.0,0.99,0.0,-0.0
PF06029,PF08964:PF03775:PF05666:PF02951:PF04687,5,5,1,4,4,1009,0.2,0.99,0.2,0.2,0,0,5,0,1013,0,1.0,0.0,0
PF11493,PF09252:PF07327:PF15119:PF05151:PF02087,0,4,0,0,4,1014,0.0,1.0,0,0,0,0,0,0,1018,0,1.0,0,0
PF14817,PF17167:PF15995:PF00073:PF02350:PF06792,3,20,0,3,20,995,0.0,0.98,0.0,-0.01,0,0,3,0,1015,0,1.0,0.0,0
PF05136,PF01312:PF04355:PF02979:PF08708:PF11245,3,3,0,3,3,1012,0.0,0.99,0.0,-0.0,0,0,3,0,1015,0,1.0,0.0,0
PF16043,PF06637:PF15275:PF14722:PF15619:PF15257,1,17,0,1,17,1000,0.0,0.98,0.0,-0.0,0,0,1,0,1017,0,1.0,0.0,0
PF09586,PF09611:PF17007:PF07610:PF09250:PF17128,0,2,0,0,2,1016,0.0,1.0,0,0,0,0,0,0,1018,0,1.0,0,0
PF11070,PF06890:PF03845:PF06826:PF15817:PF09829,0,10,0,0,10,1008,0.0,0.99,0,0,0,0,0,0,1018,0,1.0,0,0
PF17144,PF14204:PF02482:PF03763:PF08523:PF07231,14,28,12,2,16,988,0.43,0.98,0.86,0.6,1,1,13,0,1004,1.0,0.99,0.07,0.27
PF10758,PF07617:PF11792:PF00931:PF07725:PF14076,0,83,0,0,83,935,0.0,0.92,0,0,0,0,0,0,1018,0,1.0,0,0
PF12561,PF11681:PF15214:PF09493:PF15662:PF07881,0,3,0,0,3,1015,0.0,1.0,0,0,0,0,0,0,1018,0,1.0,0,0
PF07757,PF04516:PF03359:PF10179:PF15996:PF04087,12,22,3,9,19,987,0.14,0.97,0.25,0.17,0,0,12,0,1006,0,0.99,0.0,0
PF09049,PF09051:PF09050:PF15690:PF07014:PF15689,0,0,0,0,0,1018,0,1.0,0,0,0,0,0,0,1018,0,1.0,0,0
PF02617,PF02207:PF05048:PF13764:PF02916:PF13329,6,23,5,1,18,994,0.22,0.98,0.83,0.42,4,3,3,1,1011,0.75,1.0,0.5,0.61
PF12200,PF17106:PF10423:PF02909:PF10703:PF01297,1,10,1,0,9,1008,0.1,0.99,1.0,0.31,1,1,0,0,1017,1.0,1.0,1.0,1.0
PF09613,PF02252:PF06464:PF12456:PF11608:PF16177,0,36,0,0,36,982,0.0,0.96,0,0,4,0,0,4,1014,0.0,1.0,0,0
PF16208,PF04732:PF00932:PF00038:PF10042:PF11502,4,25,4,0,21,993,0.16,0.98,1.0,0.4,2,1,3,1,1013,0.5,1.0,0.25,0.35
PF00815,PF01502:PF01503:PF06276:PF04183:PF13204,15,21,8,7,13,990,0.38,0.98,0.53,0.44,0,0,15,0,1003,0,0.99,0.0,0
PF11835,PF13320:PF14613:PF12432:PF15491:PF08579,1,5,0,1,5,1012,0.0,0.99,0.0,-0.0,0,0,1,0,1017,0,1.0,0.0,0
PF11997,PF14573:PF16967:PF06505:PF05838:PF00700,0,1,0,0,1,1017,0.0,1.0,0,0,0,0,0,0,1018,0,1.0,0,0
PF11791,PF06434:PF00694:PF11870:PF00330:PF02589,2,42,2,0,40,976,0.05,0.96,1.0,0.21,2,1,1,1,1015,0.5,1.0,0.5,0.5
PF02588,PF10035:PF09327:PF13612:PF11751:PF16861,2,8,2,0,6,1010,0.25,0.99,1.0,0.5,0,0,2,0,1016,0,1.0,0.0,0
PF01364,PF15518:PF03090:PF10554:PF12603:PF08411,2,2,0,2,2,1014,0.0,1.0,0.0,-0.0,0,0,2,0,1016,0,1.0,0.0,0
PF14961,PF15020:PF11229:PF15782:PF14680:PF14675,0,12,0,0,12,1006,0.0,0.99,0,0,0,0,0,0,1018,0,1.0,0,0
PF06328,PF09067:PF07227:PF05473:PF12453:PF12772,4,7,1,3,6,1008,0.14,0.99,0.25,0.18,1,1,3,0,1014,1.0,1.0,0.25,0.5
PF06209,PF10537:PF17105:PF17035:PF16737:PF03383,2,23,1,1,22,994,0.04,0.98,0.5,0.14,1,1,1,0,1016,1.0,1.0,0.5,0.71
PF00262,PF10595:PF03647:PF04729:PF01781:PF15237,21,24,7,14,17,980,0.29,0.97,0.33,0.3,2,2,19,0,997,1.0,0.98,0.1,0.31
PF00587,PF02686:PF03129:PF02403:PF07973:PF00749,48,79,44,4,35,935,0.56,0.96,0.92,0.7,14,14,34,0,970,1.0,0.97,0.29,0.53
PF05781,PF14662:PF15501:PF15246:PF07894:PF15244,4,8,2,2,6,1008,0.25,0.99,0.5,0.35,1,1,3,0,1014,1.0,1.0,0.25,0.5
PF10291,PF08683:PF15246:PF15920:PF10114:PF17095,6,9,1,5,8,1004,0.11,0.99,0.17,0.13,0,0,6,0,1012,0,0.99,0.0,0
PF00555,PF15529:PF10109:PF10995:PF04717:PF05109,2,0,0,2,0,1016,0,1.0,0.0,0,0,0,2,0,1016,0,1.0,0.0,0
PF02671,PF08295:PF16879:PF02761:PF02262:PF02762,29,20,16,13,4,985,0.8,0.98,0.55,0.66,5,3,26,2,987,0.6,0.97,0.1,0.24
PF07961,PF17032:PF08591:PF02427:PF15062:PF02393,0,0,0,0,0,1018,0,1.0,0,0,0,0,0,0,1018,0,1.0,0,0
PF11354,PF05613:PF09937:PF12883:PF07295:PF00348,0,45,0,0,45,973,0.0,0.96,0,0,0,0,0,0,1018,0,1.0,0,0
PF10274,PF11977:PF09736:PF11768:PF08839:PF14611,12,19,8,4,11,995,0.42,0.99,0.67,0.52,1,1,11,0,1006,1.0,0.99,0.08,0.29
PF04989,PF02595:PF01292:PF15105:PF15212:PF07980,2,7,0,2,7,1009,0.0,0.99,0.0,-0.0,0,0,2,0,1016,0,1.0,0.0,0
PF00221,PF12053:PF01569:PF03417:PF04819:PF00311,11,47,2,9,45,962,0.04,0.95,0.18,0.07,3,1,10,2,1005,0.33,0.99,0.09,0.17
PF09354,PF16675:PF08430:PF16676:PF16159:PF00250,4,45,4,0,41,973,0.09,0.96,1.0,0.29,3,2,2,1,1013,0.67,1.0,0.5,0.58
PF15209,PF03317:PF08189:PF05155:PF15434:PF17050,0,7,0,0,7,1011,0.0,0.99,0,0,0,0,0,0,1018,0,1.0,0,0
PF04471,PF00555:PF15281:PF02119:PF04222:PF11794,3,7,0,3,7,1008,0.0,0.99,0.0,-0.0,0,0,3,0,1015,0,1.0,0.0,0
PF00337,PF13334:PF01762:PF12326:PF04099:PF07061,26,54,18,8,36,956,0.33,0.96,0.69,0.46,4,4,22,0,992,1.0,0.98,0.15,0.39
PF06124,PF03406:PF14903:PF04986:PF13099:PF02613,2,3,0,2,3,1013,0.0,1.0,0.0,-0.0,0,0,2,0,1016,0,1.0,0.0,0
PF08757,PF10042:PF10104:PF04478:PF12855:PF08643,4,17,1,3,16,998,0.06,0.98,0.25,0.11,0,0,4,0,1014,0,1.0,0.0,0
PF05467,PF11037:PF13148:PF09109:PF07045:PF17022,0,1,0,0,1,1017,0.0,1.0,0,0,0,0,0,0,1018,0,1.0,0,0
PF01793,PF11807:PF03595:PF00793:PF12311:PF01625,15,49,5,10,44,959,0.1,0.95,0.33,0.16,7,2,13,5,998,0.29,0.98,0.13,0.19
PF13095,PF07444:PF00737:PF15503:PF08576:PF02427,2,5,1,1,4,1012,0.2,1.0,0.5,0.31,0,0,2,0,1016,0,1.0,0.0,0
PF05204,PF07157:PF07409:PF02305:PF11751:PF04196,5,2,0,5,2,1011,0.0,0.99,0.0,-0.0,0,0,5,0,1013,0,1.0,0.0,0
PF08198,PF03020:PF09402:PF11560:PF00554:PF06781,1,30,1,0,29,988,0.03,0.97,1.0,0.18,3,1,0,2,1015,0.33,1.0,1.0,0.58
PF07779,PF03385:PF04083:PF10022:PF08568:PF01757,11,64,7,4,57,950,0.11,0.94,0.64,0.25,1,0,11,1,1006,0.0,0.99,0.0,-0.0
PF11210,PF01752:PF15207:PF05167:PF01312:PF15776,0,6,0,0,6,1012,0.0,0.99,0,0,0,0,0,0,1018,0,1.0,0,0
PF04658,PF10234:PF09728:PF10595:PF09755:PF09282,10,18,5,5,13,995,0.28,0.98,0.5,0.36,1,1,9,0,1008,1.0,0.99,0.1,0.31
PF16504,PF04958:PF10460:PF02929:PF04245:PF01363,0,83,0,0,83,935,0.0,0.92,0,0,0,0,0,0,1018,0,1.0,0,0
PF00155,PF05175:PF13847:PF09029:PF07706:PF02953,102,75,29,73,46,870,0.39,0.88,0.28,0.27,4,4,98,0,916,1.0,0.9,0.04,0.19
PF10255,PF01896:PF04819:PF01702:PF03022:PF04588,9,34,5,4,29,980,0.15,0.97,0.56,0.27,3,3,6,0,1009,1.0,0.99,0.33,0.58
PF13118,PF11995:PF07199:PF15337:PF04965:PF15235,3,7,3,0,4,1011,0.43,1.0,1.0,0.65,0,0,3,0,1015,0,1.0,0.0,0
PF10200,PF03073:PF10775:PF01922:PF13741:PF10306,5,13,2,3,11,1002,0.15,0.99,0.4,0.24,1,0,5,1,1012,0.0,0.99,0.0,-0.0
PF13802,PF16863:PF01055:PF17137:PF00088:PF16338,21,45,20,1,25,972,0.44,0.97,0.95,0.64,8,8,13,0,997,1.0,0.99,0.38,0.61
PF03166,PF00859:PF10524:PF03165:PF15509:PF06312,16,14,8,8,6,996,0.57,0.99,0.5,0.53,2,2,14,0,1002,1.0,0.99,0.12,0.35
PF02403,PF03129:PF04073:PF11573:PF00587:PF02272,26,68,24,2,44,948,0.35,0.95,0.92,0.56,12,7,19,5,987,0.58,0.98,0.27,0.39
PF06181,PF12628:PF15337:PF15553:PF08093:PF10999,0,4,0,0,4,1014,0.0,1.0,0,0,0,0,0,0,1018,0,1.0,0,0
PF14429,PF16172:PF11878:PF06920:PF12768:PF16910,13,25,8,5,17,988,0.32,0.98,0.62,0.43,3,3,10,0,1005,1.0,0.99,0.23,0.48
PF14998,PF06596:PF06581:PF04402:PF14653:PF04856,2,7,1,1,6,1010,0.14,0.99,0.5,0.26,0,0,2,0,1016,0,1.0,0.0,0
PF03038,PF17083:PF03405:PF07226:PF02718:PF08392,0,9,0,0,9,1009,0.0,0.99,0,0,0,0,0,0,1018,0,1.0,0,0
PF11669,PF12527:PF10361:PF08528:PF02116:PF12579,3,7,0,3,7,1008,0.0,0.99,0.0,-0.0,0,0,3,0,1015,0,1.0,0.0,0
PF04138,PF14322:PF09837:PF01673:PF03562:PF05673,0,2,0,0,2,1016,0.0,1.0,0,0,0,0,0,0,1018,0,1.0,0,0
PF03548,PF15186:PF03050:PF00669:PF15775:PF14885,3,3,0,3,3,1012,0.0,0.99,0.0,-0.0,0,0,3,0,1015,0,1.0,0.0,0
PF09037,PF15775:PF02595:PF04350:PF04351:PF03589,0,2,0,0,2,1016,0.0,1.0,0,0,0,0,0,0,1018,0,1.0,0,0
PF04383,PF10544:PF04665:PF03288:PF11735:PF15346,5,20,3,2,17,996,0.15,0.98,0.6,0.29,1,1,4,0,1013,1.0,1.0,0.2,0.45
PF09291,PF10570:PF02124:PF02439:PF12104:PF11465,0,5,0,0,5,1013,0.0,1.0,0,0,0,0,0,0,1018,0,1.0,0,0
PF02281,PF08558:PF07317:PF01448:PF06282:PF16495,0,27,0,0,27,991,0.0,0.97,0,0,0,0,0,0,1018,0,1.0,0,0
PF10542,PF00127:PF02361:PF12046:PF09348:PF07544,0,14,0,0,14,1004,0.0,0.99,0,0,0,0,0,0,1018,0,1.0,0,0
PF03414,PF06951:PF12301:PF09777:PF05308:PF13841,5,16,3,2,13,1000,0.19,0.99,0.6,0.33,0,0,5,0,1013,0,1.0,0.0,0
PF13673,PF13508:PF07470:PF00583:PF05368:PF04072,23,115,17,6,98,897,0.15,0.9,0.74,0.3,16,10,13,6,989,0.62,0.98,0.43,0.51
PF15010,PF01705:PF08209:PF10104:PF11250:PF03352,2,24,1,1,23,993,0.04,0.98,0.5,0.14,1,0,2,1,1015,0.0,1.0,0.0,-0.0
PF11768,PF15279:PF14646:PF15396:PF10033:PF09816,0,13,0,0,13,1005,0.0,0.99,0,0,1,0,0,1,1017,0.0,1.0,0,0
PF15444,PF15130:PF15872:PF17085:PF15096:PF10856,0,1,0,0,1,1017,0.0,1.0,0,0,0,0,0,0,1018,0,1.0,0,0
PF01022,PF01710:PF12760:PF06821:PF14865:PF01943,2,3,0,2,3,1013,0.0,1.0,0.0,-0.0,0,0,2,0,1016,0,1.0,0.0,0
PF15884,PF11029:PF10161:PF15071:PF16089:PF04402,3,8,2,1,6,1009,0.25,0.99,0.67,0.41,0,0,3,0,1015,0,1.0,0.0,0
PF03948,PF17221:PF01386:PF05173:PF14767:PF11635,6,14,1,5,13,999,0.07,0.98,0.17,0.1,0,0,6,0,1012,0,0.99,0.0,0
PF04124,PF04981:PF05334:PF09804:PF04646:PF12309,8,20,2,6,18,992,0.1,0.98,0.25,0.15,0,0,8,0,1010,0,0.99,0.0,0
PF13491,PF09397:PF06505:PF01580:PF05939:PF09074,5,5,5,0,0,1013,1.0,1.0,1.0,1.0,0,0,5,0,1013,0,1.0,0.0,0
PF10228,PF10283:PF03993:PF16759:PF02868:PF06087,8,35,6,2,29,981,0.17,0.97,0.75,0.35,2,1,7,1,1009,0.5,0.99,0.12,0.25
PF12972,PF12971:PF05089:PF08530:PF16874:PF16712,9,27,9,0,18,991,0.33,0.98,1.0,0.57,3,3,6,0,1009,1.0,0.99,0.33,0.58
PF12223,PF04148:PF05176:PF01774:PF05996:PF05630,1,17,0,1,17,1000,0.0,0.98,0.0,-0.0,0,0,1,0,1017,0,1.0,0.0,0
PF11975,PF02056:PF08886:PF15272:PF02741:PF14842,8,9,8,0,1,1009,0.89,1.0,1.0,0.94,0,0,8,0,1010,0,0.99,0.0,0
PF00273,PF09164:PF17187:PF14306:PF01747:PF06535,0,11,0,0,11,1007,0.0,0.99,0,0,0,0,0,0,1018,0,1.0,0,0
PF05228,PF16697:PF09967:PF03135:PF02472:PF09444,1,10,0,1,10,1007,0.0,0.99,0.0,-0.0,0,0,1,0,1017,0,1.0,0.0,0
PF08145,PF04494:PF04158:PF10313:PF08149:PF16699,4,25,3,1,22,992,0.12,0.98,0.75,0.29,1,1,3,0,1014,1.0,1.0,0.25,0.5
PF16791,PF03509:PF03508:PF00029:PF03957:PF12498,0,8,0,0,8,1010,0.0,0.99,0,0,2,0,0,2,1016,0.0,1.0,0,0
PF04088,PF08397:PF08824:PF12026:PF03983:PF05060,2,17,1,1,16,1000,0.06,0.98,0.5,0.17,1,1,1,0,1016,1.0,1.0,0.5,0.71
PF07738,PF09387:PF06701:PF15808:PF07202:PF11547,28,24,11,17,13,977,0.46,0.97,0.39,0.41,1,0,28,1,989,0.0,0.97,0.0,-0.01
PF02550,PF13336:PF01273:PF01144:PF03385:PF05023,10,45,9,1,36,972,0.2,0.96,0.9,0.41,2,1,9,1,1007,0.5,0.99,0.1,0.22
PF01558,PF17147:PF10371:PF01855:PF12838:PF02775,6,46,6,0,40,972,0.13,0.96,1.0,0.35,6,5,1,1,1011,0.83,1.0,0.83,0.83
PF11416,PF09177:PF00804:PF02269:PF10496:PF05739,5,54,4,1,50,963,0.07,0.95,0.8,0.23,13,2,3,11,1002,0.15,0.99,0.4,0.24
PF16565,PF12002:PF05496:PF16193:PF09336:PF02252,1,35,0,1,35,982,0.0,0.96,0.0,-0.01,8,0,1,8,1009,0.0,0.99,0.0,-0.0
PF07803,PF00822:PF15226:PF02180:PF02988:PF11303,0,13,0,0,13,1005,0.0,0.99,0,0,0,0,0,0,1018,0,1.0,0,0
PF06465,PF08073:PF06461:PF08074:PF07529:PF15790,11,26,11,0,15,992,0.42,0.99,1.0,0.65,11,10,1,1,1006,0.91,1.0,0.91,0.91
PF10429,PF15212:PF15114:PF10567:PF15141:PF08497,0,1,0,0,1,1017,0.0,1.0,0,0,0,0,0,0,1018,0,1.0,0,0
PF00589,PF12259:PF00075:PF03732:PF08284:PF14529,21,109,13,8,96,901,0.12,0.9,0.62,0.24,12,6,15,6,991,0.5,0.98,0.29,0.37
PF15332,PF15115:PF15333:PF15036:PF08591:PF07961,1,1,0,1,1,1016,0.0,1.0,0.0,-0.0,0,0,1,0,1017,0,1.0,0.0,0
PF00316,PF04666:PF07542:PF01731:PF05191:PF01896,27,39,10,17,29,962,0.26,0.95,0.37,0.29,2,1,26,1,990,0.5,0.97,0.04,0.13
PF03465,PF03464:PF03463:PF04927:PF14577:PF14576,9,11,8,1,3,1006,0.73,1.0,0.89,0.8,1,1,8,0,1009,1.0,0.99,0.11,0.33
PF11291,PF10375:PF05685:PF00524:PF15233:PF02108,0,9,0,0,9,1009,0.0,0.99,0,0,0,0,0,0,1018,0,1.0,0,0
PF16131,PF04098:PF08081:PF12220:PF12196:PF13865,17,21,6,11,15,986,0.29,0.97,0.35,0.3,2,2,15,0,1001,1.0,0.99,0.12,0.34
PF15774,PF15337:PF15696:PF07199:PF11162:PF16756,0,3,0,0,3,1015,0.0,1.0,0,0,0,0,0,0,1018,0,1.0,0,0
PF09799,PF00159:PF00965:PF10244:PF04716:PF08561,6,28,5,1,23,989,0.18,0.98,0.83,0.38,2,1,5,1,1011,0.5,0.99,0.17,0.29
PF03928,PF06912:PF15071:PF12716:PF00545:PF06766,8,8,0,8,8,1002,0.0,0.98,0.0,-0.01,0,0,8,0,1010,0,0.99,0.0,0
PF14279,PF02576:PF11255:PF03703:PF00127:PF11016,0,4,0,0,4,1014,0.0,1.0,0,0,0,0,0,0,1018,0,1.0,0,0
PF08443,PF00328:PF15675:PF09713:PF04536:PF04281,3,60,3,0,57,958,0.05,0.94,1.0,0.22,2,0,3,2,1013,0.0,1.0,0.0,-0.0
PF12112,PF11289:PF05973:PF02660:PF05720:PF17097,0,1,0,0,1,1017,0.0,1.0,0,0,0,0,0,0,1018,0,1.0,0,0
PF02838,PF03174:PF03173:PF14845:PF07555:PF00728,9,38,9,0,29,980,0.24,0.97,1.0,0.48,3,3,6,0,1009,1.0,0.99,0.33,0.58
PF15759,PF15918:PF10295:PF13810:PF08744:PF13094,0,5,0,0,5,1013,0.0,1.0,0,0,0,0,0,0,1018,0,1.0,0,0
PF16568,PF16551:PF16544:PF09005:PF16274:PF10470,1,13,1,0,12,1005,0.08,0.99,1.0,0.28,1,1,0,0,1017,1.0,1.0,1.0,1.0
PF05266,PF16097:PF16098:PF16096:PF12235:PF03735,0,12,0,0,12,1006,0.0,0.99,0,0,2,0,0,2,1016,0.0,1.0,0,0
PF09307,PF08831:PF02961:PF10511:PF00086:PF09289,3,26,3,0,23,992,0.12,0.98,1.0,0.34,3,0,3,3,1012,0.0,0.99,0.0,-0.0
PF08919,PF09027:PF15303:PF08416:PF07001:PF10606,10,17,3,7,14,994,0.18,0.98,0.3,0.22,1,1,9,0,1008,1.0,0.99,0.1,0.31
PF17083,PF03038:PF07755:PF01585:PF10761:PF02749,0,68,0,0,68,950,0.0,0.93,0,0,0,0,0,0,1018,0,1.0,0,0
PF07359,PF10974:PF06890:PF01752:PF03238:PF13247,0,2,0,0,2,1016,0.0,1.0,0,0,0,0,0,0,1018,0,1.0,0,0
PF02940,PF11538:PF03919:PF09713:PF05841:PF13810,8,24,2,6,22,988,0.08,0.97,0.25,0.13,1,0,8,1,1009,0.0,0.99,0.0,-0.0
PF15090,PF15292:PF07904:PF05548:PF15778:PF15045,1,8,0,1,8,1009,0.0,0.99,0.0,-0.0,0,0,1,0,1017,0,1.0,0.0,0
PF11629,PF14593:PF12063:PF12202:PF12179:PF12605,4,19,4,0,15,999,0.21,0.99,1.0,0.46,3,3,1,0,1014,1.0,1.0,0.75,0.87
PF16075,PF08744:PF12628:PF09917:PF11179:PF03739,0,7,0,0,7,1011,0.0,0.99,0,0,0,0,0,0,1018,0,1.0,0,0
PF08154,PF16699:PF12265:PF04158:PF14077:PF08614,12,20,5,7,15,991,0.25,0.98,0.42,0.31,2,1,11,1,1005,0.5,0.99,0.08,0.2
PF06480,PF16193:PF16725:PF08519:PF12002:PF05496,16,29,5,11,24,978,0.17,0.97,0.31,0.22,8,4,12,4,998,0.5,0.98,0.25,0.35
PF05188,PF01624:PF05190:PF05192:PF00488:PF07453,28,47,28,0,19,971,0.6,0.98,1.0,0.76,24,24,4,0,990,1.0,1.0,0.86,0.92
PF14186,PF16276:PF08910:PF11628:PF16680:PF03066,5,12,0,5,12,1001,0.0,0.98,0.0,-0.01,0,0,5,0,1013,0,1.0,0.0,0
PF10531,PF01512:PF10589:PF03074:PF13375:PF00674,13,16,7,6,9,996,0.44,0.99,0.54,0.48,0,0,13,0,1005,0,0.99,0.0,0
PF02606,PF01701:PF15252:PF10166:PF15398:PF15710,2,4,0,2,4,1012,0.0,0.99,0.0,-0.0,0,0,2,0,1016,0,1.0,0.0,0
PF00361,PF00690:PF03810:PF00880:PF12612:PF00694,26,111,16,10,95,897,0.14,0.9,0.62,0.26,15,8,18,7,985,0.53,0.98,0.31,0.39
PF03426,PF02770:PF00441:PF07905:PF08028:PF02771,0,69,0,0,69,949,0.0,0.93,0,0,56,0,0,56,962,0.0,0.94,0,0
PF07842,PF12457:PF13821:PF01585:PF07713:PF11952,15,65,10,5,55,948,0.15,0.94,0.67,0.3,6,4,11,2,1001,0.67,0.99,0.27,0.42
PF15069,PF15060:PF15231:PF15685:PF15741:PF17085,0,1,0,0,1,1017,0.0,1.0,0,0,0,0,0,0,1018,0,1.0,0,0
PF12047,PF02008:PF00145:PF01426:PF06464:PF05066,12,58,12,0,46,960,0.21,0.95,1.0,0.44,12,8,4,4,1002,0.67,0.99,0.67,0.66
PF09435,PF08026:PF12194:PF06868:PF06805:PF15478,2,2,0,2,2,1014,0.0,1.0,0.0,-0.0,0,0,2,0,1016,0,1.0,0.0,0
PF02073,PF15834:PF02565:PF14539:PF06890:PF09510,1,0,0,1,0,1017,0,1.0,0.0,0,0,0,1,0,1017,0,1.0,0.0,0
PF16799,PF03521:PF11933:PF03520:PF11404:PF16885,2,14,1,1,13,1003,0.07,0.99,0.5,0.19,1,1,1,0,1016,1.0,1.0,0.5,0.71
PF07603,PF05673:PF10216:PF15091:PF12903:PF04222,0,0,0,0,0,1018,0,1.0,0,0,0,0,0,0,1018,0,1.0,0,0
PF01329,PF01097:PF10244:PF08561:PF07114:PF02284,16,20,4,12,16,986,0.2,0.97,0.25,0.21,1,0,16,1,1001,0.0,0.98,0.0,-0.0
PF02601,PF01752:PF04965:PF08291:PF09361:PF06505,2,2,0,2,2,1014,0.0,1.0,0.0,-0.0,0,0,2,0,1016,0,1.0,0.0,0
PF09453,PF13925:PF07304:PF15512:PF12931:PF13271,13,21,7,6,14,991,0.33,0.98,0.54,0.41,4,3,10,1,1004,0.75,0.99,0.23,0.41
PF06003,PF04144:PF11357:PF10173:PF04921:PF14857,6,32,3,3,29,983,0.09,0.97,0.5,0.21,3,0,6,3,1009,0.0,0.99,0.0,-0.0
PF05840,PF11019:PF12477:PF03745:PF09677:PF12241,0,1,0,0,1,1017,0.0,1.0,0,0,0,0,0,0,1018,0,1.0,0,0
PF16387,PF00686:PF04378:PF13340:PF03105:PF03009,1,69,1,0,68,949,0.01,0.93,1.0,0.12,9,1,0,8,1009,0.11,0.99,1.0,0.33
PF15281,PF02277:PF17076:PF06798:PF03241:PF03244,3,3,0,3,3,1012,0.0,0.99,0.0,-0.0,0,0,3,0,1015,0,1.0,0.0,0
PF14870,PF15334:PF08730:PF00669:PF01668:PF07359,1,3,0,1,3,1014,0.0,1.0,0.0,-0.0,0,0,1,0,1017,0,1.0,0.0,0
PF03984,PF07085:PF00905:PF08444:PF01515:PF08426,0,26,0,0,26,992,0.0,0.97,0,0,3,0,0,3,1015,0.0,1.0,0,0
PF16039,PF09057:PF02087:PF07240:PF15883:PF06876,0,2,0,0,2,1016,0.0,1.0,0,0,0,0,0,0,1018,0,1.0,0,0
PF13346,PF00297:PF09923:PF04506:PF09531:PF10558,0,35,0,0,35,983,0.0,0.97,0,0,2,0,0,2,1016,0.0,1.0,0,0
PF10791,PF03389:PF05488:PF07499:PF11612:PF04965,0,3,0,0,3,1015,0.0,1.0,0,0,0,0,0,0,1018,0,1.0,0,0
PF15246,PF10377:PF16501:PF16529:PF14738:PF04108,0,10,0,0,10,1008,0.0,0.99,0,0,1,0,0,1,1017,0.0,1.0,0,0
PF07295,PF09676:PF05746:PF14041:PF11351:PF14214,0,45,0,0,45,973,0.0,0.96,0,0,0,0,0,0,1018,0,1.0,0,0
PF07996,PF08808:PF05962:PF09498:PF01668:PF05167,3,4,0,3,4,1011,0.0,0.99,0.0,-0.0,0,0,3,0,1015,0,1.0,0.0,0
PF01315,PF02738:PF03450:PF01799:PF00941:PF00111,23,43,23,0,20,975,0.53,0.98,1.0,0.72,21,21,2,0,995,1.0,1.0,0.91,0.95
PF03332,PF01775:PF05724:PF05742:PF06093:PF05995,16,23,6,10,17,985,0.26,0.97,0.38,0.3,2,2,14,0,1002,1.0,0.99,0.12,0.35
PF09856,PF02561:PF05229:PF03831:PF06744:PF15529,0,0,0,0,0,1018,0,1.0,0,0,0,0,0,0,1018,0,1.0,0,0
PF04346,PF03244:PF17066:PF08258:PF15312:PF00796,2,1,0,2,1,1015,0.0,1.0,0.0,-0.0,0,0,2,0,1016,0,1.0,0.0,0
PF15201,PF10690:PF05675:PF02705:PF07399:PF03029,0,32,0,0,32,986,0.0,0.97,0,0,0,0,0,0,1018,0,1.0,0,0
PF08770,PF01943:PF08017:PF10731:PF11245:PF13094,0,8,0,0,8,1010,0.0,0.99,0,0,0,0,0,0,1018,0,1.0,0,0
PF05716,PF10522:PF14047:PF14049:PF11235:PF15792,4,8,2,2,6,1008,0.25,0.99,0.5,0.35,0,0,4,0,1014,0,1.0,0.0,0
PF03603,PF06005:PF00004:PF11811:PF00713:PF09912,3,157,1,2,156,859,0.01,0.84,0.33,0.03,0,0,3,0,1015,0,1.0,0.0,0
PF03474,PF08828:PF15791:PF12374:PF00751:PF09816,2,11,2,0,9,1007,0.18,0.99,1.0,0.42,1,1,1,0,1016,1.0,1.0,0.5,0.71
PF13761,PF14328:PF12479:PF13677:PF07833:PF13322,1,6,0,1,6,1011,0.0,0.99,0.0,-0.0,0,0,1,0,1017,0,1.0,0.0,0
PF13462,PF01097:PF07333:PF05039:PF00321:PF00537,10,5,0,10,5,1003,0.0,0.99,0.0,-0.01,0,0,10,0,1008,0,0.99,0.0,0
PF04013,PF07805:PF05513:PF11874:PF10566:PF08497,1,2,0,1,2,1015,0.0,1.0,0.0,-0.0,0,0,1,0,1017,0,1.0,0.0,0
PF01256,PF01652:PF03091:PF12239:PF02936:PF10190,15,49,6,9,43,960,0.12,0.95,0.4,0.2,4,3,12,1,1002,0.75,0.99,0.2,0.38
PF15471,PF04965:PF08867:PF05939:PF08744:PF03525,0,0,0,0,0,1018,0,1.0,0,0,0,0,0,0,1018,0,1.0,0,0
PF12610,PF09267:PF02864:PF12162:PF02865:PF14596,0,5,0,0,5,1013,0.0,1.0,0,0,2,0,0,2,1016,0.0,1.0,0,0
PF04931,PF10257:PF09736:PF08728:PF11977:PF03359,13,29,4,9,25,980,0.14,0.97,0.31,0.19,4,3,10,1,1004,0.75,0.99,0.23,0.41
PF16183,PF12423:PF12473:PF16540:PF00225:PF14739,19,104,19,0,85,914,0.18,0.92,1.0,0.41,15,14,5,1,998,0.93,0.99,0.74,0.83
PF04100,PF16854:PF06662:PF04031:PF08161:PF08216,6,19,4,2,15,997,0.21,0.98,0.67,0.37,2,2,4,0,1012,1.0,1.0,0.33,0.58
PF10251,PF14931:PF15551:PF02371:PF01415:PF15096,3,6,1,2,5,1010,0.17,0.99,0.33,0.23,0,0,3,0,1015,0,1.0,0.0,0
PF08092,PF08089:PF11317:PF02531:PF05151:PF03379,1,3,0,1,3,1014,0.0,1.0,0.0,-0.0,0,0,1,0,1017,0,1.0,0.0,0
PF15424,PF14882:PF06798:PF06403:PF14690:PF13722,0,1,0,0,1,1017,0.0,1.0,0,0,0,0,0,0,1018,0,1.0,0,0
PF02649,PF07143:PF17186:PF00496:PF02754:PF09330,5,23,2,3,21,992,0.09,0.98,0.4,0.18,0,0,5,0,1013,0,1.0,0.0,0
PF00376,PF09278:PF12792:PF07494:PF13421:PF01136,2,4,2,0,2,1014,0.5,1.0,1.0,0.71,0,0,2,0,1016,0,1.0,0.0,0
PF01344,PF10102:PF07646:PF02594:PF02676:PF06588,84,30,22,62,8,926,0.73,0.93,0.26,0.41,3,3,81,0,934,1.0,0.92,0.04,0.18
PF13102,PF08037:PF05928:PF15844:PF05613:PF04766,0,1,0,0,1,1017,0.0,1.0,0,0,0,0,0,0,1018,0,1.0,0,0
PF05911,PF03468:PF04108:PF03470:PF07888:PF07899,0,13,0,0,13,1005,0.0,0.99,0,0,1,0,0,1,1017,0.0,1.0,0,0
PF06824,PF06609:PF14612:PF07519:PF11700:PF04148,11,30,5,6,25,982,0.17,0.97,0.45,0.26,2,1,10,1,1006,0.5,0.99,0.09,0.21
PF07881,PF02952:PF07882:PF05974:PF07411:PF13742,1,3,1,0,2,1015,0.33,1.0,1.0,0.58,0,0,1,0,1017,0,1.0,0.0,0
PF04178,PF03208:PF00810:PF04176:PF03650:PF06244,13,43,7,6,36,969,0.16,0.96,0.54,0.28,4,4,9,0,1005,1.0,0.99,0.31,0.55
PF09108,PF03090:PF15032:PF02277:PF06798:PF09109,0,3,0,0,3,1015,0.0,1.0,0,0,0,0,0,0,1018,0,1.0,0,0
PF07168,PF07712:PF00197:PF06113:PF06376:PF03331,2,8,0,2,8,1008,0.0,0.99,0.0,-0.0,0,0,2,0,1016,0,1.0,0.0,0
PF08562,PF00188:PF05884:PF03229:PF04230:PF10707,0,56,0,0,56,962,0.0,0.94,0,0,0,0,0,0,1018,0,1.0,0,0
PF05262,PF07988:PF06640:PF08558:PF09316:PF15160,1,10,1,0,9,1008,0.1,0.99,1.0,0.31,0,0,1,0,1017,0,1.0,0.0,0
PF11618,PF16056:PF15625:PF09457:PF06631:PF17047,4,27,3,1,24,990,0.11,0.98,0.75,0.28,1,1,3,0,1014,1.0,1.0,0.25,0.5
PF01530,PF08474:PF17208:PF12140:PF02820:PF12618,14,24,10,4,14,990,0.42,0.98,0.71,0.54,4,2,12,2,1002,0.5,0.99,0.14,0.26
PF09358,PF16191:PF16190:PF16195:PF14732:PF10585,12,12,4,8,8,998,0.33,0.98,0.33,0.33,3,1,11,2,1004,0.33,0.99,0.08,0.16
PF03760,PF04852:PF15003:PF13933:PF08636:PF13564,1,15,1,0,14,1003,0.07,0.99,1.0,0.26,0,0,1,0,1017,0,1.0,0.0,0
PF07123,PF05936:PF07338:PF06834:PF15272:PF13795,6,5,2,4,3,1009,0.4,0.99,0.33,0.36,0,0,6,0,1012,0,0.99,0.0,0
PF03470,PF03468:PF10212:PF15905:PF15908:PF04388,3,19,3,0,16,999,0.16,0.98,1.0,0.39,2,0,3,2,1013,0.0,1.0,0.0,-0.0
PF00253,PF00124:PF00499:PF00115:PF00119:PF00507,16,22,5,11,17,985,0.23,0.97,0.31,0.25,4,2,14,2,1000,0.5,0.98,0.12,0.24
PF07716,PF00170:PF00233:PF02701:PF00250:PF14719,36,82,19,17,63,919,0.23,0.92,0.53,0.31,6,4,32,2,980,0.67,0.97,0.11,0.26
PF11701,PF12770:PF16669:PF08640:PF10350:PF08216,11,32,4,7,28,979,0.12,0.97,0.36,0.2,3,2,9,1,1006,0.67,0.99,0.18,0.34
PF14113,PF06890:PF13722:PF08411:PF15976:PF04355,0,1,0,0,1,1017,0.0,1.0,0,0,0,0,0,0,1018,0,1.0,0,0
PF03250,PF10189:PF15996:PF06830:PF10699:PF05450,4,22,1,3,21,993,0.05,0.98,0.25,0.1,0,0,4,0,1014,0,1.0,0.0,0
PF13655,PF08388:PF06817:PF08284:PF12009:PF13804,6,33,6,0,27,985,0.18,0.97,1.0,0.42,3,1,5,2,1010,0.33,0.99,0.17,0.23
PF14163,PF10399:PF04552:PF09826:PF17164:PF04917,2,6,2,0,4,1012,0.33,1.0,1.0,0.58,0,0,2,0,1016,0,1.0,0.0,0
PF17176,PF13718:PF13725:PF05127:PF08351:PF00807,2,16,2,0,14,1002,0.12,0.99,1.0,0.35,12,1,1,11,1005,0.08,0.99,0.5,0.2
PF07883,PF05899:PF02502:PF06249:PF11807:PF06052,30,23,11,19,12,976,0.48,0.97,0.37,0.4,1,1,29,0,988,1.0,0.97,0.03,0.18
PF10480,PF03306:PF17084:PF04624:PF10793:PF13530,0,9,0,0,9,1009,0.0,0.99,0,0,0,0,0,0,1018,0,1.0,0,0
PF14494,PF09715:PF03601:PF09962:PF09216:PF15460,0,2,0,0,2,1016,0.0,1.0,0,0,0,0,0,0,1018,0,1.0,0,0
PF12357,PF16165:PF08150:PF00614:PF13918:PF08165,7,25,6,1,19,992,0.24,0.98,0.86,0.45,4,3,4,1,1010,0.75,1.0,0.43,0.56
PF02177,PF10515:PF12925:PF03494:PF12924:PF15761,9,9,8,1,1,1008,0.89,1.0,0.89,0.89,8,8,1,0,1009,1.0,1.0,0.89,0.94
PF05306,PF06581:PF09057:PF06729:PF16037:PF03488,0,1,0,0,1,1017,0.0,1.0,0,0,0,0,0,0,1018,0,1.0,0,0
PF08384,PF08035:PF16102:PF00976:PF04422:PF05991,0,3,0,0,3,1015,0.0,1.0,0,0,0,0,0,0,1018,0,1.0,0,0
PF09316,PF07988:PF08558:PF16496:PF06640:PF04433,5,28,4,1,24,989,0.14,0.98,0.8,0.33,0,0,5,0,1013,0,1.0,0.0,0
PF13545,PF10137:PF16526:PF00325:PF08412:PF15666,3,13,1,2,12,1003,0.08,0.99,0.33,0.16,0,0,3,0,1015,0,1.0,0.0,0
PF13292,PF00456:PF02779:PF02449:PF02780:PF14764,3,54,3,0,51,964,0.06,0.95,1.0,0.23,12,1,2,11,1004,0.08,0.99,0.33,0.16
PF14319,PF09795:PF09986:PF16330:PF10557:PF03256,0,38,0,0,38,980,0.0,0.96,0,0,0,0,0,0,1018,0,1.0,0,0
PF04468,PF15050:PF07392:PF15673:PF05551:PF14474,7,7,2,5,5,1006,0.29,0.99,0.29,0.28,0,0,7,0,1011,0,0.99,0.0,0
PF13613,PF12596:PF05485:PF13359:PF14949:PF12017,8,92,8,0,84,926,0.09,0.92,1.0,0.28,12,4,4,8,1002,0.33,0.99,0.5,0.4
PF03959,PF12368:PF01667:PF06617:PF11176:PF08806,28,28,8,20,20,970,0.29,0.96,0.29,0.27,2,2,26,0,990,1.0,0.97,0.07,0.26
PF00450,PF05388:PF00694:PF00141:PF00232:PF03140,53,86,33,20,53,912,0.38,0.93,0.62,0.45,10,6,47,4,961,0.6,0.95,0.11,0.25
PF05513,PF05509:PF07178:PF05309:PF03831:PF06586,1,1,1,0,0,1017,1.0,1.0,1.0,1.0,1,1,0,0,1017,1.0,1.0,1.0,1.0
PF06472,PF01061:PF14510:PF13304:PF04068:PF00037,13,68,9,4,59,946,0.13,0.94,0.69,0.28,11,3,10,8,997,0.27,0.98,0.23,0.24
PF05030,PF08624:PF16944:PF14611:PF10307:PF10198,6,14,0,6,14,998,0.0,0.98,0.0,-0.01,0,0,6,0,1012,0,0.99,0.0,0
PF13306,PF13855:PF00001:PF12369:PF01462:PF12799,38,206,35,3,171,809,0.17,0.83,0.92,0.35,30,14,24,16,964,0.47,0.96,0.37,0.39
PF09020,PF08843:PF05399:PF03243:PF01303:PF10468,0,4,0,0,4,1014,0.0,1.0,0,0,0,0,0,0,1018,0,1.0,0,0
PF01154,PF08540:PF02797:PF04064:PF05634:PF03900,19,47,18,1,29,970,0.38,0.97,0.95,0.59,3,2,17,1,998,0.67,0.98,0.11,0.26
PF15331,PF15752:PF03553:PF12081:PF02336:PF15021,2,3,0,2,3,1013,0.0,1.0,0.0,-0.0,0,0,2,0,1016,0,1.0,0.0,0
PF01140,PF01141:PF02093:PF02337:PF00607:PF00077,5,18,4,1,14,999,0.22,0.99,0.8,0.42,5,4,1,1,1012,0.8,1.0,0.8,0.8
PF16521,PF01843:PF07926:PF16735:PF14846:PF05104,5,35,3,2,32,981,0.09,0.97,0.6,0.22,2,2,3,0,1013,1.0,1.0,0.4,0.63
PF16608,PF12938:PF10427:PF06495:PF12220:PF12196,4,9,2,2,7,1007,0.22,0.99,0.5,0.33,1,1,3,0,1014,1.0,1.0,0.25,0.5
PF06487,PF03760:PF04852:PF15003:PF11623:PF12926,4,6,0,4,6,1008,0.0,0.99,0.0,-0.0,0,0,4,0,1014,0,1.0,0.0,0
PF16972,PF11069:PF17223:PF17054:PF12350:PF12243,2,12,1,1,11,1005,0.08,0.99,0.5,0.2,0,0,2,0,1016,0,1.0,0.0,0
PF16420,PF08825:PF00899:PF10585:PF16191:PF16190,11,57,11,0,46,961,0.19,0.95,1.0,0.43,3,1,10,2,1005,0.33,0.99,0.09,0.17
PF02948,PF09394:PF12201:PF11493:PF06217:PF02972,4,0,0,4,0,1014,0,1.0,0.0,0,0,0,4,0,1014,0,1.0,0.0,0
PF04056,PF07975:PF04704:PF15350:PF03648:PF14688,9,17,5,4,12,997,0.29,0.98,0.56,0.4,0,0,9,0,1009,0,0.99,0.0,0
PF01608,PF08913:PF09141:PF16511:PF05902:PF16515,22,23,12,10,11,985,0.52,0.98,0.55,0.52,5,5,17,0,996,1.0,0.98,0.23,0.47
PF16840,PF15318:PF10357:PF00022:PF11187:PF15361,0,64,0,0,64,954,0.0,0.94,0,0,2,0,0,2,1016,0.0,1.0,0,0
PF00688,PF04709:PF00019:PF09771:PF02045:PF15369,15,22,15,0,7,996,0.68,0.99,1.0,0.82,5,5,10,0,1003,1.0,0.99,0.33,0.57
PF07297,PF03912:PF06882:PF14985:PF02972:PF13592,5,4,0,5,4,1009,0.0,0.99,0.0,-0.0,0,0,5,0,1013,0,1.0,0.0,0
PF16421,PF08781:PF02319:PF04855:PF14949:PF13865,8,38,7,1,31,979,0.18,0.97,0.88,0.39,6,3,5,3,1007,0.5,0.99,0.38,0.43
PF04552,PF04963:PF08479:PF07805:PF03831:PF13269,1,2,1,0,1,1016,0.5,1.0,1.0,0.71,0,0,1,0,1017,0,1.0,0.0,0
PF10145,PF15186:PF01303:PF12194:PF06074:PF07960,0,4,0,0,4,1014,0.0,1.0,0,0,0,0,0,0,1018,0,1.0,0,0
PF00875,PF03441:PF12546:PF03009:PF04244:PF03092,18,45,11,7,34,966,0.24,0.96,0.61,0.37,2,2,16,0,1000,1.0,0.98,0.11,0.33
PF09343,PF15175:PF15849:PF17062:PF17084:PF15134,2,1,0,2,1,1015,0.0,1.0,0.0,-0.0,0,0,2,0,1016,0,1.0,0.0,0
PF12620,PF11568:PF12204:PF11016:PF03703:PF15673,2,6,1,1,5,1011,0.17,0.99,0.5,0.29,0,0,2,0,1016,0,1.0,0.0,0
PF13328,PF04607:PF13291:PF14923:PF00380:PF12999,10,35,7,3,28,980,0.2,0.97,0.7,0.36,2,2,8,0,1008,1.0,0.99,0.2,0.45
PF04719,PF08692:PF08508:PF11016:PF02575:PF14279,12,8,1,11,7,999,0.12,0.98,0.08,0.09,0,0,12,0,1006,0,0.99,0.0,0
PF06288,PF01323:PF08338:PF12435:PF16952:PF09296,1,34,1,0,33,984,0.03,0.97,1.0,0.17,3,0,1,3,1014,0.0,1.0,0.0,-0.0
PF12899,PF14159:PF03350:PF11833:PF03168:PF07816,2,16,1,1,15,1001,0.06,0.98,0.5,0.17,0,0,2,0,1016,0,1.0,0.0,0
PF01658,PF07994:PF03670:PF11105:PF07823:PF15556,1,15,1,0,14,1003,0.07,0.99,1.0,0.26,0,0,1,0,1017,0,1.0,0.0,0
PF04072,PF13673:PF07819:PF03178:PF12333:PF14959,15,53,10,5,43,960,0.19,0.95,0.67,0.34,5,4,11,1,1002,0.8,0.99,0.27,0.46
PF01058,PF00329:PF00124:PF00507:PF00499:PF00430,17,24,9,8,15,986,0.38,0.98,0.53,0.43,2,1,16,1,1000,0.5,0.98,0.06,0.17
PF01498,PF13936:PF02517:PF13813:PF16087:PF01066,48,63,26,22,37,933,0.41,0.94,0.54,0.44,6,4,44,2,968,0.67,0.95,0.08,0.23
PF01480,PF16131:PF10378:PF15815:PF03941:PF07744,24,38,12,12,26,968,0.32,0.96,0.5,0.38,3,3,21,0,994,1.0,0.98,0.12,0.35
PF05155,PF12081:PF06082:PF11874:PF09951:PF11794,0,0,0,0,0,1018,0,1.0,0,0,0,0,0,0,1018,0,1.0,0,0
PF00503,PF03332:PF04922:PF06093:PF14808:PF05822,44,34,16,28,18,956,0.47,0.95,0.36,0.39,3,3,41,0,974,1.0,0.96,0.07,0.26
PF00970,PF00175:PF00174:PF03404:PF09791:PF17147,37,70,36,1,34,947,0.51,0.97,0.97,0.69,16,14,23,2,979,0.88,0.98,0.38,0.57
PF13001,PF11916:PF12755:PF08146:PF12074:PF11919,14,31,8,6,23,981,0.26,0.97,0.57,0.37,2,2,12,0,1004,1.0,0.99,0.14,0.38
PF03483,PF03484:PF01409:PF00984:PF03147:PF07801,18,36,16,2,20,980,0.44,0.98,0.89,0.62,8,8,10,0,1000,1.0,0.99,0.44,0.66
PF12598,PF16176:PF11078:PF00907:PF10477:PF05178,1,25,1,0,24,993,0.04,0.98,1.0,0.2,3,1,0,2,1015,0.33,1.0,1.0,0.58
PF05387,PF15576:PF15120:PF03823:PF07259:PF15829,0,5,0,0,5,1013,0.0,1.0,0,0,1,0,0,1,1017,0.0,1.0,0,0
PF15752,PF15762:PF04625:PF08258:PF05874:PF06626,0,3,0,0,3,1015,0.0,1.0,0,0,0,0,0,0,1018,0,1.0,0,0
PF15508,PF05432:PF17187:PF05076:PF14875:PF08029,4,13,2,2,11,1003,0.15,0.99,0.5,0.27,1,0,4,1,1013,0.0,1.0,0.0,-0.0
PF10279,PF11751:PF13995:PF07157:PF03729:PF07409,0,0,0,0,0,1018,0,1.0,0,0,0,0,0,0,1018,0,1.0,0,0
PF12328,PF06351:PF15316:PF02024:PF00489:PF00727,4,10,0,4,10,1004,0.0,0.99,0.0,-0.01,0,0,4,0,1014,0,1.0,0.0,0
PF13888,PF13887:PF13884:PF05224:PF16099:PF12886,6,21,6,0,15,997,0.29,0.99,1.0,0.53,6,6,0,0,1012,1.0,1.0,1.0,1.0
PF07735,PF01827:PF07734:PF08268:PF10442:PF12078,11,31,7,4,24,983,0.23,0.97,0.64,0.37,7,2,9,5,1002,0.29,0.99,0.18,0.22
PF02101,PF08228:PF09784:PF01878:PF06907:PF07253,7,12,1,6,11,1000,0.08,0.98,0.14,0.1,0,0,7,0,1011,0,0.99,0.0,0
PF01412,PF01237:PF08916:PF08174:PF16553:PF15898,47,49,19,28,30,941,0.39,0.94,0.4,0.37,1,1,46,0,971,1.0,0.95,0.02,0.14
PF10421,PF01909:PF13427:PF13373:PF16455:PF16843,5,28,4,1,24,989,0.14,0.98,0.8,0.33,2,1,4,1,1012,0.5,1.0,0.2,0.31
PF09111,PF09110:PF13892:PF16203:PF08061:PF07443,14,30,14,0,16,988,0.47,0.98,1.0,0.68,5,5,9,0,1004,1.0,0.99,0.36,0.59
PF02628,PF05630:PF03650:PF01774:PF04176:PF10160,12,28,4,8,24,982,0.14,0.97,0.33,0.2,1,1,11,0,1006,1.0,0.99,0.08,0.29
PF10119,PF17192:PF11130:PF09677:PF00381:PF03882,0,0,0,0,0,1018,0,1.0,0,0,0,0,0,0,1018,0,1.0,0,0
PF12257,PF16646:PF09743:PF16474:PF00610:PF08687,10,47,7,3,40,968,0.15,0.96,0.7,0.31,2,1,9,1,1007,0.5,0.99,0.1,0.22
PF16414,PF02460:PF12349:PF00368:PF03176:PF13323,16,61,16,0,45,957,0.26,0.96,1.0,0.5,5,1,15,4,998,0.2,0.98,0.06,0.1
PF12862,PF05183:PF11701:PF13374:PF09797:PF15979,15,74,11,4,63,940,0.15,0.93,0.73,0.31,10,4,11,6,997,0.4,0.98,0.27,0.32
PF15691,PF15741:PF15703:PF17085:PF16829:PF15234,1,1,0,1,1,1016,0.0,1.0,0.0,-0.0,0,0,1,0,1017,0,1.0,0.0,0
PF09984,PF05272:PF12729:PF14690:PF13861:PF10279,2,1,1,1,0,1016,1.0,1.0,0.5,0.71,0,0,2,0,1016,0,1.0,0.0,0
PF00156,PF00215:PF04043:PF14572:PF10155:PF04515,33,55,20,13,35,950,0.36,0.95,0.61,0.45,5,5,28,0,985,1.0,0.97,0.15,0.38
PF12760,PF03831:PF05913:PF03539:PF14690:PF07411,0,2,0,0,2,1016,0.0,1.0,0,0,0,0,0,0,1018,0,1.0,0,0
PF11429,PF05316:PF10035:PF07391:PF15681:PF12834,1,6,0,1,6,1011,0.0,0.99,0.0,-0.0,0,0,1,0,1017,0,1.0,0.0,0
PF04844,PF03479:PF11250:PF02234:PF08209:PF11282,6,25,4,2,21,991,0.16,0.98,0.67,0.32,1,1,5,0,1012,1.0,1.0,0.17,0.41
PF04201,PF10246:PF03034:PF16680:PF15095:PF03821,4,20,1,3,19,995,0.05,0.98,0.25,0.1,0,0,4,0,1014,0,1.0,0.0,0
PF07646,PF06588:PF10102:PF07734:PF08268:PF15881,14,25,5,9,20,984,0.2,0.97,0.36,0.25,1,1,13,0,1004,1.0,0.99,0.07,0.27
PF15498,PF17164:PF06826:PF07499:PF01580:PF11019,0,7,0,0,7,1011,0.0,0.99,0,0,0,0,0,0,1018,0,1.0,0,0
PF14805,PF04764:PF14882:PF15029:PF14690:PF07308,3,0,0,3,0,1015,0,1.0,0.0,0,0,0,3,0,1015,0,1.0,0.0,0
PF13380,PF13607:PF15161:PF14996:PF06466:PF02567,8,23,6,2,17,993,0.26,0.98,0.75,0.44,2,1,7,1,1009,0.5,0.99,0.12,0.25
PF17135,PF01268:PF00763:PF10376:PF10504:PF02882,12,32,7,5,25,981,0.22,0.97,0.58,0.35,13,7,5,6,1000,0.54,0.99,0.58,0.55
PF06312,PF05679:PF06237:PF03074:PF08652:PF10179,3,27,3,0,24,991,0.11,0.98,1.0,0.33,0,0,3,0,1015,0,1.0,0.0,0
PF07196,PF01258:PF10458:PF06827:PF09358:PF13866,0,25,0,0,25,993,0.0,0.98,0,0,3,0,0,3,1015,0.0,1.0,0,0
PF10285,PF10284:PF05295:PF06753:PF02057:PF07276,0,2,0,0,2,1016,0.0,1.0,0,0,0,0,0,0,1018,0,1.0,0,0
PF03399,PF16769:PF16768:PF16766:PF10211:PF15246,23,8,6,17,2,993,0.75,0.98,0.26,0.44,1,1,22,0,995,1.0,0.98,0.04,0.21
PF08241,PF13847:PF02353:PF00328:PF02536:PF13532,78,114,43,35,71,869,0.38,0.9,0.55,0.4,17,16,62,1,939,0.94,0.94,0.21,0.42
PF05149,PF05551:PF14988:PF15311:PF03275:PF04468,2,13,0,2,13,1003,0.0,0.99,0.0,-0.01,2,0,2,2,1014,0.0,1.0,0.0,-0.0
PF10512,PF10444:PF15805:PF15803:PF04422:PF10234,1,9,0,1,9,1008,0.0,0.99,0.0,-0.0,0,0,1,0,1017,0,1.0,0.0,0
PF05182,PF10309:PF14722:PF16043:PF15249:PF09816,17,27,8,9,19,982,0.3,0.97,0.47,0.36,0,0,17,0,1001,0,0.98,0.0,0
PF02072,PF15088:PF13094:PF12724:PF15333:PF15748,0,1,0,0,1,1017,0.0,1.0,0,0,0,0,0,0,1018,0,1.0,0,0
PF10264,PF04182:PF14545:PF13945:PF07001:PF11261,6,18,2,4,16,996,0.11,0.98,0.33,0.18,0,0,6,0,1012,0,0.99,0.0,0
PF12889,PF03354:PF02591:PF01429:PF17058:PF09402,0,33,0,0,33,985,0.0,0.97,0,0,0,0,0,0,1018,0,1.0,0,0
PF02652,PF06826:PF07523:PF15750:PF02589:PF15834,4,8,1,3,7,1007,0.12,0.99,0.25,0.17,0,0,4,0,1014,0,1.0,0.0,0
PF04527,PF15955:PF05497:PF15868:PF00965:PF11018,0,19,0,0,19,999,0.0,0.98,0,0,0,0,0,0,1018,0,1.0,0,0
PF15028,PF03618:PF10912:PF15001:PF15553:PF06681,0,4,0,0,4,1014,0.0,1.0,0,0,0,0,0,0,1018,0,1.0,0,0
PF06377,PF08738:PF16716:PF12046:PF14672:PF10839,2,0,0,2,0,1016,0,1.0,0.0,0,0,0,2,0,1016,0,1.0,0.0,0
PF08170,PF06978:PF09797:PF12733:PF06662:PF14022,6,16,6,0,10,1002,0.38,0.99,1.0,0.61,2,1,5,1,1011,0.5,0.99,0.17,0.29
PF08831,PF09307:PF10511:PF02961:PF00086:PF09289,3,26,3,0,23,992,0.12,0.98,1.0,0.34,3,0,3,3,1012,0.0,0.99,0.0,-0.0
PF09273,PF05033:PF15811:PF11764:PF02064:PF01753,17,81,8,9,73,928,0.1,0.92,0.47,0.19,7,2,15,5,996,0.29,0.98,0.12,0.17
PF08157,PF00524:PF13005:PF14917:PF05164:PF06965,4,7,1,3,6,1008,0.14,0.99,0.25,0.18,0,0,4,0,1014,0,1.0,0.0,0
PF14322,PF05513:PF11751:PF04355:PF10109:PF05509,0,1,0,0,1,1017,0.0,1.0,0,0,0,0,0,0,1018,0,1.0,0,0
PF06671,PF02343:PF15789:PF02084:PF10322:PF10578,0,2,0,0,2,1016,0.0,1.0,0,0,0,0,0,0,1018,0,1.0,0,0
PF03402,PF00143:PF00124:PF12020:PF00119:PF00965,3,18,2,1,16,999,0.11,0.98,0.67,0.27,0,0,3,0,1015,0,1.0,0.0,0
PF12430,PF12537:PF01237:PF01028:PF00804:PF01777,1,68,1,0,67,950,0.01,0.93,1.0,0.12,6,1,0,5,1012,0.17,1.0,1.0,0.41
PF13735,PF00308:PF12626:PF05280:PF11492:PF15150,2,10,2,0,8,1008,0.2,0.99,1.0,0.45,0,0,2,0,1016,0,1.0,0.0,0
PF00710,PF07693:PF16553:PF11904:PF13606:PF15898,16,55,7,9,48,954,0.13,0.94,0.44,0.21,3,3,13,0,1002,1.0,0.99,0.19,0.43
PF10277,PF00252:PF16906:PF08790:PF14027:PF05832,27,44,12,15,32,959,0.27,0.95,0.44,0.33,9,5,22,4,987,0.56,0.97,0.19,0.31
PF15084,PF15292:PF15232:PF12516:PF15249:PF15309,3,12,2,1,10,1005,0.17,0.99,0.67,0.33,0,0,3,0,1015,0,1.0,0.0,0
PF15031,PF15171:PF15109:PF03488:PF16218:PF07464,6,3,0,6,3,1009,0.0,0.99,0.0,-0.0,0,0,6,0,1012,0,0.99,0.0,0
PF14778,PF05719:PF14943:PF06870:PF00048:PF00965,3,35,3,0,32,983,0.09,0.97,1.0,0.29,2,1,2,1,1014,0.5,1.0,0.33,0.41
PF08430,PF09354:PF16675:PF16676:PF16159:PF13724,5,9,4,1,5,1008,0.44,0.99,0.8,0.59,2,2,3,0,1013,1.0,1.0,0.4,0.63
PF04152,PF16891:PF10360:PF05011:PF02872:PF14008,14,47,9,5,38,966,0.19,0.96,0.64,0.34,4,3,11,1,1003,0.75,0.99,0.21,0.4
PF14838,PF14837:PF02128:PF07504:PF16334:PF01989,4,5,3,1,2,1012,0.6,1.0,0.75,0.67,2,1,3,1,1013,0.5,1.0,0.25,0.35
PF05670,PF14722:PF08573:PF07557:PF06294:PF15266,13,24,3,10,21,984,0.12,0.97,0.23,0.16,1,0,13,1,1004,0.0,0.99,0.0,-0.0
PF12460,PF07035:PF12036:PF04091:PF08427:PF08696,6,32,1,5,31,981,0.03,0.96,0.17,0.06,2,0,6,2,1010,0.0,0.99,0.0,-0.0
PF05453,PF08093:PF11402:PF15547:PF15355:PF07960,1,3,0,1,3,1014,0.0,1.0,0.0,-0.0,0,0,1,0,1017,0,1.0,0.0,0
PF15873,PF05135:PF15856:PF17022:PF10514:PF12827,1,1,0,1,1,1016,0.0,1.0,0.0,-0.0,0,0,1,0,1017,0,1.0,0.0,0
PF04922,PF06172:PF02089:PF10266:PF05724:PF08584,9,24,3,6,21,988,0.12,0.97,0.33,0.19,0,0,9,0,1009,0,0.99,0.0,0
PF12406,PF04145:PF07080:PF07823:PF06708:PF08292,1,32,1,0,31,986,0.03,0.97,1.0,0.17,2,0,1,2,1015,0.0,1.0,0.0,-0.0
PF16214,PF06327:PF07700:PF08376:PF00211:PF04940,9,59,8,1,51,958,0.14,0.95,0.89,0.34,4,3,6,1,1008,0.75,0.99,0.33,0.5
PF01925,PF04406:PF06237:PF01144:PF01273:PF03385,9,39,5,4,34,975,0.13,0.96,0.56,0.25,4,2,7,2,1007,0.5,0.99,0.22,0.33
PF00015,PF02203:PF00563:PF00672:PF00990:PF08918,12,27,10,2,17,989,0.37,0.98,0.83,0.55,7,5,7,2,1004,0.71,0.99,0.42,0.54
PF04601,PF11891:PF04139:PF05097:PF06136:PF07223,3,22,3,0,19,996,0.14,0.98,1.0,0.37,1,1,2,0,1015,1.0,1.0,0.33,0.58
PF13914,PF05548:PF10104:PF15274:PF15045:PF07904,7,11,2,5,9,1002,0.18,0.99,0.29,0.22,1,1,6,0,1011,1.0,0.99,0.14,0.38
PF02568,PF07494:PF04466:PF12538:PF06744:PF14606,2,3,0,2,3,1013,0.0,1.0,0.0,-0.0,0,0,2,0,1016,0,1.0,0.0,0
PF10737,PF15107:PF03238:PF17112:PF15212:PF01316,0,2,0,0,2,1016,0.0,1.0,0,0,0,0,0,0,1018,0,1.0,0,0
PF13910,PF14959:PF15027:PF08168:PF15627:PF16748,2,3,0,2,3,1013,0.0,1.0,0.0,-0.0,0,0,2,0,1016,0,1.0,0.0,0
PF04740,PF13780:PF16888:PF03428:PF16325:PF14842,0,1,0,0,1,1017,0.0,1.0,0,0,0,0,0,0,1018,0,1.0,0,0
PF07305,PF11075:PF10366:PF04797:PF08771:PF04212,0,49,0,0,49,969,0.0,0.95,0,0,1,0,0,1,1017,0.0,1.0,0,0
PF09776,PF09837:PF04138:PF10044:PF01523:PF10111,1,12,0,1,12,1005,0.0,0.99,0.0,-0.0,0,0,1,0,1017,0,1.0,0.0,0
PF12499,PF11765:PF02415:PF09770:PF03382:PF00073,1,21,1,0,20,997,0.05,0.98,1.0,0.22,0,0,1,0,1017,0,1.0,0.0,0
PF09861,PF03525:PF16055:PF01514:PF00669:PF08744,0,1,0,0,1,1017,0.0,1.0,0,0,0,0,0,0,1018,0,1.0,0,0
PF17050,PF15556:PF16647:PF14534:PF15119:PF13550,1,2,0,1,2,1015,0.0,1.0,0.0,-0.0,0,0,1,0,1017,0,1.0,0.0,0
PF07905,PF11855:PF03426:PF05284:PF05452:PF10796,0,2,0,0,2,1016,0.0,1.0,0,0,0,0,0,0,1018,0,1.0,0,0
PF05404,PF02752:PF10937:PF00532:PF00339:PF10722,3,40,1,2,39,976,0.03,0.96,0.33,0.08,2,0,3,2,1013,0.0,1.0,0.0,-0.0
PF07511,PF06834:PF12080:PF01706:PF05509:PF00516,0,2,0,0,2,1016,0.0,1.0,0,0,0,0,0,0,1018,0,1.0,0,0
PF17045,PF09762:PF11577:PF11496:PF15066:PF15368,0,15,0,0,15,1003,0.0,0.99,0,0,0,0,0,0,1018,0,1.0,0,0
PF15783,PF17053:PF10279:PF10873:PF07708:PF13559,1,2,0,1,2,1015,0.0,1.0,0.0,-0.0,0,0,1,0,1017,0,1.0,0.0,0
PF01208,PF05562:PF01264:PF04690:PF05096:PF07712,12,11,2,10,9,997,0.18,0.98,0.17,0.16,1,0,12,1,1005,0.0,0.99,0.0,-0.0
PF09827,PF01258:PF02412:PF08516:PF11855:PF12260,0,34,0,0,34,984,0.0,0.97,0,0,3,0,0,3,1015,0.0,1.0,0,0
PF15175,PF08945:PF15207:PF15776:PF17062:PF15046,0,6,0,0,6,1012,0.0,0.99,0,0,0,0,0,0,1018,0,1.0,0,0
PF15101,PF03050:PF10974:PF11638:PF13247:PF14659,1,4,0,1,4,1013,0.0,1.0,0.0,-0.0,0,0,1,0,1017,0,1.0,0.0,0
PF10584,PF12465:PF00227:PF04859:PF08652:PF04833,32,90,31,1,59,927,0.34,0.94,0.97,0.56,0,0,32,0,986,0,0.97,0.0,0
PF03459,PF03412:PF00950:PF02694:PF05936:PF12857,3,5,2,1,3,1012,0.4,1.0,0.67,0.51,2,2,1,0,1015,1.0,1.0,0.67,0.82
PF13478,PF04290:PF06808:PF06240:PF03480:PF08352,6,10,6,0,4,1008,0.6,1.0,1.0,0.77,6,6,0,0,1012,1.0,1.0,1.0,1.0
PF10405,PF10403:PF10404:PF03835:PF04721:PF16485,10,13,10,0,3,1005,0.77,1.0,1.0,0.88,7,7,3,0,1008,1.0,1.0,0.7,0.84
PF00355,PF01180:PF07992:PF08417:PF04305:PF00848,39,103,30,9,73,906,0.29,0.92,0.77,0.44,7,7,32,0,979,1.0,0.97,0.18,0.42
PF15080,PF14512:PF03238:PF15547:PF01303:PF11402,1,0,0,1,0,1017,0,1.0,0.0,0,0,0,1,0,1017,0,1.0,0.0,0
PF16644,PF08619:PF00999:PF02254:PF02080:PF06427,2,61,2,0,59,957,0.03,0.94,1.0,0.18,3,1,1,2,1014,0.33,1.0,0.5,0.41
PF03091,PF02284:PF10244:PF12020:PF10455:PF04176,13,19,4,9,15,990,0.21,0.98,0.31,0.24,1,1,12,0,1005,1.0,0.99,0.08,0.28
PF03491,PF00209:PF05291:PF09648:PF16205:PF17200,2,49,2,0,47,969,0.04,0.95,1.0,0.2,3,0,2,3,1013,0.0,1.0,0.0,-0.0
PF05036,PF02603:PF07475:PF03668:PF09646:PF02381,7,7,4,3,3,1008,0.57,0.99,0.57,0.57,4,4,3,0,1011,1.0,1.0,0.57,0.75
PF15232,PF09047:PF15392:PF09596:PF17096:PF15888,0,2,0,0,2,1016,0.0,1.0,0,0,0,0,0,0,1018,0,1.0,0,0
PF01614,PF16416:PF02056:PF10410:PF13568:PF02107,10,13,2,8,11,997,0.15,0.98,0.2,0.17,0,0,10,0,1008,0,0.99,0.0,0
PF09767,PF02450:PF02341:PF01546:PF10604:PF14476,4,60,1,3,59,955,0.02,0.94,0.25,0.05,3,0,4,3,1011,0.0,0.99,0.0,-0.0
PF04204,PF03049:PF10062:PF00805:PF10061:PF09694,0,17,0,0,17,1001,0.0,0.98,0,0,0,0,0,0,1018,0,1.0,0,0
PF03502,PF03772:PF06339:PF02224:PF11336:PF05170,0,14,0,0,14,1004,0.0,0.99,0,0,0,0,0,0,1018,0,1.0,0,0
PF05761,PF15388:PF03096:PF04230:PF08449:PF05308,10,34,5,5,29,979,0.15,0.97,0.5,0.26,1,0,10,1,1007,0.0,0.99,0.0,-0.0
PF16871,PF11958:PF07963:PF17085:PF00345:PF05658,0,10,0,0,10,1008,0.0,0.99,0,0,0,0,0,0,1018,0,1.0,0,0
PF04826,PF08609:PF01705:PF16689:PF09756:PF14279,3,20,2,1,18,997,0.1,0.98,0.67,0.25,1,1,2,0,1015,1.0,1.0,0.33,0.58
PF16715,PF06161:PF16654:PF13009:PF15360:PF15545,1,2,0,1,2,1015,0.0,1.0,0.0,-0.0,0,0,1,0,1017,0,1.0,0.0,0
PF04909,PF16952:PF03951:PF12437:PF00120:PF07247,38,31,14,24,17,963,0.45,0.96,0.37,0.39,4,3,35,1,979,0.75,0.96,0.08,0.24
PF05406,PF02877:PF08063:PF00645:PF00644:PF12174,23,60,20,3,40,955,0.33,0.96,0.87,0.52,10,9,14,1,994,0.9,0.99,0.39,0.59
PF16709,PF16711:PF16712:PF16874:PF02065:PF16875,3,6,1,2,5,1010,0.17,0.99,0.33,0.23,1,0,3,1,1014,0.0,1.0,0.0,-0.0
PF04392,PF01752:PF04355:PF14251:PF04451:PF17206,2,6,0,2,6,1010,0.0,0.99,0.0,-0.0,0,0,2,0,1016,0,1.0,0.0,0
PF01798,PF08156:PF09785:PF00311:PF04802:PF04499,26,49,24,2,25,967,0.49,0.97,0.92,0.66,4,4,22,0,992,1.0,0.98,0.15,0.39
PF17018,PF11210:PF04076:PF15340:PF09829:PF15775,0,2,0,0,2,1016,0.0,1.0,0,0,0,0,0,0,1018,0,1.0,0,0
PF16558,PF04699:PF03256:PF14377:PF15492:PF03152,7,37,3,4,34,977,0.08,0.96,0.43,0.17,2,1,6,1,1010,0.5,0.99,0.14,0.26
PF15683,PF06729:PF15760:PF05355:PF15119:PF04691,0,3,0,0,3,1015,0.0,1.0,0,0,1,0,0,1,1017,0.0,1.0,0,0
PF14436,PF17206:PF10951:PF17188:PF01514:PF01752,0,3,0,0,3,1015,0.0,1.0,0,0,0,0,0,0,1018,0,1.0,0,0
PF12510,PF15147:PF10358:PF15949:PF12130:PF03271,1,38,1,0,37,980,0.03,0.96,1.0,0.16,2,1,0,1,1016,0.5,1.0,1.0,0.71
PF05889,PF00147:PF08702:PF15043:PF12160:PF00375,1,60,1,0,59,958,0.02,0.94,1.0,0.13,3,0,1,3,1014,0.0,1.0,0.0,-0.0
PF00707,PF03479:PF03066:PF08636:PF07797:PF11623,9,17,2,7,15,994,0.12,0.98,0.22,0.15,0,0,9,0,1009,0,0.99,0.0,0
PF14524,PF11803:PF04321:PF00908:PF16363:PF08338,1,48,0,1,48,969,0.0,0.95,0.0,-0.01,6,0,1,6,1011,0.0,0.99,0.0,-0.0
PF00061,PF08212:PF03973:PF05434:PF06870:PF00277,20,21,8,12,13,985,0.38,0.98,0.4,0.38,0,0,20,0,998,0,0.98,0.0,0
PF01037,PF15750:PF05857:PF03050:PF07805:PF02465,3,2,0,3,2,1013,0.0,1.0,0.0,-0.0,0,0,3,0,1015,0,1.0,0.0,0
PF14632,PF14641:PF14639:PF14635:PF14878:PF14633,13,13,12,1,1,1004,0.92,1.0,0.92,0.92,13,12,1,1,1004,0.92,1.0,0.92,0.92
PF13547,PF06403:PF13753:PF08479:PF06745:PF15976,0,1,0,0,1,1017,0.0,1.0,0,0,0,0,0,0,1018,0,1.0,0,0
PF09286,PF16470:PF05922:PF12583:PF01483:PF06964,15,51,9,6,42,961,0.18,0.95,0.6,0.31,7,5,10,2,1001,0.71,0.99,0.33,0.48
PF03509,PF16791:PF03508:PF00029:PF16174:PF09598,0,9,0,0,9,1009,0.0,0.99,0,0,0,0,0,0,1018,0,1.0,0,0
PF14975,PF04142:PF00638:PF08911:PF08552:PF01015,5,49,4,1,45,968,0.08,0.95,0.8,0.25,8,3,2,5,1008,0.38,0.99,0.6,0.47
PF01376,PF04366:PF11464:PF02894:PF00790:PF12210,0,54,0,0,54,964,0.0,0.95,0,0,5,0,0,5,1013,0.0,1.0,0,0
PF05837,PF13096:PF02083:PF15934:PF12709:PF12001,1,8,0,1,8,1009,0.0,0.99,0.0,-0.0,0,0,1,0,1017,0,1.0,0.0,0
PF08264,PF00133:PF06827:PF09334:PF10458:PF13603,41,72,38,3,34,943,0.53,0.96,0.93,0.68,12,12,29,0,977,1.0,0.97,0.29,0.53
PF04874,PF01778:PF15431:PF01113:PF01087:PF05173,7,28,5,2,23,988,0.18,0.98,0.71,0.35,1,0,7,1,1010,0.0,0.99,0.0,-0.0
PF07794,PF02740:PF11035:PF15710:PF10630:PF05295,0,3,0,0,3,1015,0.0,1.0,0,0,0,0,0,0,1018,0,1.0,0,0
PF06144,PF16725:PF08519:PF09850:PF16193:PF12002,5,25,4,1,21,992,0.16,0.98,0.8,0.35,5,1,4,4,1009,0.2,0.99,0.2,0.2
PF03269,PF03710:PF06592:PF09510:PF08208:PF00419,0,10,0,0,10,1008,0.0,0.99,0,0,0,0,0,0,1018,0,1.0,0,0
PF02823,PF02560:PF05609:PF16839:PF04836:PF07047,6,17,3,3,14,998,0.18,0.98,0.5,0.29,0,0,6,0,1012,0,0.99,0.0,0
PF04408,PF07717:PF08320:PF04568:PF00270:PF13234,80,191,79,1,112,826,0.41,0.89,0.99,0.6,10,10,70,0,938,1.0,0.93,0.12,0.34
PF12331,PF10999:PF15482:PF09428:PF05874:PF03601,3,2,0,3,2,1013,0.0,1.0,0.0,-0.0,0,0,3,0,1015,0,1.0,0.0,0
PF00372,PF03722:PF03723:PF16126:PF05645:PF04870,6,24,6,0,18,994,0.25,0.98,1.0,0.5,2,2,4,0,1012,1.0,1.0,0.33,0.58
PF07065,PF02089:PF01680:PF07350:PF07096:PF01115,9,25,5,4,20,989,0.2,0.98,0.56,0.32,2,1,8,1,1008,0.5,0.99,0.11,0.23
PF05648,PF04371:PF11807:PF03972:PF11700:PF06609,14,24,6,8,18,986,0.25,0.97,0.43,0.32,3,2,12,1,1003,0.67,0.99,0.14,0.3
PF05514,PF09781:PF15786:PF15667:PF15228:PF15162,0,4,0,0,4,1014,0.0,1.0,0,0,0,0,0,0,1018,0,1.0,0,0
PF09802,PF15849:PF08107:PF09784:PF08636:PF05387,2,2,0,2,2,1014,0.0,1.0,0.0,-0.0,0,0,2,0,1016,0,1.0,0.0,0
PF02010,PF01477:PF08016:PF00801:PF00305:PF01825,14,69,12,2,57,947,0.17,0.94,0.86,0.37,14,8,6,6,998,0.57,0.99,0.57,0.57
PF14914,PF15304:PF05866:PF07394:PF11765:PF15395,2,7,1,1,6,1010,0.14,0.99,0.5,0.26,0,0,2,0,1016,0,1.0,0.0,0
PF16744,PF13864:PF04004:PF07545:PF04090:PF13002,1,17,0,1,17,1000,0.0,0.98,0.0,-0.0,2,0,1,2,1015,0.0,1.0,0.0,-0.0
PF07366,PF12006:PF03576:PF08843:PF07444:PF06330,4,8,0,4,8,1006,0.0,0.99,0.0,-0.01,0,0,4,0,1014,0,1.0,0.0,0
PF11095,PF05014:PF04402:PF08674:PF09232:PF02943,6,10,1,5,9,1003,0.1,0.99,0.17,0.12,0,0,6,0,1012,0,0.99,0.0,0
PF12084,PF10225:PF09747:PF13136:PF00072:PF06966,0,86,0,0,86,932,0.0,0.92,0,0,6,0,0,6,1012,0.0,0.99,0,0
PF15467,PF15398:PF03842:PF15060:PF17085:PF10630,0,1,0,0,1,1017,0.0,1.0,0,0,0,0,0,0,1018,0,1.0,0,0
PF07520,PF10139:PF10908:PF11245:PF06798:PF10566,0,0,0,0,0,1018,0,1.0,0,0,0,0,0,0,1018,0,1.0,0,0
PF09121,PF09169:PF09103:PF09104:PF00634:PF01443,0,14,0,0,14,1004,0.0,0.99,0,0,2,0,0,2,1016,0.0,1.0,0,0
PF05937,PF05956:PF05924:PF05923:PF16689:PF05972,3,10,3,0,7,1008,0.3,0.99,1.0,0.55,7,3,0,4,1011,0.43,1.0,1.0,0.65
PF14080,PF01466:PF03931:PF02419:PF11791:PF16073,0,48,0,0,48,970,0.0,0.95,0,0,6,0,0,6,1012,0.0,0.99,0,0
PF06886,PF12214:PF04087:PF04000:PF09816:PF04910,5,25,4,1,21,992,0.16,0.98,0.8,0.35,2,0,5,2,1011,0.0,0.99,0.0,-0.0
PF00302,PF00566:PF02990:PF11730:PF09758:PF07888,1,98,0,1,98,919,0.0,0.9,0.0,-0.01,1,0,1,1,1016,0.0,1.0,0.0,-0.0
PF08695,PF08641:PF09631:PF10780:PF01987:PF09597,4,16,1,3,15,999,0.06,0.98,0.25,0.12,1,1,3,0,1014,1.0,1.0,0.25,0.5
PF13774,PF00957:PF09426:PF07542:PF01357:PF00056,20,61,18,2,43,955,0.3,0.96,0.9,0.5,6,3,17,3,995,0.5,0.98,0.15,0.27
PF05086,PF05109:PF08887:PF02601:PF14573:PF09361,0,2,0,0,2,1016,0.0,1.0,0,0,0,0,0,0,1018,0,1.0,0,0
PF02341,PF16974:PF06799:PF10674:PF06351:PF11264,4,6,2,2,4,1010,0.33,0.99,0.5,0.41,0,0,4,0,1014,0,1.0,0.0,0
PF17026,PF11057:PF15119:PF05728:PF15186:PF15828,0,7,0,0,7,1011,0.0,0.99,0,0,0,0,0,0,1018,0,1.0,0,0
PF10890,PF10459:PF15976:PF08453:PF03241:PF16967,1,4,0,1,4,1013,0.0,1.0,0.0,-0.0,0,0,1,0,1017,0,1.0,0.0,0
PF16969,PF07767:PF05693:PF09751:PF03096:PF14798,11,24,5,6,19,988,0.21,0.98,0.45,0.3,1,1,10,0,1007,1.0,0.99,0.09,0.3
PF16047,PF08023:PF16048:PF08018:PF12121:PF07440,0,0,0,0,0,1018,0,1.0,0,0,0,0,0,0,1018,0,1.0,0,0
PF11736,PF03922:PF03050:PF01752:PF02465:PF10566,4,2,0,4,2,1012,0.0,0.99,0.0,-0.0,0,0,4,0,1014,0,1.0,0.0,0
PF04129,PF14800:PF06248:PF04114:PF11989:PF03828,18,41,9,9,32,968,0.22,0.96,0.5,0.31,4,3,15,1,999,0.75,0.98,0.17,0.35
PF05636,PF07499:PF05045:PF08411:PF04453:PF02503,0,5,0,0,5,1013,0.0,1.0,0,0,0,0,0,0,1018,0,1.0,0,0
PF14569,PF03552:PF09265:PF06364:PF02913:PF17200,8,48,8,0,40,970,0.17,0.96,1.0,0.4,1,0,8,1,1009,0.0,0.99,0.0,-0.0
PF14552,PF00669:PF05707:PF11304:PF04848:PF03944,1,6,0,1,6,1011,0.0,0.99,0.0,-0.0,0,0,1,0,1017,0,1.0,0.0,0
PF14967,PF15467:PF15069:PF15060:PF17085:PF15398,2,1,0,2,1,1015,0.0,1.0,0.0,-0.0,0,0,2,0,1016,0,1.0,0.0,0
PF02947,PF15138:PF14224:PF15211:PF10693:PF15075,3,2,2,1,0,1015,1.0,1.0,0.67,0.82,0,0,3,0,1015,0,1.0,0.0,0
PF15754,PF14862:PF15333:PF15838:PF15207:PF15212,0,1,0,0,1,1017,0.0,1.0,0,0,0,0,0,0,1018,0,1.0,0,0
PF12317,PF03760:PF04852:PF15810:PF11282:PF10248,2,11,0,2,11,1005,0.0,0.99,0.0,-0.0,0,0,2,0,1016,0,1.0,0.0,0
PF13466,PF05494:PF07520:PF14805:PF05736:PF10139,1,4,0,1,4,1013,0.0,1.0,0.0,-0.0,0,0,1,0,1017,0,1.0,0.0,0
PF11134,PF02979:PF15817:PF04860:PF11751:PF06832,0,6,0,0,6,1012,0.0,0.99,0,0,0,0,0,0,1018,0,1.0,0,0
PF09825,PF02237:PF10437:PF10210:PF03413:PF00745,2,20,1,1,19,997,0.05,0.98,0.5,0.15,2,1,1,1,1015,0.5,1.0,0.5,0.5
PF08731,PF13810:PF05841:PF07931:PF10295:PF11770,1,6,0,1,6,1011,0.0,0.99,0.0,-0.0,0,0,1,0,1017,0,1.0,0.0,0
PF01788,PF00882:PF13400:PF08291:PF13677:PF15730,0,1,0,0,1,1017,0.0,1.0,0,0,0,0,0,0,1018,0,1.0,0,0
PF11412,PF08411:PF15823:PF00997:PF02951:PF15750,0,6,0,0,6,1012,0.0,0.99,0,0,0,0,0,0,1018,0,1.0,0,0
PF09339,PF01022:PF01614:PF02311:PF01710:PF02796,11,21,10,1,11,996,0.48,0.99,0.91,0.65,1,1,10,0,1007,1.0,0.99,0.09,0.3
PF03103,PF15973:PF02520:PF01269:PF08643:PF01277,7,20,1,6,19,992,0.05,0.98,0.14,0.07,0,0,7,0,1011,0,0.99,0.0,0
PF01042,PF01902:PF01497:PF02353:PF01593:PF00248,23,114,17,6,97,898,0.15,0.9,0.74,0.3,12,7,16,5,990,0.58,0.98,0.3,0.41
PF10620,PF01411:PF15470:PF05725:PF09685:PF00030,1,51,0,1,51,966,0.0,0.95,0.0,-0.01,5,0,1,5,1012,0.0,0.99,0.0,-0.0
PF00699,PF00449:PF00547:PF13382:PF03841:PF01979,7,49,7,0,42,969,0.14,0.96,1.0,0.37,6,6,1,0,1011,1.0,1.0,0.86,0.93
PF16089,PF15884:PF00727:PF04402:PF11029:PF06351,0,11,0,0,11,1007,0.0,0.99,0,0,1,0,0,1,1017,0.0,1.0,0,0
PF02615,PF03962:PF09495:PF06842:PF03972:PF01265,8,29,4,4,25,985,0.14,0.97,0.5,0.25,3,2,6,1,1009,0.67,0.99,0.25,0.41
PF02630,PF01871:PF06026:PF07816:PF06244:PF01730,17,21,3,14,18,983,0.14,0.97,0.18,0.14,0,0,17,0,1001,0,0.98,0.0,0
PF02880,PF02879:PF00408:PF02878:PF08722:PF12696,37,41,37,0,4,977,0.9,1.0,1.0,0.95,23,23,14,0,981,1.0,0.99,0.62,0.78
PF04998,PF04992:PF04983:PF11523:PF04990:PF05000,35,36,31,4,5,978,0.86,0.99,0.89,0.87,6,5,30,1,982,0.83,0.97,0.14,0.34
PF06500,PF06108:PF12900:PF01933:PF12929:PF08787,2,24,0,2,24,992,0.0,0.97,0.0,-0.01,3,0,2,3,1013,0.0,1.0,0.0,-0.0
PF10313,PF08145:PF04494:PF12931:PF08149:PF08614,4,27,3,1,24,990,0.11,0.98,0.75,0.28,3,1,3,2,1012,0.33,1.0,0.25,0.29
PF05283,PF06679:PF00726:PF06373:PF06446:PF00964,3,1,0,3,1,1014,0.0,1.0,0.0,-0.0,0,0,3,0,1015,0,1.0,0.0,0
PF15863,PF03907:PF06485:PF14877:PF17078:PF08653,1,11,1,0,10,1007,0.09,0.99,1.0,0.3,0,0,1,0,1017,0,1.0,0.0,0
PF06745,PF13753:PF06890:PF17164:PF16325:PF08404,0,1,0,0,1,1017,0.0,1.0,0,0,0,0,0,0,1018,0,1.0,0,0
PF04379,PF13369:PF08755:PF09346:PF12014:PF10442,10,15,6,4,9,999,0.4,0.99,0.6,0.48,1,1,9,0,1008,1.0,0.99,0.1,0.31
PF08643,PF14610:PF02325:PF12317:PF11282:PF15810,5,8,0,5,8,1005,0.0,0.99,0.0,-0.01,0,0,5,0,1013,0,1.0,0.0,0
PF05210,PF08776:PF09816:PF00786:PF03715:PF04844,1,45,1,0,44,973,0.02,0.96,1.0,0.15,7,1,0,6,1011,0.14,0.99,1.0,0.38
PF14843,PF01030:PF00757:PF15913:PF16470:PF01483,8,30,8,0,22,988,0.27,0.98,1.0,0.51,8,6,2,2,1008,0.75,1.0,0.75,0.75
PF02987,PF02919:PF15694:PF01028:PF15693:PF09425,0,12,0,0,12,1006,0.0,0.99,0,0,2,0,0,2,1016,0.0,1.0,0,0
PF04666,PF05191:PF07542:PF00316:PF12483:PF06159,11,49,7,4,42,965,0.14,0.95,0.64,0.29,1,0,11,1,1006,0.0,0.99,0.0,-0.0
PF13364,PF13363:PF10435:PF01301:PF02140:PF00251,10,53,10,0,43,965,0.19,0.96,1.0,0.43,6,6,4,0,1008,1.0,1.0,0.6,0.77
PF02984,PF16899:PF00134:PF13825:PF08268:PF13506,43,77,39,4,38,937,0.51,0.96,0.91,0.66,2,2,41,0,975,1.0,0.96,0.05,0.21
PF05125,PF10964:PF10172:PF08813:PF08785:PF03730,0,26,0,0,26,992,0.0,0.97,0,0,1,0,0,1,1017,0.0,1.0,0,0
PF07774,PF13360:PF13570:PF16177:PF01011:PF00668,14,62,12,2,50,954,0.19,0.95,0.86,0.39,6,4,10,2,1002,0.67,0.99,0.29,0.43
PF01777,PF01929:PF17136:PF00900:PF16121:PF08071,15,38,8,7,30,973,0.21,0.96,0.53,0.32,11,3,12,8,995,0.27,0.98,0.2,0.22
PF01645,PF04898:PF00310:PF14691:PF01493:PF14962,6,18,6,0,12,1000,0.33,0.99,1.0,0.57,7,6,0,1,1011,0.86,1.0,1.0,0.93
PF10616,PF08936:PF06227:PF15828:PF11561:PF12331,0,6,0,0,6,1012,0.0,0.99,0,0,0,0,0,0,1018,0,1.0,0,0
PF17109,PF12770:PF14420:PF06424:PF17100:PF07721,6,38,5,1,33,979,0.13,0.97,0.83,0.32,6,1,5,5,1007,0.17,0.99,0.17,0.16
PF06716,PF14539:PF15340:PF08026:PF02565:PF08730,0,2,0,0,2,1016,0.0,1.0,0,0,0,0,0,0,1018,0,1.0,0,0
PF12820,PF01594:PF15627:PF09733:PF15189:PF12036,1,16,0,1,16,1001,0.0,0.98,0.0,-0.0,1,0,1,1,1016,0.0,1.0,0.0,-0.0
PF17200,PF06228:PF12106:PF02654:PF06956:PF04632,0,6,0,0,6,1012,0.0,0.99,0,0,0,0,0,0,1018,0,1.0,0,0
PF13741,PF10775:PF10310:PF08656:PF11711:PF13933,2,3,1,1,2,1014,0.33,1.0,0.5,0.41,0,0,2,0,1016,0,1.0,0.0,0
PF14836,PF06337:PF13446:PF16674:PF00167:PF14533,9,26,7,2,19,990,0.27,0.98,0.78,0.45,4,4,5,0,1009,1.0,1.0,0.44,0.67
PF15046,PF08945:PF07392:PF15175:PF14877:PF15050,3,6,0,3,6,1009,0.0,0.99,0.0,-0.0,0,0,3,0,1015,0,1.0,0.0,0
PF03694,PF07281:PF05039:PF03980:PF01716:PF01828,7,15,0,7,15,996,0.0,0.98,0.0,-0.01,0,0,7,0,1011,0,0.99,0.0,0
PF04671,PF13753:PF15150:PF16325:PF10411:PF14344,1,1,0,1,1,1016,0.0,1.0,0.0,-0.0,0,0,1,0,1017,0,1.0,0.0,0
PF09426,PF13774:PF14995:PF15277:PF01220:PF02588,0,34,0,0,34,984,0.0,0.97,0,0,1,0,0,1,1017,0.0,1.0,0,0
PF16028,PF16657:PF09154:PF11941:PF09260:PF02806,1,23,1,0,22,995,0.04,0.98,1.0,0.21,2,1,0,1,1016,0.5,1.0,1.0,0.71
PF14433,PF09932:PF16233:PF11769:PF05242:PF11080,0,1,0,0,1,1017,0.0,1.0,0,0,0,0,0,0,1018,0,1.0,0,0
PF10502,PF13911:PF15907:PF01726:PF13443:PF05014,4,22,1,3,21,993,0.05,0.98,0.25,0.1,0,0,4,0,1014,0,1.0,0.0,0
PF01791,PF04176:PF02284:PF04667:PF00210:PF01192,12,29,4,8,25,981,0.14,0.97,0.33,0.2,1,1,11,0,1006,1.0,0.99,0.08,0.29
PF03123,PF13876:PF06406:PF07523:PF15150:PF14082,2,1,0,2,1,1015,0.0,1.0,0.0,-0.0,0,0,2,0,1016,0,1.0,0.0,0
PF11584,PF15809:PF15041:PF05151:PF14862:PF14866,0,1,0,0,1,1017,0.0,1.0,0,0,0,0,0,0,1018,0,1.0,0,0
PF11981,PF12840:PF15482:PF11037:PF05962:PF06651,0,1,0,0,1,1017,0.0,1.0,0,0,0,0,0,0,1018,0,1.0,0,0
PF05795,PF13206:PF15377:PF12301:PF05612:PF04598,2,4,0,2,4,1012,0.0,0.99,0.0,-0.0,0,0,2,0,1016,0,1.0,0.0,0
PF09849,PF06681:PF02557:PF15837:PF15771:PF15380,0,2,0,0,2,1016,0.0,1.0,0,0,0,0,0,0,1018,0,1.0,0,0
PF07928,PF10474:PF10475:PF06662:PF10383:PF01902,9,14,4,5,10,999,0.29,0.99,0.44,0.35,2,2,7,0,1009,1.0,0.99,0.22,0.47
PF04127,PF14365:PF03080:PF04862:PF05652:PF03951,8,32,6,2,26,984,0.19,0.97,0.75,0.37,3,0,8,3,1007,0.0,0.99,0.0,-0.0
PF07653,PF00018:PF00620:PF14604:PF12485:PF16600,56,153,45,11,108,854,0.29,0.88,0.8,0.44,29,21,35,8,954,0.72,0.96,0.38,0.5
PF01964,PF12049:PF03741:PF11460:PF11267:PF08692,5,8,1,4,7,1006,0.12,0.99,0.2,0.15,0,0,5,0,1013,0,1.0,0.0,0
PF17005,PF10647:PF17108:PF14077:PF08581:PF15807,1,8,1,0,7,1010,0.12,0.99,1.0,0.35,1,1,0,0,1017,1.0,1.0,1.0,1.0
PF02806,PF02922:PF16028:PF07821:PF09260:PF11852,20,21,13,7,8,990,0.62,0.99,0.65,0.63,2,2,18,0,998,1.0,0.98,0.1,0.31
PF02863,PF08021:PF06805:PF03831:PF01913:PF10995,2,1,0,2,1,1015,0.0,1.0,0.0,-0.0,0,0,2,0,1016,0,1.0,0.0,0
PF07367,PF15610:PF12200:PF17106:PF00866:PF13473,2,11,0,2,11,1005,0.0,0.99,0.0,-0.0,1,0,2,1,1015,0.0,1.0,0.0,-0.0
PF11325,PF14877:PF15046:PF17015:PF05853:PF03203,0,8,0,0,8,1010,0.0,0.99,0,0,0,0,0,0,1018,0,1.0,0,0
PF14538,PF08232:PF12234:PF09453:PF07304:PF03920,18,28,8,10,20,980,0.29,0.97,0.44,0.34,1,1,17,0,1000,1.0,0.98,0.06,0.23
PF08786,PF11691:PF01280:PF05625:PF07584:PF14901,0,22,0,0,22,996,0.0,0.98,0,0,1,0,0,1,1017,0.0,1.0,0,0
PF15363,PF15082:PF10407:PF12443:PF15392:PF03389,1,3,0,1,3,1014,0.0,1.0,0.0,-0.0,0,0,1,0,1017,0,1.0,0.0,0
PF06127,PF10780:PF03980:PF06244:PF01097:PF01987,4,22,1,3,21,993,0.05,0.98,0.25,0.1,0,0,4,0,1014,0,1.0,0.0,0
PF12023,PF06351:PF06232:PF11264:PF07333:PF15359,4,9,3,1,6,1008,0.33,0.99,0.75,0.5,0,0,4,0,1014,0,1.0,0.0,0
PF14484,PF02758:PF13355:PF08709:PF17034:PF10441,11,29,6,5,23,984,0.21,0.97,0.55,0.32,1,1,10,0,1007,1.0,0.99,0.09,0.3
PF11612,PF02501:PF04612:PF10908:PF02465:PF07804,2,3,2,0,1,1015,0.67,1.0,1.0,0.82,0,0,2,0,1016,0,1.0,0.0,0
PF14826,PF08644:PF16188:PF01321:PF15801:PF05195,10,33,9,1,24,984,0.27,0.98,0.9,0.49,3,3,7,0,1008,1.0,0.99,0.3,0.55
PF13683,PF08298:PF07411:PF11202:PF06761:PF05598,8,3,2,6,1,1009,0.67,0.99,0.25,0.41,0,0,8,0,1010,0,0.99,0.0,0
PF16696,PF11464:PF11409:PF13713:PF09311:PF04366,2,30,2,0,28,988,0.07,0.97,1.0,0.25,2,2,0,0,1016,1.0,1.0,1.0,1.0
PF10482,PF07001:PF15557:PF15326:PF15624:PF15914,1,12,0,1,12,1005,0.0,0.99,0.0,-0.0,0,0,1,0,1017,0,1.0,0.0,0
PF02183,PF16878:PF03792:PF00157:PF04731:PF12413,6,18,4,2,14,998,0.22,0.98,0.67,0.38,2,2,4,0,1012,1.0,1.0,0.33,0.58
PF00188,PF08562:PF01497:PF04406:PF01902:PF13640,53,56,23,30,33,932,0.41,0.94,0.43,0.39,4,4,49,0,965,1.0,0.95,0.08,0.27
PF07133,PF15447:PF15445:PF12377:PF03011:PF15448,1,1,1,0,0,1017,1.0,1.0,1.0,1.0,1,1,0,0,1017,1.0,1.0,1.0,1.0
PF12009,PF14529:PF06817:PF08333:PF13655:PF13966,6,122,4,2,118,894,0.03,0.88,0.67,0.13,6,1,5,5,1007,0.17,0.99,0.17,0.16
PF13193,PF16177:PF13360:PF00668:PF14535:PF00550,85,87,48,37,39,894,0.55,0.93,0.56,0.52,13,13,72,0,933,1.0,0.93,0.15,0.38
PF00642,PF15815:PF10453:PF08941:PF05495:PF16207,71,27,13,58,14,933,0.48,0.93,0.18,0.27,2,2,69,0,947,1.0,0.93,0.03,0.16
PF10208,PF05529:PF07933:PF09288:PF10520:PF00179,7,106,6,1,100,911,0.06,0.9,0.86,0.21,4,2,5,2,1009,0.5,0.99,0.29,0.37
PF16008,PF09818:PF01666:PF10138:PF04562:PF11223,0,4,0,0,4,1014,0.0,1.0,0,0,0,0,0,0,1018,0,1.0,0,0
PF06295,PF06560:PF00789:PF02793:PF11722:PF02690,0,52,0,0,52,966,0.0,0.95,0,0,1,0,0,1,1017,0.0,1.0,0,0
PF08604,PF17219:PF16764:PF00641:PF10599:PF06554,7,49,7,0,42,969,0.14,0.96,1.0,0.37,2,2,5,0,1011,1.0,1.0,0.29,0.53
PF08733,PF08624:PF15923:PF09463:PF05030:PF16944,2,13,0,2,13,1003,0.0,0.99,0.0,-0.01,0,0,2,0,1016,0,1.0,0.0,0
PF02182,PF12148:PF14051:PF12165:PF12269:PF03172,18,19,9,9,10,990,0.47,0.98,0.5,0.48,1,1,17,0,1000,1.0,0.98,0.06,0.23
PF14357,PF03901:PF10996:PF14833:PF00334:PF03644,0,84,0,0,84,934,0.0,0.92,0,0,9,0,0,9,1009,0.0,0.99,0,0
PF10342,PF12243:PF00871:PF07950:PF16740:PF01386,13,16,2,11,14,991,0.12,0.98,0.15,0.13,0,0,13,0,1005,0,0.99,0.0,0
PF09685,PF04714:PF03754:PF06916:PF10234:PF04934,0,28,0,0,28,990,0.0,0.97,0,0,1,0,0,1,1017,0.0,1.0,0,0
PF07802,PF06907:PF15549:PF03883:PF08228:PF06109,4,8,1,3,7,1007,0.12,0.99,0.25,0.17,0,0,4,0,1014,0,1.0,0.0,0
PF15960,PF16716:PF06581:PF10716:PF07240:PF02024,0,2,0,0,2,1016,0.0,1.0,0,0,0,0,0,0,1018,0,1.0,0,0
PF06852,PF11581:PF01666:PF06681:PF08730:PF02070,0,0,0,0,0,1018,0,1.0,0,0,0,0,0,0,1018,0,1.0,0,0
PF11802,PF16001:PF15814:PF14992:PF16590:PF01840,0,2,0,0,2,1016,0.0,1.0,0,0,0,0,0,0,1018,0,1.0,0,0
PF02084,PF02420:PF00323:PF11054:PF10322:PF06994,0,1,0,0,1,1017,0.0,1.0,0,0,0,0,0,0,1018,0,1.0,0,0
PF11894,PF04704:PF11899:PF16875:PF07159:PF01175,11,17,7,4,10,997,0.41,0.99,0.64,0.51,0,0,11,0,1007,0,0.99,0.0,0
PF14108,PF10868:PF08576:PF15699:PF06351:PF17032,2,5,1,1,4,1012,0.2,1.0,0.5,0.31,0,0,2,0,1016,0,1.0,0.0,0
PF15344,PF06989:PF15062:PF13270:PF11460:PF04359,1,4,0,1,4,1013,0.0,1.0,0.0,-0.0,0,0,1,0,1017,0,1.0,0.0,0
PF12397,PF13001:PF08146:PF11919:PF12755:PF12074,10,37,10,0,27,981,0.27,0.97,1.0,0.51,2,2,8,0,1008,1.0,0.99,0.2,0.45
PF15706,PF15705:PF16070:PF00963:PF16978:PF12310,3,25,3,0,22,993,0.12,0.98,1.0,0.34,1,0,3,1,1014,0.0,1.0,0.0,-0.0
PF03018,PF03168:PF01419:PF04398:PF07847:PF02704,12,37,6,6,31,975,0.16,0.96,0.5,0.27,2,2,10,0,1006,1.0,0.99,0.17,0.41
PF04339,PF15216:PF15041:PF11317:PF04691:PF09057,2,3,0,2,3,1013,0.0,1.0,0.0,-0.0,0,0,2,0,1016,0,1.0,0.0,0
PF12757,PF11496:PF15368:PF11577:PF15456:PF17020,0,15,0,0,15,1003,0.0,0.99,0,0,1,0,0,1,1017,0.0,1.0,0,0
PF01996,PF11403:PF10816:PF07934:PF13651:PF07385,0,15,0,0,15,1003,0.0,0.99,0,0,0,0,0,0,1018,0,1.0,0,0
PF12999,PF13015:PF14923:PF08976:PF16166:PF13164,16,17,11,5,6,996,0.65,0.99,0.69,0.66,1,1,15,0,1002,1.0,0.99,0.06,0.25
PF12413,PF10525:PF04617:PF13293:PF12407:PF03867,1,4,1,0,3,1014,0.25,1.0,1.0,0.5,1,1,0,0,1017,1.0,1.0,1.0,1.0
PF10204,PF03036:PF09755:PF05301:PF15806:PF02076,3,16,2,1,14,1001,0.12,0.99,0.67,0.28,1,0,3,1,1014,0.0,1.0,0.0,-0.0
PF15682,PF08843:PF15680:PF11057:PF08398:PF05962,1,2,0,1,2,1015,0.0,1.0,0.0,-0.0,0,0,1,0,1017,0,1.0,0.0,0
PF02049,PF12724:PF02072:PF09673:PF07075:PF05418,2,3,0,2,3,1013,0.0,1.0,0.0,-0.0,0,0,2,0,1016,0,1.0,0.0,0
PF13936,PF11427:PF16087:PF09339:PF02796:PF01498,6,64,6,0,58,954,0.09,0.94,1.0,0.3,7,3,3,4,1008,0.43,0.99,0.5,0.46
PF12971,PF12972:PF05089:PF03648:PF16875:PF08530,8,28,8,0,20,990,0.29,0.98,1.0,0.53,3,3,5,0,1010,1.0,1.0,0.38,0.61
PF11617,PF16754:PF12034:PF06668:PF13400:PF05586,1,5,0,1,5,1012,0.0,0.99,0.0,-0.0,0,0,1,0,1017,0,1.0,0.0,0
PF05335,PF00468:PF07172:PF06446:PF10018:PF00758,2,23,0,2,23,993,0.0,0.98,0.0,-0.01,0,0,2,0,1016,0,1.0,0.0,0
PF11935,PF15917:PF12166:PF16399:PF12295:PF12359,8,27,7,1,20,990,0.26,0.98,0.88,0.47,3,2,6,1,1009,0.67,0.99,0.25,0.41
PF06017,PF00063:PF04088:PF10580:PF16521:PF16735,22,76,20,2,56,940,0.26,0.94,0.91,0.47,3,3,19,0,996,1.0,0.98,0.14,0.37
PF10107,PF07327:PF11111:PF08026:PF11032:PF08847,0,5,0,0,5,1013,0.0,1.0,0,0,0,0,0,0,1018,0,1.0,0,0
PF00439,PF12157:PF17105:PF17035:PF10513:PF00628,78,106,52,26,54,886,0.49,0.92,0.67,0.53,6,6,72,0,940,1.0,0.93,0.08,0.27
PF09713,PF11669:PF12579:PF08265:PF08202:PF15245,10,21,2,8,19,989,0.1,0.97,0.2,0.13,0,0,10,0,1008,0,0.99,0.0,0
PF00648,PF01067:PF09149:PF02666:PF13833:PF01735,47,83,36,11,47,924,0.43,0.94,0.77,0.55,11,9,38,2,969,0.82,0.96,0.19,0.38
PF13926,PF16501:PF10377:PF10264:PF03941:PF15246,4,19,1,3,18,996,0.05,0.98,0.25,0.11,1,1,3,0,1014,1.0,1.0,0.25,0.5
PF14161,PF02805:PF06736:PF02078:PF07140:PF14160,2,14,2,0,12,1004,0.14,0.99,1.0,0.38,0,0,2,0,1016,0,1.0,0.0,0
PF15248,PF12240:PF15866:PF08227:PF14988:PF11291,5,12,4,1,8,1005,0.33,0.99,0.8,0.51,1,1,4,0,1013,1.0,1.0,0.2,0.45
PF14617,PF08641:PF15359:PF15370:PF06232:PF04402,4,15,3,1,12,1002,0.2,0.99,0.75,0.38,1,0,4,1,1013,0.0,1.0,0.0,-0.0
PF13490,PF15750:PF02369:PF11614:PF04546:PF10554,3,9,3,0,6,1009,0.33,0.99,1.0,0.58,0,0,3,0,1015,0,1.0,0.0,0
PF09498,PF03406:PF17206:PF08497:PF01706:PF05840,0,2,0,0,2,1016,0.0,1.0,0,0,0,0,0,0,1018,0,1.0,0,0
PF15800,PF14554:PF04692:PF00341:PF03128:PF03298,1,11,1,0,10,1007,0.09,0.99,1.0,0.3,1,1,0,0,1017,1.0,1.0,1.0,1.0
PF08571,PF17221:PF14934:PF10706:PF07937:PF08340,8,4,0,8,4,1006,0.0,0.99,0.0,-0.01,0,0,8,0,1010,0,0.99,0.0,0
PF11312,PF13013:PF08398:PF13094:PF02072:PF02557,1,5,0,1,5,1012,0.0,0.99,0.0,-0.0,0,0,1,0,1017,0,1.0,0.0,0
PF11282,PF11623:PF16007:PF08034:PF08636:PF14610,2,6,0,2,6,1010,0.0,0.99,0.0,-0.0,0,0,2,0,1016,0,1.0,0.0,0
PF11614,PF13746:PF04984:PF02501:PF05034:PF10908,4,6,4,0,2,1012,0.67,1.0,1.0,0.82,0,0,4,0,1014,0,1.0,0.0,0
PF05480,PF02556:PF04494:PF08953:PF06147:PF03109,0,56,0,0,56,962,0.0,0.94,0,0,3,0,0,3,1015,0.0,1.0,0,0
PF03847,PF07816:PF04484:PF09754:PF11833:PF13664,7,21,3,4,18,993,0.14,0.98,0.43,0.24,1,1,6,0,1011,1.0,0.99,0.14,0.38
PF11546,PF08173:PF11075:PF00763:PF02882:PF01012,0,45,0,0,45,973,0.0,0.96,0,0,6,0,0,6,1012,0.0,0.99,0,0
PF01947,PF00737:PF08738:PF17124:PF03379:PF02393,0,2,0,0,2,1016,0.0,1.0,0,0,0,0,0,0,1018,0,1.0,0,0
PF15356,PF11057:PF15119:PF15212:PF15041:PF05836,0,2,0,0,2,1016,0.0,1.0,0,0,0,0,0,0,1018,0,1.0,0,0
PF14713,PF15551:PF15252:PF14931:PF15398:PF10166,2,4,0,2,4,1012,0.0,0.99,0.0,-0.0,0,0,2,0,1016,0,1.0,0.0,0
PF03130,PF10508:PF16689:PF11336:PF03235:PF06887,1,16,1,0,15,1002,0.06,0.99,1.0,0.25,0,0,1,0,1017,0,1.0,0.0,0
PF08828,PF15791:PF12374:PF03474:PF00751:PF10330,1,8,1,0,7,1010,0.12,0.99,1.0,0.35,1,1,0,0,1017,1.0,1.0,1.0,1.0
PF08722,PF12696:PF11022:PF06745:PF04687:PF06381,1,2,1,0,1,1016,0.5,1.0,1.0,0.71,0,0,1,0,1017,0,1.0,0.0,0
PF05875,PF10455:PF13088:PF06966:PF05910:PF01912,19,34,10,9,24,975,0.29,0.97,0.53,0.38,5,3,16,2,997,0.6,0.98,0.16,0.3
PF15699,PF02427:PF17032:PF10868:PF08576:PF06351,0,5,0,0,5,1013,0.0,1.0,0,0,0,0,0,0,1018,0,1.0,0,0
PF08832,PF16279:PF08815:PF07469:PF11413:PF08778,6,11,6,0,5,1007,0.55,1.0,1.0,0.74,4,4,2,0,1012,1.0,1.0,0.67,0.82
PF16526,PF13545:PF08412:PF11879:PF10137:PF11933,7,13,1,6,12,999,0.08,0.98,0.14,0.1,1,1,6,0,1011,1.0,0.99,0.14,0.38
PF00263,PF17084:PF02501:PF11614:PF03958:PF04612,3,6,2,1,4,1011,0.33,1.0,0.67,0.47,1,1,2,0,1015,1.0,1.0,0.33,0.58
PF00328,PF00201:PF08443:PF03478:PF08241:PF01501,49,130,34,15,96,873,0.26,0.89,0.69,0.38,25,18,31,7,962,0.72,0.96,0.37,0.5
PF11714,PF00618:PF02966:PF00520:PF04099:PF03301,0,119,0,0,119,899,0.0,0.88,0,0,10,0,0,10,1008,0.0,0.99,0,0
PF07471,PF11744:PF03096:PF11955:PF02466:PF03343,0,42,0,0,42,976,0.0,0.96,0,0,4,0,0,4,1014,0.0,1.0,0,0
PF00226,PF11926:PF16669:PF05154:PF04777:PF03962,113,45,33,80,12,893,0.73,0.91,0.29,0.43,2,2,111,0,905,1.0,0.89,0.02,0.13
PF13334,PF12326:PF00337:PF07061:PF01762:PF04099,3,62,3,0,59,956,0.05,0.94,1.0,0.21,9,1,2,8,1007,0.11,0.99,0.33,0.19
PF01128,PF04736:PF06581:PF15370:PF15171:PF01716,4,6,0,4,6,1008,0.0,0.99,0.0,-0.0,0,0,4,0,1014,0,1.0,0.0,0
PF00537,PF10839:PF06351:PF07333:PF06446:PF01241,1,3,0,1,3,1014,0.0,1.0,0.0,-0.0,0,0,1,0,1017,0,1.0,0.0,0
PF00471,PF05912:PF07544:PF08883:PF13468:PF10868,4,21,2,2,19,995,0.1,0.98,0.5,0.21,2,2,2,0,1014,1.0,1.0,0.5,0.71
PF12491,PF06448:PF09172:PF01347:PF09175:PF16034,1,20,1,0,19,998,0.05,0.98,1.0,0.22,4,1,0,3,1014,0.25,1.0,1.0,0.5
PF07719,PF00515:PF13181:PF13174:PF09976:PF16669,38,126,30,8,96,884,0.24,0.9,0.79,0.4,16,12,26,4,976,0.75,0.97,0.32,0.48
PF03878,PF07809:PF09419:PF07816:PF04716:PF15795,11,22,3,8,19,988,0.14,0.97,0.27,0.18,0,0,11,0,1007,0,0.99,0.0,0
PF11109,PF05857:PF07149:PF02951:PF07411:PF01254,1,4,0,1,4,1013,0.0,1.0,0.0,-0.0,0,0,1,0,1017,0,1.0,0.0,0
PF11727,PF10361:PF15311:PF12527:PF12927:PF16043,0,10,0,0,10,1008,0.0,0.99,0,0,0,0,0,0,1018,0,1.0,0,0
PF01352,PF02023:PF12417:PF14291:PF12036:PF12017,43,47,20,23,27,948,0.43,0.95,0.47,0.42,7,7,36,0,975,1.0,0.96,0.16,0.4
PF01431,PF05649:PF02347:PF14498:PF03177:PF08427,38,53,35,3,18,962,0.66,0.98,0.92,0.77,6,6,32,0,980,1.0,0.97,0.16,0.39
PF11842,PF06962:PF10105:PF11230:PF12345:PF04794,2,3,2,0,1,1015,0.67,1.0,1.0,0.82,2,2,0,0,1016,1.0,1.0,1.0,1.0
PF13606,PF00710:PF12796:PF00023:PF16553:PF11904,49,251,47,2,204,765,0.19,0.8,0.96,0.37,18,10,39,8,961,0.56,0.95,0.2,0.32
PF01997,PF01680:PF02284:PF16906:PF06658:PF05047,9,29,3,6,26,983,0.1,0.97,0.33,0.17,3,1,8,2,1007,0.33,0.99,0.11,0.19
PF02312,PF02525:PF10705:PF06342:PF05612:PF13741,2,5,0,2,5,1011,0.0,0.99,0.0,-0.0,0,0,2,0,1016,0,1.0,0.0,0
PF15049,PF02277:PF06890:PF10974:PF07157:PF03050,0,3,0,0,3,1015,0.0,1.0,0,0,0,0,0,0,1018,0,1.0,0,0
PF13434,PF00743:PF01544:PF07938:PF11905:PF11951,17,122,15,2,107,894,0.12,0.89,0.88,0.31,23,12,5,11,990,0.52,0.98,0.71,0.6
PF14976,PF07021:PF02503:PF15770:PF15895:PF03745,2,2,0,2,2,1014,0.0,1.0,0.0,-0.0,0,0,2,0,1016,0,1.0,0.0,0
PF02150,PF01096:PF15694:PF10660:PF08752:PF15693,15,22,9,6,13,990,0.41,0.98,0.6,0.49,0,0,15,0,1003,0,0.99,0.0,0
PF15040,PF11351:PF03886:PF14400:PF02264:PF04381,0,4,0,0,4,1014,0.0,1.0,0,0,0,0,0,0,1018,0,1.0,0,0
PF10380,PF09818:PF05939:PF01514:PF08708:PF11214,1,1,0,1,1,1016,0.0,1.0,0.0,-0.0,0,0,1,0,1017,0,1.0,0.0,0
PF00967,PF00187:PF00182:PF03427:PF08329:PF00166,3,31,3,0,28,987,0.1,0.97,1.0,0.31,5,3,0,2,1013,0.6,1.0,1.0,0.77
PF08555,PF10780:PF10244:PF01470:PF06232:PF01632,4,23,1,3,22,992,0.04,0.98,0.25,0.1,1,0,4,1,1013,0.0,1.0,0.0,-0.0
PF06934,PF10566:PF08497:PF07805:PF10908:PF16822,0,1,0,0,1,1017,0.0,1.0,0,0,0,0,0,0,1018,0,1.0,0,0
PF02613,PF15776:PF15023:PF03592:PF02565:PF06834,1,2,0,1,2,1015,0.0,1.0,0.0,-0.0,0,0,1,0,1017,0,1.0,0.0,0
PF11740,PF08291:PF08857:PF15496:PF08848:PF16804,0,1,0,0,1,1017,0.0,1.0,0,0,0,0,0,0,1018,0,1.0,0,0
PF11862,PF14258:PF06798:PF03241:PF13722:PF03090,1,0,0,1,0,1017,0,1.0,0.0,0,0,0,1,0,1017,0,1.0,0.0,0
PF06311,PF00640:PF12473:PF11830:PF08916:PF10296,2,48,2,0,46,970,0.04,0.95,1.0,0.2,2,1,1,1,1015,0.5,1.0,0.5,0.5
PF16041,PF12936:PF09332:PF11970:PF09729:PF15539,7,17,4,3,13,998,0.24,0.98,0.57,0.36,0,0,7,0,1011,0,0.99,0.0,0
PF13463,PF07484:PF05939:PF03553:PF02465:PF08497,1,1,0,1,1,1016,0.0,1.0,0.0,-0.0,0,0,1,0,1017,0,1.0,0.0,0
PF09206,PF05270:PF09175:PF08742:PF13330:PF05375,3,40,2,1,38,977,0.05,0.96,0.67,0.18,4,0,3,4,1011,0.0,0.99,0.0,-0.0
PF01141,PF01140:PF02093:PF13276:PF02022:PF02337,4,13,4,0,9,1005,0.31,0.99,1.0,0.55,4,4,0,0,1014,1.0,1.0,1.0,1.0
PF06880,PF06830:PF04833:PF05450:PF05023:PF06414,2,28,1,1,27,989,0.04,0.97,0.5,0.13,0,0,2,0,1016,0,1.0,0.0,0
PF02839,PF08329:PF03427:PF06483:PF07382:PF14856,8,15,3,5,12,998,0.2,0.98,0.38,0.27,0,0,8,0,1010,0,0.99,0.0,0
PF13225,PF00468:PF02915:PF13092:PF04367:PF15346,3,15,1,2,14,1001,0.07,0.98,0.33,0.14,1,0,3,1,1014,0.0,1.0,0.0,-0.0
PF15807,PF15046:PF15754:PF07458:PF04360:PF07259,2,4,0,2,4,1012,0.0,0.99,0.0,-0.0,0,0,2,0,1016,0,1.0,0.0,0
PF07660,PF03241:PF11863:PF15281:PF02572:PF14841,1,5,0,1,5,1012,0.0,0.99,0.0,-0.0,0,0,1,0,1017,0,1.0,0.0,0
PF08096,PF07042:PF05525:PF08850:PF14065:PF08195,0,1,0,0,1,1017,0.0,1.0,0,0,0,0,0,0,1018,0,1.0,0,0
PF14554,PF04692:PF15800:PF03128:PF00341:PF05808,2,9,2,0,7,1009,0.22,0.99,1.0,0.47,1,1,1,0,1016,1.0,1.0,0.5,0.71
PF13873,PF16064:PF04189:PF10226:PF04087:PF10998,19,20,7,12,13,986,0.35,0.98,0.37,0.35,0,0,19,0,999,0,0.98,0.0,0
PF04335,PF12883:PF13471:PF04060:PF00528:PF10118,7,38,4,3,34,977,0.11,0.96,0.57,0.23,2,2,5,0,1011,1.0,1.0,0.29,0.53
PF02598,PF07137:PF14988:PF15313:PF00835:PF13870,11,15,2,9,13,994,0.13,0.98,0.18,0.14,0,0,11,0,1007,0,0.99,0.0,0
PF12780,PF12777:PF08393:PF08385:PF03028:PF07728,37,57,37,0,20,961,0.65,0.98,1.0,0.8,33,30,7,3,978,0.91,0.99,0.81,0.85
PF07695,PF04122:PF12532:PF14607:PF13205:PF17092,1,4,0,1,4,1013,0.0,1.0,0.0,-0.0,0,0,1,0,1017,0,1.0,0.0,0
PF03888,PF17188:PF11874:PF08497:PF03241:PF16325,0,1,0,0,1,1017,0.0,1.0,0,0,0,0,0,0,1018,0,1.0,0,0
PF01912,PF01775:PF06172:PF04176:PF02284:PF01997,11,23,3,8,20,987,0.13,0.97,0.27,0.18,3,1,10,2,1005,0.33,0.99,0.09,0.17
PF05685,PF11291:PF13495:PF15233:PF05791:PF05164,1,4,0,1,4,1013,0.0,1.0,0.0,-0.0,0,0,1,0,1017,0,1.0,0.0,0
PF00241,PF14724:PF11527:PF04801:PF07000:PF06521,26,28,5,21,23,969,0.18,0.96,0.19,0.16,1,1,25,0,992,1.0,0.98,0.04,0.19
PF05511,PF15158:PF07961:PF15715:PF08656:PF15664,7,2,2,5,0,1011,1.0,1.0,0.29,0.53,0,0,7,0,1011,0,0.99,0.0,0
PF06839,PF01396:PF10237:PF01131:PF01751:PF13368,28,41,14,14,27,963,0.34,0.96,0.5,0.39,12,7,21,5,985,0.58,0.97,0.25,0.37
PF08122,PF09696:PF10780:PF15013:PF09769:PF10244,4,16,1,3,15,999,0.06,0.98,0.25,0.12,1,0,4,1,1013,0.0,1.0,0.0,-0.0
PF15481,PF02200:PF16091:PF05677:PF15997:PF14939,4,9,1,3,8,1006,0.11,0.99,0.25,0.16,0,0,4,0,1014,0,1.0,0.0,0
PF10384,PF09596:PF12478:PF09649:PF10056:PF15232,6,8,1,5,7,1005,0.12,0.99,0.17,0.14,0,0,6,0,1012,0,0.99,0.0,0
PF03367,PF03074:PF06830:PF12735:PF09713:PF06880,8,17,1,7,16,994,0.06,0.98,0.12,0.08,0,0,8,0,1010,0,0.99,0.0,0
PF01158,PF07074:PF15551:PF15139:PF10166:PF15252,9,11,3,6,8,1001,0.27,0.99,0.33,0.29,0,0,9,0,1009,0,0.99,0.0,0
PF13251,PF08161:PF12074:PF08216:PF15296:PF08640,4,23,2,2,21,993,0.09,0.98,0.5,0.2,2,2,2,0,1014,1.0,1.0,0.5,0.71
PF10152,PF02181:PF06346:PF10158:PF00836:PF05395,12,48,8,4,40,966,0.17,0.96,0.67,0.32,2,0,12,2,1004,0.0,0.99,0.0,-0.0
PF03478,PF07734:PF08268:PF08387:PF10442:PF12014,29,37,14,15,23,966,0.38,0.96,0.48,0.41,4,4,25,0,989,1.0,0.98,0.14,0.37
PF00941,PF03450:PF01315:PF00111:PF11591:PF01799,22,43,22,0,21,975,0.51,0.98,1.0,0.71,21,21,1,0,996,1.0,1.0,0.95,0.98
PF08275,PF01807:PF10410:PF09327:PF11975:PF11800,4,13,4,0,9,1005,0.31,0.99,1.0,0.55,1,1,3,0,1014,1.0,1.0,0.25,0.5
PF08040,PF15664:PF04691:PF05355:PF15828:PF03819,1,6,0,1,6,1011,0.0,0.99,0.0,-0.0,0,0,1,0,1017,0,1.0,0.0,0
PF15202,PF15895:PF17015:PF15553:PF02425:PF15482,0,0,0,0,0,1018,0,1.0,0,0,0,0,0,0,1018,0,1.0,0,0
PF04841,PF04840:PF12215:PF04685:PF10487:PF16863,9,36,9,0,27,982,0.25,0.97,1.0,0.49,3,2,7,1,1008,0.67,0.99,0.22,0.38
PF02251,PF02252:PF01132:PF13332:PF09285:PF03665,6,17,6,0,11,1001,0.35,0.99,1.0,0.59,3,2,4,1,1011,0.67,1.0,0.33,0.47
PF05499,PF05129:PF16858:PF08649:PF08636:PF03823,6,19,2,4,17,995,0.11,0.98,0.33,0.18,0,0,6,0,1012,0,0.99,0.0,0
PF04234,PF03389:PF11775:PF03135:PF08744:PF03090,1,5,0,1,5,1012,0.0,0.99,0.0,-0.0,0,0,1,0,1017,0,1.0,0.0,0
PF04275,PF04030:PF02913:PF09265:PF00215:PF02873,9,68,7,2,61,948,0.1,0.94,0.78,0.27,7,4,5,3,1006,0.57,0.99,0.44,0.5
PF04153,PF04959:PF13914:PF08209:PF11250:PF04844,12,27,4,8,23,983,0.15,0.97,0.33,0.21,4,2,10,2,1004,0.5,0.99,0.17,0.28
PF15377,PF01959:PF15053:PF11017:PF15252:PF01415,0,7,0,0,7,1011,0.0,0.99,0,0,0,0,0,0,1018,0,1.0,0,0
PF01014,PF00731:PF02578:PF04927:PF00081:PF08611,3,38,2,1,36,979,0.05,0.96,0.67,0.18,1,0,3,1,1014,0.0,1.0,0.0,-0.0
PF14667,PF01554:PF11136:PF10623:PF14109:PF03312,2,29,2,0,27,989,0.07,0.97,1.0,0.26,0,0,2,0,1016,0,1.0,0.0,0
PF12278,PF11671:PF15362:PF15374:PF06567:PF16829,0,2,0,0,2,1016,0.0,1.0,0,0,0,0,0,0,1018,0,1.0,0,0
PF14677,PF14680:PF14676:PF14679:PF14674:PF14675,1,1,1,0,0,1017,1.0,1.0,1.0,1.0,1,1,0,0,1017,1.0,1.0,1.0,1.0
PF11465,PF07204:PF03921:PF12355:PF05790:PF02158,3,9,1,2,8,1007,0.11,0.99,0.33,0.19,2,1,2,1,1014,0.5,1.0,0.33,0.41
PF03883,PF15849:PF02202:PF15125:PF10664:PF11371,2,4,1,1,3,1013,0.25,1.0,0.5,0.35,0,0,2,0,1016,0,1.0,0.0,0
PF12857,PF01032:PF16326:PF09383:PF09821:PF03459,2,9,2,0,7,1009,0.22,0.99,1.0,0.47,2,2,0,0,1016,1.0,1.0,1.0,1.0
PF08565,PF08564:PF03234:PF02083:PF08234:PF06211,11,15,10,1,5,1002,0.67,0.99,0.91,0.78,1,1,10,0,1007,1.0,0.99,0.09,0.3
PF09348,PF08576:PF12046:PF17032:PF02427:PF00737,1,4,0,1,4,1013,0.0,1.0,0.0,-0.0,0,0,1,0,1017,0,1.0,0.0,0
PF13458,PF12849:PF08376:PF16214:PF07701:PF04940,8,34,6,2,28,982,0.18,0.97,0.75,0.35,3,3,5,0,1010,1.0,1.0,0.38,0.61
PF04670,PF04724:PF01712:PF10160:PF03034:PF03878,18,24,6,12,18,982,0.25,0.97,0.33,0.27,3,1,17,2,998,0.33,0.98,0.06,0.13
PF15802,PF12243:PF06283:PF02226:PF05438:PF15794,1,28,1,0,27,990,0.04,0.97,1.0,0.19,0,0,1,0,1017,0,1.0,0.0,0
PF00932,PF16208:PF04732:PF00038:PF10042:PF08757,6,27,5,1,22,990,0.19,0.98,0.83,0.39,2,1,5,1,1011,0.5,0.99,0.17,0.29
PF01761,PF00275:PF01202:PF01487:PF08501:PF01488,14,31,11,3,20,984,0.35,0.98,0.79,0.52,12,11,3,1,1003,0.92,1.0,0.79,0.85
PF10500,PF09216:PF14866:PF15621:PF16311:PF03692,2,1,0,2,1,1015,0.0,1.0,0.0,-0.0,0,0,2,0,1016,0,1.0,0.0,0
PF00254,PF13174:PF00515:PF01346:PF07719:PF01694,57,90,31,26,59,902,0.34,0.92,0.54,0.39,20,13,44,7,954,0.65,0.95,0.23,0.37
PF09003,PF13356:PF14842:PF08298:PF07411:PF08886,2,3,1,1,2,1014,0.33,1.0,0.5,0.41,0,0,2,0,1016,0,1.0,0.0,0
PF10406,PF04139:PF03715:PF04000:PF07524:PF15369,9,43,9,0,34,975,0.21,0.97,1.0,0.45,5,2,7,3,1006,0.4,0.99,0.22,0.29
PF09267,PF12610:PF15895:PF12162:PF17017:PF06608,0,3,0,0,3,1015,0.0,1.0,0,0,0,0,0,0,1018,0,1.0,0,0
PF02025,PF14862:PF06868:PF05418:PF15340:PF15333,2,3,0,2,3,1013,0.0,1.0,0.0,-0.0,0,0,2,0,1016,0,1.0,0.0,0
PF14349,PF11593:PF01913:PF07505:PF10995:PF03888,2,3,0,2,3,1013,0.0,1.0,0.0,-0.0,0,0,2,0,1016,0,1.0,0.0,0
PF12018,PF10156:PF14868:PF10253:PF08316:PF08639,8,16,3,5,13,997,0.19,0.98,0.38,0.26,0,0,8,0,1010,0,0.99,0.0,0
PF04622,PF07444:PF13095:PF11317:PF10716:PF15699,5,3,0,5,3,1010,0.0,0.99,0.0,-0.0,0,0,5,0,1013,0,1.0,0.0,0
PF08627,PF08137:PF03350:PF10276:PF07939:PF10173,0,9,0,0,9,1009,0.0,0.99,0,0,0,0,0,0,1018,0,1.0,0,0
PF04342,PF13742:PF11751:PF13722:PF03428:PF04451,0,3,0,0,3,1015,0.0,1.0,0,0,0,0,0,0,1018,0,1.0,0,0
PF09284,PF14683:PF14686:PF06045:PF07831:PF16712,8,20,8,0,12,998,0.4,0.99,1.0,0.63,3,0,8,3,1007,0.0,0.99,0.0,-0.0
PF09451,PF06697:PF01670:PF08536:PF07911:PF04690,9,14,0,9,14,995,0.0,0.98,0.0,-0.01,0,0,9,0,1009,0,0.99,0.0,0
PF03962,PF05207:PF09495:PF00684:PF06842:PF02615,7,28,5,2,23,988,0.18,0.98,0.71,0.35,1,1,6,0,1011,1.0,0.99,0.14,0.38
PF05568,PF05881:PF04160:PF01273:PF05183:PF15489,0,39,0,0,39,979,0.0,0.96,0,0,2,0,0,2,1016,0.0,1.0,0,0
PF06476,PF10118:PF07399:PF04225:PF03061:PF04260,1,42,1,0,41,976,0.02,0.96,1.0,0.15,0,0,1,0,1017,0,1.0,0.0,0
PF02098,PF02284:PF04176:PF06658:PF00210:PF00965,3,27,1,2,26,989,0.04,0.97,0.33,0.1,3,0,3,3,1012,0.0,0.99,0.0,-0.0
PF08138,PF17201:PF06134:PF05298:PF08119:PF03420,1,4,0,1,4,1013,0.0,1.0,0.0,-0.0,0,0,1,0,1017,0,1.0,0.0,0
PF08020,PF01591:PF16322:PF00789:PF03727:PF06327,0,50,0,0,50,968,0.0,0.95,0,0,7,0,0,7,1011,0.0,0.99,0,0
PF03436,PF02343:PF05075:PF15362:PF14049:PF00865,1,3,1,0,2,1015,0.33,1.0,1.0,0.58,0,0,1,0,1017,0,1.0,0.0,0
PF02507,PF02531:PF08576:PF09252:PF12046:PF10868,0,4,0,0,4,1014,0.0,1.0,0,0,0,0,0,0,1018,0,1.0,0,0
PF09051,PF09049:PF09050:PF07014:PF15690:PF15689,0,0,0,0,0,1018,0,1.0,0,0,0,0,0,0,1018,0,1.0,0,0
PF08240,PF00107:PF01066:PF08652:PF01408:PF13813,100,125,85,15,40,878,0.68,0.95,0.85,0.73,15,14,86,1,917,0.93,0.91,0.14,0.34
PF11942,PF03439:PF00467:PF02357:PF16121:PF08071,7,33,7,0,26,985,0.21,0.97,1.0,0.45,6,3,4,3,1008,0.5,0.99,0.43,0.46
PF00180,PF00255:PF00724:PF01198:PF00210:PF08584,37,74,15,22,59,922,0.2,0.92,0.41,0.25,6,4,33,2,979,0.67,0.97,0.11,0.26
PF08707,PF08453:PF17164:PF11751:PF00669:PF05488,1,3,0,1,3,1014,0.0,1.0,0.0,-0.0,0,0,1,0,1017,0,1.0,0.0,0
PF12361,PF11556:PF12377:PF15445:PF03011:PF15447,1,1,1,0,0,1017,1.0,1.0,1.0,1.0,1,1,0,0,1017,1.0,1.0,1.0,1.0
PF09036,PF16018:PF06395:PF09128:PF16562:PF15720,9,12,4,5,8,1001,0.33,0.99,0.44,0.38,2,2,7,0,1009,1.0,0.99,0.22,0.47
PF16117,PF15823:PF01289:PF04391:PF03963:PF13995,1,2,0,1,2,1015,0.0,1.0,0.0,-0.0,0,0,1,0,1017,0,1.0,0.0,0
PF00475,PF12311:PF01933:PF01687:PF04667:PF12680,9,28,4,5,24,985,0.14,0.97,0.44,0.24,0,0,9,0,1009,0,0.99,0.0,0
PF15753,PF00669:PF15119:PF15776:PF05836:PF17053,3,4,0,3,4,1011,0.0,0.99,0.0,-0.0,0,0,3,0,1015,0,1.0,0.0,0
PF00653,PF00382:PF12356:PF04181:PF05424:PF05046,16,35,8,8,27,975,0.23,0.97,0.5,0.32,1,1,15,0,1002,1.0,0.99,0.06,0.25
PF12588,PF02666:PF08165:PF12735:PF05664:PF05431,3,30,3,0,27,988,0.1,0.97,1.0,0.31,1,0,3,1,1014,0.0,1.0,0.0,-0.0
PF00635,PF03567:PF00650:PF03765:PF07985:PF06479,38,84,21,17,63,917,0.25,0.92,0.55,0.34,8,6,32,2,978,0.75,0.97,0.16,0.33
PF03134,PF01215:PF13664:PF03162:PF09769:PF13908,25,23,9,16,14,979,0.39,0.97,0.36,0.36,1,1,24,0,993,1.0,0.98,0.04,0.2
PF12024,PF17035:PF17105:PF00439:PF15612:PF01342,7,87,6,1,81,930,0.07,0.92,0.86,0.23,7,1,6,6,1005,0.14,0.99,0.14,0.14
PF01493,PF00310:PF14691:PF16092:PF04898:PF01645,7,22,7,0,15,996,0.32,0.99,1.0,0.56,6,6,1,0,1011,1.0,1.0,0.86,0.93
PF11787,PF11786:PF11785:PF12498:PF08601:PF03957,4,7,4,0,3,1011,0.57,1.0,1.0,0.75,2,2,2,0,1014,1.0,1.0,0.5,0.71
PF10735,PF08262:PF10960:PF15440:PF08020:PF04461,0,3,0,0,3,1015,0.0,1.0,0,0,0,0,0,0,1018,0,1.0,0,0
PF05627,PF06136:PF07798:PF04570:PF04729:PF02076,8,24,3,5,21,989,0.12,0.97,0.38,0.21,1,1,7,0,1010,1.0,0.99,0.12,0.35
PF01677,PF06311:PF14364:PF05026:PF13724:PF10296,0,22,0,0,22,996,0.0,0.98,0,0,1,0,0,1,1017,0.0,1.0,0,0
PF14770,PF15071:PF06232:PF15370:PF00727:PF10868,3,10,0,3,10,1005,0.0,0.99,0.0,-0.01,0,0,3,0,1015,0,1.0,0.0,0
PF12696,PF08722:PF12168:PF15153:PF01695:PF08361,1,9,1,0,8,1009,0.11,0.99,1.0,0.33,0,0,1,0,1017,0,1.0,0.0,0
PF14800,PF04129:PF05942:PF15091:PF08566:PF02401,4,24,2,2,22,992,0.08,0.98,0.5,0.2,0,0,4,0,1014,0,1.0,0.0,0
PF12947,PF12946:PF02412:PF00093:PF07462:PF07474,25,29,13,12,16,977,0.45,0.97,0.52,0.47,2,2,23,0,993,1.0,0.98,0.08,0.28
PF14956,PF00272:PF14935:PF06679:PF01128:PF06951,1,14,1,0,13,1004,0.07,0.99,1.0,0.27,1,1,0,0,1017,1.0,1.0,1.0,1.0
PF00524,PF05065:PF11291:PF06965:PF11300:PF13495,4,5,2,2,3,1011,0.4,1.0,0.5,0.44,0,0,4,0,1014,0,1.0,0.0,0
PF01804,PF17084:PF07149:PF11369:PF15096:PF03963,1,1,0,1,1,1016,0.0,1.0,0.0,-0.0,0,0,1,0,1017,0,1.0,0.0,0
PF13632,PF08174:PF03552:PF01031:PF13091:PF00350,15,91,9,6,82,921,0.1,0.91,0.6,0.22,18,5,10,13,990,0.28,0.98,0.33,0.29
PF16192,PF02366:PF02815:PF15012:PF01365:PF08709,14,28,14,0,14,990,0.5,0.99,1.0,0.7,9,2,12,7,997,0.22,0.98,0.14,0.17
PF14297,PF02557:PF01913:PF15482:PF00669:PF06724,0,4,0,0,4,1014,0.0,1.0,0,0,0,0,0,0,1018,0,1.0,0,0
PF12246,PF12247:PF00867:PF00752:PF10926:PF00593,2,41,2,0,39,977,0.05,0.96,1.0,0.22,3,1,1,2,1014,0.33,1.0,0.5,0.41
PF14311,PF14743:PF01068:PF03119:PF04679:PF15059,2,24,2,0,22,994,0.08,0.98,1.0,0.29,3,2,0,1,1015,0.67,1.0,1.0,0.82
PF10963,PF04960:PF02446:PF01204:PF02045:PF05291,0,39,0,0,39,979,0.0,0.96,0,0,2,0,0,2,1016,0.0,1.0,0,0
PF08698,PF10173:PF10248:PF09340:PF11911:PF07052,14,22,5,9,17,987,0.23,0.97,0.36,0.27,2,1,13,1,1003,0.5,0.99,0.07,0.19
PF09696,PF10244:PF05039:PF15370:PF15359:PF10780,9,11,4,5,7,1002,0.36,0.99,0.44,0.4,0,0,9,0,1009,0,0.99,0.0,0
PF03388,PF08114:PF10501:PF10147:PF03879:PF07047,15,20,6,9,14,989,0.3,0.98,0.4,0.34,0,0,15,0,1003,0,0.99,0.0,0
PF03422,PF06439:PF04616:PF08531:PF16990:PF03442,14,44,9,5,35,969,0.2,0.96,0.64,0.35,3,3,11,0,1004,1.0,0.99,0.21,0.46
PF15180,PF17062:PF17015:PF10664:PF15175:PF05853,3,2,0,3,2,1013,0.0,1.0,0.0,-0.0,0,0,3,0,1015,0,1.0,0.0,0
PF16320,PF13259:PF00542:PF11429:PF08523:PF06298,9,20,9,0,11,998,0.45,0.99,1.0,0.67,0,0,9,0,1009,0,0.99,0.0,0
PF01227,PF01512:PF05023:PF10589:PF10531:PF13288,5,26,2,3,24,989,0.08,0.97,0.4,0.17,5,1,4,4,1009,0.2,0.99,0.2,0.2
PF02493,PF08154:PF00415:PF02204:PF15811:PF11616,45,86,23,22,63,910,0.27,0.92,0.51,0.33,9,7,38,2,971,0.78,0.96,0.16,0.34
PF12016,PF10574:PF09786:PF01217:PF06545:PF16952,0,54,0,0,54,964,0.0,0.95,0,0,0,0,0,0,1018,0,1.0,0,0
PF14804,PF12631:PF16712:PF16709:PF10396:PF16711,2,13,2,0,11,1005,0.15,0.99,1.0,0.39,1,0,2,1,1015,0.0,1.0,0.0,-0.0
PF01342,PF03172:PF17035:PF14051:PF08788:PF12024,8,33,8,0,25,985,0.24,0.98,1.0,0.49,1,1,7,0,1010,1.0,0.99,0.12,0.35
PF14057,PF08119:PF10938:PF13321:PF01404:PF17208,0,8,0,0,8,1010,0.0,0.99,0,0,0,0,0,0,1018,0,1.0,0,0
PF02102,PF14866:PF16311:PF17049:PF05234:PF09715,3,2,0,3,2,1013,0.0,1.0,0.0,-0.0,0,0,3,0,1015,0,1.0,0.0,0
PF05368,PF11807:PF04199:PF14027:PF05721:PF01063,46,66,22,24,44,928,0.33,0.93,0.48,0.37,12,12,34,0,972,1.0,0.97,0.26,0.5
PF02391,PF05176:PF13023:PF08315:PF01680:PF14943,10,37,6,4,31,977,0.16,0.97,0.6,0.3,3,2,8,1,1007,0.67,0.99,0.2,0.36
PF11558,PF17046:PF17106:PF07367:PF13287:PF09372,0,12,0,0,12,1006,0.0,0.99,0,0,1,0,0,1,1017,0.0,1.0,0,0
PF01079,PF01085:PF04424:PF04870:PF10141:PF12470,13,29,10,3,19,986,0.34,0.98,0.77,0.51,2,2,11,0,1005,1.0,0.99,0.15,0.39
PF15347,PF15703:PF15068:PF15427:PF10445:PF03306,0,9,0,0,9,1009,0.0,0.99,0,0,0,0,0,0,1018,0,1.0,0,0
PF14831,PF09804:PF16550:PF02112:PF12141:PF09033,2,11,2,0,9,1007,0.18,0.99,1.0,0.42,0,0,2,0,1016,0,1.0,0.0,0
PF08303,PF08302:PF09511:PF17167:PF06165:PF16874,3,13,3,0,10,1005,0.23,0.99,1.0,0.48,1,1,2,0,1015,1.0,1.0,0.33,0.58
PF04952,PF01114:PF02057:PF12904:PF03842:PF15130,3,3,1,2,2,1013,0.33,1.0,0.33,0.33,0,0,3,0,1015,0,1.0,0.0,0
PF10162,PF13330:PF07691:PF03782:PF13402:PF01833,10,58,7,3,51,957,0.12,0.95,0.7,0.28,4,3,7,1,1007,0.75,0.99,0.3,0.47
PF03725,PF01138:PF07541:PF10469:PF08067:PF03726,29,67,29,0,38,951,0.43,0.96,1.0,0.65,3,3,26,0,989,1.0,0.97,0.1,0.32
PF11404,PF07941:PF08763:PF16519:PF03521:PF16799,1,18,1,0,17,1000,0.06,0.98,1.0,0.23,1,1,0,0,1017,1.0,1.0,1.0,1.0
PF15701,PF10737:PF00720:PF02072:PF17053:PF01882,0,1,0,0,1,1017,0.0,1.0,0,0,0,0,0,0,1018,0,1.0,0,0
PF09545,PF08108:PF02066:PF06103:PF14671:PF13783,0,4,0,0,4,1014,0.0,1.0,0,0,0,0,0,0,1018,0,1.0,0,0
PF09537,PF15776:PF09490:PF08548:PF02613:PF08805,0,5,0,0,5,1013,0.0,1.0,0,0,0,0,0,0,1018,0,1.0,0,0
PF09591,PF07192:PF04562:PF08208:PF05418:PF14862,0,6,0,0,6,1012,0.0,0.99,0,0,0,0,0,0,1018,0,1.0,0,0
PF02955,PF02951:PF03729:PF06890:PF02277:PF06798,4,7,4,0,3,1011,0.57,1.0,1.0,0.75,0,0,4,0,1014,0,1.0,0.0,0
PF01878,PF08228:PF12926:PF11805:PF13933:PF12855,10,5,1,9,4,1004,0.2,0.99,0.1,0.14,0,0,10,0,1008,0,0.99,0.0,0
PF11926,PF00684:PF14308:PF11875:PF14237:PF10222,2,26,2,0,24,992,0.08,0.98,1.0,0.27,1,0,2,1,1015,0.0,1.0,0.0,-0.0
PF07599,PF07471:PF00493:PF01754:PF03400:PF04024,0,53,0,0,53,965,0.0,0.95,0,0,1,0,0,1,1017,0.0,1.0,0,0
PF01968,PF05378:PF02538:PF06032:PF06746:PF14306,28,34,28,0,6,984,0.82,0.99,1.0,0.9,8,8,20,0,990,1.0,0.98,0.29,0.53
PF16747,PF15137:PF01580:PF04451:PF14711:PF14885,0,7,0,0,7,1011,0.0,0.99,0,0,0,0,0,0,1018,0,1.0,0,0
PF05225,PF04218:PF03221:PF03184:PF04236:PF09607,27,78,23,4,55,936,0.29,0.94,0.85,0.48,15,8,19,7,984,0.53,0.97,0.3,0.39
PF00918,PF03745:PF06681:PF14290:PF06890:PF15185,1,2,0,1,2,1015,0.0,1.0,0.0,-0.0,0,0,1,0,1017,0,1.0,0.0,0
PF15186,PF03548:PF03050:PF11697:PF08497:PF01514,1,3,0,1,3,1014,0.0,1.0,0.0,-0.0,0,0,1,0,1017,0,1.0,0.0,0
PF02824,PF16897:PF01018:PF09269:PF13291:PF13167,24,21,15,9,6,988,0.71,0.99,0.62,0.66,3,3,21,0,994,1.0,0.98,0.12,0.35
PF07936,PF14866:PF15085:PF15555:PF03379:PF15119,1,5,0,1,5,1012,0.0,0.99,0.0,-0.0,0,0,1,0,1017,0,1.0,0.0,0
PF10407,PF15082:PF12178:PF15407:PF15392:PF08183,0,5,0,0,5,1013,0.0,1.0,0,0,0,0,0,0,1018,0,1.0,0,0
PF01247,PF12232:PF01586:PF15372:PF12533:PF06621,18,7,3,15,4,996,0.43,0.98,0.17,0.26,2,2,16,0,1000,1.0,0.98,0.11,0.33
PF12660,PF06469:PF14844:PF12657:PF13271:PF07569,4,36,3,1,33,981,0.08,0.97,0.75,0.24,4,1,3,3,1011,0.25,0.99,0.25,0.25
PF15515,PF15400:PF01076:PF05065:PF05962:PF01943,0,3,0,0,3,1015,0.0,1.0,0,0,0,0,0,0,1018,0,1.0,0,0
PF11092,PF15482:PF11863:PF06724:PF08708:PF09669,0,1,0,0,1,1017,0.0,1.0,0,0,0,0,0,0,1018,0,1.0,0,0
PF13164,PF06039:PF05754:PF03238:PF09673:PF15281,2,5,1,1,4,1012,0.2,1.0,0.5,0.31,0,0,2,0,1016,0,1.0,0.0,0
PF05731,PF05386:PF13271:PF06469:PF09453:PF08954,5,19,3,2,16,997,0.16,0.98,0.6,0.3,2,2,3,0,1013,1.0,1.0,0.4,0.63
PF12245,PF12583:PF12580:PF03797:PF06280:PF12177,3,7,1,2,6,1009,0.14,0.99,0.33,0.21,1,1,2,0,1015,1.0,1.0,0.33,0.58
PF11709,PF01226:PF13564:PF13933:PF13093:PF15786,6,17,2,4,15,997,0.12,0.98,0.33,0.19,0,0,6,0,1012,0,0.99,0.0,0
PF15041,PF15119:PF06729:PF14866:PF15809:PF00770,1,2,0,1,2,1015,0.0,1.0,0.0,-0.0,0,0,1,0,1017,0,1.0,0.0,0
PF04715,PF00425:PF00977:PF00697:PF00218:PF06418,12,47,12,0,35,971,0.26,0.97,1.0,0.5,4,3,9,1,1005,0.75,0.99,0.25,0.43
PF04629,PF09007:PF10608:PF09058:PF12316:PF02377,6,10,2,4,8,1004,0.2,0.99,0.33,0.25,1,1,5,0,1012,1.0,1.0,0.17,0.41
PF15000,PF04892:PF09216:PF05919:PF09690:PF15748,1,2,0,1,2,1015,0.0,1.0,0.0,-0.0,0,0,1,0,1017,0,1.0,0.0,0
PF13322,PF14028:PF06798:PF16449:PF03050:PF03616,0,1,0,0,1,1017,0.0,1.0,0,0,0,0,0,0,1018,0,1.0,0,0
PF10971,PF12147:PF14671:PF09192:PF13026:PF10329,1,9,1,0,8,1009,0.11,0.99,1.0,0.33,1,1,0,0,1017,1.0,1.0,1.0,1.0
PF16673,PF08941:PF02176:PF06803:PF15815:PF15451,4,23,3,1,20,994,0.13,0.98,0.75,0.31,3,3,1,0,1014,1.0,1.0,0.75,0.87
PF07651,PF16515:PF09788:PF11498:PF04388:PF03468,20,23,10,10,13,985,0.43,0.98,0.5,0.45,2,2,18,0,998,1.0,0.98,0.1,0.31
PF10563,PF03203:PF11371:PF15754:PF17015:PF07353,1,2,0,1,2,1015,0.0,1.0,0.0,-0.0,0,0,1,0,1017,0,1.0,0.0,0
PF10466,PF06309:PF03022:PF10420:PF04884:PF03122,1,25,0,1,25,992,0.0,0.97,0.0,-0.0,1,0,1,1,1016,0.0,1.0,0.0,-0.0
PF08614,PF14077:PF13925:PF12265:PF09453:PF09384,6,29,5,1,24,988,0.17,0.98,0.83,0.37,3,2,4,1,1011,0.67,1.0,0.33,0.47
PF12319,PF10180:PF04367:PF07939:PF02116:PF09419,1,23,0,1,23,994,0.0,0.98,0.0,-0.0,1,0,1,1,1016,0.0,1.0,0.0,-0.0
PF10177,PF15862:PF15280:PF03615:PF05030:PF08578,1,18,1,0,17,1000,0.06,0.98,1.0,0.23,1,1,0,0,1017,1.0,1.0,1.0,1.0
PF11127,PF09122:PF06617:PF12368:PF13972:PF03912,2,9,0,2,9,1007,0.0,0.99,0.0,-0.0,0,0,2,0,1016,0,1.0,0.0,0
PF06097,PF15771:PF15184:PF14328:PF09092:PF15207,0,3,0,0,3,1015,0.0,1.0,0,0,0,0,0,0,1018,0,1.0,0,0
PF06718,PF02452:PF06028:PF03323:PF05336:PF06711,0,13,0,0,13,1005,0.0,0.99,0,0,0,0,0,0,1018,0,1.0,0,0
PF06585,PF16984:PF06757:PF08925:PF04133:PF10271,11,16,5,6,11,996,0.31,0.98,0.45,0.37,1,0,11,1,1006,0.0,0.99,0.0,-0.0
PF03660,PF08400:PF06162:PF14609:PF01959:PF02157,4,11,2,2,9,1005,0.18,0.99,0.5,0.3,0,0,4,0,1014,0,1.0,0.0,0
PF00383,PF01872:PF08719:PF08211:PF01249:PF00588,51,51,28,23,23,944,0.55,0.95,0.55,0.53,9,8,43,1,966,0.89,0.96,0.16,0.36
PF08418,PF12213:PF16002:PF16653:PF01958:PF04455,5,26,2,3,24,989,0.08,0.97,0.4,0.17,4,1,4,3,1010,0.25,0.99,0.2,0.22
PF02130,PF02348:PF12409:PF09040:PF08282:PF12515,5,38,2,3,36,977,0.05,0.96,0.4,0.13,5,0,5,5,1008,0.0,0.99,0.0,-0.0
PF08936,PF04222:PF04445:PF04835:PF10995:PF15776,0,4,0,0,4,1014,0.0,1.0,0,0,0,0,0,0,1018,0,1.0,0,0
PF08115,PF08676:PF12736:PF11864:PF08596:PF11916,0,38,0,0,38,980,0.0,0.96,0,0,3,0,0,3,1015,0.0,1.0,0,0
PF04765,PF03195:PF08643:PF04788:PF12317:PF04819,10,17,3,7,14,994,0.18,0.98,0.3,0.22,2,1,9,1,1007,0.5,0.99,0.1,0.22
PF08635,PF09166:PF02894:PF01041:PF09290:PF02774,2,41,2,0,39,977,0.05,0.96,1.0,0.22,2,1,1,1,1015,0.5,1.0,0.5,0.5
PF16141,PF01033:PF08084:PF08083:PF08082:PF12134,0,31,0,0,31,987,0.0,0.97,0,0,13,0,0,13,1005,0.0,0.99,0,0
PF16600,PF16632:PF16553:PF12485:PF15808:PF15898,1,6,1,0,5,1012,0.17,1.0,1.0,0.41,1,1,0,0,1017,1.0,1.0,1.0,1.0
PF07240,PF15883:PF16037:PF06581:PF01947:PF08092,0,1,0,0,1,1017,0.0,1.0,0,0,0,0,0,0,1018,0,1.0,0,0
PF07800,PF02186:PF02291:PF07946:PF00363:PF04111,4,31,0,4,31,983,0.0,0.97,0.0,-0.01,3,0,4,3,1011,0.0,0.99,0.0,-0.0
PF09414,PF14948:PF11548:PF12567:PF00102:PF12453,7,54,5,2,49,962,0.09,0.95,0.71,0.25,4,1,6,3,1008,0.25,0.99,0.14,0.18
PF12751,PF11510:PF15999:PF13824:PF10253:PF07222,1,15,0,1,15,1002,0.0,0.98,0.0,-0.0,1,0,1,1,1016,0.0,1.0,0.0,-0.0
PF10345,PF04679:PF01068:PF04675:PF11411:PF14743,6,19,6,0,13,999,0.32,0.99,1.0,0.56,18,5,1,13,999,0.28,0.99,0.83,0.48
PF12371,PF09596:PF12478:PF15249:PF15888:PF15232,1,14,1,0,13,1004,0.07,0.99,1.0,0.27,0,0,1,0,1017,0,1.0,0.0,0
PF04760,PF14578:PF11987:PF10383:PF11989:PF12733,9,31,9,0,22,987,0.29,0.98,1.0,0.53,1,0,9,1,1008,0.0,0.99,0.0,-0.0
PF13976,PF07727:PF13961:PF14244:PF09337:PF13276,60,139,53,7,86,872,0.38,0.91,0.88,0.54,8,8,52,0,958,1.0,0.95,0.13,0.36
PF16676,PF16675:PF09354:PF08430:PF16159:PF00250,5,45,5,0,40,973,0.11,0.96,1.0,0.33,4,2,3,2,1011,0.5,1.0,0.4,0.44
PF05556,PF14877:PF11360:PF03203:PF15776:PF09461,5,7,1,4,6,1007,0.14,0.99,0.2,0.16,0,0,5,0,1013,0,1.0,0.0,0
PF09042,PF06582:PF06583:PF07204:PF02158:PF02818,3,8,3,0,5,1010,0.38,1.0,1.0,0.61,3,3,0,0,1015,1.0,1.0,1.0,1.0
PF04341,PF01458:PF07522:PF08609:PF03118:PF00847,0,49,0,0,49,969,0.0,0.95,0,0,3,0,0,3,1015,0.0,1.0,0,0
PF14280,PF12835:PF09543:PF02388:PF13464:PF04375,1,4,1,0,3,1014,0.25,1.0,1.0,0.5,1,1,0,0,1017,1.0,1.0,1.0,1.0
PF14885,PF17049:PF00669:PF03548:PF03050:PF15856,1,6,0,1,6,1011,0.0,0.99,0.0,-0.0,0,0,1,0,1017,0,1.0,0.0,0
PF14510,PF06422:PF08370:PF00037:PF01061:PF03485,16,66,15,1,51,951,0.23,0.95,0.94,0.45,12,7,9,5,997,0.58,0.99,0.44,0.5
PF01023,PF16166:PF01221:PF00036:PF08976:PF05996,10,50,6,4,44,964,0.12,0.95,0.6,0.25,3,2,8,1,1007,0.67,0.99,0.2,0.36
PF13206,PF00913:PF10659:PF07939:PF10276:PF09805,0,12,0,0,12,1006,0.0,0.99,0,0,0,0,0,0,1018,0,1.0,0,0
PF04577,PF02517:PF13344:PF02701:PF13679:PF02365,21,69,14,7,55,942,0.2,0.94,0.67,0.35,11,6,15,5,992,0.55,0.98,0.29,0.39
PF10366,PF10367:PF00637:PF17122:PF05131:PF12451,14,35,12,2,23,981,0.34,0.98,0.86,0.53,7,4,10,3,1001,0.57,0.99,0.29,0.4
PF07885,PF03530:PF02888:PF03493:PF15113:PF03520,62,27,24,38,3,953,0.89,0.96,0.39,0.57,3,2,60,1,955,0.67,0.94,0.03,0.14
PF09532,PF12701:PF03853:PF02750:PF04377:PF09402,17,41,16,1,25,976,0.39,0.97,0.94,0.6,2,2,15,0,1001,1.0,0.99,0.12,0.34
PF05352,PF16838:PF12256:PF12603:PF09829:PF04196,0,1,0,0,1,1017,0.0,1.0,0,0,0,0,0,0,1018,0,1.0,0,0
PF10316,PF10325:PF10327:PF06113:PF10319:PF03125,7,17,2,5,15,996,0.12,0.98,0.29,0.17,1,0,7,1,1010,0.0,0.99,0.0,-0.0
PF12294,PF08497:PF01668:PF08017:PF10974:PF14251,0,10,0,0,10,1008,0.0,0.99,0,0,0,0,0,0,1018,0,1.0,0,0
PF02604,PF03831:PF05913:PF15143:PF12241:PF14882,0,2,0,0,2,1016,0.0,1.0,0,0,0,0,0,0,1018,0,1.0,0,0
PF08394,PF05100:PF05947:PF03135:PF08183:PF15577,1,7,0,1,7,1010,0.0,0.99,0.0,-0.0,0,0,1,0,1017,0,1.0,0.0,0
PF14666,PF14663:PF14664:PF14668:PF15961:PF14837,10,15,10,0,5,1003,0.67,1.0,1.0,0.81,10,10,0,0,1008,1.0,1.0,1.0,1.0
PF03186,PF06725:PF06082:PF09684:PF15281:PF08497,1,5,0,1,5,1012,0.0,0.99,0.0,-0.0,0,0,1,0,1017,0,1.0,0.0,0
PF00650,PF03765:PF04707:PF00635:PF13897:PF03062,67,74,39,28,35,916,0.53,0.94,0.58,0.52,10,9,58,1,950,0.9,0.94,0.13,0.34
PF16093,PF10181:PF09769:PF00499:PF02284:PF00430,8,16,4,4,12,998,0.25,0.98,0.5,0.35,1,1,7,0,1010,1.0,0.99,0.12,0.35
PF05241,PF07106:PF04667:PF01680:PF16906:PF10455,9,29,2,7,27,982,0.07,0.97,0.22,0.11,0,0,9,0,1009,0,0.99,0.0,0
PF13411,PF07739:PF10490:PF14917:PF02108:PF15934,4,6,1,3,5,1009,0.17,0.99,0.25,0.2,0,0,4,0,1014,0,1.0,0.0,0
PF00320,PF13919:PF01448:PF16563:PF14379:PF06203,41,36,13,28,23,954,0.36,0.95,0.32,0.31,6,6,35,0,977,1.0,0.97,0.15,0.38
PF12185,PF00638:PF08911:PF08604:PF04641:PF14304,5,50,5,0,45,968,0.1,0.96,1.0,0.31,4,2,3,2,1011,0.5,1.0,0.4,0.44
PF05881,PF17157:PF17122:PF12451:PF07263:PF02122,4,9,2,2,7,1007,0.22,0.99,0.5,0.33,0,0,4,0,1014,0,1.0,0.0,0
PF04888,PF09688:PF06764:PF02427:PF08576:PF15172,0,4,0,0,4,1014,0.0,1.0,0,0,0,0,0,0,1018,0,1.0,0,0
PF14856,PF03427:PF08329:PF00704:PF02839:PF01476,10,71,10,0,61,947,0.14,0.94,1.0,0.36,8,3,7,5,1003,0.38,0.99,0.3,0.33
PF14781,PF14782:PF14783:PF14944:PF09303:PF05110,4,17,4,0,13,1001,0.24,0.99,1.0,0.48,2,1,3,1,1013,0.5,1.0,0.25,0.35
PF01242,PF02566:PF04148:PF03928:PF09057:PF05005,7,26,4,3,22,989,0.15,0.98,0.57,0.29,0,0,7,0,1011,0,0.99,0.0,0
PF05019,PF05180:PF03151:PF03096:PF07426:PF05197,9,40,6,3,34,975,0.15,0.96,0.67,0.3,2,1,8,1,1008,0.5,0.99,0.11,0.23
PF04004,PF04090:PF07223:PF15045:PF10104:PF13864,11,13,3,8,10,997,0.23,0.98,0.27,0.24,1,1,10,0,1007,1.0,0.99,0.09,0.3
PF10252,PF01632:PF10218:PF09597:PF04716:PF00830,1,20,1,0,19,998,0.05,0.98,1.0,0.22,0,0,1,0,1017,0,1.0,0.0,0
PF02124,PF10570:PF09291:PF02439:PF07010:PF02480,0,5,0,0,5,1013,0.0,1.0,0,0,0,0,0,0,1018,0,1.0,0,0
PF15089,PF08795:PF02554:PF02277:PF09108:PF11162,0,3,0,0,3,1015,0.0,1.0,0,0,0,0,0,0,1018,0,1.0,0,0
PF15214,PF03241:PF05974:PF06834:PF13742:PF01706,2,3,0,2,3,1013,0.0,1.0,0.0,-0.0,0,0,2,0,1016,0,1.0,0.0,0
PF04937,PF14372:PF02892:PF10683:PF14291:PF05699,20,88,18,2,70,928,0.2,0.93,0.9,0.41,17,9,11,8,990,0.53,0.98,0.45,0.48
PF02488,PF16541:PF06446:PF00446:PF05039:PF01097,0,8,0,0,8,1010,0.0,0.99,0,0,0,0,0,0,1018,0,1.0,0,0
PF13363,PF10435:PF13364:PF01301:PF02140:PF02449,5,51,5,0,46,967,0.1,0.95,1.0,0.31,8,5,0,3,1010,0.62,1.0,1.0,0.79
PF13810,PF05841:PF10295:PF03525:PF03235:PF07931,1,8,0,1,8,1009,0.0,0.99,0.0,-0.0,0,0,1,0,1017,0,1.0,0.0,0
PF07440,PF12121:PF08110:PF08023:PF16048:PF08018,0,0,0,0,0,1018,0,1.0,0,0,0,0,0,0,1018,0,1.0,0,0
PF06315,PF16216:PF01796:PF04093:PF03729:PF02830,8,3,1,7,2,1008,0.33,0.99,0.12,0.2,0,0,8,0,1010,0,0.99,0.0,0
PF00997,PF13588:PF16590:PF02951:PF15623:PF06798,0,5,0,0,5,1013,0.0,1.0,0,0,0,0,0,0,1018,0,1.0,0,0
PF14079,PF02217:PF08291:PF01752:PF13753:PF15463,0,6,0,0,6,1012,0.0,0.99,0,0,0,0,0,0,1018,0,1.0,0,0
PF02146,PF04574:PF16815:PF10275:PF03134:PF08423,51,50,26,25,24,943,0.52,0.95,0.51,0.49,8,8,43,0,967,1.0,0.96,0.16,0.39
PF10324,PF10413:PF10328:PF05823:PF01130:PF16087,31,49,11,20,38,949,0.22,0.94,0.35,0.25,5,5,26,0,987,1.0,0.97,0.16,0.4
PF15489,PF11277:PF01930:PF11229:PF03511:PF15818,3,9,2,1,7,1008,0.22,0.99,0.67,0.38,0,0,3,0,1015,0,1.0,0.0,0
PF07954,PF05448:PF10445:PF09962:PF14251:PF05962,1,7,0,1,7,1010,0.0,0.99,0.0,-0.0,0,0,1,0,1017,0,1.0,0.0,0
PF02018,PF00331:PF08244:PF11837:PF00251:PF16346,7,24,4,3,20,991,0.17,0.98,0.57,0.3,4,0,7,4,1007,0.0,0.99,0.0,-0.01
PF01656,PF05825:PF08656:PF01741:PF06875:PF09056,10,8,3,7,5,1003,0.38,0.99,0.3,0.33,0,0,10,0,1008,0,0.99,0.0,0
PF09587,PF07327:PF08576:PF17124:PF15104:PF09232,5,4,1,4,3,1010,0.25,0.99,0.2,0.22,0,0,5,0,1013,0,1.0,0.0,0
PF16325,PF14841:PF06070:PF02465:PF10566:PF03428,1,2,0,1,2,1015,0.0,1.0,0.0,-0.0,0,0,1,0,1017,0,1.0,0.0,0
PF08126,PF15518:PF16888:PF13780:PF04740:PF16325,2,2,0,2,2,1014,0.0,1.0,0.0,-0.0,0,0,2,0,1016,0,1.0,0.0,0
PF06174,PF00736:PF03736:PF10587:PF14864:PF14863,0,37,0,0,37,981,0.0,0.96,0,0,4,0,0,4,1014,0.0,1.0,0,0
PF12859,PF09743:PF04182:PF10264:PF09497:PF14952,3,19,2,1,17,998,0.11,0.98,0.67,0.26,1,0,3,1,1014,0.0,1.0,0.0,-0.0
PF04090,PF10104:PF11001:PF15045:PF08528:PF11489,2,15,1,1,14,1002,0.07,0.99,0.5,0.18,0,0,2,0,1016,0,1.0,0.0,0
PF14935,PF10244:PF01716:PF02372:PF04901:PF14954,2,13,1,1,12,1004,0.08,0.99,0.5,0.19,0,0,2,0,1016,0,1.0,0.0,0
PF13359,PF13613:PF14949:PF12017:PF05485:PF13873,45,77,23,22,54,919,0.3,0.93,0.51,0.35,12,11,34,1,972,0.92,0.97,0.24,0.46
PF14784,PF06239:PF17187:PF02799:PF16545:PF01233,1,26,1,0,25,992,0.04,0.98,1.0,0.19,3,0,1,3,1014,0.0,1.0,0.0,-0.0
PF06396,PF16594:PF08656:PF15055:PF02202:PF15831,3,3,2,1,1,1014,0.67,1.0,0.67,0.67,0,0,3,0,1015,0,1.0,0.0,0
PF05879,PF04091:PF13519:PF03839:PF12460:PF12036,13,52,9,4,43,962,0.17,0.95,0.69,0.33,2,2,11,0,1005,1.0,0.99,0.15,0.39
PF14572,PF13793:PF03951:PF00156:PF06414:PF06830,14,53,14,0,39,965,0.26,0.96,1.0,0.5,3,3,11,0,1004,1.0,0.99,0.21,0.46
PF02759,PF00566:PF03456:PF02141:PF11830:PF12068,32,103,20,12,83,903,0.19,0.91,0.62,0.31,14,9,23,5,981,0.64,0.97,0.28,0.41
PF12742,PF07919:PF12584:PF11817:PF08427:PF09511,3,28,3,0,25,990,0.11,0.98,1.0,0.32,2,2,1,0,1015,1.0,1.0,0.67,0.82
PF09409,PF16678:PF04721:PF11470:PF08059:PF08325,28,23,12,16,11,979,0.52,0.97,0.43,0.46,3,3,25,0,990,1.0,0.98,0.11,0.32
PF14711,PF16325:PF13247:PF11751:PF08411:PF14841,0,3,0,0,3,1015,0.0,1.0,0,0,0,0,0,0,1018,0,1.0,0,0
PF01285,PF14764:PF06584:PF03615:PF13824:PF09949,4,21,2,2,19,995,0.1,0.98,0.5,0.21,1,0,4,1,1013,0.0,1.0,0.0,-0.0
PF14871,PF03428:PF10459:PF09951:PF10566:PF03925,1,3,0,1,3,1014,0.0,1.0,0.0,-0.0,0,0,1,0,1017,0,1.0,0.0,0
PF11540,PF04494:PF08159:PF12490:PF13925:PF08145,1,24,1,0,23,994,0.04,0.98,1.0,0.2,4,1,0,3,1014,0.25,1.0,1.0,0.5
PF09592,PF07418:PF00321:PF15071:PF04736:PF15370,0,4,0,0,4,1014,0.0,1.0,0,0,0,0,0,0,1018,0,1.0,0,0
PF16816,PF03092:PF16840:PF01031:PF11914:PF00875,0,62,0,0,62,956,0.0,0.94,0,0,1,0,0,1,1017,0.0,1.0,0,0
PF12075,PF12297:PF16830:PF16574:PF11577:PF10377,8,9,3,5,6,1004,0.33,0.99,0.38,0.35,0,0,8,0,1010,0,0.99,0.0,0
PF08567,PF03909:PF04376:PF05422:PF08066:PF16978,8,39,8,0,31,979,0.21,0.97,1.0,0.45,5,2,6,3,1007,0.4,0.99,0.25,0.31
PF02297,PF16953:PF09713:PF15375:PF10471:PF01279,18,32,7,11,25,975,0.22,0.96,0.39,0.27,2,2,16,0,1000,1.0,0.98,0.11,0.33
PF14903,PF10554:PF02399:PF01706:PF15518:PF03406,0,3,0,0,3,1015,0.0,1.0,0,0,0,0,0,0,1018,0,1.0,0,0
PF09689,PF03979:PF04546:PF13332:PF08281:PF04773,0,12,0,0,12,1006,0.0,0.99,0,0,3,0,0,3,1015,0.0,1.0,0,0
PF08343,PF10554:PF12467:PF04196:PF09950:PF17154,2,7,1,1,6,1010,0.14,0.99,0.5,0.26,0,0,2,0,1016,0,1.0,0.0,0
PF09798,PF07499:PF05939:PF03241:PF03428:PF07157,0,2,0,0,2,1016,0.0,1.0,0,0,0,0,0,0,1018,0,1.0,0,0
PF13826,PF08656:PF02202:PF14021:PF07961:PF07368,0,2,0,0,2,1016,0.0,1.0,0,0,0,0,0,0,1018,0,1.0,0,0
PF12704,PF08352:PF08402:PF12399:PF13732:PF13304,6,17,3,3,14,998,0.18,0.98,0.5,0.29,4,3,3,1,1011,0.75,1.0,0.5,0.61
PF01275,PF14798:PF05197:PF01294:PF05308:PF03073,5,13,1,4,12,1001,0.08,0.98,0.2,0.12,1,0,5,1,1012,0.0,0.99,0.0,-0.0
PF05504,PF03592:PF14882:PF01514:PF10566:PF15736,8,1,0,8,1,1009,0.0,0.99,0.0,-0.0,0,0,8,0,1010,0,0.99,0.0,0
PF09057,PF07464:PF06875:PF00489:PF14653:PF02605,0,2,0,0,2,1016,0.0,1.0,0,0,0,0,0,0,1018,0,1.0,0,0
PF00082,PF05922:PF16470:PF12583:PF09286:PF12580,63,44,40,23,4,951,0.91,0.97,0.63,0.75,4,4,59,0,955,1.0,0.94,0.06,0.24
PF01586,PF12533:PF12232:PF15372:PF09427:PF02344,3,10,3,0,7,1008,0.3,0.99,1.0,0.55,1,1,2,0,1015,1.0,1.0,0.33,0.58
PF16018,PF10193:PF06972:PF02040:PF13945:PF07001,1,28,1,0,27,990,0.04,0.97,1.0,0.19,0,0,1,0,1017,0,1.0,0.0,0
PF12861,PF15189:PF04536:PF08034:PF10273:PF12678,14,25,6,8,19,985,0.24,0.97,0.43,0.31,2,2,12,0,1004,1.0,0.99,0.14,0.38
PF00396,PF09353:PF03301:PF08127:PF08773:PF08038,12,11,4,8,7,999,0.36,0.99,0.33,0.34,1,1,11,0,1006,1.0,0.99,0.08,0.29
PF05974,PF03090:PF05939:PF06798:PF13722:PF07499,0,2,0,0,2,1016,0.0,1.0,0,0,0,0,0,0,1018,0,1.0,0,0
PF03015,PF07993:PF01422:PF08690:PF00550:PF16100,20,87,19,1,68,930,0.22,0.93,0.95,0.44,6,4,16,2,996,0.67,0.98,0.2,0.36
PF01373,PF05687:PF03181:PF00982:PF04859:PF02446,8,31,5,3,26,984,0.16,0.97,0.62,0.31,2,2,6,0,1010,1.0,0.99,0.25,0.5
PF15237,PF10217:PF15242:PF09728:PF10595:PF15991,2,12,2,0,10,1006,0.17,0.99,1.0,0.41,0,0,2,0,1016,0,1.0,0.0,0
PF01540,PF00201:PF12819:PF11721:PF13947:PF00485,0,97,0,0,97,921,0.0,0.9,0,0,7,0,0,7,1011,0.0,0.99,0,0
PF02990,PF00197:PF02330:PF01625:PF04979:PF06749,29,41,10,19,31,958,0.24,0.95,0.34,0.27,3,3,26,0,989,1.0,0.97,0.1,0.32
PF05641,PF03735:PF05266:PF16097:PF12235:PF16096,13,12,8,5,4,1001,0.67,0.99,0.62,0.64,1,1,12,0,1005,1.0,0.99,0.08,0.28
PF09092,PF03971:PF00381:PF09093:PF11736:PF04552,1,7,1,0,6,1011,0.14,0.99,1.0,0.38,0,0,1,0,1017,0,1.0,0.0,0
PF07001,PF15624:PF10482:PF15557:PF13945:PF15912,5,8,0,5,8,1005,0.0,0.99,0.0,-0.01,0,0,5,0,1013,0,1.0,0.0,0
PF02491,PF12327:PF14819:PF08114:PF14945:PF07331,2,8,2,0,6,1010,0.25,0.99,1.0,0.5,0,0,2,0,1016,0,1.0,0.0,0
PF08894,PF05509:PF07178:PF03729:PF14690:PF08708,1,1,0,1,1,1016,0.0,1.0,0.0,-0.0,0,0,1,0,1017,0,1.0,0.0,0
PF05495,PF13441:PF13705:PF06547:PF04757:PF15419,11,32,7,4,25,982,0.22,0.97,0.64,0.36,2,2,9,0,1007,1.0,0.99,0.18,0.42
PF07171,PF07364:PF06742:PF03315:PF05683:PF06863,3,14,3,0,11,1004,0.21,0.99,1.0,0.46,0,0,3,0,1015,0,1.0,0.0,0
PF09690,PF02977:PF15119:PF00770:PF07327:PF13367,0,6,0,0,6,1012,0.0,0.99,0,0,0,0,0,0,1018,0,1.0,0,0
PF11852,PF03714:PF02806:PF02922:PF00128:PF16657,2,42,2,0,40,976,0.05,0.96,1.0,0.21,13,1,1,12,1004,0.08,0.99,0.5,0.19
PF10965,PF07295:PF00713:PF04112:PF08260:PF04273,0,10,0,0,10,1008,0.0,0.99,0,0,0,0,0,0,1018,0,1.0,0,0
PF06748,PF10816:PF01645:PF00310:PF16855:PF13806,0,21,0,0,21,997,0.0,0.98,0,0,2,0,0,2,1016,0.0,1.0,0,0
PF05177,PF15509:PF12886:PF15622:PF11699:PF15499,4,13,1,3,12,1002,0.08,0.99,0.25,0.13,0,0,4,0,1014,0,1.0,0.0,0
PF16742,PF16556:PF15037:PF07923:PF14022:PF09586,0,11,0,0,11,1007,0.0,0.99,0,0,0,0,0,0,1018,0,1.0,0,0
PF08285,PF05336:PF08566:PF04119:PF15766:PF10961,2,15,1,1,14,1002,0.07,0.99,0.5,0.18,0,0,2,0,1016,0,1.0,0.0,0
PF02108,PF05164:PF16872:PF11291:PF13362:PF13005,0,0,0,0,0,1018,0,1.0,0,0,0,0,0,0,1018,0,1.0,0,0
PF04738,PF07409:PF01752:PF07157:PF03050:PF01514,0,2,0,0,2,1016,0.0,1.0,0,0,0,0,0,0,1018,0,1.0,0,0
PF12232,PF01586:PF15372:PF02344:PF01056:PF12533,3,15,3,0,12,1003,0.2,0.99,1.0,0.44,2,1,2,1,1014,0.5,1.0,0.33,0.41
PF11035,PF15302:PF07085:PF10630:PF15398:PF01114,2,8,1,1,7,1009,0.12,0.99,0.5,0.25,0,0,2,0,1016,0,1.0,0.0,0
PF09365,PF08093:PF14877:PF17017:PF05853:PF11044,2,6,0,2,6,1010,0.0,0.99,0.0,-0.0,0,0,2,0,1016,0,1.0,0.0,0
PF07495,PF11863:PF01943:PF06403:PF11019:PF08021,1,1,0,1,1,1016,0.0,1.0,0.0,-0.0,0,0,1,0,1017,0,1.0,0.0,0
PF13005,PF05065:PF16872:PF10490:PF02108:PF10375,0,6,0,0,6,1012,0.0,0.99,0,0,0,0,0,0,1018,0,1.0,0,0
PF12498,PF03957:PF02173:PF08601:PF11785:PF11787,2,11,2,0,9,1007,0.18,0.99,1.0,0.42,2,2,0,0,1016,1.0,1.0,1.0,1.0
PF01337,PF16836:PF02955:PF09074:PF06934:PF09673,0,4,0,0,4,1014,0.0,1.0,0,0,0,0,0,0,1018,0,1.0,0,0
PF04882,PF06384:PF02374:PF12718:PF06211:PF04597,10,26,2,8,24,984,0.08,0.97,0.2,0.11,0,0,10,0,1008,0,0.99,0.0,0
PF12231,PF14952:PF15912:PF12372:PF04357:PF07792,3,11,0,3,11,1004,0.0,0.99,0.0,-0.01,0,0,3,0,1015,0,1.0,0.0,0
PF15313,PF13097:PF14988:PF10173:PF05615:PF00835,8,17,2,6,15,995,0.12,0.98,0.25,0.16,0,0,8,0,1010,0,0.99,0.0,0
PF01142,PF06991:PF11885:PF07967:PF03299:PF06886,15,29,9,6,20,983,0.31,0.97,0.6,0.42,3,2,13,1,1002,0.67,0.99,0.13,0.29
PF02522,PF05167:PF01514:PF06890:PF17206:PF03592,1,2,0,1,2,1015,0.0,1.0,0.0,-0.0,0,0,1,0,1017,0,1.0,0.0,0
PF04934,PF03479:PF15991:PF04714:PF06420:PF10571,13,9,1,12,8,997,0.11,0.98,0.08,0.08,0,0,13,0,1005,0,0.99,0.0,0
PF11720,PF09183:PF03243:PF08040:PF10315:PF15555,1,6,1,0,5,1012,0.17,1.0,1.0,0.41,0,0,1,0,1017,0,1.0,0.0,0
PF00709,PF05212:PF05458:PF03671:PF04885:PF05562,12,25,7,5,18,988,0.28,0.98,0.58,0.39,1,1,11,0,1006,1.0,0.99,0.08,0.29
PF15780,PF12510:PF10358:PF15147:PF15949:PF03836,10,26,3,7,23,985,0.12,0.97,0.3,0.17,1,1,9,0,1008,1.0,0.99,0.1,0.31
PF15490,PF14494:PF03573:PF16965:PF14980:PF00947,2,15,1,1,14,1002,0.07,0.99,0.5,0.18,0,0,2,0,1016,0,1.0,0.0,0
PF02878,PF00408:PF02880:PF02879:PF13423:PF08722,39,53,38,1,15,964,0.72,0.98,0.97,0.83,23,23,16,0,979,1.0,0.98,0.59,0.76
PF12054,PF08658:PF13892:PF15790:PF08797:PF09369,10,36,5,5,31,977,0.14,0.96,0.5,0.25,5,3,7,2,1006,0.6,0.99,0.3,0.42
PF16220,PF04546:PF03979:PF13490:PF00691:PF08281,7,12,3,4,9,1002,0.25,0.99,0.43,0.32,3,3,4,0,1011,1.0,1.0,0.43,0.65
PF08234,PF16516:PF06211:PF04440:PF13870:PF13096,2,8,1,1,7,1009,0.12,0.99,0.5,0.25,0,0,2,0,1016,0,1.0,0.0,0
PF12816,PF12451:PF17122:PF00637:PF14906:PF08216,4,33,2,2,31,983,0.06,0.97,0.5,0.17,6,1,3,5,1009,0.17,0.99,0.25,0.2
PF12010,PF01339:PF04397:PF12532:PF12431:PF02954,1,11,1,0,10,1007,0.09,0.99,1.0,0.3,0,0,1,0,1017,0,1.0,0.0,0
PF13017,PF00505:PF09011:PF13775:PF11365:PF12444,2,66,1,1,65,951,0.02,0.94,0.5,0.08,3,1,1,2,1014,0.33,1.0,0.5,0.41
PF15264,PF02116:PF10180:PF04090:PF08528:PF17098,2,21,1,1,20,996,0.05,0.98,0.5,0.15,0,0,2,0,1016,0,1.0,0.0,0
PF00575,PF09371:PF14633:PF14878:PF16921:PF07541,34,19,16,18,3,981,0.84,0.98,0.47,0.62,2,2,32,0,984,1.0,0.97,0.06,0.24
PF03806,PF04764:PF15851:PF02503:PF03865:PF06761,1,2,1,0,1,1016,0.5,1.0,1.0,0.71,0,0,1,0,1017,0,1.0,0.0,0
PF17085,PF15060:PF15231:PF15741:PF15703:PF10856,0,1,0,0,1,1017,0.0,1.0,0,0,0,0,0,0,1018,0,1.0,0,0
PF03060,PF06052:PF01259:PF09339:PF07883:PF11807,23,43,10,13,33,962,0.23,0.95,0.43,0.3,5,4,19,1,994,0.8,0.98,0.17,0.37
PF15868,PF15955:PF14935:PF10853:PF02046:PF06658,6,11,0,6,11,1001,0.0,0.98,0.0,-0.01,1,0,6,1,1011,0.0,0.99,0.0,-0.0
PF05119,PF04235:PF09695:PF05928:PF01202:PF00292,0,18,0,0,18,1000,0.0,0.98,0,0,0,0,0,0,1018,0,1.0,0,0
PF13167,PF16360:PF01018:PF15086:PF09269:PF06780,5,15,2,3,13,1000,0.13,0.98,0.4,0.22,1,1,4,0,1013,1.0,1.0,0.2,0.45
PF15318,PF16840:PF14251:PF01330:PF11775:PF06431,0,6,0,0,6,1012,0.0,0.99,0,0,0,0,0,0,1018,0,1.0,0,0
PF05055,PF08536:PF03652:PF07333:PF06206:PF11947,3,12,0,3,12,1003,0.0,0.99,0.0,-0.01,0,0,3,0,1015,0,1.0,0.0,0
PF13499,PF13833:PF00036:PF13405:PF13202:PF00153,125,176,80,45,96,797,0.45,0.86,0.64,0.46,36,34,91,2,891,0.94,0.91,0.27,0.48
PF01279,PF02044:PF00159:PF15063:PF15910:PF00446,2,4,1,1,3,1013,0.25,1.0,0.5,0.35,0,0,2,0,1016,0,1.0,0.0,0
PF10517,PF03351:PF01082:PF03712:PF03188:PF04526,6,44,6,0,38,974,0.14,0.96,1.0,0.36,15,2,4,13,999,0.13,0.98,0.33,0.2
PF05257,PF06324:PF12138:PF15289:PF16763:PF11581,2,4,1,1,3,1013,0.25,1.0,0.5,0.35,0,0,2,0,1016,0,1.0,0.0,0
PF12825,PF12828:PF09325:PF03700:PF13924:PF08944,7,24,6,1,18,993,0.25,0.98,0.86,0.46,3,2,5,1,1010,0.67,0.99,0.29,0.43
PF15275,PF16043:PF04576:PF08634:PF07535:PF06637,5,18,2,3,16,997,0.11,0.98,0.4,0.2,0,0,5,0,1013,0,1.0,0.0,0
PF00629,PF01033:PF11980:PF12714:PF00102:PF00047,35,79,23,12,56,927,0.29,0.93,0.66,0.41,15,9,26,6,977,0.6,0.97,0.26,0.38
PF16705,PF04382:PF05902:PF16511:PF07693:PF13287,1,26,1,0,25,992,0.04,0.98,1.0,0.19,2,1,0,1,1016,0.5,1.0,1.0,0.71
PF10772,PF05251:PF08190:PF03348:PF05842:PF14234,0,40,0,0,40,978,0.0,0.96,0,0,3,0,0,3,1015,0.0,1.0,0,0
PF03475,PF11591:PF03473:PF03450:PF00111:PF03476,6,49,6,0,43,969,0.12,0.96,1.0,0.34,9,6,0,3,1009,0.67,1.0,1.0,0.82
PF09726,PF10491:PF14674:PF14678:PF14677:PF14675,5,6,1,4,5,1008,0.17,0.99,0.2,0.18,1,0,5,1,1012,0.0,0.99,0.0,-0.0
PF10294,PF01869:PF01063:PF13847:PF14904:PF05721,39,82,18,21,64,915,0.22,0.92,0.46,0.28,8,7,32,1,978,0.88,0.97,0.18,0.39
PF02618,PF03831:PF13780:PF11245:PF04013:PF07805,1,2,0,1,2,1015,0.0,1.0,0.0,-0.0,0,0,1,0,1017,0,1.0,0.0,0
PF07904,PF06989:PF02116:PF10180:PF11460:PF15045,3,12,0,3,12,1003,0.0,0.99,0.0,-0.01,0,0,3,0,1015,0,1.0,0.0,0
PF11547,PF12516:PF10309:PF15778:PF15249:PF14722,4,25,4,0,21,993,0.16,0.98,1.0,0.4,0,0,4,0,1014,0,1.0,0.0,0
PF02792,PF03842:PF14967:PF14931:PF02126:PF01387,6,10,4,2,6,1006,0.4,0.99,0.67,0.51,0,0,6,0,1012,0,0.99,0.0,0
PF11991,PF01828:PF10780:PF12296:PF06127:PF12680,5,23,3,2,20,993,0.13,0.98,0.6,0.27,0,0,5,0,1013,0,1.0,0.0,0
PF02181,PF06345:PF06367:PF06371:PF06346:PF16474,39,30,22,17,8,971,0.73,0.98,0.56,0.63,8,7,32,1,978,0.88,0.97,0.18,0.39
PF13407,PF04069:PF00739:PF03524:PF02694:PF06530,17,13,5,12,8,993,0.38,0.98,0.29,0.33,2,2,15,0,1001,1.0,0.99,0.12,0.34
PF13897,PF03765:PF04707:PF03371:PF00650:PF01745,8,74,8,0,66,944,0.11,0.94,1.0,0.32,8,3,5,5,1005,0.38,0.99,0.38,0.37
PF03997,PF01775:PF00210:PF05497:PF14943:PF02284,6,34,4,2,30,982,0.12,0.97,0.67,0.27,3,1,5,2,1010,0.33,0.99,0.17,0.23
PF02782,PF00370:PF02550:PF01144:PF03694:PF05221,38,69,36,2,33,947,0.52,0.97,0.95,0.69,4,3,35,1,979,0.75,0.96,0.08,0.24
PF16415,PF12842:PF16417:PF04054:PF16418:PF06333,13,20,12,1,8,997,0.6,0.99,0.92,0.74,10,10,3,0,1005,1.0,1.0,0.77,0.88
PF09735,PF10480:PF08158:PF17215:PF05285:PF08314,5,22,0,5,22,991,0.0,0.97,0.0,-0.01,1,0,5,1,1012,0.0,0.99,0.0,-0.0
PF02121,PF02862:PF09751:PF04006:PF00375:PF08570,12,38,8,4,30,976,0.21,0.97,0.67,0.36,2,1,11,1,1005,0.5,0.99,0.08,0.2
PF01505,PF11978:PF02762:PF02761:PF02262:PF10926,2,7,2,0,5,1011,0.29,1.0,1.0,0.53,4,1,1,3,1013,0.25,1.0,0.5,0.35
PF08712,PF01106:PF01113:PF01386:PF00081:PF10561,15,46,15,0,31,972,0.33,0.97,1.0,0.56,1,1,14,0,1003,1.0,0.99,0.07,0.26
PF02532,PF10856:PF04624:PF02074:PF02283:PF14322,0,4,0,0,4,1014,0.0,1.0,0,0,0,0,0,0,1018,0,1.0,0,0
PF01136,PF01706:PF14842:PF08886:PF15518:PF03090,1,2,0,1,2,1015,0.0,1.0,0.0,-0.0,0,0,1,0,1017,0,1.0,0.0,0
PF00100,PF00530:PF01055:PF14845:PF00088:PF16477,55,83,27,28,56,907,0.33,0.92,0.49,0.36,7,7,48,0,963,1.0,0.95,0.13,0.35
PF07739,PF13096:PF15934:PF05837:PF12709:PF10375,1,4,0,1,4,1013,0.0,1.0,0.0,-0.0,0,0,1,0,1017,0,1.0,0.0,0
PF02467,PF14552:PF13366:PF07996:PF15186:PF15170,0,6,0,0,6,1012,0.0,0.99,0,0,0,0,0,0,1018,0,1.0,0,0
PF05433,PF08881:PF03883:PF05512:PF07386:PF05532,3,14,1,2,13,1002,0.07,0.99,0.33,0.15,1,0,3,1,1014,0.0,1.0,0.0,-0.0
PF01103,PF07244:PF08318:PF02225:PF10521:PF00016,23,64,13,10,51,944,0.2,0.94,0.57,0.31,2,2,21,0,995,1.0,0.98,0.09,0.29
PF14771,PF15057:PF04357:PF15912:PF12231:PF07558,4,17,2,2,15,999,0.12,0.98,0.5,0.24,0,0,4,0,1014,0,1.0,0.0,0
PF11705,PF12131:PF08127:PF08660:PF03301:PF08773,8,15,1,7,14,996,0.07,0.98,0.12,0.08,1,0,8,1,1009,0.0,0.99,0.0,-0.0
PF03731,PF02735:PF03730:PF08785:PF01820:PF08244,21,37,21,0,16,981,0.57,0.98,1.0,0.75,6,6,15,0,997,1.0,0.99,0.29,0.53
PF04814,PF04812:PF03867:PF12045:PF10525:PF04731,4,6,3,1,3,1011,0.5,1.0,0.75,0.61,1,1,3,0,1014,1.0,1.0,0.25,0.5
PF15326,PF10482:PF15914:PF07001:PF15557:PF09322,1,8,0,1,8,1009,0.0,0.99,0.0,-0.0,0,0,1,0,1017,0,1.0,0.0,0
PF15091,PF15556:PF17050:PF09690:PF09428:PF02977,0,2,0,0,2,1016,0.0,1.0,0,0,0,0,0,0,1018,0,1.0,0,0
PF12463,PF08568:PF04704:PF03385:PF15350:PF10155,2,13,0,2,13,1003,0.0,0.99,0.0,-0.01,0,0,2,0,1016,0,1.0,0.0,0
PF02676,PF15679:PF10102:PF02475:PF06588:PF15881,10,27,7,3,20,988,0.26,0.98,0.7,0.42,1,1,9,0,1008,1.0,0.99,0.1,0.31
PF00085,PF04777:PF15928:PF07449:PF01507:PF05903,99,56,31,68,25,894,0.55,0.91,0.31,0.37,2,2,97,0,919,1.0,0.9,0.02,0.14
PF00814,PF03091:PF01215:PF10190:PF06093:PF09788,30,27,12,18,15,973,0.44,0.97,0.4,0.41,2,1,29,1,987,0.5,0.97,0.03,0.12
PF03919,PF02940:PF01331:PF16545:PF17104:PF14671,14,28,13,1,15,989,0.46,0.98,0.93,0.65,0,0,14,0,1004,0,0.99,0.0,0
PF04300,PF08495:PF12014:PF10442:PF03048:PF13369,8,11,2,6,9,1001,0.18,0.99,0.25,0.21,1,1,7,0,1010,1.0,0.99,0.12,0.35
PF08123,PF14722:PF10309:PF16529:PF10264:PF08729,13,22,5,8,17,988,0.23,0.98,0.38,0.28,3,3,10,0,1005,1.0,0.99,0.23,0.48
PF01632,PF10218:PF04716:PF08561:PF09597:PF10244,5,23,1,4,22,991,0.04,0.97,0.2,0.08,1,0,5,1,1012,0.0,0.99,0.0,-0.0
PF09987,PF10690:PF11418:PF04958:PF10828:PF05613,0,3,0,0,3,1015,0.0,1.0,0,0,0,0,0,0,1018,0,1.0,0,0
PF03380,PF15724:PF06954:PF06875:PF14672:PF15339,0,1,0,0,1,1017,0.0,1.0,0,0,0,0,0,0,1018,0,1.0,0,0
PF17035,PF12024:PF17105:PF03172:PF00439:PF15612,14,86,12,2,74,930,0.14,0.93,0.86,0.33,3,2,12,1,1003,0.67,0.99,0.14,0.3
PF07829,PF10017:PF10070:PF07385:PF01540:PF05023,1,17,0,1,17,1000,0.0,0.98,0.0,-0.0,0,0,1,0,1017,0,1.0,0.0,0
PF16920,PF11921:PF02158:PF10428:PF15904:PF11465,2,10,2,0,8,1008,0.2,0.99,1.0,0.45,1,1,1,0,1016,1.0,1.0,0.5,0.71
PF05710,PF02557:PF03739:PF11288:PF14251:PF04001,0,9,0,0,9,1009,0.0,0.99,0,0,0,0,0,0,1018,0,1.0,0,0
PF09980,PF15114:PF03050:PF15207:PF15754:PF14862,0,1,0,0,1,1017,0.0,1.0,0,0,0,0,0,0,1018,0,1.0,0,0
PF02136,PF09162:PF03943:PF14327:PF03467:PF05383,19,37,11,8,26,973,0.3,0.97,0.58,0.4,3,3,16,0,999,1.0,0.98,0.16,0.39
PF02456,PF03845:PF03930:PF05857:PF02305:PF09829,0,9,0,0,9,1009,0.0,0.99,0,0,0,0,0,0,1018,0,1.0,0,0
PF10382,PF14383:PF07529:PF12552:PF14309:PF14075,6,25,4,2,21,991,0.16,0.98,0.67,0.32,5,2,4,3,1009,0.4,0.99,0.33,0.36
PF14792,PF10391:PF14791:PF14716:PF12821:PF00126,19,28,19,0,9,990,0.68,0.99,1.0,0.82,12,12,7,0,999,1.0,0.99,0.63,0.79
PF10376,PF09367:PF11017:PF15551:PF16576:PF05658,1,1,0,1,1,1016,0.0,1.0,0.0,-0.0,0,0,1,0,1017,0,1.0,0.0,0
PF09771,PF04709:PF00688:PF00019:PF12355:PF12453,5,21,5,0,16,997,0.24,0.98,1.0,0.48,2,2,3,0,1013,1.0,1.0,0.4,0.63
PF02919,PF14370:PF01028:PF05392:PF00140:PF03979,7,15,6,1,9,1002,0.4,0.99,0.86,0.58,2,2,5,0,1011,1.0,1.0,0.29,0.53
PF10574,PF09786:PF12016:PF15321:PF04093:PF09174,0,10,0,0,10,1008,0.0,0.99,0,0,0,0,0,0,1018,0,1.0,0,0
PF07228,PF00654:PF09335:PF11303:PF04134:PF07763,9,52,4,5,48,961,0.08,0.95,0.44,0.17,2,2,7,0,1009,1.0,0.99,0.22,0.47
PF04198,PF01420:PF05280:PF03831:PF04917:PF08021,6,6,4,2,2,1010,0.67,1.0,0.67,0.66,0,0,6,0,1012,0,0.99,0.0,0
PF00449,PF00699:PF00547:PF13382:PF03841:PF01979,7,49,7,0,42,969,0.14,0.96,1.0,0.37,6,6,1,0,1011,1.0,1.0,0.86,0.93
PF01924,PF02119:PF01303:PF00267:PF11312:PF07243,2,4,0,2,4,1012,0.0,0.99,0.0,-0.0,0,0,2,0,1016,0,1.0,0.0,0
PF07014,PF09051:PF09049:PF09050:PF07231:PF05594,0,0,0,0,0,1018,0,1.0,0,0,0,0,0,0,1018,0,1.0,0,0
PF17180,PF13696:PF08783:PF14978:PF02702:PF13411,3,20,2,1,18,997,0.1,0.98,0.67,0.25,2,0,3,2,1013,0.0,1.0,0.0,-0.0
PF09580,PF13828:PF01825:PF05613:PF02793:PF00664,0,128,0,0,128,890,0.0,0.87,0,0,3,0,0,3,1015,0.0,1.0,0,0
PF07007,PF17119:PF06677:PF01679:PF09531:PF09725,0,28,0,0,28,990,0.0,0.97,0,0,3,0,0,3,1015,0.0,1.0,0,0
PF13362,PF02108:PF00524:PF09834:PF05164:PF05065,0,5,0,0,5,1013,0.0,1.0,0,0,0,0,0,0,1018,0,1.0,0,0
PF16034,PF04423:PF07989:PF06918:PF12455:PF06294,2,27,1,1,26,990,0.04,0.97,0.5,0.13,1,0,2,1,1015,0.0,1.0,0.0,-0.0
PF04569,PF10295:PF03525:PF06724:PF08795:PF09917,0,3,0,0,3,1015,0.0,1.0,0,0,0,0,0,0,1018,0,1.0,0,0
PF08219,PF08228:PF10664:PF02448:PF11805:PF15863,0,5,0,0,5,1013,0.0,1.0,0,0,0,0,0,0,1018,0,1.0,0,0
PF06996,PF04214:PF11260:PF01733:PF01442:PF02405,0,18,0,0,18,1000,0.0,0.98,0,0,2,0,0,2,1016,0.0,1.0,0,0
PF07893,PF14800:PF00762:PF15091:PF02144:PF02326,20,25,8,12,17,981,0.32,0.97,0.4,0.34,2,2,18,0,998,1.0,0.98,0.1,0.31
PF02333,PF02012:PF15636:PF06484:PF05593:PF03527,4,6,0,4,6,1008,0.0,0.99,0.0,-0.0,0,0,4,0,1014,0,1.0,0.0,0
PF03000,PF09494:PF00917:PF09237:PF02135:PF07202,16,52,10,6,42,960,0.19,0.95,0.62,0.33,5,3,13,2,1000,0.6,0.99,0.19,0.33
PF00290,PF14821:PF00585:PF00291:PF01645:PF01380,4,67,2,2,65,949,0.03,0.93,0.5,0.11,4,0,4,4,1010,0.0,0.99,0.0,-0.0
PF12931,PF12932:PF09453:PF03920:PF08232:PF07304,12,27,11,1,16,990,0.41,0.98,0.92,0.61,1,1,11,0,1006,1.0,0.99,0.08,0.29
PF01515,PF07085:PF00799:PF11958:PF03958:PF15398,8,13,5,3,8,1002,0.38,0.99,0.62,0.49,1,1,7,0,1010,1.0,0.99,0.12,0.35
PF00478,PF04739:PF00571:PF03471:PF04134:PF05724,20,67,12,8,55,943,0.18,0.94,0.6,0.3,3,2,18,1,997,0.67,0.98,0.1,0.25
PF00076,PF08081:PF12353:PF08050:PF12220:PF15861,245,21,21,224,0,773,1.0,0.78,0.09,0.26,1,1,244,0,773,1.0,0.76,0.0,0.06
PF10673,PF08247:PF01217:PF13352:PF10607:PF00390,0,67,0,0,67,951,0.0,0.93,0,0,4,0,0,4,1014,0.0,1.0,0,0
PF01371,PF08414:PF01979:PF04992:PF02790:PF02142,1,75,1,0,74,943,0.01,0.93,1.0,0.11,4,0,1,4,1013,0.0,1.0,0.0,-0.0
PF03947,PF07985:PF00181:PF08294:PF04884:PF03083,18,50,16,2,34,966,0.32,0.96,0.89,0.52,6,4,14,2,998,0.67,0.98,0.22,0.38
PF04227,PF00294:PF09863:PF01380:PF03891:PF02449,7,58,7,0,51,960,0.12,0.95,1.0,0.34,1,0,7,1,1010,0.0,0.99,0.0,-0.0
PF05698,PF05697:PF10022:PF14764:PF16669:PF07034,0,23,0,0,23,995,0.0,0.98,0,0,1,0,0,1,1017,0.0,1.0,0,0
PF00770,PF05355:PF15339:PF15041:PF02950:PF15119,1,5,0,1,5,1012,0.0,0.99,0.0,-0.0,0,0,1,0,1017,0,1.0,0.0,0
PF00939,PF03105:PF03124:PF03600:PF02656:PF01923,17,49,12,5,37,964,0.24,0.96,0.71,0.4,6,2,15,4,997,0.33,0.98,0.12,0.19
PF02180,PF02731:PF07803:PF11303:PF15328:PF10361,2,9,0,2,9,1007,0.0,0.99,0.0,-0.0,0,0,2,0,1016,0,1.0,0.0,0
PF01719,PF10694:PF10962:PF02591:PF01219:PF06183,2,4,1,1,3,1013,0.25,1.0,0.5,0.35,0,0,2,0,1016,0,1.0,0.0,0
PF16118,PF15730:PF15763:PF10951:PF06070:PF07980,1,2,0,1,2,1015,0.0,1.0,0.0,-0.0,0,0,1,0,1017,0,1.0,0.0,0
PF06229,PF14941:PF15053:PF10166:PF09781:PF15551,8,3,1,7,2,1008,0.33,0.99,0.12,0.2,0,0,8,0,1010,0,0.99,0.0,0
PF15658,PF09500:PF00479:PF08015:PF10339:PF14312,0,17,0,0,17,1001,0.0,0.98,0,0,0,0,0,0,1018,0,1.0,0,0
PF00303,PF00186:PF12940:PF09265:PF09261:PF06974,6,46,3,3,43,969,0.07,0.95,0.5,0.17,2,0,6,2,1010,0.0,0.99,0.0,-0.0
PF17022,PF15334:PF01668:PF15343:PF05962:PF15856,0,4,0,0,4,1014,0.0,1.0,0,0,0,0,0,0,1018,0,1.0,0,0
PF14694,PF04412:PF03709:PF00073:PF08621:PF14240,3,23,0,3,23,992,0.0,0.97,0.0,-0.01,0,0,3,0,1015,0,1.0,0.0,0
PF07650,PF16897:PF06071:PF16360:PF13167:PF08079,14,29,8,6,21,983,0.28,0.97,0.57,0.39,2,2,12,0,1004,1.0,0.99,0.14,0.38
PF01903,PF00489:PF09459:PF02024:PF12328:PF06521,2,8,0,2,8,1008,0.0,0.99,0.0,-0.0,0,0,2,0,1016,0,1.0,0.0,0
PF02503,PF13090:PF03090:PF05939:PF02336:PF04865,2,4,2,0,2,1014,0.5,1.0,1.0,0.71,0,0,2,0,1016,0,1.0,0.0,0
PF10213,PF10260:PF15247:PF08511:PF12319:PF08598,10,17,5,5,12,996,0.29,0.98,0.5,0.38,1,1,9,0,1008,1.0,0.99,0.1,0.31
PF10242,PF06951:PF00210:PF14955:PF00143:PF12020,4,25,3,1,22,992,0.12,0.98,0.75,0.29,0,0,4,0,1014,0,1.0,0.0,0
PF10979,PF01076:PF12795:PF15497:PF05164:PF15400,0,5,0,0,5,1013,0.0,1.0,0,0,0,0,0,0,1018,0,1.0,0,0
PF01670,PF01083:PF03664:PF01099:PF09451:PF06373,6,25,3,3,22,990,0.12,0.98,0.5,0.24,1,0,6,1,1011,0.0,0.99,0.0,-0.0
PF08151,PF16165:PF08150:PF08165:PF15625:PF16056,6,14,6,0,8,1004,0.43,0.99,1.0,0.65,1,1,5,0,1012,1.0,1.0,0.17,0.41
PF07670,PF07662:PF01773:PF07664:PF08527:PF03068,7,24,5,2,19,992,0.21,0.98,0.71,0.38,2,1,6,1,1010,0.5,0.99,0.14,0.26
PF04380,PF10782:PF13946:PF15214:PF06407:PF07499,0,5,0,0,5,1013,0.0,1.0,0,0,0,0,0,0,1018,0,1.0,0,0
PF13891,PF05030:PF14611:PF06058:PF16528:PF00649,2,35,2,0,33,983,0.06,0.97,1.0,0.24,1,0,2,1,1015,0.0,1.0,0.0,-0.0
PF02128,PF07504:PF03413:PF14837:PF10305:PF08302,3,13,3,0,10,1005,0.23,0.99,1.0,0.48,0,0,3,0,1015,0,1.0,0.0,0
PF14558,PF11597:PF06011:PF14636:PF06333:PF14638,5,15,4,1,11,1002,0.27,0.99,0.8,0.46,4,3,2,1,1012,0.75,1.0,0.6,0.67
PF06830,PF04833:PF01458:PF04646:PF06880:PF06414,0,19,0,0,19,999,0.0,0.98,0,0,2,0,0,2,1016,0.0,1.0,0,0
PF06025,PF06012:PF12057:PF10427:PF16843:PF16099,9,9,5,4,4,1005,0.56,0.99,0.56,0.55,1,1,8,0,1009,1.0,0.99,0.11,0.33
PF05585,PF05380:PF07245:PF03564:PF00665:PF12259,23,129,22,1,107,888,0.17,0.89,0.96,0.38,15,13,10,2,993,0.87,0.99,0.57,0.69
PF01466,PF03931:PF01357:PF05605:PF11729:PF00352,26,49,21,5,28,964,0.43,0.97,0.81,0.57,7,6,20,1,991,0.86,0.98,0.23,0.44
PF14509,PF03592:PF06381:PF06070:PF02572:PF14841,0,3,0,0,3,1015,0.0,1.0,0,0,0,0,0,0,1018,0,1.0,0,0
PF01734,PF05057:PF01529:PF06985:PF01544:PF11815,54,119,33,21,86,878,0.28,0.89,0.61,0.36,21,15,39,6,958,0.71,0.96,0.28,0.43
PF12347,PF01486:PF00319:PF12346:PF01873:PF08911,7,34,7,0,27,984,0.21,0.97,1.0,0.45,2,1,6,1,1010,0.5,0.99,0.14,0.26
PF07955,PF07327:PF17124:PF03379:PF09253:PF08847,2,2,0,2,2,1014,0.0,1.0,0.0,-0.0,0,0,2,0,1016,0,1.0,0.0,0
PF00352,PF13259:PF04927:PF04111:PF03824:PF01106,22,34,8,14,26,970,0.24,0.96,0.36,0.27,3,2,20,1,995,0.67,0.98,0.09,0.24
PF09766,PF07978:PF00769:PF04382:PF16705:PF09379,9,49,4,5,45,964,0.08,0.95,0.44,0.17,6,3,6,3,1006,0.5,0.99,0.33,0.4
PF15727,PF09669:PF10109:PF04466:PF02554:PF08021,0,1,0,0,1,1017,0.0,1.0,0,0,0,0,0,0,1018,0,1.0,0,0
PF04768,PF00696:PF13840:PF01118:PF02774:PF10000,10,55,7,3,48,960,0.13,0.95,0.7,0.28,8,5,5,3,1005,0.62,0.99,0.5,0.56
PF03801,PF07989:PF16531:PF07926:PF12455:PF03255,9,34,5,4,29,980,0.15,0.97,0.56,0.27,2,2,7,0,1009,1.0,0.99,0.22,0.47
PF01170,PF13391:PF02926:PF04504:PF09995:PF11708,14,41,7,7,34,970,0.17,0.96,0.5,0.28,3,2,12,1,1003,0.67,0.99,0.14,0.3
PF15995,PF15994:PF01043:PF12733:PF00680:PF03511,0,15,0,0,15,1003,0.0,0.99,0,0,0,0,0,0,1018,0,1.0,0,0
PF17065,PF08991:PF10384:PF13805:PF09649:PF15232,12,20,4,8,16,990,0.2,0.98,0.33,0.25,0,0,12,0,1006,0,0.99,0.0,0
PF14368,PF04720:PF14009:PF06749:PF04690:PF04535,15,23,6,9,17,986,0.26,0.97,0.4,0.31,2,2,13,0,1003,1.0,0.99,0.13,0.36
PF02681,PF06206:PF12638:PF06373:PF07172:PF00964,5,7,2,3,5,1008,0.29,0.99,0.4,0.33,0,0,5,0,1013,0,1.0,0.0,0
PF15700,PF15972:PF14539:PF17049:PF08848:PF03713,0,1,0,0,1,1017,0.0,1.0,0,0,0,0,0,0,1018,0,1.0,0,0
PF10300,PF13174:PF03661:PF13176:PF05279:PF13181,14,119,8,6,111,893,0.07,0.89,0.57,0.17,12,4,10,8,996,0.33,0.98,0.29,0.3
PF07390,PF06681:PF16861:PF10974:PF05840:PF15207,0,4,0,0,4,1014,0.0,1.0,0,0,0,0,0,0,1018,0,1.0,0,0
PF14273,PF10681:PF06108:PF06206:PF06912:PF07335,9,12,2,7,10,999,0.17,0.98,0.22,0.18,0,0,9,0,1009,0,0.99,0.0,0
PF00197,PF04520:PF05915:PF06749:PF06376:PF00143,1,10,0,1,10,1007,0.0,0.99,0.0,-0.0,0,0,1,0,1017,0,1.0,0.0,0
PF03301,PF08127:PF00396:PF12131:PF08660:PF03409,6,23,4,2,19,993,0.17,0.98,0.67,0.33,1,1,5,0,1012,1.0,1.0,0.17,0.41
PF06451,PF02025:PF14862:PF07192:PF17049:PF04370,0,3,0,0,3,1015,0.0,1.0,0,0,0,0,0,0,1018,0,1.0,0,0
PF16173,PF16116:PF07085:PF11958:PF00799:PF08283,0,11,0,0,11,1007,0.0,0.99,0,0,0,0,0,0,1018,0,1.0,0,0
PF10087,PF06009:PF00055:PF16033:PF14478:PF09992,0,31,0,0,31,987,0.0,0.97,0,0,0,0,0,0,1018,0,1.0,0,0
PF13099,PF09074:PF14376:PF09673:PF01706:PF07499,0,5,0,0,5,1013,0.0,1.0,0,0,0,0,0,0,1018,0,1.0,0,0
PF04923,PF06417:PF03587:PF02038:PF08610:PF14705,4,26,3,1,23,991,0.12,0.98,0.75,0.29,2,2,2,0,1014,1.0,1.0,0.5,0.71
PF10719,PF09269:PF06780:PF15086:PF05128:PF10662,3,6,1,2,5,1010,0.17,0.99,0.33,0.23,1,1,2,0,1015,1.0,1.0,0.33,0.58
PF17020,PF02562:PF08632:PF13694:PF10979:PF12757,1,7,0,1,7,1010,0.0,0.99,0.0,-0.0,0,0,1,0,1017,0,1.0,0.0,0
PF04031,PF08161:PF14611:PF10699:PF09202:PF15862,13,16,4,9,12,993,0.25,0.98,0.31,0.27,1,1,12,0,1005,1.0,0.99,0.08,0.28
PF00342,PF04668:PF00223:PF00421:PF05995:PF06870,22,34,7,15,27,969,0.21,0.96,0.32,0.24,3,2,20,1,995,0.67,0.98,0.09,0.24
PF05132,PF15311:PF11727:PF10332:PF14922:PF06428,13,15,6,7,9,996,0.4,0.98,0.46,0.42,0,0,13,0,1005,0,0.99,0.0,0
PF12658,PF17015:PF15207:PF15047:PF15713:PF06952,1,3,0,1,3,1014,0.0,1.0,0.0,-0.0,0,0,1,0,1017,0,1.0,0.0,0
PF12840,PF08093:PF06681:PF10106:PF05962:PF08291,0,2,0,0,2,1016,0.0,1.0,0,0,0,0,0,0,1018,0,1.0,0,0
PF06457,PF08557:PF01821:PF01687:PF03259:PF04253,1,38,0,1,38,979,0.0,0.96,0.0,-0.01,2,0,1,2,1015,0.0,1.0,0.0,-0.0
PF14336,PF03769:PF07286:PF14735:PF02165:PF02394,1,9,0,1,9,1008,0.0,0.99,0.0,-0.0,0,0,1,0,1017,0,1.0,0.0,0
PF03741,PF06420:PF12049:PF02576:PF11255:PF10571,7,1,0,7,1,1010,0.0,0.99,0.0,-0.0,0,0,7,0,1011,0,0.99,0.0,0
PF03405,PF05910:PF00197:PF06404:PF04720:PF10604,3,31,1,2,30,985,0.03,0.97,0.33,0.1,2,1,2,1,1014,0.5,1.0,0.33,0.41
PF00623,PF04983:PF04997:PF04992:PF04990:PF05000,29,33,29,0,4,985,0.88,1.0,1.0,0.94,29,29,0,0,989,1.0,1.0,1.0,1.0
PF14762,PF14763:PF14761:PF09303:PF14679:PF14951,0,5,0,0,5,1013,0.0,1.0,0,0,0,0,0,0,1018,0,1.0,0,0
PF09296,PF09297:PF15916:PF05026:PF14803:PF10169,8,20,7,1,13,997,0.35,0.99,0.88,0.55,1,1,7,0,1010,1.0,0.99,0.12,0.35
PF00490,PF05051:PF04603:PF03266:PF16981:PF02431,16,12,4,12,8,994,0.33,0.98,0.25,0.28,1,1,15,0,1002,1.0,0.99,0.06,0.25
PF09278,PF00376:PF00813:PF00555:PF04717:PF12792,2,4,2,0,2,1014,0.5,1.0,1.0,0.71,0,0,2,0,1016,0,1.0,0.0,0
PF15045,PF10104:PF04090:PF06989:PF07904:PF13270,0,13,0,0,13,1005,0.0,0.99,0,0,0,0,0,0,1018,0,1.0,0,0
PF00110,PF00822:PF13088:PF06179:PF03402:PF00197,13,24,5,8,19,986,0.21,0.97,0.38,0.27,0,0,13,0,1005,0,0.99,0.0,0
PF08385,PF08393:PF12780:PF12777:PF03028:PF07728,26,55,24,2,31,961,0.44,0.97,0.92,0.62,39,23,3,16,976,0.59,0.98,0.88,0.71
PF03733,PF01699:PF16494:PF14312:PF03709:PF07024,4,42,3,1,39,975,0.07,0.96,0.75,0.22,0,0,4,0,1014,0,1.0,0.0,0
PF05148,PF09310:PF15898:PF15264:PF10234:PF04934,14,19,3,11,16,988,0.16,0.97,0.21,0.17,0,0,14,0,1004,0,0.99,0.0,0
PF02201,PF02229:PF03126:PF08766:PF01253:PF02701,28,60,24,4,36,954,0.4,0.96,0.86,0.57,9,8,20,1,989,0.89,0.98,0.29,0.5
PF15736,PF04865:PF08334:PF08411:PF13946:PF08479,1,3,0,1,3,1014,0.0,1.0,0.0,-0.0,0,0,1,0,1017,0,1.0,0.0,0
PF05186,PF00334:PF16553:PF03666:PF15898:PF09310,20,30,6,14,24,974,0.2,0.96,0.3,0.23,1,1,19,0,998,1.0,0.98,0.05,0.22
PF03853,PF06212:PF01256:PF09532:PF12701:PF10590,21,35,16,5,19,978,0.46,0.98,0.76,0.58,5,5,16,0,997,1.0,0.98,0.24,0.48
PF06477,PF08212:PF02958:PF03997:PF15960:PF10242,9,40,5,4,35,974,0.12,0.96,0.56,0.25,2,0,9,2,1007,0.0,0.99,0.0,-0.0
PF00840,PF02013:PF02156:PF03664:PF16990:PF00734,16,42,9,7,33,969,0.21,0.96,0.56,0.33,5,2,14,3,999,0.4,0.98,0.12,0.22
PF06150,PF04023:PF04160:PF01359:PF11352:PF03581,0,46,0,0,46,972,0.0,0.95,0,0,0,0,0,0,1018,0,1.0,0,0
PF11267,PF06485:PF10571:PF12049:PF11460:PF15045,2,4,0,2,4,1012,0.0,0.99,0.0,-0.0,0,0,2,0,1016,0,1.0,0.0,0
PF05064,PF13874:PF09787:PF03469:PF16034:PF06294,5,27,2,3,25,988,0.07,0.97,0.4,0.16,3,1,4,2,1011,0.33,0.99,0.2,0.26
PF15013,PF10244:PF03980:PF08561:PF01097:PF07114,1,18,0,1,18,999,0.0,0.98,0.0,-0.0,1,0,1,1,1016,0.0,1.0,0.0,-0.0
PF13468,PF07961:PF08228:PF09232:PF03379:PF17124,7,4,0,7,4,1007,0.0,0.99,0.0,-0.01,0,0,7,0,1011,0,0.99,0.0,0
PF15808,PF16700:PF15898:PF16553:PF09310:PF09372,3,4,0,3,4,1011,0.0,0.99,0.0,-0.0,1,0,3,1,1014,0.0,1.0,0.0,-0.0
PF01381,PF08523:PF08752:PF16381:PF16205:PF00101,9,20,8,1,12,997,0.4,0.99,0.89,0.59,3,2,7,1,1008,0.67,0.99,0.22,0.38
PF15079,PF06773:PF15851:PF11369:PF08964:PF14564,0,1,0,0,1,1017,0.0,1.0,0,0,0,0,0,0,1018,0,1.0,0,0
PF03616,PF08497:PF02465:PF11245:PF03090:PF04349,1,0,0,1,0,1017,0,1.0,0.0,0,0,0,1,0,1017,0,1.0,0.0,0
PF01033,PF09412:PF00629:PF01663:PF03782:PF01223,18,74,16,2,58,942,0.22,0.94,0.89,0.42,11,6,12,5,995,0.55,0.98,0.33,0.42
PF09485,PF03807:PF03417:PF03463:PF01507:PF08850,1,35,1,0,34,983,0.03,0.97,1.0,0.17,1,0,1,1,1016,0.0,1.0,0.0,-0.0
PF00624,PF10528:PF00526:PF05436:PF04648:PF05053,0,6,0,0,6,1012,0.0,0.99,0,0,0,0,0,0,1018,0,1.0,0,0
PF07213,PF14967:PF15741:PF15069:PF15079:PF10630,5,3,2,3,1,1012,0.67,1.0,0.4,0.51,0,0,5,0,1013,0,1.0,0.0,0
PF05065,PF00524:PF06210:PF13005:PF15482:PF01580,1,7,0,1,7,1010,0.0,0.99,0.0,-0.0,0,0,1,0,1017,0,1.0,0.0,0
PF03425,PF03442:PF12600:PF00517:PF02449:PF09822,2,24,1,1,23,993,0.04,0.98,0.5,0.14,0,0,2,0,1016,0,1.0,0.0,0
PF10460,PF11651:PF08803:PF02354:PF02676:PF16504,0,12,0,0,12,1006,0.0,0.99,0,0,0,0,0,0,1018,0,1.0,0,0
PF05024,PF06584:PF14441:PF01285:PF07782:PF14764,8,24,1,7,23,987,0.04,0.97,0.12,0.06,1,1,7,0,1010,1.0,0.99,0.12,0.35
PF03229,PF17110:PF12891:PF05808:PF12098:PF11259,2,3,1,1,2,1014,0.33,1.0,0.5,0.41,0,0,2,0,1016,0,1.0,0.0,0
PF04332,PF08333:PF00077:PF16469:PF05585:PF06817,0,34,0,0,34,984,0.0,0.97,0,0,5,0,0,5,1013,0.0,1.0,0,0
PF11677,PF04691:PF02531:PF15172:PF14986:PF12046,0,4,0,0,4,1014,0.0,1.0,0,0,0,0,0,0,1018,0,1.0,0,0
PF11235,PF11244:PF11232:PF11265:PF10488:PF16706,2,7,0,2,7,1009,0.0,0.99,0.0,-0.0,0,0,2,0,1016,0,1.0,0.0,0
PF02023,PF12417:PF01352:PF03732:PF01107:PF14529,15,105,12,3,93,910,0.11,0.91,0.8,0.28,11,6,9,5,998,0.55,0.99,0.4,0.46
PF09789,PF15929:PF10188:PF04139:PF04910:PF04664,4,17,2,2,15,999,0.12,0.98,0.5,0.24,0,0,4,0,1014,0,1.0,0.0,0
PF01770,PF14778:PF05719:PF10317:PF10323:PF05822,6,32,1,5,31,981,0.03,0.96,0.17,0.06,1,1,5,0,1012,1.0,1.0,0.17,0.41
PF05321,PF00550:PF02769:PF00560:PF03157:PF04998,0,121,0,0,121,897,0.0,0.88,0,0,11,0,0,11,1007,0.0,0.99,0,0
PF11020,PF14959:PF12612:PF08168:PF10441:PF17034,0,20,0,0,20,998,0.0,0.98,0,0,1,0,0,1,1017,0.0,1.0,0,0
PF08453,PF01752:PF00669:PF01514:PF09951:PF08707,2,4,2,0,2,1014,0.5,1.0,1.0,0.71,0,0,2,0,1016,0,1.0,0.0,0
PF14780,PF14977:PF10198:PF14909:PF05508:PF10307,4,14,0,4,14,1000,0.0,0.98,0.0,-0.01,1,0,4,1,1013,0.0,1.0,0.0,-0.0
PF00877,PF01810:PF09991:PF06756:PF10992:PF10542,2,10,0,2,10,1006,0.0,0.99,0.0,-0.0,0,0,2,0,1016,0,1.0,0.0,0
PF14774,PF15359:PF00159:PF08641:PF01099:PF15370,5,11,2,3,9,1004,0.18,0.99,0.4,0.26,0,0,5,0,1013,0,1.0,0.0,0
PF08144,PF05715:PF08578:PF15862:PF12726:PF15030,4,12,3,1,9,1005,0.25,0.99,0.75,0.43,1,0,4,1,1013,0.0,1.0,0.0,-0.0
PF15360,PF15550:PF15107:PF01316:PF08040:PF15119,2,4,0,2,4,1012,0.0,0.99,0.0,-0.0,0,0,2,0,1016,0,1.0,0.0,0
PF02162,PF03827:PF09193:PF10413:PF08983:PF12369,6,4,2,4,2,1010,0.5,0.99,0.33,0.41,1,1,5,0,1012,1.0,1.0,0.17,0.41
PF05491,PF06934:PF09850:PF01364:PF14508:PF04984,5,3,0,5,3,1010,0.0,0.99,0.0,-0.0,0,0,5,0,1013,0,1.0,0.0,0
PF15908,PF10481:PF05104:PF12297:PF15905:PF07926,5,14,2,3,12,1001,0.14,0.99,0.4,0.23,0,0,5,0,1013,0,1.0,0.0,0
PF00726,PF06679:PF00727:PF06373:PF14672:PF00714,1,5,0,1,5,1012,0.0,0.99,0.0,-0.0,0,0,1,0,1017,0,1.0,0.0,0
PF14904,PF01869:PF10294:PF07109:PF09989:PF04288,2,47,2,0,45,971,0.04,0.96,1.0,0.2,1,0,2,1,1015,0.0,1.0,0.0,-0.0
PF04559,PF03865:PF08411:PF05939:PF03428:PF05974,0,1,0,0,1,1017,0.0,1.0,0,0,0,0,0,0,1018,0,1.0,0,0
PF15935,PF16449:PF01706:PF08411:PF12080:PF08461,0,2,0,0,2,1016,0.0,1.0,0,0,0,0,0,0,1018,0,1.0,0,0
PF04050,PF12152:PF02854:PF10573:PF06345:PF08101,6,37,6,0,31,981,0.16,0.97,1.0,0.4,2,2,4,0,1012,1.0,1.0,0.33,0.58
PF05201,PF00745:PF01488:PF08501:PF01487:PF00275,8,32,8,0,24,986,0.25,0.98,1.0,0.49,12,1,7,11,999,0.08,0.98,0.12,0.09
PF01292,PF11794:PF08497:PF06834:PF09498:PF14028,6,0,0,6,0,1012,0,0.99,0.0,0,0,0,6,0,1012,0,0.99,0.0,0
PF14637,PF14638:PF14636:PF06333:PF11597:PF08167,6,16,6,0,10,1002,0.38,0.99,1.0,0.61,2,2,4,0,1012,1.0,1.0,0.33,0.58
PF16453,PF12783:PF09324:PF01369:PF16213:PF16206,14,53,13,1,40,964,0.25,0.96,0.93,0.47,17,5,9,12,992,0.29,0.98,0.36,0.31
PF13908,PF14719:PF09398:PF08265:PF16541:PF03045,2,25,0,2,25,991,0.0,0.97,0.0,-0.01,1,0,2,1,1015,0.0,1.0,0.0,-0.0
PF01266,PF16901:PF01571:PF08491:PF08669:PF16350,67,38,27,40,11,940,0.71,0.95,0.4,0.51,11,11,56,0,951,1.0,0.94,0.16,0.39
PF12101,PF03428:PF03241:PF03831:PF01580:PF12477,0,5,0,0,5,1013,0.0,1.0,0,0,0,0,0,0,1018,0,1.0,0,0
PF12546,PF00875:PF04244:PF03441:PF02446:PF16657,0,21,0,0,21,997,0.0,0.98,0,0,0,0,0,0,1018,0,1.0,0,0
PF01333,PF16639:PF03118:PF03951:PF00306:PF06414,5,38,5,0,33,980,0.13,0.97,1.0,0.36,3,1,4,2,1011,0.33,0.99,0.2,0.26
PF15094,PF15914:PF15082:PF09322:PF14465:PF05203,0,12,0,0,12,1006,0.0,0.99,0,0,0,0,0,0,1018,0,1.0,0,0
PF14099,PF12716:PF03576:PF09056:PF11029:PF10340,1,6,0,1,6,1011,0.0,0.99,0.0,-0.0,0,0,1,0,1017,0,1.0,0.0,0
PF10355,PF10348:PF16978:PF09729:PF16979:PF02156,5,30,5,0,25,988,0.17,0.98,1.0,0.4,3,1,4,2,1011,0.33,0.99,0.2,0.26
PF01453,PF08276:PF11883:PF00954:PF01064:PF13947,39,49,26,13,23,956,0.53,0.96,0.67,0.58,10,10,29,0,979,1.0,0.97,0.26,0.5
PF08587,PF13240:PF08332:PF12605:PF12063:PF11629,11,16,3,8,13,994,0.19,0.98,0.27,0.22,4,3,8,1,1006,0.75,0.99,0.27,0.45
PF04433,PF08558:PF16496:PF07988:PF16495:PF09316,23,16,10,13,6,989,0.62,0.98,0.43,0.51,2,2,21,0,995,1.0,0.98,0.09,0.29
PF13557,PF08274:PF03934:PF04122:PF08345:PF14882,4,2,0,4,2,1012,0.0,0.99,0.0,-0.0,0,0,4,0,1014,0,1.0,0.0,0
PF00255,PF01625:PF00810:PF01775:PF05995:PF05047,19,40,5,14,35,964,0.12,0.95,0.26,0.16,6,2,17,4,995,0.33,0.98,0.11,0.18
PF04193,PF10171:PF04577:PF00561:PF00852:PF04117,27,114,20,7,94,897,0.18,0.9,0.74,0.33,17,10,17,7,984,0.59,0.98,0.37,0.46
PF13148,PF06805:PF09818:PF02917:PF05939:PF02601,0,5,0,0,5,1013,0.0,1.0,0,0,0,0,0,0,1018,0,1.0,0,0
PF02145,PF03542:PF11864:PF02188:PF15996:PF11881,14,20,10,4,10,994,0.5,0.99,0.71,0.59,2,2,12,0,1004,1.0,0.99,0.14,0.38
PF04732,PF16208:PF00932:PF00038:PF10042:PF16210,4,25,4,0,21,993,0.16,0.98,1.0,0.4,2,1,3,1,1013,0.5,1.0,0.25,0.35
PF15462,PF15109:PF15115:PF15715:PF06729:PF06581,1,0,0,1,0,1017,0,1.0,0.0,0,0,0,1,0,1017,0,1.0,0.0,0
PF02373,PF02375:PF02928:PF10497:PF01388:PF16866,38,47,24,14,23,957,0.51,0.96,0.63,0.55,12,12,26,0,980,1.0,0.97,0.32,0.55
PF02369,PF15518:PF03710:PF17060:PF05857:PF02399,0,7,0,0,7,1011,0.0,0.99,0,0,0,0,0,0,1018,0,1.0,0,0
PF06405,PF09585:PF06876:PF02371:PF16001:PF15667,3,5,0,3,5,1010,0.0,0.99,0.0,-0.0,0,0,3,0,1015,0,1.0,0.0,0
PF12316,PF02377:PF00778:PF04629:PF09058:PF09007,6,15,4,2,11,1001,0.27,0.99,0.67,0.42,1,1,5,0,1012,1.0,1.0,0.17,0.41
PF00861,PF05915:PF02704:PF00321:PF06232:PF09631,9,18,2,7,16,993,0.11,0.98,0.22,0.15,2,1,8,1,1008,0.5,0.99,0.11,0.23
PF02883,PF09066:PF07718:PF14796:PF08752:PF14806,17,21,6,11,15,986,0.29,0.97,0.35,0.3,6,5,12,1,1000,0.83,0.99,0.29,0.49
PF12004,PF08165:PF00616:PF16056:PF16165:PF16562,1,27,1,0,26,991,0.04,0.97,1.0,0.19,1,1,0,0,1017,1.0,1.0,1.0,1.0
PF06887,PF01580:PF10618:PF05065:PF13742:PF13722,0,8,0,0,8,1010,0.0,0.99,0,0,0,0,0,0,1018,0,1.0,0,0
PF16469,PF16126:PF16485:PF08762:PF08140:PF14307,2,7,0,2,7,1009,0.0,0.99,0.0,-0.0,0,0,2,0,1016,0,1.0,0.0,0
PF00018,PF14604:PF07653:PF08824:PF12026:PF00017,98,120,62,36,58,862,0.52,0.91,0.63,0.52,26,26,72,0,920,1.0,0.93,0.27,0.5
PF13795,PF03548:PF03050:PF10974:PF15041:PF14323,1,4,0,1,4,1013,0.0,1.0,0.0,-0.0,0,0,1,0,1017,0,1.0,0.0,0
PF02496,PF06351:PF02361:PF01716:PF04839:PF00127,1,12,1,0,11,1006,0.08,0.99,1.0,0.29,0,0,1,0,1017,0,1.0,0.0,0
PF02566,PF06912:PF08787:PF07544:PF09459:PF06232,5,16,2,3,14,999,0.12,0.98,0.4,0.22,0,0,5,0,1013,0,1.0,0.0,0
PF05706,PF11032:PF00727:PF15812:PF03912:PF02024,4,9,0,4,9,1005,0.0,0.99,0.0,-0.01,0,0,4,0,1014,0,1.0,0.0,0
PF08314,PF15492:PF17167:PF08696:PF05285:PF08158,5,26,3,2,23,990,0.12,0.98,0.6,0.26,2,0,5,2,1011,0.0,0.99,0.0,-0.0
PF01825,PF02793:PF00002:PF16489:PF06652:PF02010,33,62,29,4,33,952,0.47,0.96,0.88,0.63,11,8,25,3,982,0.73,0.97,0.24,0.41
PF08328,PF14698:PF10415:PF10397:PF05524:PF00206,2,46,2,0,44,972,0.04,0.96,1.0,0.2,7,0,2,7,1009,0.0,0.99,0.0,-0.0
PF12920,PF09374:PF17013:PF01640:PF13505:PF17152,0,2,0,0,2,1016,0.0,1.0,0,0,0,0,0,0,1018,0,1.0,0,0
PF06644,PF06127:PF02284:PF00499:PF09754:PF04520,11,16,4,7,12,995,0.25,0.98,0.36,0.29,0,0,11,0,1007,0,0.99,0.0,0
PF13442,PF04736:PF15884:PF05825:PF15370:PF12351,9,10,0,9,10,999,0.0,0.98,0.0,-0.01,0,0,9,0,1009,0,0.99,0.0,0
PF04354,PF06586:PF07178:PF02924:PF03389:PF05309,1,1,0,1,1,1016,0.0,1.0,0.0,-0.0,1,0,1,1,1016,0.0,1.0,0.0,-0.0
PF09364,PF09363:PF03894:PF08369:PF03185:PF00220,2,12,2,0,10,1006,0.17,0.99,1.0,0.41,0,0,2,0,1016,0,1.0,0.0,0
PF05890,PF09814:PF03981:PF06632:PF07248:PF02470,8,23,3,5,20,990,0.13,0.98,0.38,0.21,1,0,8,1,1009,0.0,0.99,0.0,-0.0
PF02971,PF04961:PF07837:PF14920:PF14919:PF08527,4,11,4,0,7,1007,0.36,0.99,1.0,0.6,0,0,4,0,1014,0,1.0,0.0,0
PF14943,PF10853:PF00159:PF05361:PF14542:PF10780,12,8,3,9,5,1001,0.38,0.99,0.25,0.3,1,1,11,0,1006,1.0,0.99,0.08,0.29
PF12485,PF16533:PF16600:PF07647:PF09246:PF04088,1,42,1,0,41,976,0.02,0.96,1.0,0.15,1,1,0,0,1017,1.0,1.0,1.0,1.0
PF05669,PF11938:PF15028:PF05253:PF07593:PF09064,12,25,5,7,20,986,0.2,0.97,0.42,0.28,2,1,11,1,1005,0.5,0.99,0.08,0.2
PF09704,PF00721:PF07265:PF10807:PF03025:PF05957,0,1,0,0,1,1017,0.0,1.0,0,0,0,0,0,0,1018,0,1.0,0,0
PF14476,PF07712:PF05910:PF03767:PF06206:PF06376,1,18,1,0,17,1000,0.06,0.98,1.0,0.23,0,0,1,0,1017,0,1.0,0.0,0
PF03147,PF02912:PF10354:PF01409:PF08279:PF09012,19,36,19,0,17,982,0.53,0.98,1.0,0.72,3,3,16,0,999,1.0,0.98,0.16,0.39
PF08676,PF16413:PF01119:PF09239:PF01388:PF00183,24,74,16,8,58,936,0.22,0.94,0.67,0.36,9,5,19,4,990,0.56,0.98,0.21,0.33
PF10282,PF09724:PF01185:PF12296:PF12680:PF11807,14,32,7,7,25,979,0.22,0.97,0.5,0.32,4,2,12,2,1002,0.5,0.99,0.14,0.26
PF06992,PF08890:PF16330:PF16122:PF00318:PF08557,0,33,0,0,33,985,0.0,0.97,0,0,2,0,0,2,1016,0.0,1.0,0,0
PF01325,PF03090:PF01706:PF13269:PF03241:PF02211,3,4,1,2,3,1012,0.25,1.0,0.33,0.29,0,0,3,0,1015,0,1.0,0.0,0
PF16457,PF11841:PF04727:PF00388:PF00387:PF09279,15,34,13,2,21,982,0.38,0.98,0.87,0.57,13,9,6,4,999,0.69,0.99,0.6,0.64
PF10359,PF10305:PF10344:PF10293:PF10351:PF10347,3,8,3,0,5,1010,0.38,1.0,1.0,0.61,5,3,0,2,1013,0.6,1.0,1.0,0.77
PF08819,PF08189:PF12201:PF09394:PF17003:PF08843,0,0,0,0,0,1018,0,1.0,0,0,0,0,0,0,1018,0,1.0,0,0
PF02829,PF14602:PF12464:PF06426:PF00132:PF13720,3,62,3,0,59,956,0.05,0.94,1.0,0.21,9,1,2,8,1007,0.11,0.99,0.33,0.19
PF16216,PF15272:PF08483:PF01136:PF14323:PF07411,0,2,0,0,2,1016,0.0,1.0,0,0,0,0,0,0,1018,0,1.0,0,0
PF17168,PF16335:PF08760:PF16334:PF09363:PF03894,4,7,4,0,3,1011,0.57,1.0,1.0,0.75,1,1,3,0,1014,1.0,1.0,0.25,0.5
PF16737,PF14061:PF12269:PF03172:PF12165:PF12998,1,28,1,0,27,990,0.04,0.97,1.0,0.19,2,1,0,1,1016,0.5,1.0,1.0,0.71
PF09309,PF16892:PF16893:PF12258:PF03119:PF08605,0,6,0,0,6,1012,0.0,0.99,0,0,0,0,0,0,1018,0,1.0,0,0
PF01031,PF00350:PF04799:PF02212:PF09265:PF13632,47,86,46,1,40,931,0.53,0.96,0.98,0.71,11,10,37,1,970,0.91,0.96,0.21,0.43
PF11952,PF13821:PF01424:PF12457:PF07713:PF01585,6,82,6,0,76,936,0.07,0.93,1.0,0.26,8,5,1,3,1009,0.62,1.0,0.83,0.72
PF13689,PF12019:PF06082:PF03831:PF03241:PF10995,0,1,0,0,1,1017,0.0,1.0,0,0,0,0,0,0,1018,0,1.0,0,0
PF16770,PF12258:PF16892:PF16893:PF01834:PF09309,12,8,1,11,7,999,0.12,0.98,0.08,0.09,0,0,12,0,1006,0,0.99,0.0,0
PF07569,PF15512:PF09453:PF11816:PF04192:PF14077,13,33,11,2,22,983,0.33,0.98,0.85,0.52,1,1,12,0,1005,1.0,0.99,0.08,0.28
PF00963,PF15705:PF15706:PF16070:PF04100:PF12884,6,17,6,0,11,1001,0.35,0.99,1.0,0.59,2,0,6,2,1010,0.0,0.99,0.0,-0.0
PF12115,PF06912:PF10839:PF00537:PF15071:PF06108,0,10,0,0,10,1008,0.0,0.99,0,0,0,0,0,0,1018,0,1.0,0,0
PF02329,PF08127:PF05534:PF02550:PF14629:PF08118,1,21,0,1,21,996,0.0,0.98,0.0,-0.0,0,0,1,0,1017,0,1.0,0.0,0
PF00670,PF05221:PF02812:PF03071:PF14031:PF00605,6,41,6,0,35,977,0.15,0.97,1.0,0.38,2,2,4,0,1012,1.0,1.0,0.33,0.58
PF04262,PF12461:PF15271:PF03631:PF15272:PF06505,1,0,0,1,0,1017,0,1.0,0.0,0,0,0,1,0,1017,0,1.0,0.0,0
PF13375,PF15483:PF15162:PF10073:PF02056:PF11369,0,9,0,0,9,1009,0.0,0.99,0,0,0,0,0,0,1018,0,1.0,0,0
PF02208,PF08687:PF12516:PF12052:PF15737:PF11822,4,14,2,2,12,1002,0.14,0.99,0.5,0.26,1,1,3,0,1014,1.0,1.0,0.25,0.5
PF12201,PF09690:PF02972:PF00519:PF08189:PF14985,0,7,0,0,7,1011,0.0,0.99,0,0,0,0,0,0,1018,0,1.0,0,0
PF15244,PF15369:PF15290:PF15717:PF15396:PF12851,1,7,0,1,7,1010,0.0,0.99,0.0,-0.0,0,0,1,0,1017,0,1.0,0.0,0
PF02221,PF11938:PF12513:PF00833:PF08061:PF04568,19,35,6,13,29,970,0.17,0.96,0.32,0.21,4,2,17,2,997,0.5,0.98,0.11,0.22
PF02746,PF08288:PF02789:PF10022:PF16582:PF02885,22,37,5,17,32,964,0.14,0.95,0.23,0.15,1,1,21,0,996,1.0,0.98,0.05,0.21
PF14363,PF14629:PF08740:PF12037:PF08542:PF16725,9,33,4,5,29,980,0.12,0.97,0.44,0.22,2,1,8,1,1008,0.5,0.99,0.11,0.23
PF16212,PF16209:PF12424:PF12409:PF00689:PF08282,44,93,40,4,53,921,0.43,0.94,0.91,0.6,9,8,36,1,973,0.89,0.96,0.18,0.39
PF02845,PF01735:PF15625:PF13441:PF16056:PF11618,32,24,7,25,17,969,0.29,0.96,0.22,0.23,1,1,31,0,986,1.0,0.97,0.03,0.17
PF12473,PF16183:PF12423:PF14739:PF11995:PF16540,20,25,16,4,9,989,0.64,0.99,0.8,0.71,3,3,17,0,998,1.0,0.98,0.15,0.38
PF05226,PF02991:PF01018:PF02939:PF13167:PF16360,3,36,1,2,35,980,0.03,0.96,0.33,0.09,4,1,2,3,1012,0.25,1.0,0.33,0.29
PF02952,PF07881:PF07882:PF07411:PF05974:PF07016,1,1,1,0,0,1017,1.0,1.0,1.0,1.0,0,0,1,0,1017,0,1.0,0.0,0
PF00805,PF13599:PF11601:PF16885:PF16113:PF01115,17,27,8,9,19,982,0.3,0.97,0.47,0.36,2,2,15,0,1001,1.0,0.99,0.12,0.34
PF14551,PF00493:PF17207:PF12619:PF01835:PF08159,46,54,44,2,10,962,0.81,0.99,0.96,0.88,20,20,26,0,972,1.0,0.97,0.43,0.65
PF06971,PF00549:PF05353:PF08714:PF15199:PF15667,1,33,1,0,32,985,0.03,0.97,1.0,0.17,0,0,1,0,1017,0,1.0,0.0,0
PF04474,PF16010:PF03082:PF06923:PF11503:PF00528,0,47,0,0,47,971,0.0,0.95,0,0,0,0,0,0,1018,0,1.0,0,0
PF07202,PF10377:PF10650:PF11577:PF13815:PF17213,8,18,4,4,14,996,0.22,0.98,0.5,0.33,1,1,7,0,1010,1.0,0.99,0.12,0.35
PF00766,PF01012:PF03900:PF02672:PF03484:PF14875,9,46,7,2,39,970,0.15,0.96,0.78,0.33,2,0,9,2,1007,0.0,0.99,0.0,-0.0
PF08625,PF14077:PF15512:PF09384:PF17005:PF08614,6,15,2,4,13,999,0.13,0.98,0.33,0.2,2,1,5,1,1011,0.5,0.99,0.17,0.29
PF14823,PF13241:PF14824:PF00590:PF10414:PF10261,8,26,8,0,18,992,0.31,0.98,1.0,0.55,5,4,4,1,1009,0.8,1.0,0.5,0.63
PF04720,PF06749:PF05910:PF04690:PF06376:PF07911,8,15,3,5,12,998,0.2,0.98,0.38,0.27,1,1,7,0,1010,1.0,0.99,0.12,0.35
PF02361,PF06695:PF17056:PF12046:PF02427:PF02531,5,2,1,4,1,1012,0.5,1.0,0.2,0.31,0,0,5,0,1013,0,1.0,0.0,0
PF00758,PF15129:PF06373:PF08194:PF07172:PF15364,3,2,1,2,1,1014,0.5,1.0,0.33,0.41,0,0,3,0,1015,0,1.0,0.0,0
PF14876,PF17219:PF02201:PF12620:PF10629:PF08757,0,32,0,0,32,986,0.0,0.97,0,0,0,0,0,0,1018,0,1.0,0,0
PF00675,PF05193:PF16187:PF08367:PF07732:PF01565,57,151,53,4,98,863,0.35,0.9,0.93,0.54,20,19,38,1,960,0.95,0.96,0.33,0.55
PF12720,PF10454:PF00737:PF00770:PF01947:PF14618,3,2,0,3,2,1013,0.0,1.0,0.0,-0.0,0,0,3,0,1015,0,1.0,0.0,0
PF08795,PF06724:PF15482:PF02277:PF04451:PF09510,0,4,0,0,4,1014,0.0,1.0,0,0,0,0,0,0,1018,0,1.0,0,0
PF10590,PF10615:PF01243:PF03853:PF00591:PF07831,8,33,8,0,25,985,0.24,0.98,1.0,0.49,2,2,6,0,1010,1.0,0.99,0.25,0.5
PF01271,PF01093:PF01296:PF06540:PF10529:PF02451,0,2,0,0,2,1016,0.0,1.0,0,0,0,0,0,0,1018,0,1.0,0,0
PF10572,PF15623:PF16590:PF00997:PF11109:PF09470,4,2,0,4,2,1012,0.0,0.99,0.0,-0.0,0,0,4,0,1014,0,1.0,0.0,0
PF04851,PF11648:PF16739:PF03368:PF13625:PF00636,45,34,25,20,9,964,0.74,0.97,0.56,0.62,7,7,38,0,973,1.0,0.96,0.16,0.39
PF07720,PF07721:PF07219:PF04049:PF16546:PF14280,7,26,5,2,21,990,0.19,0.98,0.71,0.36,1,1,6,0,1011,1.0,0.99,0.14,0.38
PF07214,PF12834:PF03934:PF17007:PF11713:PF01914,0,3,0,0,3,1015,0.0,1.0,0,0,0,0,0,0,1018,0,1.0,0,0
PF01496,PF05742:PF10266:PF04922:PF01255:PF03492,16,38,12,4,26,976,0.32,0.97,0.75,0.48,3,3,13,0,1002,1.0,0.99,0.19,0.43
PF16311,PF15141:PF09216:PF17049:PF14866:PF15097,0,2,0,0,2,1016,0.0,1.0,0,0,0,0,0,0,1018,0,1.0,0,0
PF00701,PF04479:PF04199:PF14027:PF11807:PF03328,22,45,14,8,31,965,0.31,0.96,0.64,0.43,13,8,14,5,991,0.62,0.98,0.36,0.46
PF06203,PF00320:PF16563:PF09949:PF12126:PF13919,14,51,8,6,43,961,0.16,0.95,0.57,0.28,6,4,10,2,1002,0.67,0.99,0.29,0.43
PF06280,PF05922:PF12583:PF12580:PF12245:PF09286,2,37,2,0,35,981,0.05,0.97,1.0,0.23,2,1,1,1,1015,0.5,1.0,0.5,0.5
PF02750,PF10581:PF02078:PF14160:PF15805:PF04774,0,10,0,0,10,1008,0.0,0.99,0,0,0,0,0,0,1018,0,1.0,0,0
PF01223,PF01663:PF04987:PF01033:PF10338:PF02148,23,72,17,6,55,940,0.24,0.94,0.74,0.4,11,8,15,3,992,0.73,0.98,0.35,0.5
PF04225,PF08437:PF10118:PF14685:PF05103:PF13286,6,14,1,5,13,999,0.07,0.98,0.17,0.1,0,0,6,0,1012,0,0.99,0.0,0
PF02705,PF03407:PF04130:PF12899:PF10250:PF00860,15,84,11,4,73,930,0.13,0.92,0.73,0.29,10,4,11,6,997,0.4,0.98,0.27,0.32
PF13020,PF14908:PF13320:PF12726:PF15491:PF15232,5,8,1,4,7,1006,0.12,0.99,0.2,0.15,0,0,5,0,1013,0,1.0,0.0,0
PF05695,PF09262:PF02359:PF10350:PF05362:PF12612,9,49,6,3,43,966,0.12,0.95,0.67,0.27,4,1,8,3,1006,0.25,0.99,0.11,0.16
PF13780,PF04740:PF16888:PF03090:PF03428:PF15518,0,1,0,0,1,1017,0.0,1.0,0,0,0,0,0,0,1018,0,1.0,0,0
PF00307,PF02187:PF03271:PF14923:PF03836:PF12130,74,32,25,49,7,937,0.78,0.94,0.34,0.49,3,3,71,0,944,1.0,0.93,0.04,0.19
PF05380,PF05585:PF07245:PF03564:PF00665:PF14529,28,143,25,3,118,872,0.17,0.88,0.89,0.36,20,13,15,7,983,0.65,0.98,0.46,0.54
PF14438,PF06741:PF12886:PF12884:PF07145:PF06333,13,28,10,3,18,987,0.36,0.98,0.77,0.52,3,3,10,0,1005,1.0,0.99,0.23,0.48
PF02211,PF03090:PF03241:PF14690:PF04865:PF13722,3,0,0,3,0,1015,0,1.0,0.0,0,0,0,3,0,1015,0,1.0,0.0,0
PF09744,PF04388:PF16471:PF09730:PF03469:PF10377,9,24,4,5,20,989,0.17,0.98,0.44,0.26,2,0,9,2,1007,0.0,0.99,0.0,-0.0
PF05383,PF14327:PF04098:PF16131:PF03467:PF15861,20,40,8,12,32,966,0.2,0.96,0.4,0.26,2,2,18,0,998,1.0,0.98,0.1,0.31
PF05419,PF12046:PF17032:PF02531:PF02427:PF00489,0,3,0,0,3,1015,0.0,1.0,0,0,0,0,0,0,1018,0,1.0,0,0
PF07434,PF15976:PF16967:PF11874:PF04349:PF03241,0,0,0,0,0,1018,0,1.0,0,0,0,0,0,0,1018,0,1.0,0,0
PF08245,PF10288:PF13813:PF10022:PF05827:PF07786,32,31,9,23,22,964,0.29,0.96,0.28,0.26,2,1,31,1,985,0.5,0.97,0.03,0.12
PF15746,PF15480:PF15729:PF15107:PF02601:PF14539,0,4,0,0,4,1014,0.0,1.0,0,0,0,0,0,0,1018,0,1.0,0,0
PF16511,PF09141:PF08913:PF01608:PF05902:PF16705,17,27,11,6,16,985,0.41,0.98,0.65,0.5,5,5,12,0,1001,1.0,0.99,0.29,0.54
PF01547,PF02608:PF07562:PF03247:PF13407:PF00497,21,44,12,9,32,965,0.27,0.96,0.57,0.38,9,4,17,5,992,0.44,0.98,0.19,0.28
PF04076,PF04451:PF02413:PF08795:PF01580:PF04392,0,8,0,0,8,1010,0.0,0.99,0,0,0,0,0,0,1018,0,1.0,0,0
PF14542,PF04402:PF02372:PF00727:PF14774:PF06912,2,15,1,1,14,1002,0.07,0.99,0.5,0.18,1,0,2,1,1015,0.0,1.0,0.0,-0.0
PF02155,PF02161:PF02159:PF12577:PF12743:PF11825,6,12,5,1,7,1005,0.42,0.99,0.83,0.59,5,5,1,0,1012,1.0,1.0,0.83,0.91
PF02278,PF02884:PF08124:PF04425:PF16485:PF01447,2,3,2,0,1,1015,0.67,1.0,1.0,0.82,0,0,2,0,1016,0,1.0,0.0,0
PF11146,PF16824:PF01970:PF04391:PF05887:PF02599,0,1,0,0,1,1017,0.0,1.0,0,0,0,0,0,0,1018,0,1.0,0,0
PF11886,PF04548:PF03673:PF00735:PF04103:PF07888,3,49,3,0,46,969,0.06,0.95,1.0,0.24,4,1,2,3,1012,0.25,1.0,0.33,0.29
PF14486,PF12628:PF00770:PF06993:PF15505:PF09715,0,2,0,0,2,1016,0.0,1.0,0,0,0,0,0,0,1018,0,1.0,0,0
PF16669,PF07721:PF09295:PF13174:PF05279:PF13181,8,108,7,1,101,909,0.06,0.9,0.88,0.22,3,1,7,2,1008,0.33,0.99,0.12,0.2
PF13503,PF09287:PF15773:PF01339:PF11946:PF09997,0,7,0,0,7,1011,0.0,0.99,0,0,0,0,0,0,1018,0,1.0,0,0
PF01672,PF02259:PF03157:PF12947:PF12530:PF08244,0,57,0,0,57,961,0.0,0.94,0,0,4,0,0,4,1014,0.0,1.0,0,0
PF03607,PF05517:PF13281:PF12474:PF11629:PF01477,17,43,10,7,33,968,0.23,0.96,0.59,0.35,5,5,12,0,1001,1.0,0.99,0.29,0.54
PF06446,PF07740:PF00537:PF16716:PF02024:PF05039,0,2,0,0,2,1016,0.0,1.0,0,0,0,0,0,0,1018,0,1.0,0,0
PF05147,PF12239:PF00797:PF03972:PF08584:PF04828,13,39,5,8,34,971,0.13,0.96,0.38,0.21,6,1,12,5,1000,0.17,0.98,0.08,0.11
PF08805,PF04917:PF11751:PF08411:PF17007:PF16449,1,2,1,0,1,1016,0.5,1.0,1.0,0.71,0,0,1,0,1017,0,1.0,0.0,0
PF01111,PF10203:PF10471:PF02044:PF06645:PF10310,7,17,3,4,14,997,0.18,0.98,0.43,0.27,1,1,6,0,1011,1.0,0.99,0.14,0.38
PF11251,PF16968:PF14258:PF13036:PF15203:PF14987,0,4,0,0,4,1014,0.0,1.0,0,0,0,0,0,0,1018,0,1.0,0,0
PF16901,PF16350:PF01266:PF08491:PF01571:PF07892,9,73,6,3,67,942,0.08,0.93,0.67,0.22,11,1,8,10,999,0.09,0.98,0.11,0.09
PF00923,PF06376:PF01195:PF07712:PF04720:PF04669,13,22,5,8,17,988,0.23,0.98,0.38,0.28,1,1,12,0,1005,1.0,0.99,0.08,0.28
PF01101,PF04222:PF15856:PF02500:PF01514:PF06450,16,2,0,16,2,1000,0.0,0.98,0.0,-0.01,0,0,16,0,1002,0,0.98,0.0,0
PF08013,PF01580:PF09611:PF07980:PF09677:PF12477,1,5,0,1,5,1012,0.0,0.99,0.0,-0.0,0,0,1,0,1017,0,1.0,0.0,0
PF07458,PF15120:PF07259:PF15829:PF15849:PF15576,0,3,0,0,3,1015,0.0,1.0,0,0,0,0,0,0,1018,0,1.0,0,0
PF00441,PF02770:PF02771:PF08028:PF12806:PF09317,60,68,59,1,9,949,0.87,0.99,0.98,0.92,3,3,57,0,958,1.0,0.94,0.05,0.22
PF15396,PF07797:PF15778:PF15369:PF15245:PF14822,3,10,0,3,10,1005,0.0,0.99,0.0,-0.01,0,0,3,0,1015,0,1.0,0.0,0
PF09695,PF01753:PF00613:PF00575:PF02064:PF07859,0,130,0,0,130,888,0.0,0.87,0,0,23,0,0,23,995,0.0,0.98,0,0
PF11411,PF10345:PF14743:PF04679:PF01068:PF03119,7,21,7,0,14,997,0.33,0.99,1.0,0.57,7,6,1,1,1010,0.86,1.0,0.86,0.86
PF03175,PF02945:PF16061:PF13402:PF13251:PF00429,11,19,6,5,13,994,0.32,0.98,0.55,0.41,0,0,11,0,1007,0,0.99,0.0,0
PF02667,PF08726:PF13599:PF10335:PF08321:PF02556,0,28,0,0,28,990,0.0,0.97,0,0,1,0,0,1,1017,0.0,1.0,0,0
PF13419,PF01687:PF01636:PF00475:PF00561:PF12311,55,113,34,21,79,884,0.3,0.9,0.62,0.39,11,9,46,2,961,0.82,0.95,0.16,0.35
PF02304,PF09095:PF01361:PF11084:PF01258:PF05966,0,9,0,0,9,1009,0.0,0.99,0,0,0,0,0,0,1018,0,1.0,0,0
PF14631,PF10293:PF10351:PF15149:PF00680:PF10487,1,26,1,0,25,992,0.04,0.98,1.0,0.19,1,1,0,0,1017,1.0,1.0,1.0,1.0
PF05053,PF14674:PF14677:PF14679:PF14675:PF14680,2,1,0,2,1,1015,0.0,1.0,0.0,-0.0,1,0,2,1,1015,0.0,1.0,0.0,-0.0
PF04435,PF15362:PF12278:PF11052:PF15479:PF15622,7,4,1,6,3,1008,0.25,0.99,0.14,0.18,0,0,7,0,1011,0,0.99,0.0,0
PF03594,PF17028:PF11352:PF08121:PF16278:PF09972,2,10,0,2,10,1006,0.0,0.99,0.0,-0.0,0,0,2,0,1016,0,1.0,0.0,0
PF12446,PF15224:PF12658:PF08093:PF06452:PF17015,0,12,0,0,12,1006,0.0,0.99,0,0,0,0,0,0,1018,0,1.0,0,0
PF04637,PF17164:PF17206:PF06074:PF13542:PF11402,0,1,0,0,1,1017,0.0,1.0,0,0,0,0,0,0,1018,0,1.0,0,0
PF10561,PF01106:PF14378:PF08712:PF16680:PF04683,4,27,1,3,26,988,0.04,0.97,0.25,0.09,3,0,4,3,1011,0.0,0.99,0.0,-0.0
PF03702,PF12006:PF05870:PF11017:PF08229:PF02195,8,17,3,5,14,996,0.18,0.98,0.38,0.25,0,0,8,0,1010,0,0.99,0.0,0
PF00023,PF12796:PF13606:PF00710:PF16553:PF03859,108,250,104,4,146,764,0.42,0.85,0.96,0.57,8,8,100,0,910,1.0,0.9,0.07,0.26
PF03164,PF01068:PF04675:PF10345:PF14743:PF11411,18,19,8,10,11,989,0.42,0.98,0.44,0.42,8,7,11,1,999,0.88,0.99,0.39,0.58
PF06185,PF10938:PF11380:PF17103:PF17101:PF02718,0,8,0,0,8,1010,0.0,0.99,0,0,4,0,0,4,1014,0.0,1.0,0,0
PF09818,PF15482:PF03601:PF06626:PF15460:PF06724,1,2,0,1,2,1015,0.0,1.0,0.0,-0.0,0,0,1,0,1017,0,1.0,0.0,0
PF01124,PF00210:PF02284:PF07947:PF00143:PF05995,12,26,5,7,21,985,0.19,0.97,0.42,0.27,3,3,9,0,1006,1.0,0.99,0.25,0.5
PF01254,PF04764:PF15823:PF11109:PF14564:PF03058,1,2,0,1,2,1015,0.0,1.0,0.0,-0.0,0,0,1,0,1017,0,1.0,0.0,0
PF04195,PF11500:PF02040:PF15871:PF12757:PF16501,8,11,0,8,11,999,0.0,0.98,0.0,-0.01,0,0,8,0,1010,0,0.99,0.0,0
PF08213,PF02780:PF15328:PF10104:PF13230:PF10180,5,42,0,5,42,971,0.0,0.95,0.0,-0.01,1,0,5,1,1012,0.0,0.99,0.0,-0.0
PF16038,PF04901:PF02285:PF00159:PF06541:PF14473,1,8,0,1,8,1009,0.0,0.99,0.0,-0.0,0,0,1,0,1017,0,1.0,0.0,0
PF04833,PF06830:PF06880:PF04859:PF04646:PF01458,2,13,2,0,11,1005,0.15,0.99,1.0,0.39,0,0,2,0,1016,0,1.0,0.0,0
PF04284,PF12209:PF04993:PF12098:PF04848:PF15633,0,3,0,0,3,1015,0.0,1.0,0,0,0,0,0,0,1018,0,1.0,0,0
PF03143,PF09173:PF16658:PF09107:PF05652:PF06414,25,26,8,17,18,975,0.31,0.97,0.32,0.3,2,2,23,0,993,1.0,0.98,0.08,0.28
PF07526,PF16493:PF12737:PF05722:PF12731:PF03791,4,3,1,3,2,1012,0.33,1.0,0.25,0.29,1,1,3,0,1014,1.0,1.0,0.25,0.5
PF16928,PF11811:PF07439:PF10460:PF09719:PF02066,0,1,0,0,1,1017,0.0,1.0,0,0,0,0,0,0,1018,0,1.0,0,0
PF06544,PF01205:PF08572:PF16543:PF09186:PF01480,13,45,7,6,38,967,0.16,0.96,0.54,0.27,5,3,10,2,1003,0.6,0.99,0.23,0.37
PF03059,PF02897:PF01960:PF00930:PF01680:PF04674,5,38,4,1,34,979,0.11,0.97,0.8,0.28,2,0,5,2,1011,0.0,0.99,0.0,-0.0
PF05673,PF10566:PF02554:PF06505:PF13722:PF01580,0,5,0,0,5,1013,0.0,1.0,0,0,0,0,0,0,1018,0,1.0,0,0
PF09738,PF02374:PF07137:PF16044:PF01280:PF15313,1,35,1,0,34,983,0.03,0.97,1.0,0.17,2,0,1,2,1015,0.0,1.0,0.0,-0.0
PF04526,PF03188:PF16010:PF03351:PF02014:PF16491,2,61,2,0,59,957,0.03,0.94,1.0,0.18,9,1,1,8,1008,0.11,0.99,0.5,0.23
PF11745,PF16824:PF06725:PF05935:PF12101:PF15052,0,6,0,0,6,1012,0.0,0.99,0,0,0,0,0,0,1018,0,1.0,0,0
PF00126,PF00220:PF14232:PF03466:PF05690:PF09050,6,16,6,0,10,1002,0.38,0.99,1.0,0.61,0,0,6,0,1012,0,0.99,0.0,0
PF07425,PF08719:PF01872:PF08211:PF16491:PF00903,0,66,0,0,66,952,0.0,0.94,0,0,7,0,0,7,1011,0.0,0.99,0,0
PF08454,PF06459:PF01365:PF02026:PF08709:PF00520,14,90,13,1,77,927,0.14,0.92,0.93,0.35,10,10,4,0,1004,1.0,1.0,0.71,0.84
PF02735,PF03731:PF03730:PF08785:PF01435:PF00955,24,56,23,1,33,961,0.41,0.97,0.96,0.62,10,10,14,0,994,1.0,0.99,0.42,0.64
PF15473,PF00162:PF02390:PF02203:PF05436:PF14713,8,36,6,2,30,980,0.17,0.97,0.75,0.34,0,0,8,0,1010,0,0.99,0.0,0
PF12627,PF10521:PF13735:PF06414:PF04437:PF03385,9,28,4,5,24,985,0.14,0.97,0.44,0.24,2,1,8,1,1008,0.5,0.99,0.11,0.23
PF13886,PF10505:PF00924:PF01755:PF06047:PF09733,18,34,6,12,28,972,0.18,0.96,0.33,0.22,2,2,16,0,1000,1.0,0.98,0.11,0.33
PF07178,PF05509:PF06586:PF05309:PF05513:PF11751,1,1,1,0,0,1017,1.0,1.0,1.0,1.0,1,1,0,0,1017,1.0,1.0,1.0,1.0
PF04961,PF02971:PF07837:PF08527:PF14920:PF14919,4,11,4,0,7,1007,0.36,0.99,1.0,0.6,0,0,4,0,1014,0,1.0,0.0,0
PF10428,PF15904:PF11921:PF14914:PF04689:PF12534,4,9,1,3,8,1006,0.11,0.99,0.25,0.16,1,1,3,0,1014,1.0,1.0,0.25,0.5
PF07966,PF00026:PF09478:PF07855:PF05690:PF07823,2,73,2,0,71,945,0.03,0.93,1.0,0.16,2,0,2,2,1014,0.0,1.0,0.0,-0.0
PF13988,PF06594:PF07964:PF10554:PF09867:PF11304,0,2,0,0,2,1016,0.0,1.0,0,0,0,0,0,0,1018,0,1.0,0,0
PF14765,PF16073:PF08659:PF08242:PF00109:PF08354,36,73,36,0,37,945,0.49,0.96,1.0,0.69,29,25,11,4,978,0.86,0.99,0.69,0.77
PF02441,PF13462:PF08660:PF08584:PF05426:PF04045,21,38,7,14,31,966,0.18,0.96,0.33,0.23,1,1,20,0,997,1.0,0.98,0.05,0.22
PF00432,PF13249:PF13243:PF03404:PF00441:PF13057,26,78,14,12,64,928,0.18,0.93,0.54,0.28,9,5,21,4,988,0.56,0.98,0.19,0.32
PF06426,PF13720:PF14602:PF12464:PF04613:PF01050,10,42,6,4,36,972,0.14,0.96,0.6,0.28,2,2,8,0,1008,1.0,0.99,0.2,0.45
PF06094,PF02330:PF06884:PF12311:PF05721:PF04479,18,58,10,8,48,952,0.17,0.94,0.56,0.29,5,4,14,1,999,0.8,0.99,0.22,0.42
PF00988,PF00185:PF02729:PF01808:PF02786:PF00117,18,111,18,0,93,907,0.16,0.91,1.0,0.38,15,13,5,2,998,0.87,0.99,0.72,0.79
PF06401,PF16173:PF01114:PF08444:PF07085:PF01515,3,12,0,3,12,1003,0.0,0.99,0.0,-0.01,0,0,3,0,1015,0,1.0,0.0,0
PF14693,PF01386:PF01132:PF09285:PF05173:PF03769,3,12,2,1,10,1005,0.17,0.99,0.67,0.33,2,0,3,2,1013,0.0,1.0,0.0,-0.0
PF09317,PF12806:PF08028:PF12418:PF14749:PF01756,3,23,3,0,20,995,0.13,0.98,1.0,0.36,3,3,0,0,1015,1.0,1.0,1.0,1.0
PF03055,PF15219:PF10157:PF00154:PF07983:PF03198,22,42,8,14,34,962,0.19,0.95,0.36,0.24,6,3,19,3,993,0.5,0.98,0.14,0.25
PF13934,PF10699:PF10177:PF03615:PF14611:PF10198,8,13,2,6,11,999,0.15,0.98,0.25,0.19,1,1,7,0,1010,1.0,0.99,0.12,0.35
PF16843,PF09055:PF05162:PF01020:PF04758:PF12057,1,28,1,0,27,990,0.04,0.97,1.0,0.19,2,1,0,1,1016,0.5,1.0,1.0,0.71
PF01754,PF01428:PF05839:PF02338:PF03638:PF08325,10,63,8,2,55,953,0.13,0.94,0.8,0.31,6,2,8,4,1004,0.33,0.99,0.2,0.25
PF00305,PF01477:PF02010:PF00151:PF08016:PF07632,19,70,17,2,53,946,0.24,0.95,0.89,0.45,10,3,16,7,992,0.3,0.98,0.16,0.21
PF08503,PF07530:PF15299:PF16012:PF09675:PF06817,1,21,0,1,21,996,0.0,0.98,0.0,-0.0,2,0,1,2,1015,0.0,1.0,0.0,-0.0
PF03765,PF13897:PF04707:PF00650:PF03371:PF00635,24,90,24,0,66,928,0.27,0.94,1.0,0.5,14,7,17,7,987,0.5,0.98,0.29,0.37
PF15921,PF12180:PF16516:PF09730:PF06211:PF15070,0,13,0,0,13,1005,0.0,0.99,0,0,0,0,0,0,1018,0,1.0,0,0
PF05141,PF06155:PF09084:PF02668:PF08402:PF00528,9,72,7,2,65,944,0.1,0.93,0.78,0.26,10,4,5,6,1003,0.4,0.99,0.44,0.42
PF03745,PF03238:PF06681:PF05448:PF05840:PF09428,0,3,0,0,3,1015,0.0,1.0,0,0,0,0,0,0,1018,0,1.0,0,0
PF15898,PF09310:PF16553:PF09372:PF15808:PF07693,2,10,0,2,10,1006,0.0,0.99,0.0,-0.0,1,0,2,1,1015,0.0,1.0,0.0,-0.0
PF13945,PF15624:PF09441:PF07001:PF15912:PF05397,1,22,0,1,22,995,0.0,0.98,0.0,-0.0,0,0,1,0,1017,0,1.0,0.0,0
PF08065,PF15690:PF09049:PF15689:PF15687:PF00184,1,2,0,1,2,1015,0.0,1.0,0.0,-0.0,0,0,1,0,1017,0,1.0,0.0,0
PF02866,PF00056:PF07258:PF01731:PF05743:PF10420,22,46,20,2,26,970,0.43,0.97,0.91,0.62,1,0,22,1,995,0.0,0.98,0.0,-0.0
PF10328,PF10323:PF02118:PF10316:PF10320:PF10325,16,25,6,10,19,983,0.24,0.97,0.38,0.29,1,0,16,1,1001,0.0,0.98,0.0,-0.0
PF00182,PF00187:PF00967:PF00704:PF00722:PF01551,14,89,10,4,79,925,0.11,0.92,0.71,0.26,13,6,8,7,997,0.46,0.99,0.43,0.44
PF02527,PF02448:PF15364:PF06541:PF15063:PF14986,8,0,0,8,0,1010,0,0.99,0.0,0,0,0,8,0,1010,0,0.99,0.0,0
PF08577,PF10573:PF01080:PF04300:PF16322:PF15042,3,21,0,3,21,994,0.0,0.98,0.0,-0.01,1,0,3,1,1014,0.0,1.0,0.0,-0.0
PF06367,PF06371:PF06345:PF06346:PF02181:PF04108,24,42,24,0,18,976,0.57,0.98,1.0,0.75,4,4,20,0,994,1.0,0.98,0.17,0.4
PF04390,PF10458:PF03320:PF13603:PF06902:PF15174,4,17,1,3,16,998,0.06,0.98,0.25,0.11,3,1,3,2,1012,0.33,1.0,0.25,0.29
PF07200,PF10520:PF04729:PF07412:PF02234:PF10273,13,23,6,7,17,988,0.26,0.98,0.46,0.34,1,0,13,1,1004,0.0,0.99,0.0,-0.0
PF08427,PF07035:PF08696:PF10350:PF12036:PF12612,9,31,3,6,28,981,0.1,0.97,0.33,0.17,3,2,7,1,1008,0.67,0.99,0.22,0.38
PF06259,PF13036:PF15117:PF11794:PF06761:PF11681,0,0,0,0,0,1018,0,1.0,0,0,0,0,0,0,1018,0,1.0,0,0
PF02567,PF13380:PF15161:PF14996:PF13607:PF00496,17,21,7,10,14,987,0.33,0.98,0.41,0.36,1,1,16,0,1001,1.0,0.98,0.06,0.24
PF07352,PF01325:PF04984:PF15150:PF11138:PF03090,1,3,0,1,3,1014,0.0,1.0,0.0,-0.0,0,0,1,0,1017,0,1.0,0.0,0
PF11882,PF07923:PF07171:PF02884:PF15966:PF02278,6,14,6,0,8,1004,0.43,0.99,1.0,0.65,0,0,6,0,1012,0,0.99,0.0,0
PF16544,PF16274:PF16568:PF16551:PF08067:PF09005,4,13,2,2,11,1003,0.15,0.99,0.5,0.27,1,1,3,0,1014,1.0,1.0,0.25,0.5
PF15315,PF05135:PF15119:PF15776:PF15340:PF05797,0,5,0,0,5,1013,0.0,1.0,0,0,0,0,0,0,1018,0,1.0,0,0
PF06552,PF03842:PF15015:PF01701:PF15130:PF15060,4,2,0,4,2,1012,0.0,0.99,0.0,-0.0,0,0,4,0,1014,0,1.0,0.0,0
PF05944,PF16980:PF10092:PF01424:PF04752:PF00439,2,102,2,0,100,916,0.02,0.9,1.0,0.13,4,0,2,4,1012,0.0,0.99,0.0,-0.0
PF01284,PF07303:PF03096:PF03195:PF15675:PF04419,26,26,13,13,13,979,0.5,0.97,0.5,0.49,2,2,24,0,992,1.0,0.98,0.08,0.27
PF15924,PF13439:PF12038:PF04413:PF08288:PF13579,5,33,2,3,31,982,0.06,0.97,0.4,0.15,1,1,4,0,1013,1.0,1.0,0.2,0.45
PF01273,PF02886:PF02550:PF01144:PF13336:PF02144,12,43,12,0,31,975,0.28,0.97,1.0,0.52,3,2,10,1,1005,0.67,0.99,0.17,0.33
PF13863,PF04880:PF14922:PF10226:PF11559:PF11831,7,24,4,3,20,991,0.17,0.98,0.57,0.3,1,1,6,0,1011,1.0,0.99,0.14,0.38
PF15397,PF06485:PF12855:PF03596:PF05547:PF16060,5,11,3,2,8,1005,0.27,0.99,0.6,0.4,0,0,5,0,1013,0,1.0,0.0,0
PF09029,PF07706:PF00155:PF00392:PF10797:PF07702,2,111,2,0,109,907,0.02,0.89,1.0,0.13,5,1,1,4,1012,0.2,1.0,0.5,0.31
PF05602,PF10236:PF02186:PF04111:PF07946:PF10187,11,32,5,6,27,980,0.16,0.97,0.45,0.25,5,3,8,2,1005,0.6,0.99,0.27,0.4
PF04691,PF15760:PF02950:PF15055:PF11771:PF14519,1,1,0,1,1,1016,0.0,1.0,0.0,-0.0,0,0,1,0,1017,0,1.0,0.0,0
PF05612,PF04901:PF02372:PF03488:PF00727:PF15171,0,9,0,0,9,1009,0.0,0.99,0,0,0,0,0,0,1018,0,1.0,0,0
PF10516,PF06428:PF15266:PF05132:PF15558:PF15311,3,23,2,1,21,994,0.09,0.98,0.67,0.24,1,1,2,0,1015,1.0,1.0,0.33,0.58
PF12439,PF01660:PF15823:PF04625:PF15480:PF16931,0,8,0,0,8,1010,0.0,0.99,0,0,0,0,0,0,1018,0,1.0,0,0
PF16499,PF09072:PF13813:PF00150:PF04616:PF00161,20,79,14,6,65,933,0.18,0.93,0.7,0.33,8,6,14,2,996,0.75,0.98,0.3,0.47
PF08706,PF13722:PF04196:PF15518:PF16967:PF00915,5,2,0,5,2,1011,0.0,0.99,0.0,-0.0,0,0,5,0,1013,0,1.0,0.0,0
PF02730,PF07411:PF14376:PF03090:PF06082:PF03865,4,3,2,2,1,1013,0.67,1.0,0.5,0.58,0,0,4,0,1014,0,1.0,0.0,0
PF02770,PF00441:PF02771:PF08028:PF09317:PF12806,67,61,59,8,2,949,0.97,0.99,0.88,0.92,3,3,64,0,951,1.0,0.94,0.04,0.2
PF01731,PF10420:PF00243:PF07258:PF00346:PF13506,4,36,1,3,35,979,0.03,0.96,0.25,0.07,2,1,3,1,1013,0.5,1.0,0.25,0.35
PF00220,PF15690:PF15689:PF04644:PF07806:PF06683,2,1,0,2,1,1015,0.0,1.0,0.0,-0.0,0,0,2,0,1016,0,1.0,0.0,0
PF11430,PF10994:PF15169:PF15825:PF15119:PF09057,0,1,0,0,1,1017,0.0,1.0,0,0,0,0,0,0,1018,0,1.0,0,0
PF00847,PF02362:PF14733:PF02701:PF06507:PF05182,26,46,12,14,34,958,0.26,0.95,0.46,0.32,5,3,23,2,990,0.6,0.98,0.12,0.26
PF12157,PF17105:PF10537:PF10513:PF09247:PF09429,7,41,5,2,36,975,0.12,0.96,0.71,0.29,3,2,5,1,1010,0.67,0.99,0.29,0.43
PF02405,PF09383:PF08352:PF12800:PF03649:PF01032,3,9,2,1,7,1008,0.22,0.99,0.67,0.38,2,2,1,0,1015,1.0,1.0,0.67,0.82
PF09443,PF15346:PF14279:PF15298:PF04839:PF00212,2,4,1,1,3,1013,0.25,1.0,0.5,0.35,0,0,2,0,1016,0,1.0,0.0,0
PF00550,PF08659:PF14765:PF00109:PF00501:PF02801,68,148,62,6,86,864,0.42,0.91,0.91,0.58,48,44,24,4,946,0.92,0.97,0.65,0.76
PF14288,PF02364:PF14498:PF06964:PF10350:PF13910,9,31,9,0,22,987,0.29,0.98,1.0,0.53,5,2,7,3,1006,0.4,0.99,0.22,0.29
PF12949,PF09402:PF16944:PF05640:PF12701:PF00649,12,34,11,1,23,983,0.32,0.98,0.92,0.54,1,1,11,0,1006,1.0,0.99,0.08,0.29
PF04051,PF10247:PF00118:PF01912:PF08122:PF06093,21,61,11,10,50,947,0.18,0.94,0.52,0.28,3,2,19,1,996,0.67,0.98,0.1,0.25
PF02310,PF01642:PF02965:PF02607:PF00809:PF02574,7,25,7,0,18,993,0.28,0.98,1.0,0.52,5,5,2,0,1011,1.0,1.0,0.71,0.84
PF12612,PF10350:PF14959:PF17034:PF07539:PF15979,13,29,7,6,22,983,0.24,0.97,0.54,0.35,2,2,11,0,1005,1.0,0.99,0.15,0.39
PF00132,PF00483:PF14602:PF06426:PF01050:PF12464,59,55,42,17,13,946,0.76,0.97,0.71,0.72,6,6,53,0,959,1.0,0.95,0.1,0.31
PF14799,PF06232:PF10244:PF14935:PF05039:PF09696,6,18,4,2,14,998,0.22,0.98,0.67,0.38,1,0,6,1,1011,0.0,0.99,0.0,-0.0
PF11832,PF04245:PF03092:PF13277:PF07339:PF00208,0,27,0,0,27,991,0.0,0.97,0,0,0,0,0,0,1018,0,1.0,0,0
PF05044,PF09462:PF10407:PF10056:PF09441:PF15082,6,7,1,5,6,1006,0.14,0.99,0.17,0.15,0,0,6,0,1012,0,0.99,0.0,0
PF15733,PF12068:PF11830:PF00566:PF02893:PF09122,0,99,0,0,99,919,0.0,0.9,0,0,4,0,0,4,1014,0.0,1.0,0,0
PF00102,PF14948:PF11548:PF09414:PF00629:PF09379,54,64,29,25,35,929,0.45,0.94,0.54,0.46,5,5,49,0,964,1.0,0.95,0.09,0.3
PF04930,PF15011:PF10195:PF01596:PF14989:PF11991,9,23,3,6,20,989,0.13,0.97,0.33,0.2,0,0,9,0,1009,0,0.99,0.0,0
PF04993,PF15529:PF06798:PF06403:PF03241:PF02554,0,1,0,0,1,1017,0.0,1.0,0,0,0,0,0,0,1018,0,1.0,0,0
PF04864,PF04863:PF03979:PF04546:PF15722:PF00879,4,8,2,2,6,1008,0.25,0.99,0.5,0.35,0,0,4,0,1014,0,1.0,0.0,0
PF15793,PF15491:PF15735:PF16748:PF08579:PF13320,0,6,0,0,6,1012,0.0,0.99,0,0,0,0,0,0,1018,0,1.0,0,0
PF02284,PF05915:PF08561:PF07114:PF06658:PF04176,6,17,4,2,13,999,0.24,0.99,0.67,0.39,1,0,6,1,1011,0.0,0.99,0.0,-0.0
PF12897,PF04350:PF12241:PF03882:PF08886:PF01136,2,2,0,2,2,1014,0.0,1.0,0.0,-0.0,0,0,2,0,1016,0,1.0,0.0,0
PF00073,PF00548:PF12381:PF08762:PF02226:PF00680,12,12,12,0,0,1006,1.0,1.0,1.0,1.0,12,12,0,0,1006,1.0,1.0,1.0,1.0
PF03160,PF07965:PF14312:PF08725:PF00362:PF03733,14,15,4,10,11,993,0.27,0.98,0.29,0.27,4,2,12,2,1002,0.5,0.99,0.14,0.26
PF05041,PF14611:PF12422:PF11331:PF00649:PF09429,8,23,1,7,22,988,0.04,0.97,0.12,0.06,0,0,8,0,1010,0,0.99,0.0,0
PF15020,PF14961:PF15069:PF14674:PF10480:PF15149,6,1,0,6,1,1011,0.0,0.99,0.0,-0.0,0,0,6,0,1012,0,0.99,0.0,0
PF09145,PF13722:PF11751:PF04451:PF03135:PF11316,0,6,0,0,6,1012,0.0,0.99,0,0,0,0,0,0,1018,0,1.0,0,0
PF11196,PF08744:PF02217:PF06745:PF03135:PF13753,0,6,0,0,6,1012,0.0,0.99,0,0,0,0,0,0,1018,0,1.0,0,0
PF00942,PF02927:PF07476:PF13726:PF05016:PF00816,2,3,1,1,2,1014,0.33,1.0,0.5,0.41,0,0,2,0,1016,0,1.0,0.0,0
PF02785,PF00289:PF08326:PF02436:PF01039:PF00364,33,63,33,0,30,955,0.52,0.97,1.0,0.71,18,18,15,0,985,1.0,0.99,0.55,0.73
PF05097,PF06136:PF05627:PF14547:PF03141:PF04601,5,30,2,3,28,985,0.07,0.97,0.4,0.15,2,1,4,1,1012,0.5,1.0,0.2,0.31
PF12765,PF10441:PF15917:PF12830:PF02368:PF12074,13,20,8,5,12,993,0.4,0.98,0.62,0.49,1,1,12,0,1005,1.0,0.99,0.08,0.28
PF01131,PF01751:PF01396:PF13368:PF00521:PF16898,20,34,16,4,18,980,0.47,0.98,0.8,0.6,9,5,15,4,994,0.56,0.98,0.25,0.36
PF17184,PF04179:PF08369:PF09363:PF17168:PF16335,4,8,3,1,5,1009,0.38,0.99,0.75,0.53,1,1,3,0,1014,1.0,1.0,0.25,0.5
PF09777,PF00159:PF12020:PF13841:PF10853:PF01099,2,6,0,2,6,1010,0.0,0.99,0.0,-0.0,0,0,2,0,1016,0,1.0,0.0,0
PF03540,PF12597:PF06500:PF10780:PF16541:PF14799,6,16,1,5,15,997,0.06,0.98,0.17,0.09,1,1,5,0,1012,1.0,1.0,0.17,0.41
PF04764,PF12241:PF14882:PF15143:PF08334:PF05671,0,4,0,0,4,1014,0.0,1.0,0,0,0,0,0,0,1018,0,1.0,0,0
PF16399,PF15917:PF12166:PF02368:PF08638:PF09743,14,20,4,10,16,988,0.2,0.97,0.29,0.23,3,2,12,1,1003,0.67,0.99,0.14,0.3
PF02751,PF02268:PF02965:PF02607:PF08523:PF12590,14,22,12,2,10,994,0.55,0.99,0.86,0.68,0,0,14,0,1004,0,0.99,0.0,0
PF12243,PF12350:PF05390:PF07950:PF03769:PF06239,2,13,2,0,11,1005,0.15,0.99,1.0,0.39,0,0,2,0,1016,0,1.0,0.0,0
PF03492,PF03087:PF00197:PF01960:PF10604:PF04535,9,32,7,2,25,984,0.22,0.97,0.78,0.4,2,1,8,1,1008,0.5,0.99,0.11,0.23
PF00022,PF10357:PF16840:PF15361:PF15318:PF11187,60,15,11,49,4,954,0.73,0.95,0.18,0.35,0,0,60,0,958,0,0.94,0.0,0
PF13240,PF12202:PF16797:PF08587:PF11629:PF14593,5,19,3,2,16,997,0.16,0.98,0.6,0.3,4,3,2,1,1012,0.75,1.0,0.6,0.67
PF00146,PF00421:PF00507:PF00223:PF00124:PF13237,22,28,12,10,16,980,0.43,0.97,0.55,0.47,2,1,21,1,995,0.5,0.98,0.05,0.15
PF06752,PF04126:PF16756:PF00114:PF12064:PF15608,3,6,0,3,6,1009,0.0,0.99,0.0,-0.0,0,0,3,0,1015,0,1.0,0.0,0
PF05917,PF16752:PF11970:PF06374:PF05035:PF06426,0,20,0,0,20,998,0.0,0.98,0,0,0,0,0,0,1018,0,1.0,0,0
PF06676,PF01750:PF10144:PF03496:PF16600:PF05541,0,5,0,0,5,1013,0.0,1.0,0,0,0,0,0,0,1018,0,1.0,0,0
PF00694,PF00330:PF11791:PF06434:PF08244:PF08031,31,72,28,3,44,943,0.39,0.95,0.9,0.58,5,4,27,1,986,0.8,0.97,0.13,0.31
PF01638,PF01312:PF03749:PF14290:PF02277:PF06681,1,5,0,1,5,1012,0.0,0.99,0.0,-0.0,0,0,1,0,1017,0,1.0,0.0,0
PF14822,PF07406:PF15003:PF09784:PF12304:PF12926,2,4,0,2,4,1012,0.0,0.99,0.0,-0.0,0,0,2,0,1016,0,1.0,0.0,0
PF01571,PF08669:PF16350:PF10170:PF01266:PF16901,26,79,26,0,53,939,0.33,0.95,1.0,0.56,11,11,15,0,992,1.0,0.99,0.42,0.65
PF06933,PF07610:PF10407:PF15082:PF10933:PF08744,0,4,0,0,4,1014,0.0,1.0,0,0,0,0,0,0,1018,0,1.0,0,0
PF13726,PF14983:PF12241:PF03922:PF14882:PF03971,0,4,0,0,4,1014,0.0,1.0,0,0,0,0,0,0,1018,0,1.0,0,0
PF06675,PF15633:PF05988:PF15775:PF01345:PF09990,0,2,0,0,2,1016,0.0,1.0,0,0,0,0,0,0,1018,0,1.0,0,0
PF01883,PF10609:PF02195:PF02668:PF10046:PF09439,16,63,8,8,55,947,0.13,0.94,0.5,0.23,5,3,13,2,1000,0.6,0.99,0.19,0.33
PF11209,PF13205:PF07805:PF12019:PF13296:PF06070,1,7,0,1,7,1010,0.0,0.99,0.0,-0.0,0,0,1,0,1017,0,1.0,0.0,0
PF09444,PF09967:PF03344:PF09931:PF02472:PF11672,1,5,0,1,5,1012,0.0,0.99,0.0,-0.0,0,0,1,0,1017,0,1.0,0.0,0
PF02349,PF00261:PF14802:PF13851:PF12718:PF08172,0,13,0,0,13,1005,0.0,0.99,0,0,0,0,0,0,1018,0,1.0,0,0
PF15529,PF09611:PF04717:PF07805:PF14841:PF15271,0,2,0,0,2,1016,0.0,1.0,0,0,0,0,0,0,1018,0,1.0,0,0
PF04420,PF09749:PF04716:PF06799:PF06376:PF05915,9,23,4,5,19,990,0.17,0.98,0.44,0.27,3,2,7,1,1008,0.67,0.99,0.22,0.38
PF00721,PF09704:PF11289:PF15338:PF04060:PF16286,1,4,0,1,4,1013,0.0,1.0,0.0,-0.0,0,0,1,0,1017,0,1.0,0.0,0
PF14931,PF15069:PF15551:PF03437:PF01387:PF10166,1,4,0,1,4,1013,0.0,1.0,0.0,-0.0,0,0,1,0,1017,0,1.0,0.0,0
PF00196,PF00486:PF04397:PF06580:PF02954:PF00158,8,21,4,4,17,993,0.19,0.98,0.5,0.3,5,3,5,2,1008,0.6,0.99,0.38,0.47
PF08260,PF12276:PF13796:PF09675:PF06680:PF01369,0,42,0,0,42,976,0.0,0.96,0,0,0,0,0,0,1018,0,1.0,0,0
PF03081,PF04859:PF06830:PF07762:PF00485:PF04833,24,40,11,13,29,965,0.28,0.96,0.46,0.34,2,2,22,0,994,1.0,0.98,0.08,0.29
PF03709,PF09950:PF12381:PF12603:PF16838:PF08275,2,8,0,2,8,1008,0.0,0.99,0.0,-0.0,0,0,2,0,1016,0,1.0,0.0,0
PF00614,PF13091:PF12357:PF01735:PF06292:PF00613,17,70,12,5,58,943,0.17,0.94,0.71,0.33,9,6,11,3,998,0.67,0.99,0.35,0.48
PF07898,PF15013:PF04979:PF01097:PF00886:PF05915,6,28,3,3,25,987,0.11,0.97,0.5,0.22,1,1,5,0,1012,1.0,1.0,0.17,0.41
PF08035,PF16102:PF08384:PF00976:PF08922:PF01337,0,1,0,0,1,1017,0.0,1.0,0,0,0,0,0,0,1018,0,1.0,0,0
PF04494,PF08145:PF04158:PF11540:PF09453:PF10313,10,23,3,7,20,988,0.13,0.97,0.3,0.19,1,1,9,0,1008,1.0,0.99,0.1,0.31
PF07902,PF09365:PF05611:PF08093:PF02217:PF14398,1,6,0,1,6,1011,0.0,0.99,0.0,-0.0,0,0,1,0,1017,0,1.0,0.0,0
PF00130,PF00609:PF00017:PF00169:PF13543:PF00307,60,194,47,13,147,811,0.24,0.84,0.78,0.38,32,27,33,5,953,0.84,0.96,0.45,0.6
PF00379,PF15323:PF06417:PF04923:PF02320:PF07841,32,23,6,26,17,969,0.26,0.96,0.19,0.2,1,1,31,0,986,1.0,0.97,0.03,0.17
PF00202,PF05577:PF10046:PF12739:PF08442:PF00657,44,66,27,17,39,935,0.41,0.94,0.61,0.47,7,6,38,1,973,0.86,0.96,0.14,0.33
PF00491,PF13023:PF16906:PF14027:PF16053:PF01470,19,39,12,7,27,972,0.31,0.97,0.63,0.43,6,5,14,1,998,0.83,0.99,0.26,0.46
PF04769,PF11025:PF09687:PF01160:PF13092:PF11735,2,16,0,2,16,1000,0.0,0.98,0.0,-0.01,0,0,2,0,1016,0,1.0,0.0,0
PF09729,PF16944:PF05508:PF15279:PF04109:PF10033,8,13,2,6,11,999,0.15,0.98,0.25,0.19,1,1,7,0,1010,1.0,0.99,0.12,0.35
PF05515,PF15856:PF10407:PF15577:PF15548:PF10618,0,6,0,0,6,1012,0.0,0.99,0,0,0,0,0,0,1018,0,1.0,0,0
PF01992,PF08061:PF02559:PF03880:PF16739:PF04568,10,16,4,6,12,996,0.25,0.98,0.4,0.31,2,2,8,0,1008,1.0,0.99,0.2,0.45
PF00958,PF00977:PF00697:PF00425:PF08252:PF00218,17,35,6,11,29,972,0.17,0.96,0.35,0.23,1,0,17,1,1000,0.0,0.98,0.0,-0.0
PF12497,PF02166:PF02161:PF02155:PF02159:PF12743,3,13,3,0,10,1005,0.23,0.99,1.0,0.48,5,3,0,2,1013,0.6,1.0,1.0,0.77
PF10056,PF15082:PF15309:PF09441:PF05397:PF15888,2,17,1,1,16,1000,0.06,0.98,0.5,0.17,0,0,2,0,1016,0,1.0,0.0,0
PF08546,PF02558:PF02492:PF03439:PF02317:PF07683,20,54,20,0,34,964,0.37,0.97,1.0,0.6,4,3,17,1,997,0.75,0.98,0.15,0.33
PF00950,PF05936:PF06808:PF12837:PF07338:PF00593,4,13,3,1,10,1004,0.23,0.99,0.75,0.41,2,2,2,0,1014,1.0,1.0,0.5,0.71
PF05711,PF08848:PF06681:PF09818:PF05448:PF14494,0,3,0,0,3,1015,0.0,1.0,0,0,0,0,0,0,1018,0,1.0,0,0
PF08606,PF04158:PF16699:PF08145:PF04494:PF08149,19,24,9,10,15,984,0.38,0.98,0.47,0.41,1,1,18,0,999,1.0,0.98,0.05,0.23
PF14048,PF16564:PF01429:PF09791:PF01702:PF07148,8,42,7,1,35,975,0.17,0.96,0.88,0.37,0,0,8,0,1010,0,0.99,0.0,0
PF00394,PF07732:PF07731:PF00891:PF08246:PF00561,43,139,43,0,96,879,0.31,0.91,1.0,0.53,29,26,17,3,972,0.9,0.98,0.6,0.73
PF00800,PF13508:PF02153:PF01817:PF04884:PF00351,15,58,10,5,48,955,0.17,0.95,0.67,0.32,1,0,15,1,1002,0.0,0.98,0.0,-0.0
PF10211,PF16531:PF14846:PF05046:PF15246:PF14908,6,14,2,4,12,1000,0.14,0.98,0.33,0.21,1,1,5,0,1012,1.0,1.0,0.17,0.41
PF04143,PF12716:PF07464:PF12973:PF04736:PF03576,3,5,0,3,5,1010,0.0,0.99,0.0,-0.0,0,0,3,0,1015,0,1.0,0.0,0
PF16698,PF00200:PF01562:PF08516:PF01421:PF05986,3,46,3,0,43,972,0.07,0.96,1.0,0.25,28,1,2,27,988,0.04,0.97,0.33,0.1
PF04386,PF09772:PF11461:PF00336:PF15113:PF09730,0,25,0,0,25,993,0.0,0.98,0,0,0,0,0,0,1018,0,1.0,0,0
PF15032,PF09108:PF00669:PF15976:PF02277:PF15281,0,7,0,0,7,1011,0.0,0.99,0,0,0,0,0,0,1018,0,1.0,0,0
PF09164,PF00273:PF17187:PF12470:PF05076:PF09328,0,7,0,0,7,1011,0.0,0.99,0,0,1,0,0,1,1017,0.0,1.0,0,0
PF05476,PF15186:PF01303:PF17206:PF16997:PF01913,1,3,0,1,3,1014,0.0,1.0,0.0,-0.0,0,0,1,0,1017,0,1.0,0.0,0
PF14222,PF14225:PF14228:PF16206:PF09324:PF11919,7,27,7,0,20,991,0.26,0.98,1.0,0.5,3,3,4,0,1011,1.0,1.0,0.43,0.65
PF11943,PF11965:PF02272:PF13901:PF02514:PF04225,0,39,0,0,39,979,0.0,0.96,0,0,1,0,0,1,1017,0.0,1.0,0,0
PF05037,PF14934:PF01488:PF08501:PF02123:PF02237,0,30,0,0,30,988,0.0,0.97,0,0,0,0,0,0,1018,0,1.0,0,0
PF04681,PF09428:PF05151:PF00737:PF10333:PF02941,5,3,0,5,3,1010,0.0,0.99,0.0,-0.0,0,0,5,0,1013,0,1.0,0.0,0
PF16027,PF15806:PF00473:PF07809:PF02186:PF15242,0,19,0,0,19,999,0.0,0.98,0,0,0,0,0,0,1018,0,1.0,0,0
PF00366,PF16205:PF14853:PF02607:PF02965:PF00344,15,32,11,4,21,982,0.34,0.98,0.73,0.49,2,2,13,0,1003,1.0,0.99,0.13,0.36
PF00674,PF00799:PF16576:PF07958:PF16871:PF14654,0,7,0,0,7,1011,0.0,0.99,0,0,0,0,0,0,1018,0,1.0,0,0
PF14092,PF11249:PF12357:PF08116:PF07743:PF05818,0,21,0,0,21,997,0.0,0.98,0,0,0,0,0,0,1018,0,1.0,0,0
PF03551,PF16908:PF07250:PF01276:PF13369:PF11566,0,37,0,0,37,981,0.0,0.96,0,0,2,0,0,2,1016,0.0,1.0,0,0
PF10662,PF05128:PF06780:PF15086:PF00358:PF09269,2,13,2,0,11,1005,0.15,0.99,1.0,0.39,1,1,1,0,1016,1.0,1.0,0.5,0.71
PF01205,PF06544:PF16543:PF08572:PF09186:PF05773,18,48,12,6,36,964,0.25,0.96,0.67,0.39,3,3,15,0,1000,1.0,0.99,0.17,0.41
PF13176,PF13181:PF09295:PF13174:PF07721:PF16669,38,109,28,10,81,899,0.26,0.91,0.74,0.4,6,5,33,1,979,0.83,0.97,0.13,0.32
PF01016,PF04716:PF06376:PF05915:PF04667:PF03657,16,25,5,11,20,982,0.2,0.97,0.31,0.24,2,2,14,0,1002,1.0,0.99,0.12,0.35
PF11315,PF14279:PF07809:PF00127:PF02576:PF04839,5,4,0,5,4,1009,0.0,0.99,0.0,-0.0,0,0,5,0,1013,0,1.0,0.0,0
PF01192,PF10780:PF00159:PF06127:PF16906:PF03980,5,21,2,3,19,994,0.1,0.98,0.4,0.19,1,0,5,1,1012,0.0,0.99,0.0,-0.0
PF07822,PF04811:PF09325:PF15951:PF13713:PF09313,1,44,0,1,44,973,0.0,0.96,0.0,-0.01,1,0,1,1,1016,0.0,1.0,0.0,-0.0
PF06850,PF07209:PF04830:PF17164:PF16804:PF11876,0,1,0,0,1,1017,0.0,1.0,0,0,0,0,0,0,1018,0,1.0,0,0
PF12324,PF11245:PF11751:PF08708:PF02465:PF07409,3,0,0,3,0,1015,0,1.0,0.0,0,0,0,3,0,1015,0,1.0,0.0,0
PF00610,PF00618:PF04784:PF12257:PF00615:PF03547,38,98,29,9,69,911,0.3,0.92,0.76,0.45,11,7,31,4,976,0.64,0.97,0.18,0.33
PF15785,PF08163:PF11640:PF08064:PF11522:PF14621,11,20,4,7,16,991,0.2,0.98,0.36,0.26,3,2,9,1,1006,0.67,0.99,0.18,0.34
PF09906,PF09860:PF01109:PF12805:PF09187:PF15743,0,2,0,0,2,1016,0.0,1.0,0,0,0,0,0,0,1018,0,1.0,0,0
PF05448,PF03745:PF09962:PF09428:PF03238:PF15762,2,2,0,2,2,1014,0.0,1.0,0.0,-0.0,0,0,2,0,1016,0,1.0,0.0,0
PF06869,PF01666:PF15235:PF12443:PF05990:PF01430,0,2,0,0,2,1016,0.0,1.0,0,0,0,0,0,0,1018,0,1.0,0,0
PF01335,PF13820:PF00531:PF09034:PF11957:PF00020,13,50,13,0,37,968,0.26,0.96,1.0,0.5,3,3,10,0,1005,1.0,0.99,0.23,0.48
PF14533,PF12436:PF13446:PF16674:PF06337:PF14836,7,25,7,0,18,993,0.28,0.98,1.0,0.52,5,3,4,2,1009,0.6,0.99,0.43,0.5
PF15060,PF15231:PF10856:PF15130:PF17085:PF15685,0,1,0,0,1,1017,0.0,1.0,0,0,0,0,0,0,1018,0,1.0,0,0
PF09329,PF12253:PF16944:PF15871:PF04087:PF08634,6,8,0,6,8,1004,0.0,0.99,0.0,-0.01,0,0,6,0,1012,0,0.99,0.0,0
PF12680,PF08787:PF01828:PF10224:PF06127:PF09424,7,22,3,4,19,992,0.14,0.98,0.43,0.23,0,0,7,0,1011,0,0.99,0.0,0
PF03530,PF02888:PF15113:PF07885:PF11539:PF14578,14,63,13,1,50,954,0.21,0.95,0.93,0.42,0,0,14,0,1004,0,0.99,0.0,0
PF00386,PF00229:PF12287:PF03523:PF07546:PF01414,24,19,6,18,13,981,0.32,0.97,0.25,0.27,1,1,23,0,994,1.0,0.98,0.04,0.2
PF06484,PF05593:PF15636:PF17205:PF02333:PF03527,2,13,1,1,12,1004,0.08,0.99,0.5,0.19,0,0,2,0,1016,0,1.0,0.0,0
PF03323,PF02554:PF04466:PF09611:PF05887:PF17206,8,1,1,7,0,1010,1.0,0.99,0.12,0.35,0,0,8,0,1010,0,0.99,0.0,0
PF06877,PF13813:PF09855:PF00293:PF01812:PF02269,0,91,0,0,91,927,0.0,0.91,0,0,4,0,0,4,1014,0.0,1.0,0,0
PF05128,PF15086:PF06780:PF10662:PF08701:PF09269,1,8,1,0,7,1010,0.12,0.99,1.0,0.35,1,1,0,0,1017,1.0,1.0,1.0,1.0
PF09175,PF06448:PF09172:PF01347:PF09206:PF00094,2,46,2,0,44,972,0.04,0.96,1.0,0.2,8,1,1,7,1009,0.12,0.99,0.5,0.25
PF00504,PF00810:PF00197:PF01625:PF06749:PF10604,18,43,8,10,35,965,0.19,0.96,0.44,0.27,3,2,16,1,999,0.67,0.98,0.11,0.27
PF02359,PF02933:PF05695:PF05362:PF09262:PF09336,11,45,8,3,37,970,0.18,0.96,0.73,0.35,5,3,8,2,1005,0.6,0.99,0.27,0.4
PF05825,PF15071:PF00727:PF00714:PF14473:PF00236,2,6,0,2,6,1010,0.0,0.99,0.0,-0.0,0,0,2,0,1016,0,1.0,0.0,0
PF04949,PF07939:PF12926:PF07052:PF09805:PF06989,9,21,5,4,16,993,0.24,0.98,0.56,0.36,0,0,9,0,1009,0,0.99,0.0,0
PF08399,PF08473:PF02743:PF08487:PF13768:PF06668,10,32,8,2,24,984,0.25,0.97,0.8,0.44,7,5,5,2,1006,0.71,0.99,0.5,0.59
PF17092,PF08274:PF06751:PF08497:PF06798:PF07805,1,2,0,1,2,1015,0.0,1.0,0.0,-0.0,0,0,1,0,1017,0,1.0,0.0,0
PF12922,PF12717:PF12157:PF12887:PF09247:PF14818,17,34,17,0,17,984,0.5,0.98,1.0,0.7,1,1,16,0,1001,1.0,0.98,0.06,0.24
PF01820,PF07478:PF16353:PF02929:PF06746:PF17042,1,17,1,0,16,1001,0.06,0.98,1.0,0.24,4,0,1,4,1013,0.0,1.0,0.0,-0.0
PF05817,PF02580:PF09734:PF16720:PF04303:PF04889,13,37,9,4,28,977,0.24,0.97,0.69,0.4,3,2,11,1,1004,0.67,0.99,0.15,0.32
PF00234,PF14159:PF01871:PF14249:PF14547:PF08137,6,7,1,5,6,1006,0.14,0.99,0.17,0.15,0,0,6,0,1012,0,0.99,0.0,0
PF13195,PF01869:PF05242:PF10294:PF10626:PF04338,0,46,0,0,46,972,0.0,0.95,0,0,0,0,0,0,1018,0,1.0,0,0
PF06805,PF05939:PF05100:PF01913:PF08724:PF10412,0,1,0,0,1,1017,0.0,1.0,0,0,0,0,0,0,1018,0,1.0,0,0
PF06546,PF00447:PF02954:PF03310:PF00158:PF01339,4,37,4,0,33,981,0.11,0.97,1.0,0.32,6,3,1,3,1011,0.5,1.0,0.75,0.61
PF09806,PF15352:PF01387:PF05436:PF06524:PF15794,5,12,2,3,10,1003,0.17,0.99,0.4,0.25,0,0,5,0,1013,0,1.0,0.0,0
PF10566,PF10908:PF07157:PF06798:PF01913:PF16325,0,2,0,0,2,1016,0.0,1.0,0,0,0,0,0,0,1018,0,1.0,0,0
PF15221,PF14841:PF08724:PF06890:PF08411:PF10974,1,2,0,1,2,1015,0.0,1.0,0.0,-0.0,0,0,1,0,1017,0,1.0,0.0,0
PF02322,PF13721:PF01297:PF01706:PF06995:PF02355,1,9,0,1,9,1008,0.0,0.99,0.0,-0.0,0,0,1,0,1017,0,1.0,0.0,0
PF01491,PF01230:PF01198:PF01997:PF05724:PF01177,4,60,3,1,57,957,0.05,0.94,0.75,0.18,6,2,2,4,1010,0.33,0.99,0.5,0.41
PF00523,PF02611:PF14606:PF07068:PF09037:PF01895,0,5,0,0,5,1013,0.0,1.0,0,0,0,0,0,0,1018,0,1.0,0,0
PF16172,PF14429:PF06920:PF11878:PF12768:PF16523,2,21,2,0,19,997,0.1,0.98,1.0,0.31,5,1,1,4,1012,0.2,1.0,0.5,0.31
PF10596,PF10597:PF12134:PF08082:PF10598:PF08084,18,17,17,1,0,1000,1.0,1.0,0.94,0.97,13,13,5,0,1000,1.0,1.0,0.72,0.85
PF09165,PF08802:PF02921:PF10399:PF00848:PF04305,4,27,4,0,23,991,0.15,0.98,1.0,0.38,4,2,2,2,1012,0.5,1.0,0.5,0.5
PF14746,PF14745:PF14744:PF03894:PF09363:PF09051,5,10,5,0,5,1008,0.5,1.0,1.0,0.71,0,0,5,0,1013,0,1.0,0.0,0
PF08029,PF01634:PF00799:PF05432:PF08666:PF16116,6,17,6,0,11,1001,0.35,0.99,1.0,0.59,0,0,6,0,1012,0,0.99,0.0,0
PF15855,PF16590:PF12412:PF15758:PF00381:PF09669,0,2,0,0,2,1016,0.0,1.0,0,0,0,0,0,0,1018,0,1.0,0,0
PF02159,PF11825:PF12743:PF02155:PF12577:PF02161,10,9,6,4,3,1005,0.67,0.99,0.6,0.63,5,5,5,0,1008,1.0,1.0,0.5,0.71
PF10530,PF01234:PF01723:PF02175:PF11937:PF11703,0,10,0,0,10,1008,0.0,0.99,0,0,0,0,0,0,1018,0,1.0,0,0
PF15325,PF06876:PF03050:PF06952:PF05840:PF15119,1,1,0,1,1,1016,0.0,1.0,0.0,-0.0,0,0,1,0,1017,0,1.0,0.0,0
PF12116,PF06007:PF00555:PF12241:PF03925:PF06082,1,6,0,1,6,1011,0.0,0.99,0.0,-0.0,0,0,1,0,1017,0,1.0,0.0,0
PF03826,PF00157:PF16878:PF12045:PF02183:PF12284,8,20,4,4,16,994,0.2,0.98,0.5,0.31,3,3,5,0,1010,1.0,1.0,0.38,0.61
PF00037,PF04068:PF14510:PF02256:PF12704:PF06472,16,47,15,1,32,970,0.32,0.97,0.94,0.54,3,3,13,0,1002,1.0,0.99,0.19,0.43
PF10137,PF13545:PF00325:PF12801:PF08412:PF02551,0,12,0,0,12,1006,0.0,0.99,0,0,0,0,0,0,1018,0,1.0,0,0
PF02525,PF06232:PF10705:PF15063:PF03488:PF00214,2,5,0,2,5,1011,0.0,0.99,0.0,-0.0,0,0,2,0,1016,0,1.0,0.0,0
PF10149,PF08356:PF08355:PF02126:PF01015:PF00071,9,145,7,2,138,871,0.05,0.86,0.78,0.17,13,4,5,9,1000,0.31,0.99,0.44,0.36
PF12632,PF15871:PF15619:PF16944:PF08624:PF12253,3,11,1,2,10,1005,0.09,0.99,0.33,0.17,0,0,3,0,1015,0,1.0,0.0,0
PF11461,PF16516:PF16471:PF09730:PF06607:PF10595,11,16,2,9,14,993,0.12,0.98,0.18,0.14,0,0,11,0,1007,0,0.99,0.0,0
PF10797,PF12897:PF03882:PF17192:PF04288:PF15608,1,2,1,0,1,1016,0.5,1.0,1.0,0.71,0,0,1,0,1017,0,1.0,0.0,0
PF00127,PF10542:PF04839:PF15305:PF02427:PF06351,3,5,0,3,5,1010,0.0,0.99,0.0,-0.0,0,0,3,0,1015,0,1.0,0.0,0
PF16564,PF14048:PF01429:PF07574:PF14378:PF11567,7,38,7,0,31,980,0.18,0.97,1.0,0.42,2,1,6,1,1010,0.5,0.99,0.14,0.26
PF09090,PF09088:PF02854:PF02847:PF10573:PF04050,11,39,11,0,28,979,0.28,0.97,1.0,0.52,8,6,5,2,1005,0.75,0.99,0.55,0.64
PF10223,PF06910:PF06468:PF02014:PF00061:PF08212,2,37,2,0,35,981,0.05,0.97,1.0,0.23,2,1,1,1,1015,0.5,1.0,0.5,0.5
PF06966,PF09809:PF00159:PF04667:PF00831:PF03501,16,25,7,9,18,984,0.28,0.97,0.44,0.34,1,1,15,0,1002,1.0,0.99,0.06,0.25
PF07110,PF14027:PF04199:PF01828:PF11807:PF12680,12,37,8,4,29,977,0.22,0.97,0.67,0.37,9,4,8,5,1001,0.44,0.99,0.33,0.38
PF00767,PF06798:PF17188:PF01514:PF13722:PF06890,2,0,0,2,0,1016,0,1.0,0.0,0,0,0,2,0,1016,0,1.0,0.0,0
PF16026,PF15821:PF09787:PF13166:PF11291:PF10375,5,8,1,4,7,1006,0.12,0.99,0.2,0.15,0,0,5,0,1013,0,1.0,0.0,0
PF08180,PF04835:PF06745:PF12192:PF14489:PF17164,0,1,0,0,1,1017,0.0,1.0,0,0,0,0,0,0,1018,0,1.0,0,0
PF15146,PF15395:PF08811:PF12381:PF07394:PF12432,0,12,0,0,12,1006,0.0,0.99,0,0,0,0,0,0,1018,0,1.0,0,0
PF03409,PF10325:PF02118:PF14747:PF14936:PF10327,2,10,1,1,9,1007,0.1,0.99,0.5,0.22,0,0,2,0,1016,0,1.0,0.0,0
PF00429,PF03708:PF10155:PF04704:PF14779:PF15350,5,12,2,3,10,1003,0.17,0.99,0.4,0.25,0,0,5,0,1013,0,1.0,0.0,0
PF14763,PF14761:PF14762:PF14679:PF00073:PF04412,0,16,0,0,16,1002,0.0,0.98,0,0,0,0,0,0,1018,0,1.0,0,0
PF10290,PF10287:PF05683:PF06742:PF07171:PF05681,1,12,1,0,11,1006,0.08,0.99,1.0,0.29,1,0,1,1,1016,0.0,1.0,0.0,-0.0
PF14769,PF00212:PF09282:PF10217:PF04949:PF11255,3,13,1,2,12,1003,0.08,0.99,0.33,0.16,0,0,3,0,1015,0,1.0,0.0,0
PF03645,PF03358:PF04420:PF04176:PF01987:PF04178,20,37,7,13,30,968,0.19,0.96,0.35,0.24,3,3,17,0,998,1.0,0.98,0.15,0.38
PF05034,PF14842:PF08886:PF03428:PF12080:PF01136,0,1,0,0,1,1017,0.0,1.0,0,0,0,0,0,0,1018,0,1.0,0,0
PF02068,PF08291:PF06724:PF08308:PF10951:PF15856,1,1,0,1,1,1016,0.0,1.0,0.0,-0.0,0,0,1,0,1017,0,1.0,0.0,0
PF16512,PF01846:PF15151:PF02172:PF09036:PF10149,3,40,3,0,37,978,0.07,0.96,1.0,0.27,2,0,3,2,1013,0.0,1.0,0.0,-0.0
PF16788,PF14611:PF00649:PF15620:PF05030:PF05041,3,24,0,3,24,991,0.0,0.97,0.0,-0.01,0,0,3,0,1015,0,1.0,0.0,0
PF00330,PF00694:PF06434:PF11791:PF02347:PF06985,36,84,29,7,55,927,0.35,0.94,0.81,0.5,3,3,33,0,982,1.0,0.97,0.08,0.28
PF03353,PF10440:PF05965:PF05964:PF11616:PF15811,4,26,1,3,25,989,0.04,0.97,0.25,0.09,3,1,3,2,1012,0.33,1.0,0.25,0.29
PF00368,PF13323:PF16414:PF02460:PF12349:PF03176,16,56,11,5,45,957,0.2,0.95,0.69,0.35,13,4,12,9,993,0.31,0.98,0.25,0.27
PF11289,PF00721:PF03946:PF02556:PF06623:PF12112,0,28,0,0,28,990,0.0,0.97,0,0,0,0,0,0,1018,0,1.0,0,0
PF08407,PF15489:PF11732:PF16134:PF01644:PF15782,16,24,14,2,10,992,0.58,0.99,0.88,0.71,2,2,14,0,1002,1.0,0.99,0.12,0.35
PF13885,PF05287:PF01500:PF14735:PF16366:PF10239,1,16,1,0,15,1002,0.06,0.99,1.0,0.25,1,0,1,1,1016,0.0,1.0,0.0,-0.0
PF09066,PF14796:PF14797:PF14806:PF07718:PF02296,7,18,3,4,15,996,0.17,0.98,0.43,0.26,3,1,6,2,1009,0.33,0.99,0.14,0.21
PF12049,PF07223:PF10571:PF06420:PF02186:PF10330,0,18,0,0,18,1000,0.0,0.98,0,0,0,0,0,0,1018,0,1.0,0,0
PF15771,PF15754:PF11044:PF15333:PF14328:PF08093,0,1,0,0,1,1017,0.0,1.0,0,0,0,0,0,0,1018,0,1.0,0,0
PF08389,PF08506:PF03378:PF08767:PF03810:PF12612,39,58,27,12,31,948,0.47,0.96,0.69,0.55,11,7,32,4,975,0.64,0.96,0.18,0.33
PF14852,PF14853:PF16205:PF02560:PF09637:PF08369,4,25,4,0,21,993,0.16,0.98,1.0,0.4,0,0,4,0,1014,0,1.0,0.0,0
PF09821,PF09383:PF01032:PF16326:PF13732:PF12857,2,11,2,0,9,1007,0.18,0.99,1.0,0.42,2,2,0,0,1016,1.0,1.0,1.0,1.0
PF14963,PF15130:PF15872:PF03437:PF03842:PF15467,2,3,1,1,2,1014,0.33,1.0,0.5,0.41,0,0,2,0,1016,0,1.0,0.0,0
PF09747,PF04253:PF01133:PF12298:PF01229:PF06079,10,31,6,4,25,983,0.19,0.97,0.6,0.33,2,2,8,0,1008,1.0,0.99,0.2,0.45
PF05792,PF11766:PF12727:PF02063:PF00839:PF01268,0,18,0,0,18,1000,0.0,0.98,0,0,0,0,0,0,1018,0,1.0,0,0
PF00356,PF00532:PF02604:PF00455:PF05280:PF02614,13,12,6,7,6,999,0.5,0.99,0.46,0.47,0,0,13,0,1005,0,0.99,0.0,0
PF02902,PF09331:PF05970:PF14214:PF09588:PF10551,68,87,36,32,51,899,0.41,0.92,0.53,0.42,13,12,56,1,949,0.92,0.94,0.18,0.39
PF10515,PF02177:PF03494:PF12925:PF12924:PF14558,8,14,8,0,6,1004,0.57,0.99,1.0,0.75,8,8,0,0,1010,1.0,1.0,1.0,1.0
PF05593,PF06484:PF15636:PF03527:PF02333:PF00362,4,17,3,1,14,1000,0.18,0.99,0.75,0.36,1,0,4,1,1013,0.0,1.0,0.0,-0.0
PF05867,PF15120:PF07259:PF15849:PF14877:PF16007,5,7,1,4,6,1007,0.14,0.99,0.2,0.16,0,0,5,0,1013,0,1.0,0.0,0
PF05677,PF12898:PF14216:PF11223:PF11179:PF16091,0,5,0,0,5,1013,0.0,1.0,0,0,0,0,0,0,1018,0,1.0,0,0
PF09694,PF01722:PF15433:PF06775:PF02005:PF02099,0,37,0,0,37,981,0.0,0.96,0,0,4,0,0,4,1014,0.0,1.0,0,0
PF01802,PF07250:PF09676:PF00637:PF05703:PF03935,1,42,1,0,41,976,0.02,0.96,1.0,0.15,2,0,1,2,1015,0.0,1.0,0.0,-0.0
PF00930,PF02897:PF07676:PF00326:PF13300:PF03059,13,60,13,0,47,958,0.22,0.95,1.0,0.45,9,6,7,3,1002,0.67,0.99,0.46,0.55
PF04168,PF02281:PF15196:PF03639:PF13701:PF08105,0,12,0,0,12,1006,0.0,0.99,0,0,0,0,0,0,1018,0,1.0,0,0
PF03469,PF16034:PF06294:PF04423:PF09787:PF11831,10,26,4,6,22,986,0.15,0.97,0.4,0.24,0,0,10,0,1008,0,0.99,0.0,0
PF00171,PF00465:PF00696:PF00551:PF02911:PF04768,106,73,47,59,26,886,0.64,0.92,0.44,0.49,7,7,99,0,912,1.0,0.9,0.07,0.24
PF03516,PF12881:PF06671:PF02420:PF06566:PF05716,1,5,0,1,5,1012,0.0,0.99,0.0,-0.0,0,0,1,0,1017,0,1.0,0.0,0
PF10249,PF06342:PF02525:PF03073:PF04190:PF01294,7,17,4,3,13,998,0.24,0.98,0.57,0.36,1,0,7,1,1010,0.0,0.99,0.0,-0.0
PF05983,PF01279:PF00159:PF00446:PF00831:PF08315,11,28,4,7,24,983,0.14,0.97,0.36,0.21,2,1,10,1,1006,0.5,0.99,0.09,0.21
PF08984,PF14850:PF06813:PF04489:PF05784:PF00734,0,47,0,0,47,971,0.0,0.95,0,0,0,0,0,0,1018,0,1.0,0,0
PF04921,PF09496:PF02083:PF03908:PF05837:PF06384,11,21,4,7,17,990,0.19,0.98,0.36,0.25,0,0,11,0,1007,0,0.99,0.0,0
PF07478,PF01820:PF05965:PF11764:PF05033:PF03353,11,42,8,3,34,973,0.19,0.96,0.73,0.36,4,3,8,1,1006,0.75,0.99,0.27,0.45
PF06351,PF01241:PF00537:PF11264:PF00727:PF07333,2,7,0,2,7,1009,0.0,0.99,0.0,-0.0,0,0,2,0,1016,0,1.0,0.0,0
PF03082,PF12767:PF17137:PF04474:PF00586:PF02192,0,27,0,0,27,991,0.0,0.97,0,0,1,0,0,1,1017,0.0,1.0,0,0
PF08348,PF03255:PF11559:PF07540:PF11577:PF10539,0,30,0,0,30,988,0.0,0.97,0,0,2,0,0,2,1016,0.0,1.0,0,0
PF16005,PF00714:PF00537:PF10716:PF00727:PF15109,0,7,0,0,7,1011,0.0,0.99,0,0,0,0,0,0,1018,0,1.0,0,0
PF01220,PF06070:PF06131:PF00555:PF08886:PF17084,3,5,0,3,5,1010,0.0,0.99,0.0,-0.0,0,0,3,0,1015,0,1.0,0.0,0
PF06218,PF06699:PF09422:PF10381:PF03986:PF02961,6,20,4,2,16,996,0.2,0.98,0.67,0.36,4,1,5,3,1009,0.25,0.99,0.17,0.2
PF13691,PF12706:PF07522:PF08640:PF17034:PF08243,15,59,11,4,48,955,0.19,0.95,0.73,0.35,5,2,13,3,1000,0.4,0.98,0.13,0.22
PF13676,PF16095:PF00531:PF01335:PF09034:PF00619,21,58,17,4,41,956,0.29,0.96,0.81,0.47,12,9,12,3,994,0.75,0.99,0.43,0.56
PF00068,PF09777:PF16906:PF05823:PF16053:PF02320,10,32,4,6,28,980,0.12,0.97,0.4,0.21,1,1,9,0,1008,1.0,0.99,0.1,0.31
PF05104,PF12297:PF10481:PF07926:PF16531:PF11577,0,18,0,0,18,1000,0.0,0.98,0,0,0,0,0,0,1018,0,1.0,0,0
PF03370,PF15247:PF02045:PF09756:PF07904:PF05678,6,24,5,1,19,993,0.21,0.98,0.83,0.41,2,1,5,1,1011,0.5,0.99,0.17,0.29
PF04870,PF10179:PF04109:PF16061:PF01079:PF11051,14,33,7,7,26,978,0.21,0.97,0.5,0.31,1,1,13,0,1004,1.0,0.99,0.07,0.27
PF07421,PF10974:PF03944:PF01514:PF05857:PF06890,1,2,0,1,2,1015,0.0,1.0,0.0,-0.0,0,0,1,0,1017,0,1.0,0.0,0
PF07525,PF00710:PF07693:PF12610:PF02864:PF12265,30,26,10,20,16,972,0.38,0.96,0.33,0.34,2,2,28,0,988,1.0,0.97,0.07,0.25
PF13332,PF04232:PF00768:PF04546:PF00345:PF14232,0,16,0,0,16,1002,0.0,0.98,0,0,0,0,0,0,1018,0,1.0,0,0
PF08681,PF01580:PF08708:PF02413:PF09498:PF10566,1,5,0,1,5,1012,0.0,0.99,0.0,-0.0,0,0,1,0,1017,0,1.0,0.0,0
PF02336,PF02277:PF13753:PF12081:PF10951:PF08497,2,3,0,2,3,1013,0.0,1.0,0.0,-0.0,0,0,2,0,1016,0,1.0,0.0,0
PF02254,PF08619:PF16644:PF00999:PF02080:PF11956,13,60,13,0,47,958,0.22,0.95,1.0,0.45,1,1,12,0,1005,1.0,0.99,0.08,0.28
PF15097,PF15085:PF14866:PF15680:PF05836:PF15141,1,2,0,1,2,1015,0.0,1.0,0.0,-0.0,0,0,1,0,1017,0,1.0,0.0,0
PF01167,PF07734:PF10442:PF08268:PF12014:PF07723,12,28,5,7,23,983,0.18,0.97,0.42,0.26,3,3,9,0,1006,1.0,0.99,0.25,0.5
PF15737,PF10407:PF09322:PF15082:PF15392:PF15407,2,3,0,2,3,1013,0.0,1.0,0.0,-0.0,0,0,2,0,1016,0,1.0,0.0,0
PF14312,PF03382:PF03457:PF03160:PF03733:PF16047,2,22,0,2,22,994,0.0,0.98,0.0,-0.01,1,0,2,1,1015,0.0,1.0,0.0,-0.0
PF06290,PF14882:PF06744:PF08708:PF01752:PF11863,0,2,0,0,2,1016,0.0,1.0,0,0,0,0,0,0,1018,0,1.0,0,0
PF01545,PF00474:PF16916:PF00849:PF02517:PF01501,41,98,25,16,73,904,0.26,0.91,0.61,0.36,14,12,29,2,975,0.86,0.97,0.29,0.49
PF11729,PF11561:PF04222:PF10117:PF08936:PF10209,0,2,0,0,2,1016,0.0,1.0,0,0,0,0,0,0,1018,0,1.0,0,0
PF11360,PF08653:PF04359:PF17078:PF05556:PF15553,1,7,1,0,6,1011,0.14,0.99,1.0,0.38,0,0,1,0,1017,0,1.0,0.0,0
PF14388,PF12680:PF01083:PF01670:PF07063:PF04414,13,30,6,7,24,981,0.2,0.97,0.46,0.29,2,2,11,0,1005,1.0,0.99,0.15,0.39
PF04810,PF04815:PF08033:PF04811:PF02209:PF12036,25,39,25,0,14,979,0.64,0.99,1.0,0.79,23,21,4,2,991,0.91,0.99,0.84,0.87
PF01012,PF00766:PF00297:PF12260:PF00283:PF00804,21,50,14,7,36,961,0.28,0.96,0.67,0.41,2,2,19,0,997,1.0,0.98,0.1,0.31
PF08508,PF06485:PF10330:PF06420:PF11489:PF08642,2,7,0,2,7,1009,0.0,0.99,0.0,-0.0,0,0,2,0,1016,0,1.0,0.0,0
PF11551,PF06827:PF02283:PF10076:PF04244:PF06902,3,10,3,0,7,1008,0.3,0.99,1.0,0.55,0,0,3,0,1015,0,1.0,0.0,0
PF12333,PF14959:PF12612:PF13910:PF15979:PF08168,6,23,3,3,20,992,0.13,0.98,0.5,0.25,0,0,6,0,1012,0,0.99,0.0,0
PF09128,PF02196:PF06395:PF13543:PF09036:PF00611,5,36,2,3,34,979,0.06,0.96,0.4,0.14,4,2,3,2,1011,0.5,1.0,0.4,0.44
PF03898,PF08795:PF12843:PF15464:PF08724:PF13366,0,0,0,0,0,1018,0,1.0,0,0,0,0,0,0,1018,0,1.0,0,0
PF14991,PF14659:PF01514:PF04754:PF09498:PF14841,0,3,0,0,3,1015,0.0,1.0,0,0,0,0,0,0,1018,0,1.0,0,0
PF09058,PF10600:PF10608:PF04629:PF09007:PF06456,3,16,1,2,15,1000,0.06,0.98,0.33,0.14,1,1,2,0,1015,1.0,1.0,0.33,0.58
PF05571,PF02792:PF05856:PF14231:PF10166:PF05458,5,18,2,3,16,997,0.11,0.98,0.4,0.2,0,0,5,0,1013,0,1.0,0.0,0
PF09064,PF03954:PF08391:PF09006:PF06023:PF10393,3,4,3,0,1,1014,0.75,1.0,1.0,0.87,0,0,3,0,1015,0,1.0,0.0,0
PF04775,PF08840:PF05076:PF12470:PF08666:PF02670,3,21,2,1,19,996,0.1,0.98,0.67,0.25,3,1,2,2,1013,0.33,1.0,0.33,0.33
PF10385,PF04561:PF06883:PF04560:PF04563:PF00562,4,27,4,0,23,991,0.15,0.98,1.0,0.38,18,4,0,14,1000,0.22,0.99,1.0,0.47
PF05479,PF00321:PF06232:PF01716:PF06376:PF06108,1,12,0,1,12,1005,0.0,0.99,0.0,-0.0,0,0,1,0,1017,0,1.0,0.0,0
PF07470,PF03583:PF09995:PF04140:PF07542:PF11735,19,40,9,10,31,968,0.23,0.96,0.47,0.31,3,2,17,1,998,0.67,0.98,0.11,0.26
PF17034,PF10441:PF15027:PF02368:PF13355:PF07539,6,18,2,4,16,996,0.11,0.98,0.33,0.18,1,1,5,0,1012,1.0,1.0,0.17,0.41
PF00233,PF01590:PF07716:PF08499:PF10507:PF08629,21,59,13,8,46,951,0.22,0.95,0.62,0.35,3,2,19,1,996,0.67,0.98,0.1,0.25
PF00453,PF00499:PF04716:PF10183:PF02284:PF10256,15,38,4,11,34,969,0.11,0.96,0.27,0.15,3,1,14,2,1001,0.33,0.98,0.07,0.14
PF05216,PF06404:PF09778:PF00277:PF07712:PF00272,8,3,0,8,3,1007,0.0,0.99,0.0,-0.0,0,0,8,0,1010,0,0.99,0.0,0
PF14578,PF04760:PF09093:PF08361:PF01313:PF10634,1,11,1,0,10,1007,0.09,0.99,1.0,0.3,0,0,1,0,1017,0,1.0,0.0,0
PF08603,PF01213:PF01288:PF00809:PF16711:PF02607,10,25,9,1,16,992,0.36,0.98,0.9,0.56,3,2,8,1,1007,0.67,0.99,0.2,0.36
PF06910,PF15809:PF10737:PF15104:PF13013:PF04370,1,1,1,0,0,1017,1.0,1.0,1.0,1.0,0,0,1,0,1017,0,1.0,0.0,0
PF09773,PF00076:PF06495:PF08050:PF13865:PF15861,9,246,8,1,238,771,0.03,0.77,0.89,0.14,1,1,8,0,1009,1.0,0.99,0.11,0.33
PF07231,PF07014:PF05594:PF14920:PF03979:PF02526,0,6,0,0,6,1012,0.0,0.99,0,0,0,0,0,0,1018,0,1.0,0,0
PF15651,PF14858:PF10650:PF15739:PF16574:PF04423,0,12,0,0,12,1006,0.0,0.99,0,0,1,0,0,1,1017,0.0,1.0,0,0
PF04529,PF05979:PF12968:PF01623:PF07301:PF04340,1,5,1,0,4,1013,0.2,1.0,1.0,0.45,0,0,1,0,1017,0,1.0,0.0,0
PF04410,PF03045:PF08265:PF03162:PF01871:PF04831,24,23,8,16,15,979,0.35,0.97,0.33,0.32,3,2,22,1,993,0.67,0.98,0.08,0.23
PF09394,PF08857:PF08843:PF10868:PF12201:PF15664,0,0,0,0,0,1018,0,1.0,0,0,0,0,0,0,1018,0,1.0,0,0
PF03049,PF05375:PF04204:PF16164:PF00094:PF08742,0,39,0,0,39,979,0.0,0.96,0,0,5,0,0,5,1013,0.0,1.0,0,0
PF06589,PF16979:PF00986:PF09130:PF00594:PF17042,0,36,0,0,36,982,0.0,0.96,0,0,0,0,0,0,1018,0,1.0,0,0
PF08742,PF00094:PF12714:PF01826:PF09206:PF05270,29,51,28,1,23,966,0.55,0.98,0.97,0.72,15,15,14,0,989,1.0,0.99,0.52,0.71
PF01704,PF01652:PF09439:PF00119:PF00210:PF02284,27,46,11,16,35,956,0.24,0.95,0.41,0.29,3,3,24,0,991,1.0,0.98,0.11,0.33
PF04005,PF08423:PF07847:PF03932:PF05742:PF06189,11,54,3,8,51,956,0.06,0.94,0.27,0.1,5,2,9,3,1004,0.4,0.99,0.18,0.26
PF06054,PF03846:PF03708:PF14684:PF16834:PF10608,0,4,0,0,4,1014,0.0,1.0,0,0,0,0,0,0,1018,0,1.0,0,0
PF02797,PF00195:PF01333:PF07632:PF03951:PF00306,20,42,19,1,23,975,0.45,0.98,0.95,0.65,0,0,20,0,998,0,0.98,0.0,0
PF00775,PF13391:PF08588:PF02537:PF10356:PF13339,19,31,5,14,26,973,0.16,0.96,0.26,0.19,2,1,18,1,998,0.5,0.98,0.05,0.16
PF13577,PF00296:PF05176:PF11991:PF03972:PF06609,7,31,6,1,25,986,0.19,0.97,0.86,0.4,3,1,6,2,1009,0.33,0.99,0.14,0.21
PF00334,PF05186:PF06565:PF01956:PF02996:PF15928,24,51,10,14,41,953,0.2,0.95,0.42,0.26,4,3,21,1,993,0.75,0.98,0.12,0.3
PF09649,PF13836:PF02200:PF10384:PF15997:PF09047,2,7,0,2,7,1009,0.0,0.99,0.0,-0.0,0,0,2,0,1016,0,1.0,0.0,0
PF07273,PF08783:PF04062:PF13696:PF17180:PF10796,0,18,0,0,18,1000,0.0,0.98,0,0,3,0,0,3,1015,0.0,1.0,0,0
PF07411,PF03090:PF08299:PF12081:PF06798:PF14882,0,2,0,0,2,1016,0.0,1.0,0,0,0,0,0,0,1018,0,1.0,0,0
PF06668,PF08473:PF13757:PF08487:PF02743:PF13768,3,32,3,0,29,986,0.09,0.97,1.0,0.3,5,1,2,4,1011,0.2,0.99,0.33,0.26
PF03125,PF10317:PF10319:PF10318:PF10323:PF02118,8,28,4,4,24,986,0.14,0.97,0.5,0.26,2,0,8,2,1008,0.0,0.99,0.0,-0.0
PF10488,PF10472:PF14047:PF14049:PF11232:PF15805,1,4,0,1,4,1013,0.0,1.0,0.0,-0.0,0,0,1,0,1017,0,1.0,0.0,0
PF10497,PF02375:PF02928:PF08879:PF08429:PF08880,11,26,3,8,23,984,0.12,0.97,0.27,0.16,11,3,8,8,999,0.27,0.98,0.27,0.26
PF08365,PF00049:PF16276:PF09303:PF06540:PF10806,1,14,1,0,13,1004,0.07,0.99,1.0,0.27,0,0,1,0,1017,0,1.0,0.0,0
PF05725,PF00526:PF06151:PF17210:PF03089:PF05092,21,11,2,19,9,988,0.18,0.97,0.1,0.12,0,0,21,0,997,0,0.98,0.0,0
PF00437,PF09079:PF01272:PF05491:PF00482:PF09263,16,24,5,11,19,983,0.21,0.97,0.31,0.24,2,2,14,0,1002,1.0,0.99,0.12,0.35
PF05209,PF07499:PF06864:PF04610:PF03135:PF10618,4,6,1,3,5,1009,0.17,0.99,0.25,0.2,1,1,3,0,1014,1.0,1.0,0.25,0.5
PF07989,PF03801:PF16830:PF04423:PF16531:PF12455,13,19,2,11,17,988,0.11,0.97,0.15,0.11,2,1,12,1,1004,0.5,0.99,0.08,0.19
PF03587,PF05915:PF09768:PF04716:PF14935:PF01470,8,31,5,3,26,984,0.16,0.97,0.62,0.31,2,1,7,1,1009,0.5,0.99,0.12,0.25
PF08171,PF14465:PF15624:PF09462:PF08144:PF05715,2,12,1,1,11,1005,0.08,0.99,0.5,0.2,0,0,2,0,1016,0,1.0,0.0,0
PF03386,PF06825:PF05512:PF01176:PF13741:PF07911,0,18,0,0,18,1000,0.0,0.98,0,0,1,0,0,1,1017,0.0,1.0,0,0
PF10806,PF00816:PF08310:PF13876:PF15751:PF03123,2,6,0,2,6,1010,0.0,0.99,0.0,-0.0,0,0,2,0,1016,0,1.0,0.0,0
PF10095,PF08251:PF02933:PF15191:PF01413:PF12661,0,53,0,0,53,965,0.0,0.95,0,0,2,0,0,2,1016,0.0,1.0,0,0
PF07882,PF02952:PF07881:PF05974:PF11751:PF07195,1,1,1,0,0,1017,1.0,1.0,1.0,1.0,0,0,1,0,1017,0,1.0,0.0,0
PF01980,PF04706:PF12240:PF13870:PF12180:PF12483,1,13,1,0,12,1005,0.08,0.99,1.0,0.28,0,0,1,0,1017,0,1.0,0.0,0
PF05953,PF04120:PF08369:PF04179:PF06882:PF09363,1,7,0,1,7,1010,0.0,0.99,0.0,-0.0,0,0,1,0,1017,0,1.0,0.0,0
PF01914,PF13995:PF06798:PF03729:PF12080:PF11863,0,0,0,0,0,1018,0,1.0,0,0,0,0,0,0,1018,0,1.0,0,0
PF11741,PF04351:PF04350:PF04466:PF08808:PF10109,0,0,0,0,0,1018,0,1.0,0,0,0,0,0,0,1018,0,1.0,0,0
PF14027,PF11807:PF07350:PF04199:PF12296:PF12311,16,31,10,6,21,981,0.32,0.97,0.62,0.44,4,2,14,2,1000,0.5,0.98,0.12,0.24
PF00046,PF12403:PF02376:PF12045:PF00157:PF16557,95,13,13,82,0,923,1.0,0.92,0.14,0.35,2,2,93,0,923,1.0,0.91,0.02,0.14
PF12263,PF00127:PF12046:PF11016:PF02427:PF06695,1,3,0,1,3,1014,0.0,1.0,0.0,-0.0,0,0,1,0,1017,0,1.0,0.0,0
PF01233,PF02799:PF12470:PF05076:PF14784:PF06239,14,19,14,0,5,999,0.74,1.0,1.0,0.86,3,3,11,0,1004,1.0,0.99,0.21,0.46
PF02259,PF02260:PF08163:PF08064:PF00454:PF11640,29,69,26,3,43,946,0.38,0.95,0.9,0.56,10,10,19,0,989,1.0,0.98,0.34,0.58
PF01061,PF06472:PF14510:PF01851:PF08216:PF00037,54,48,27,27,21,943,0.56,0.95,0.5,0.51,3,3,51,0,964,1.0,0.95,0.06,0.23
PF02657,PF00358:PF07361:PF09863:PF03979:PF02378,3,21,0,3,21,994,0.0,0.98,0.0,-0.01,1,0,3,1,1014,0.0,1.0,0.0,-0.0
PF08709,PF01365:PF02026:PF15012:PF08454:PF02366,12,28,10,2,18,988,0.36,0.98,0.83,0.54,5,5,7,0,1006,1.0,0.99,0.42,0.64
PF07963,PF00482:PF02501:PF03934:PF08461:PF00816,2,3,2,0,1,1015,0.67,1.0,1.0,0.82,1,1,1,0,1016,1.0,1.0,0.5,0.71
PF02887,PF00224:PF02727:PF01179:PF02728:PF01799,26,65,26,0,39,953,0.4,0.96,1.0,0.62,16,8,18,8,984,0.5,0.97,0.31,0.38
PF16655,PF09423:PF14831:PF09029:PF05388:PF14695,3,21,3,0,18,997,0.14,0.98,1.0,0.37,0,0,3,0,1015,0,1.0,0.0,0
PF03924,PF00486:PF06580:PF00672:PF00196:PF04397,8,26,5,3,21,989,0.19,0.98,0.62,0.34,7,2,6,5,1005,0.29,0.99,0.25,0.26
PF06227,PF15775:PF01514:PF04355:PF13482:PF15856,0,2,0,0,2,1016,0.0,1.0,0,0,0,0,0,0,1018,0,1.0,0,0
PF07986,PF05334:PF12253:PF06584:PF06221:PF04087,16,17,3,13,14,988,0.18,0.97,0.19,0.17,1,1,15,0,1002,1.0,0.99,0.06,0.25
PF05758,PF10350:PF16327:PF10493:PF10487:PF03190,3,27,1,2,26,989,0.04,0.97,0.33,0.1,1,0,3,1,1014,0.0,1.0,0.0,-0.0
PF12794,PF05065:PF15400:PF00524:PF09834:PF06887,2,5,0,2,5,1011,0.0,0.99,0.0,-0.0,0,0,2,0,1016,0,1.0,0.0,0
PF16763,PF11260:PF14494:PF06756:PF00877:PF06347,0,7,0,0,7,1011,0.0,0.99,0,0,0,0,0,0,1018,0,1.0,0,0
PF17122,PF12451:PF12816:PF00637:PF10367:PF10366,6,39,6,0,33,979,0.15,0.97,1.0,0.39,9,6,0,3,1009,0.67,1.0,1.0,0.82
PF06985,PF01048:PF01328:PF14420:PF11374:PF07819,67,55,30,37,25,926,0.55,0.94,0.45,0.46,8,8,59,0,951,1.0,0.94,0.12,0.34
PF03665,PF15872:PF07956:PF15302:PF15252:PF01387,5,7,2,3,5,1008,0.29,0.99,0.4,0.33,0,0,5,0,1013,0,1.0,0.0,0
PF15806,PF16027:PF07051:PF07260:PF15242:PF02186,1,17,0,1,17,1000,0.0,0.98,0.0,-0.0,0,0,1,0,1017,0,1.0,0.0,0
PF04103,PF13908:PF10185:PF09783:PF00446:PF01099,8,23,4,4,19,991,0.17,0.98,0.5,0.29,0,0,8,0,1010,0,0.99,0.0,0
PF15076,PF15107:PF09690:PF01638:PF02025:PF06876,0,3,0,0,3,1015,0.0,1.0,0,0,0,0,0,0,1018,0,1.0,0,0
PF00408,PF02878:PF02880:PF02879:PF00689:PF08722,28,88,28,0,60,930,0.32,0.94,1.0,0.55,34,23,5,11,979,0.68,0.98,0.82,0.74
PF05908,PF15052:PF15355:PF08093:PF15482:PF03974,0,5,0,0,5,1013,0.0,1.0,0,0,0,0,0,0,1018,0,1.0,0,0
PF15835,PF00034:PF07062:PF10477:PF02312:PF05770,0,33,0,0,33,985,0.0,0.97,0,0,0,0,0,0,1018,0,1.0,0,0
PF11722,PF05206:PF05253:PF02971:PF03648:PF07837,9,25,7,2,18,991,0.28,0.98,0.78,0.46,2,0,9,2,1007,0.0,0.99,0.0,-0.0
PF12661,PF00008:PF01049:PF00683:PF01463:PF12662,41,86,40,1,46,931,0.47,0.95,0.98,0.66,7,7,34,0,977,1.0,0.97,0.17,0.41
PF06798,PF07499:PF03241:PF02572:PF07157:PF13722,0,3,0,0,3,1015,0.0,1.0,0,0,0,0,0,0,1018,0,1.0,0,0
PF03583,PF13092:PF10252:PF07542:PF11735:PF13225,1,28,0,1,28,989,0.0,0.97,0.0,-0.01,1,0,1,1,1016,0.0,1.0,0.0,-0.0
PF03932,PF06172:PF15008:PF12020:PF02284:PF08584,21,9,1,20,8,989,0.11,0.97,0.05,0.06,0,0,21,0,997,0,0.98,0.0,0
PF10257,PF14611:PF05041:PF11977:PF15996:PF11331,11,23,3,8,20,987,0.13,0.97,0.27,0.18,3,1,10,2,1005,0.33,0.99,0.09,0.17
PF16353,PF02929:PF02837:PF02836:PF16355:PF00703,5,31,5,0,26,987,0.16,0.97,1.0,0.4,14,5,0,9,1004,0.36,0.99,1.0,0.59
PF00955,PF07565:PF00359:PF02735:PF03092:PF03731,20,37,10,10,27,971,0.27,0.96,0.5,0.35,1,1,19,0,998,1.0,0.98,0.05,0.22
PF08150,PF16165:PF08165:PF08151:PF15625:PF10540,6,18,6,0,12,1000,0.33,0.99,1.0,0.57,2,2,4,0,1012,1.0,1.0,0.33,0.58
PF15913,PF01483:PF14843:PF16470:PF08686:PF12583,8,32,8,0,24,986,0.25,0.98,1.0,0.49,7,6,2,1,1009,0.86,1.0,0.75,0.8
PF00881,PF00902:PF13237:PF01470:PF07856:PF04667,14,33,5,9,28,976,0.15,0.96,0.36,0.22,0,0,14,0,1004,0,0.99,0.0,0
PF16888,PF04740:PF13780:PF15150:PF14842:PF03241,0,0,0,0,0,1018,0,1.0,0,0,0,0,0,0,1018,0,1.0,0,0
PF10785,PF12853:PF07950:PF13241:PF11937:PF08523,4,23,3,1,20,994,0.13,0.98,0.75,0.31,1,0,4,1,1013,0.0,1.0,0.0,-0.0
PF05634,PF14365:PF14577:PF14576:PF12590:PF01113,8,12,0,8,12,998,0.0,0.98,0.0,-0.01,0,0,8,0,1010,0,0.99,0.0,0
PF13237,PF00499:PF00507:PF13187:PF00430:PF00124,8,22,8,0,14,996,0.36,0.99,1.0,0.6,1,1,7,0,1010,1.0,0.99,0.12,0.35
PF14796,PF09066:PF14797:PF06375:PF07718:PF14807,6,13,4,2,9,1003,0.31,0.99,0.67,0.45,2,1,5,1,1011,0.5,0.99,0.17,0.29
PF13182,PF15182:PF13753:PF03324:PF05299:PF01155,0,2,0,0,2,1016,0.0,1.0,0,0,0,0,0,0,1018,0,1.0,0,0
PF02040,PF13945:PF15624:PF00649:PF15678:PF07001,9,15,4,5,11,998,0.27,0.98,0.44,0.34,0,0,9,0,1009,0,0.99,0.0,0
PF08315,PF01279:PF00159:PF05676:PF02044:PF00831,16,18,4,12,14,988,0.22,0.97,0.25,0.22,1,1,15,0,1002,1.0,0.99,0.06,0.25
PF05719,PF14778:PF07096:PF14954:PF14943:PF12020,5,19,2,3,17,996,0.11,0.98,0.4,0.2,1,0,5,1,1012,0.0,0.99,0.0,-0.0
PF08621,PF12830:PF15275:PF10363:PF07535:PF04576,5,28,1,4,27,986,0.04,0.97,0.2,0.07,1,1,4,0,1013,1.0,1.0,0.2,0.45
PF15509,PF05177:PF14926:PF11699:PF15499:PF06566,2,14,2,0,12,1004,0.14,0.99,1.0,0.38,1,0,2,1,1015,0.0,1.0,0.0,-0.0
PF00012,PF10712:PF06723:PF10268:PF09794:PF14895,69,20,12,57,8,941,0.6,0.94,0.17,0.3,3,3,66,0,949,1.0,0.94,0.04,0.2
PF10787,PF15826:PF14258:PF15089:PF12856:PF07243,0,1,0,0,1,1017,0.0,1.0,0,0,0,0,0,0,1018,0,1.0,0,0
PF02679,PF10703:PF02160:PF13326:PF05869:PF07075,5,9,3,2,6,1007,0.33,0.99,0.6,0.44,0,0,5,0,1013,0,1.0,0.0,0
PF05534,PF02329:PF04506:PF07402:PF02313:PF12398,0,13,0,0,13,1005,0.0,0.99,0,0,0,0,0,0,1018,0,1.0,0,0
PF14497,PF00043:PF04399:PF13409:PF13417:PF02798,37,92,31,6,61,920,0.34,0.93,0.84,0.51,17,13,24,4,977,0.76,0.97,0.35,0.51
PF05229,PF03241:PF11751:PF14842:PF00915:PF16888,0,1,0,0,1,1017,0.0,1.0,0,0,0,0,0,0,1018,0,1.0,0,0
PF04324,PF13806:PF14721:PF16020:PF14691:PF04224,9,27,8,1,19,990,0.3,0.98,0.89,0.51,1,1,8,0,1009,1.0,0.99,0.11,0.33
PF14023,PF05556:PF10995:PF11019:PF06744:PF12834,3,5,1,2,4,1011,0.2,0.99,0.33,0.26,0,0,3,0,1015,0,1.0,0.0,0
PF12540,PF07545:PF10332:PF15797:PF15389:PF12898,1,6,0,1,6,1011,0.0,0.99,0.0,-0.0,0,0,1,0,1017,0,1.0,0.0,0
PF09166,PF08635:PF02894:PF01041:PF09290:PF02774,3,40,2,1,38,977,0.05,0.96,0.67,0.18,3,1,2,2,1013,0.33,1.0,0.33,0.33
PF03261,PF14735:PF05428:PF11703:PF03821:PF04452,4,7,1,3,6,1008,0.14,0.99,0.25,0.18,0,0,4,0,1014,0,1.0,0.0,0
PF09837,PF04138:PF09776:PF10044:PF15048:PF04314,1,3,0,1,3,1014,0.0,1.0,0.0,-0.0,0,0,1,0,1017,0,1.0,0.0,0
PF01017,PF02865:PF02864:PF14596:PF15148:PF12188,2,6,2,0,4,1012,0.33,1.0,1.0,0.58,1,1,1,0,1016,1.0,1.0,0.5,0.71
PF10444,PF10512:PF15805:PF10488:PF15803:PF10234,6,5,0,6,5,1007,0.0,0.99,0.0,-0.01,0,0,6,0,1012,0,0.99,0.0,0
PF10744,PF10264:PF08729:PF04802:PF12509:PF13945,2,17,1,1,16,1000,0.06,0.98,0.5,0.17,1,1,1,0,1016,1.0,1.0,0.5,0.71
PF04156,PF12362:PF06181:PF08093:PF13340:PF04471,0,7,0,0,7,1011,0.0,0.99,0,0,0,0,0,0,1018,0,1.0,0,0
PF12479,PF06805:PF05939:PF04965:PF01580:PF04451,0,6,0,0,6,1012,0.0,0.99,0,0,0,0,0,0,1018,0,1.0,0,0
PF04667,PF01987:PF09769:PF01470:PF00159:PF04716,5,28,1,4,27,986,0.04,0.97,0.2,0.07,2,0,5,2,1011,0.0,0.99,0.0,-0.0
PF11883,PF12398:PF01453:PF08917:PF08276:PF14786,5,43,5,0,38,975,0.12,0.96,1.0,0.33,4,4,1,0,1013,1.0,1.0,0.8,0.89
PF00636,PF14622:PF03368:PF00035:PF02170:PF04851,22,103,20,2,83,913,0.19,0.92,0.91,0.4,16,14,8,2,994,0.88,0.99,0.64,0.74
PF12156,PF09040:PF02130:PF12515:PF12409:PF02348,2,25,2,0,23,993,0.08,0.98,1.0,0.28,5,2,0,3,1013,0.4,1.0,1.0,0.63
PF06237,PF07786:PF16401:PF04515:PF03074:PF10022,3,24,0,3,24,991,0.0,0.97,0.0,-0.01,1,0,3,1,1014,0.0,1.0,0.0,-0.0
PF01085,PF01079:PF04424:PF12470:PF06535:PF05076,8,26,7,1,19,991,0.27,0.98,0.88,0.48,3,1,7,2,1008,0.33,0.99,0.12,0.2
PF00264,PF12142:PF12143:PF04577:PF13679:PF01529,38,77,20,18,57,923,0.26,0.93,0.53,0.34,8,6,32,2,978,0.75,0.97,0.16,0.33
PF01248,PF07896:PF06093:PF04505:PF06083:PF07722,35,23,10,25,13,970,0.43,0.96,0.29,0.33,2,2,33,0,983,1.0,0.97,0.06,0.24
PF09479,PF01436:PF08239:PF12126:PF03712:PF00643,1,74,1,0,73,944,0.01,0.93,1.0,0.11,11,1,0,10,1007,0.09,0.99,1.0,0.3
PF08011,PF01136:PF09829:PF08411:PF11638:PF05939,0,4,0,0,4,1014,0.0,1.0,0,0,0,0,0,0,1018,0,1.0,0,0
PF15433,PF06783:PF00995:PF05050:PF08498:PF13532,10,72,7,3,65,943,0.1,0.93,0.7,0.24,10,4,6,6,1002,0.4,0.99,0.4,0.39
PF14056,PF00519:PF04911:PF05083:PF06651:PF05838,0,6,0,0,6,1012,0.0,0.99,0,0,0,0,0,0,1018,0,1.0,0,0
PF07034,PF14779:PF02219:PF14764:PF06584:PF14441,5,21,3,2,18,995,0.14,0.98,0.6,0.29,1,0,5,1,1012,0.0,0.99,0.0,-0.0
PF03466,PF00184:PF00220:PF00126:PF07846:PF08657,9,11,6,3,5,1004,0.55,0.99,0.67,0.6,0,0,9,0,1009,0,0.99,0.0,0
PF12538,PF06724:PF08707:PF09108:PF06356:PF05939,0,1,0,0,1,1017,0.0,1.0,0,0,0,0,0,0,1018,0,1.0,0,0
PF03170,PF07243:PF13094:PF15333:PF07192:PF01948,1,1,0,1,1,1016,0.0,1.0,0.0,-0.0,0,0,1,0,1017,0,1.0,0.0,0
PF02825,PF12174:PF00644:PF06012:PF02877:PF05406,26,54,16,10,38,954,0.3,0.95,0.62,0.41,18,8,18,10,982,0.44,0.97,0.31,0.36
PF00143,PF12020:PF00965:PF02284:PF00499:PF00159,1,15,0,1,15,1002,0.0,0.98,0.0,-0.0,0,0,1,0,1017,0,1.0,0.0,0
PF03359,PF15279:PF04087:PF14909:PF04109:PF15996,9,18,3,6,15,994,0.17,0.98,0.33,0.23,1,0,9,1,1008,0.0,0.99,0.0,-0.0
PF09786,PF10574:PF12016:PF00928:PF01217:PF09174,7,56,4,3,52,959,0.07,0.95,0.57,0.19,2,1,6,1,1010,0.5,0.99,0.14,0.26
PF09459,PF12046:PF10716:PF07544:PF10868:PF06581,1,7,0,1,7,1010,0.0,0.99,0.0,-0.0,0,0,1,0,1017,0,1.0,0.0,0
PF00040,PF00039:PF00878:PF09396:PF16030:PF00553,20,13,6,14,7,991,0.46,0.98,0.3,0.36,3,3,17,0,998,1.0,0.98,0.15,0.38
PF13946,PF08548:PF05857:PF13588:PF04451:PF03241,1,4,1,0,3,1014,0.25,1.0,1.0,0.5,0,0,1,0,1017,0,1.0,0.0,0
PF08352,PF08402:PF12399:PF13732:PF09383:PF01032,4,15,2,2,13,1001,0.13,0.99,0.5,0.25,4,2,2,2,1012,0.5,1.0,0.5,0.5
PF10693,PF06954:PF12046:PF16851:PF02977:PF06876,0,1,0,0,1,1017,0.0,1.0,0,0,0,0,0,0,1018,0,1.0,0,0
PF00746,PF10856:PF02226:PF08361:PF02074:PF12264,0,14,0,0,14,1004,0.0,0.99,0,0,0,0,0,0,1018,0,1.0,0,0
PF10580,PF06614:PF13178:PF15157:PF16735:PF00612,1,64,1,0,63,954,0.02,0.94,1.0,0.12,2,1,0,1,1016,0.5,1.0,1.0,0.71
PF12772,PF09067:PF12453:PF16066:PF12567:PF06328,1,6,1,0,5,1012,0.17,1.0,1.0,0.41,1,1,0,0,1017,1.0,1.0,1.0,1.0
PF06101,PF12624:PF06650:PF16910:PF16908:PF16909,13,37,4,9,33,972,0.11,0.96,0.31,0.16,18,2,11,16,989,0.11,0.97,0.15,0.12
PF11945,PF04004:PF15369:PF09755:PF07260:PF10188,6,13,1,5,12,1000,0.08,0.98,0.17,0.11,1,0,6,1,1011,0.0,0.99,0.0,-0.0
PF00459,PF12311:PF00810:PF10185:PF13088:PF03650,27,34,11,16,23,968,0.32,0.96,0.41,0.34,2,2,25,0,991,1.0,0.98,0.07,0.27
PF00748,PF08526:PF08527:PF03068:PF01773:PF07670,2,22,1,1,21,995,0.05,0.98,0.5,0.15,4,0,2,4,1012,0.0,0.99,0.0,-0.0
PF01137,PF05189:PF03972:PF05995:PF01198:PF02098,11,40,8,3,32,975,0.2,0.97,0.73,0.37,3,3,8,0,1007,1.0,0.99,0.27,0.52
PF08703,PF03490:PF15303:PF08101:PF05203:PF10482,4,10,1,3,9,1005,0.1,0.99,0.25,0.15,0,0,4,0,1014,0,1.0,0.0,0
PF00178,PF11620:PF02198:PF04621:PF00870:PF04928,30,34,17,13,17,971,0.5,0.97,0.57,0.52,3,3,27,0,988,1.0,0.97,0.1,0.31
PF07538,PF17164:PF05065:PF01051:PF02554:PF13005,0,2,0,0,2,1016,0.0,1.0,0,0,0,0,0,0,1018,0,1.0,0,0
PF00292,PF16719:PF00157:PF03826:PF02376:PF16534,9,20,6,3,14,995,0.3,0.98,0.67,0.44,3,2,7,1,1008,0.67,0.99,0.22,0.38
PF16556,PF16742:PF15037:PF07923:PF08357:PF05422,1,15,1,0,14,1003,0.07,0.99,1.0,0.26,0,0,1,0,1017,0,1.0,0.0,0
PF00310,PF04898:PF01645:PF14691:PF01493:PF01180,12,29,8,4,21,985,0.28,0.98,0.67,0.42,6,6,6,0,1006,1.0,0.99,0.5,0.71
PF03237,PF13103:PF07338:PF05733:PF15175:PF09109,1,9,1,0,8,1009,0.11,0.99,1.0,0.33,0,0,1,0,1017,0,1.0,0.0,0
PF08293,PF09996:PF17062:PF06907:PF05355:PF00770,6,6,0,6,6,1006,0.0,0.99,0.0,-0.01,0,0,6,0,1012,0,0.99,0.0,0
PF04868,PF13247:PF05167:PF17206:PF02211:PF01706,2,6,0,2,6,1010,0.0,0.99,0.0,-0.0,0,0,2,0,1016,0,1.0,0.0,0
PF09305,PF15397:PF15110:PF07392:PF03775:PF06458,0,7,0,0,7,1011,0.0,0.99,0,0,0,0,0,0,1018,0,1.0,0,0
PF04510,PF08124:PF07171:PF02092:PF10290:PF02091,1,15,1,0,14,1003,0.07,0.99,1.0,0.26,2,1,0,1,1016,0.5,1.0,1.0,0.71
PF01935,PF08886:PF06744:PF06864:PF01580:PF05509,0,5,0,0,5,1013,0.0,1.0,0,0,0,0,0,0,1018,0,1.0,0,0
PF07736,PF08364:PF06282:PF11987:PF14492:PF08513,0,63,0,0,63,955,0.0,0.94,0,0,8,0,0,8,1010,0.0,0.99,0,0
PF06219,PF03214:PF05238:PF15722:PF01114:PF02482,2,6,0,2,6,1010,0.0,0.99,0.0,-0.0,0,0,2,0,1016,0,1.0,0.0,0
PF05661,PF13994:PF06476:PF00314:PF05525:PF02298,0,33,0,0,33,985,0.0,0.97,0,0,0,0,0,0,1018,0,1.0,0,0
PF06026,PF05915:PF06376:PF07896:PF07816:PF03208,6,13,1,5,12,1000,0.08,0.98,0.17,0.11,1,0,6,1,1011,0.0,0.99,0.0,-0.0
PF07292,PF07334:PF04921:PF14766:PF03285:PF06384,2,16,2,0,14,1002,0.12,0.99,1.0,0.35,0,0,2,0,1016,0,1.0,0.0,0
PF15222,PF12226:PF11678:PF02899:PF01575:PF01361,0,40,0,0,40,978,0.0,0.96,0,0,0,0,0,0,1018,0,1.0,0,0
PF00627,PF08585:PF02149:PF06025:PF00789:PF10154,51,44,16,35,28,939,0.36,0.94,0.31,0.31,5,5,46,0,967,1.0,0.95,0.1,0.31
PF01368,PF02833:PF07971:PF03074:PF12735:PF09848,21,35,11,10,24,973,0.31,0.97,0.52,0.39,2,2,19,0,997,1.0,0.98,0.1,0.31
PF04057,PF16900:PF08646:PF01336:PF09170:PF02721,11,61,10,1,51,956,0.16,0.95,0.91,0.37,13,8,3,5,1002,0.62,0.99,0.73,0.67
PF12029,PF07999:PF02559:PF07077:PF15110:PF11093,2,7,2,0,5,1011,0.29,1.0,1.0,0.53,2,2,0,0,1016,1.0,1.0,1.0,1.0
PF13816,PF01385:PF15546:PF02306:PF10057:PF00555,1,4,0,1,4,1013,0.0,1.0,0.0,-0.0,0,0,1,0,1017,0,1.0,0.0,0
PF16699,PF04158:PF12265:PF08154:PF14077:PF08145,4,24,3,1,21,993,0.12,0.98,0.75,0.3,1,1,3,0,1014,1.0,1.0,0.25,0.5
PF15797,PF10104:PF15045:PF07051:PF02576:PF02116,4,10,1,3,9,1005,0.1,0.99,0.25,0.15,0,0,4,0,1014,0,1.0,0.0,0
PF11154,PF15826:PF09614:PF04234:PF03925:PF16824,2,2,0,2,2,1014,0.0,1.0,0.0,-0.0,0,0,2,0,1016,0,1.0,0.0,0
PF02816,PF16519:PF08729:PF12231:PF01594:PF12348,10,24,7,3,17,991,0.29,0.98,0.7,0.44,2,2,8,0,1008,1.0,0.99,0.2,0.45
PF02927,PF00942:PF09478:PF00553:PF02381:PF06674,2,15,1,1,14,1002,0.07,0.99,0.5,0.18,1,1,1,0,1016,1.0,1.0,0.5,0.71
PF13566,PF08886:PF08345:PF08186:PF06505:PF09397,1,6,0,1,6,1011,0.0,0.99,0.0,-0.0,0,0,1,0,1017,0,1.0,0.0,0
PF04250,PF12054:PF08873:PF10339:PF08658:PF10101,0,18,0,0,18,1000,0.0,0.98,0,0,0,0,0,0,1018,0,1.0,0,0
PF08251,PF07560:PF10095:PF14642:PF16676:PF16979,0,18,0,0,18,1000,0.0,0.98,0,0,0,0,0,0,1018,0,1.0,0,0
PF00260,PF08515:PF12447:PF07105:PF00652:PF08437,1,54,0,1,54,963,0.0,0.95,0.0,-0.01,0,0,1,0,1017,0,1.0,0.0,0
PF06303,PF02020:PF17146:PF01343:PF16321:PF05958,1,54,1,0,53,964,0.02,0.95,1.0,0.13,5,0,1,5,1012,0.0,0.99,0.0,-0.0
PF03302,PF09132:PF04385:PF02057:PF02420:PF10578,4,4,0,4,4,1010,0.0,0.99,0.0,-0.0,0,0,4,0,1014,0,1.0,0.0,0
PF08398,PF15085:PF13013:PF15680:PF07327:PF15097,1,5,0,1,5,1012,0.0,0.99,0.0,-0.0,0,0,1,0,1017,0,1.0,0.0,0
PF12678,PF12861:PF17175:PF09745:PF13886:PF10505,17,44,5,12,39,962,0.11,0.95,0.29,0.16,4,3,14,1,1000,0.75,0.99,0.18,0.36
PF00615,PF00610:PF00433:PF08833:PF02194:PF08628,59,73,33,26,40,919,0.45,0.94,0.56,0.47,7,7,52,0,959,1.0,0.95,0.12,0.34
PF14984,PF15129:PF15138:PF07400:PF11630:PF15211,0,2,0,0,2,1016,0.0,1.0,0,0,0,0,0,0,1018,0,1.0,0,0
PF06807,PF16573:PF16575:PF08622:PF02670:PF09328,10,31,10,0,21,987,0.32,0.98,1.0,0.56,2,2,8,0,1008,1.0,0.99,0.2,0.45
PF11604,PF11019:PF13742:PF04349:PF08453:PF02217,0,7,0,0,7,1011,0.0,0.99,0,0,0,0,0,0,1018,0,1.0,0,0
PF14361,PF02070:PF11124:PF13742:PF04222:PF00555,2,4,0,2,4,1012,0.0,0.99,0.0,-0.0,0,0,2,0,1016,0,1.0,0.0,0
PF02056,PF11975:PF15272:PF02501:PF08411:PF07411,8,11,8,0,3,1007,0.73,1.0,1.0,0.85,0,0,8,0,1010,0,0.99,0.0,0
PF15072,PF16002:PF15353:PF15045:PF15797:PF11669,7,13,2,5,11,1000,0.15,0.98,0.29,0.2,1,0,7,1,1010,0.0,0.99,0.0,-0.0
PF01842,PF00351:PF10369:PF12549:PF10637:PF00389,23,70,16,7,54,941,0.23,0.94,0.7,0.38,4,3,20,1,994,0.75,0.98,0.13,0.31
PF11911,PF09340:PF14610:PF07052:PF10248:PF11282,3,21,2,1,19,996,0.1,0.98,0.67,0.25,0,0,3,0,1015,0,1.0,0.0,0
PF02093,PF00607:PF01140:PF01141:PF02337:PF14893,5,14,4,1,10,1003,0.29,0.99,0.8,0.47,4,4,1,0,1013,1.0,1.0,0.8,0.89
PF09462,PF10407:PF15082:PF15407:PF12178:PF05762,2,9,1,1,8,1008,0.11,0.99,0.5,0.23,0,0,2,0,1016,0,1.0,0.0,0
PF12849,PF13458:PF07701:PF08376:PF00211:PF01094,11,92,8,3,84,923,0.09,0.91,0.73,0.23,10,4,7,6,1001,0.4,0.99,0.36,0.37
PF06042,PF06681:PF05962:PF09962:PF02979:PF14539,1,5,0,1,5,1012,0.0,0.99,0.0,-0.0,0,0,1,0,1017,0,1.0,0.0,0
PF10457,PF07059:PF08923:PF03061:PF04812:PF09724,7,39,4,3,35,976,0.1,0.96,0.57,0.23,6,3,4,3,1008,0.5,0.99,0.43,0.46
PF05600,PF12139:PF14817:PF06449:PF15239:PF02419,9,9,2,7,7,1002,0.22,0.99,0.22,0.22,0,0,9,0,1009,0,0.99,0.0,0
PF12146,PF03982:PF00561:PF00544:PF04083:PF12697,51,122,36,15,86,881,0.3,0.9,0.71,0.41,26,18,33,8,959,0.69,0.96,0.35,0.48
PF09445,PF12237:PF00397:PF00639:PF01846:PF16562,11,90,8,3,82,925,0.09,0.92,0.73,0.24,10,3,8,7,1000,0.3,0.99,0.27,0.28
PF00151,PF01477:PF00305:PF08016:PF02010:PF08825,33,60,19,14,41,944,0.32,0.95,0.58,0.4,9,4,29,5,980,0.44,0.97,0.12,0.22
PF01757,PF04515:PF01755:PF07162:PF07971:PF06237,33,48,9,24,39,946,0.19,0.94,0.27,0.19,3,2,31,1,984,0.67,0.97,0.06,0.19
PF15058,PF15620:PF16832:PF15059:PF06567:PF16801,4,4,3,1,1,1013,0.75,1.0,0.75,0.75,0,0,4,0,1014,0,1.0,0.0,0
PF05884,PF11703:PF15053:PF15814:PF16001:PF15551,0,3,0,0,3,1015,0.0,1.0,0,0,0,0,0,0,1018,0,1.0,0,0
PF01709,PF07350:PF04176:PF06172:PF06658:PF05630,12,14,6,6,8,998,0.43,0.99,0.5,0.46,0,0,12,0,1006,0,0.99,0.0,0
PF04906,PF15396:PF14857:PF15388:PF03036:PF14822,7,14,5,2,9,1002,0.36,0.99,0.71,0.5,1,1,6,0,1011,1.0,0.99,0.14,0.38
PF06468,PF02014:PF10223:PF03188:PF00007:PF00090,7,81,7,0,74,937,0.09,0.93,1.0,0.28,7,3,4,4,1007,0.43,0.99,0.43,0.42
PF03128,PF14554:PF04692:PF15800:PF00341:PF03185,2,13,1,1,12,1004,0.08,0.99,0.5,0.19,1,1,1,0,1016,1.0,1.0,0.5,0.71
PF01775,PF02284:PF06172:PF05995:PF00210:PF04176,9,26,6,3,20,989,0.23,0.98,0.67,0.38,4,3,6,1,1008,0.75,0.99,0.33,0.5
PF09055,PF16843:PF05162:PF04758:PF01020:PF12057,5,25,2,3,23,990,0.08,0.97,0.4,0.17,2,1,4,1,1012,0.5,1.0,0.2,0.31
PF09341,PF03073:PF15786:PF04299:PF02569:PF15171,8,23,2,6,21,989,0.09,0.97,0.25,0.14,0,0,8,0,1010,0,0.99,0.0,0
PF15672,PF00419:PF05167:PF03244:PF06890:PF10445,0,3,0,0,3,1015,0.0,1.0,0,0,0,0,0,0,1018,0,1.0,0,0
PF15903,PF15917:PF09743:PF10744:PF08638:PF12509,3,17,0,3,17,998,0.0,0.98,0.0,-0.01,0,0,3,0,1015,0,1.0,0.0,0
PF00418,PF08377:PF00593:PF15399:PF04579:PF09367,4,8,2,2,6,1008,0.25,0.99,0.5,0.35,0,0,4,0,1014,0,1.0,0.0,0
PF15817,PF11751:PF02979:PF06890:PF08453:PF08411,1,6,0,1,6,1011,0.0,0.99,0.0,-0.0,0,0,1,0,1017,0,1.0,0.0,0
PF11498,PF04501:PF02561:PF07045:PF11770:PF03848,6,2,0,6,2,1010,0.0,0.99,0.0,-0.0,0,0,6,0,1012,0,0.99,0.0,0
PF16498,PF16495:PF16496:PF14379:PF16772:PF08558,6,19,5,1,14,998,0.26,0.99,0.83,0.46,1,1,5,0,1012,1.0,1.0,0.17,0.41
PF16263,PF07338:PF13390:PF02113:PF09829:PF02277,0,9,0,0,9,1009,0.0,0.99,0,0,0,0,0,0,1018,0,1.0,0,0
PF16957,PF01312:PF07016:PF14690:PF04466:PF01514,2,0,0,2,0,1016,0,1.0,0.0,0,0,0,2,0,1016,0,1.0,0.0,0
PF14951,PF14950:PF14911:PF01447:PF14763:PF02971,1,6,0,1,6,1011,0.0,0.99,0.0,-0.0,0,0,1,0,1017,0,1.0,0.0,0
PF00118,PF10247:PF04051:PF01504:PF05527:PF01906,51,58,22,29,36,931,0.38,0.94,0.43,0.37,3,3,48,0,967,1.0,0.95,0.06,0.24
PF15518,PF04196:PF12603:PF14842:PF03090:PF08411,1,2,1,0,1,1016,0.5,1.0,1.0,0.71,0,0,1,0,1017,0,1.0,0.0,0
PF13355,PF15027:PF10441:PF17034:PF15627:PF13910,2,14,1,1,13,1003,0.07,0.99,0.5,0.19,0,0,2,0,1016,0,1.0,0.0,0
PF08667,PF01339:PF04397:PF12431:PF02954:PF12532,0,11,0,0,11,1007,0.0,0.99,0,0,0,0,0,0,1018,0,1.0,0,0
PF05197,PF14798:PF05308:PF01907:PF05676:PF16054,5,21,3,2,18,995,0.14,0.98,0.6,0.29,1,1,4,0,1013,1.0,1.0,0.2,0.45
PF10186,PF09816:PF04087:PF02701:PF04908:PF15067,8,25,2,6,23,987,0.08,0.97,0.25,0.13,1,1,7,0,1010,1.0,0.99,0.12,0.35
PF06056,PF03553:PF16055:PF06890:PF15757:PF11019,1,1,0,1,1,1016,0.0,1.0,0.0,-0.0,0,0,1,0,1017,0,1.0,0.0,0
PF07137,PF13097:PF00835:PF15313:PF08651:PF07111,3,16,1,2,15,1000,0.06,0.98,0.33,0.14,0,0,3,0,1015,0,1.0,0.0,0
PF00711,PF00272:PF12020:PF04901:PF02372:PF14935,0,5,0,0,5,1013,0.0,1.0,0,0,0,0,0,0,1018,0,1.0,0,0
PF04130,PF02705:PF03407:PF01501:PF03016:PF00282,40,100,25,15,75,903,0.25,0.91,0.62,0.36,16,11,29,5,973,0.69,0.97,0.28,0.42
PF05056,PF04758:PF01020:PF10421:PF16843:PF16455,11,28,5,6,23,984,0.18,0.97,0.45,0.27,2,1,10,1,1006,0.5,0.99,0.09,0.21
PF00645,PF08063:PF08645:PF16759:PF05406:PF02877,22,38,12,10,26,970,0.32,0.96,0.55,0.4,7,7,15,0,996,1.0,0.99,0.32,0.56
PF12946,PF07462:PF01723:PF12947:PF14956:PF02267,3,27,3,0,24,991,0.11,0.98,1.0,0.33,1,1,2,0,1015,1.0,1.0,0.33,0.58
PF13166,PF10375:PF11291:PF15453:PF14775:PF15877,0,5,0,0,5,1013,0.0,1.0,0,0,0,0,0,0,1018,0,1.0,0,0
PF03096,PF16969:PF00375:PF05197:PF01907:PF14798,3,30,1,2,29,986,0.03,0.97,0.33,0.1,1,1,2,0,1015,1.0,1.0,0.33,0.58
PF01826,PF08742:PF00094:PF09206:PF12714:PF05270,40,41,29,11,12,966,0.71,0.98,0.72,0.7,15,15,25,0,978,1.0,0.98,0.38,0.6
PF06574,PF07298:PF02401:PF15346:PF09991:PF02620,4,16,1,3,15,999,0.06,0.98,0.25,0.12,0,0,4,0,1014,0,1.0,0.0,0
PF13567,PF03772:PF08402:PF13732:PF12399:PF01032,4,17,4,0,13,1001,0.24,0.99,1.0,0.48,4,2,2,2,1012,0.5,1.0,0.5,0.5
PF09737,PF11635:PF01731:PF13506:PF11069:PF01733,5,32,2,3,30,983,0.06,0.97,0.4,0.15,0,0,5,0,1013,0,1.0,0.0,0
PF04815,PF08033:PF04810:PF04811:PF02209:PF00839,26,39,24,2,15,977,0.62,0.98,0.92,0.75,22,21,5,1,991,0.95,0.99,0.81,0.88
PF08601,PF12498:PF03957:PF11785:PF02173:PF11787,4,9,2,2,7,1007,0.22,0.99,0.5,0.33,2,2,2,0,1014,1.0,1.0,0.5,0.71
PF02296,PF09066:PF16381:PF14806:PF14797:PF08752,5,19,2,3,17,996,0.11,0.98,0.4,0.2,2,1,4,1,1012,0.5,1.0,0.2,0.31
PF16477,PF15181:PF15798:PF03527:PF05990:PF02917,0,6,0,0,6,1012,0.0,0.99,0,0,0,0,0,0,1018,0,1.0,0,0
PF01494,PF07976:PF12831:PF08491:PF06314:PF06985,90,79,44,46,35,893,0.56,0.92,0.49,0.48,7,7,83,0,928,1.0,0.92,0.08,0.27
PF09801,PF05512:PF06219:PF03239:PF09748:PF08569,8,23,1,7,22,988,0.04,0.97,0.12,0.06,3,0,8,3,1007,0.0,0.99,0.0,-0.0
PF08168,PF15027:PF13910:PF16748:PF10441:PF14952,0,9,0,0,9,1009,0.0,0.99,0,0,0,0,0,0,1018,0,1.0,0,0
PF16858,PF16869:PF06278:PF00926:PF02404:PF09305,5,13,4,1,9,1004,0.31,0.99,0.8,0.49,0,0,5,0,1013,0,1.0,0.0,0
PF02897,PF00930:PF07676:PF03059:PF00326:PF13300,15,60,15,0,45,958,0.25,0.96,1.0,0.49,8,3,12,5,998,0.38,0.98,0.2,0.27
PF16796,PF16540:PF13931:PF14739:PF12510:PF15147,8,13,5,3,8,1002,0.38,0.99,0.62,0.49,4,4,4,0,1010,1.0,1.0,0.5,0.71
PF03313,PF03315:PF05683:PF07171:PF02278:PF02884,4,12,4,0,8,1006,0.33,0.99,1.0,0.58,1,0,4,1,1013,0.0,1.0,0.0,-0.0
PF12447,PF02873:PF04978:PF02754:PF06433:PF09330,3,17,3,0,14,1001,0.18,0.99,1.0,0.42,3,3,0,0,1015,1.0,1.0,1.0,1.0
PF01077,PF03460:PF13806:PF01855:PF04324:PF02898,15,31,15,0,16,987,0.48,0.98,1.0,0.69,12,12,3,0,1003,1.0,1.0,0.8,0.89
PF14909,PF05508:PF15279:PF10198:PF08634:PF05624,4,7,1,3,6,1008,0.14,0.99,0.25,0.18,0,0,4,0,1014,0,1.0,0.0,0
PF10938,PF06185:PF01518:PF14057:PF07373:PF06819,0,2,0,0,2,1016,0.0,1.0,0,0,0,0,0,0,1018,0,1.0,0,0
PF03840,PF04237:PF02162:PF01973:PF10963:PF06476,1,7,0,1,7,1010,0.0,0.99,0.0,-0.0,0,0,1,0,1017,0,1.0,0.0,0
PF00289,PF02785:PF08326:PF00364:PF01039:PF02626,34,65,33,1,32,952,0.51,0.97,0.97,0.69,22,22,12,0,984,1.0,0.99,0.65,0.8
PF17101,PF11380:PF17102:PF17103:PF00066:PF05572,5,26,5,0,21,992,0.19,0.98,1.0,0.43,4,4,1,0,1013,1.0,1.0,0.8,0.89
PF14403,PF06355:PF02554:PF06074:PF02119:PF04671,0,5,0,0,5,1013,0.0,1.0,0,0,0,0,0,0,1018,0,1.0,0,0
PF01975,PF03133:PF02939:PF11927:PF05637:PF10275,12,55,5,7,50,956,0.09,0.94,0.42,0.18,5,3,9,2,1004,0.6,0.99,0.25,0.38
PF04336,PF12854:PF16930:PF00292:PF00379:PF01424,1,100,0,1,100,917,0.0,0.9,0.0,-0.01,9,0,1,9,1008,0.0,0.99,0.0,-0.0
PF00953,PF07542:PF09995:PF01758:PF03417:PF03583,15,30,4,11,26,977,0.13,0.96,0.27,0.17,3,1,14,2,1001,0.33,0.98,0.07,0.14
PF01687,PF13419:PF00475:PF12311:PF05536:PF08450,12,72,7,5,65,941,0.1,0.93,0.58,0.22,4,2,10,2,1004,0.5,0.99,0.17,0.28
PF05075,PF03436:PF10322:PF15252:PF01415:PF02343,0,4,0,0,4,1014,0.0,1.0,0,0,0,0,0,0,1018,0,1.0,0,0
PF10239,PF10507:PF03103:PF15973:PF15010:PF01620,6,13,2,4,11,1001,0.15,0.99,0.33,0.22,0,0,6,0,1012,0,0.99,0.0,0
PF05281,PF05361:PF15370:PF06232:PF05039:PF15359,2,11,2,0,9,1007,0.18,0.99,1.0,0.42,0,0,2,0,1016,0,1.0,0.0,0
PF14970,PF05111:PF15254:PF14992:PF15398:PF08647,3,12,1,2,11,1004,0.08,0.99,0.33,0.16,0,0,3,0,1015,0,1.0,0.0,0
PF05746,PF03485:PF00750:PF13243:PF01645:PF14510,30,50,27,3,23,965,0.54,0.97,0.9,0.69,9,8,22,1,987,0.89,0.98,0.27,0.48
PF16322,PF01167:PF10442:PF08495:PF04300:PF13361,1,34,1,0,33,984,0.03,0.97,1.0,0.17,4,0,1,4,1013,0.0,1.0,0.0,-0.0
PF06977,PF15082:PF05894:PF10618:PF07610:PF15392,0,4,0,0,4,1014,0.0,1.0,0,0,0,0,0,0,1018,0,1.0,0,0
PF09033,PF09230:PF05422:PF14831:PF06738:PF16979,0,20,0,0,20,998,0.0,0.98,0,0,0,0,0,0,1018,0,1.0,0,0
PF12854,PF13041:PF03612:PF13762:PF11851:PF01155,62,132,60,2,72,884,0.45,0.93,0.97,0.64,0,0,62,0,956,0,0.94,0.0,0
PF05947,PF05943:PF03428:PF05591:PF01913:PF13722,0,1,0,0,1,1017,0.0,1.0,0,0,0,0,0,0,1018,0,1.0,0,0
PF09969,PF15107:PF03379:PF01316:PF17112:PF15333,1,3,0,1,3,1014,0.0,1.0,0.0,-0.0,0,0,1,0,1017,0,1.0,0.0,0
PF05708,PF00171:PF00465:PF00696:PF14850:PF08174,2,127,1,1,126,890,0.01,0.88,0.5,0.05,11,1,1,10,1006,0.09,0.99,0.5,0.21
PF14918,PF14920:PF14919:PF14654:PF05647:PF02971,0,4,0,0,4,1014,0.0,1.0,0,0,0,0,0,0,1018,0,1.0,0,0
PF12940,PF10426:PF00303:PF00186:PF15815:PF04757,4,36,4,0,32,982,0.11,0.97,1.0,0.33,2,1,3,1,1013,0.5,1.0,0.25,0.35
PF08485,PF04552:PF14842:PF04963:PF06505:PF08479,1,1,0,1,1,1016,0.0,1.0,0.0,-0.0,0,0,1,0,1017,0,1.0,0.0,0
PF04176,PF04716:PF06658:PF02284:PF05915:PF01470,9,27,5,4,22,987,0.19,0.97,0.56,0.31,2,2,7,0,1009,1.0,0.99,0.22,0.47
PF03992,PF16166:PF13405:PF13202:PF01023:PF00036,23,91,9,14,82,913,0.1,0.91,0.39,0.16,18,5,18,13,982,0.28,0.97,0.22,0.23
PF08331,PF15052:PF15485:PF04642:PF12843:PF07209,0,5,0,0,5,1013,0.0,1.0,0,0,0,0,0,0,1018,0,1.0,0,0
PF03219,PF08643:PF16007:PF10471:PF15245:PF05129,5,20,2,3,18,995,0.1,0.98,0.4,0.19,1,1,4,0,1013,1.0,1.0,0.2,0.45
PF04343,PF06724:PF04076:PF15202:PF14251:PF17076,0,2,0,0,2,1016,0.0,1.0,0,0,0,0,0,0,1018,0,1.0,0,0
PF09333,PF12624:PF16910:PF16908:PF06650:PF16909,16,37,13,3,24,978,0.35,0.97,0.81,0.52,18,4,12,14,988,0.22,0.97,0.25,0.22
PF02218,PF08824:PF07815:PF12026:PF08397:PF11555,4,15,1,3,14,1000,0.07,0.98,0.25,0.12,2,1,3,1,1013,0.5,1.0,0.25,0.35
PF14672,PF15172:PF12046:PF00714:PF00489:PF15173,0,3,0,0,3,1015,0.0,1.0,0,0,0,0,0,0,1018,0,1.0,0,0
PF01464,PF13462:PF11303:PF06373:PF02060:PF10501,4,15,1,3,14,1000,0.07,0.98,0.25,0.12,0,0,4,0,1014,0,1.0,0.0,0
PF00044,PF02672:PF02800:PF00121:PF01066:PF00891,28,77,24,4,53,937,0.31,0.94,0.86,0.5,9,8,20,1,989,0.89,0.98,0.29,0.5
PF10492,PF10491:PF15999:PF12751:PF14240:PF15353,0,16,0,0,16,1002,0.0,0.98,0,0,0,0,0,0,1018,0,1.0,0,0
PF08848,PF05448:PF15443:PF02425:PF15460:PF08291,0,4,0,0,4,1014,0.0,1.0,0,0,0,0,0,0,1018,0,1.0,0,0
PF13722,PF07157:PF07409:PF03090:PF11751:PF03241,0,0,0,0,0,1018,0,1.0,0,0,0,0,0,0,1018,0,1.0,0,0
PF12081,PF08479:PF03241:PF05509:PF05513:PF06082,0,1,0,0,1,1017,0.0,1.0,0,0,0,0,0,0,1018,0,1.0,0,0
PF11440,PF04965:PF07199:PF08744:PF11162:PF00604,0,2,0,0,2,1016,0.0,1.0,0,0,0,0,0,0,1018,0,1.0,0,0
PF02894,PF09166:PF08635:PF02774:PF01041:PF09290,19,26,4,15,22,977,0.15,0.96,0.21,0.16,1,1,18,0,999,1.0,0.98,0.05,0.23
PF01427,PF07930:PF11954:PF07311:PF05170:PF02058,4,8,0,4,8,1006,0.0,0.99,0.0,-0.01,0,0,4,0,1014,0,1.0,0.0,0
PF10350,PF12612:PF07539:PF17034:PF08427:PF02368,11,29,4,7,25,982,0.14,0.97,0.36,0.21,2,2,9,0,1007,1.0,0.99,0.18,0.42
PF02390,PF00162:PF15473:PF00177:PF05630:PF00793,16,52,12,4,40,962,0.23,0.96,0.75,0.4,4,2,14,2,1000,0.5,0.98,0.12,0.24
PF07096,PF04110:PF06172:PF14954:PF06388:PF01997,5,17,1,4,16,997,0.06,0.98,0.2,0.1,1,0,5,1,1012,0.0,0.99,0.0,-0.0
PF04970,PF02594:PF01127:PF05291:PF10190:PF08641,11,29,4,7,25,982,0.14,0.97,0.36,0.21,3,2,9,1,1006,0.67,0.99,0.18,0.34
PF11128,PF14975:PF09912:PF01015:PF10149:PF00638,0,39,0,0,39,979,0.0,0.96,0,0,3,0,0,3,1015,0.0,1.0,0,0
PF11317,PF10716:PF08843:PF08092:PF03379:PF17032,0,3,0,0,3,1015,0.0,1.0,0,0,0,0,0,0,1018,0,1.0,0,0
PF02144,PF01282:PF01273:PF08315:PF03694:PF01987,9,41,6,3,35,974,0.15,0.96,0.67,0.3,1,1,8,0,1009,1.0,0.99,0.11,0.33
PF00723,PF00686:PF01757:PF03009:PF02446:PF06237,15,77,11,4,66,937,0.14,0.93,0.73,0.3,4,2,13,2,1001,0.5,0.99,0.13,0.25
PF04630,PF00006:PF01559:PF12056:PF13947:PF09203,0,62,0,0,62,956,0.0,0.94,0,0,2,0,0,2,1016,0.0,1.0,0,0
PF00538,PF14379:PF00249:PF14303:PF16772:PF07039,19,104,14,5,90,909,0.13,0.91,0.74,0.29,5,3,16,2,997,0.6,0.98,0.16,0.3
PF15047,PF08792:PF15211:PF15713:PF11371:PF12658,0,3,0,0,3,1015,0.0,1.0,0,0,0,0,0,0,1018,0,1.0,0,0
PF11965,PF02514:PF03709:PF03738:PF07231:PF07504,2,6,1,1,5,1011,0.17,0.99,0.5,0.29,0,0,2,0,1016,0,1.0,0.0,0
PF04073,PF08907:PF02403:PF01927:PF03129:PF00587,13,63,10,3,53,952,0.16,0.94,0.77,0.33,12,7,6,5,1000,0.58,0.99,0.54,0.55
PF10442,PF12014:PF04300:PF08495:PF08268:PF07734,3,29,3,0,26,989,0.1,0.97,1.0,0.32,3,1,2,2,1013,0.33,1.0,0.33,0.33
PF09783,PF14565:PF15316:PF15173:PF16218:PF15305,17,5,1,16,4,997,0.2,0.98,0.06,0.1,0,0,17,0,1001,0,0.98,0.0,0
PF10327,PF10325:PF10319:PF10318:PF10322:PF10316,5,19,4,1,15,998,0.21,0.98,0.8,0.41,1,1,4,0,1013,1.0,1.0,0.2,0.45
PF14630,PF09079:PF13401:PF14532:PF14629:PF01637,9,24,5,4,19,990,0.21,0.98,0.56,0.33,4,3,6,1,1008,0.75,0.99,0.33,0.5
PF09313,PF13503:PF13334:PF10971:PF07822:PF10437,0,7,0,0,7,1011,0.0,0.99,0,0,0,0,0,0,1018,0,1.0,0,0
PF15102,PF16649:PF05836:PF08738:PF14886:PF14519,3,5,3,0,2,1013,0.6,1.0,1.0,0.77,0,0,3,0,1015,0,1.0,0.0,0
PF04172,PF14022:PF12751:PF16692:PF13875:PF06880,2,9,1,1,8,1008,0.11,0.99,0.5,0.23,0,0,2,0,1016,0,1.0,0.0,0
PF01092,PF10234:PF09282:PF15301:PF07039:PF11708,11,25,5,6,20,987,0.2,0.97,0.45,0.29,2,1,10,1,1006,0.5,0.99,0.09,0.21
PF15111,PF07520:PF14983:PF02530:PF03631:PF03831,1,3,0,1,3,1014,0.0,1.0,0.0,-0.0,0,0,1,0,1017,0,1.0,0.0,0
PF02582,PF01025:PF03637:PF04759:PF03350:PF00468,16,35,4,12,31,971,0.11,0.96,0.25,0.15,2,1,15,1,1001,0.5,0.98,0.06,0.17
PF04849,PF12448:PF15705:PF16979:PF16978:PF15706,2,19,2,0,17,999,0.11,0.98,1.0,0.32,0,0,2,0,1016,0,1.0,0.0,0
PF09281,PF06394:PF02657:PF11421:PF16012:PF14675,2,21,0,2,21,995,0.0,0.98,0.0,-0.01,1,0,2,1,1015,0.0,1.0,0.0,-0.0
PF14306,PF01747:PF00273:PF09164:PF08472:PF16491,9,28,9,0,19,990,0.32,0.98,1.0,0.56,0,0,9,0,1009,0,0.99,0.0,0
PF14953,PF05233:PF07879:PF15104:PF08576:PF06708,3,6,2,1,4,1011,0.33,1.0,0.67,0.47,0,0,3,0,1015,0,1.0,0.0,0
PF00244,PF05091:PF03386:PF05129:PF05512:PF05254,24,36,11,13,25,969,0.31,0.96,0.46,0.36,1,1,23,0,994,1.0,0.98,0.04,0.2
PF03368,PF11648:PF00636:PF03461:PF13234:PF04851,14,58,14,0,44,960,0.24,0.96,1.0,0.48,6,5,9,1,1003,0.83,0.99,0.36,0.54
PF11830,PF15733:PF12068:PF12473:PF06311:PF17045,4,29,3,1,26,988,0.1,0.97,0.75,0.27,0,0,4,0,1014,0,1.0,0.0,0
PF11538,PF14909:PF05508:PF10198:PF12948:PF14977,4,13,1,3,12,1002,0.08,0.99,0.25,0.13,1,1,3,0,1014,1.0,1.0,0.25,0.5
PF02742,PF02277:PF12019:PF00419:PF03831:PF11751,3,5,0,3,5,1010,0.0,0.99,0.0,-0.0,0,0,3,0,1015,0,1.0,0.0,0
PF16013,PF16061:PF12309:PF08318:PF02263:PF04437,4,39,4,0,35,979,0.1,0.97,1.0,0.31,6,1,3,5,1009,0.17,0.99,0.25,0.2
PF07476,PF13007:PF08299:PF06890:PF14882:PF07805,0,3,0,0,3,1015,0.0,1.0,0,0,0,0,0,0,1018,0,1.0,0,0
PF16019,PF15279:PF04109:PF14909:PF07217:PF12877,0,20,0,0,20,998,0.0,0.98,0,0,2,0,0,2,1016,0.0,1.0,0,0
PF05824,PF06875:PF06581:PF14653:PF06729:PF15550,2,0,0,2,0,1016,0,1.0,0.0,0,0,0,2,0,1016,0,1.0,0.0,0
PF05987,PF08766:PF03711:PF10484:PF01276:PF11532,1,45,1,0,44,973,0.02,0.96,1.0,0.15,3,0,1,3,1014,0.0,1.0,0.0,-0.0
PF08617,PF12414:PF08081:PF08143:PF11627:PF12220,8,8,2,6,6,1004,0.25,0.99,0.25,0.24,1,1,7,0,1010,1.0,0.99,0.12,0.35
PF02501,PF03934:PF11612:PF02107:PF08479:PF02056,2,12,2,0,10,1006,0.17,0.99,1.0,0.41,0,0,2,0,1016,0,1.0,0.0,0
PF11223,PF10933:PF14216:PF08744:PF11179:PF07199,1,3,0,1,3,1014,0.0,1.0,0.0,-0.0,0,0,1,0,1017,0,1.0,0.0,0
PF09013,PF07334:PF11952:PF05743:PF02218:PF09103,2,22,1,1,21,995,0.05,0.98,0.5,0.15,1,0,2,1,1015,0.0,1.0,0.0,-0.0
PF15994,PF15995:PF01043:PF00680:PF12381:PF00073,0,15,0,0,15,1003,0.0,0.99,0,0,4,0,0,4,1014,0.0,1.0,0,0
PF13962,PF00710:PF07693:PF14420:PF13961:PF13606,16,74,9,7,65,937,0.12,0.93,0.56,0.24,9,5,11,4,998,0.56,0.99,0.31,0.41
PF02793,PF01825:PF16489:PF00002:PF06652:PF08541,20,68,20,0,48,950,0.29,0.95,1.0,0.53,14,5,15,9,989,0.36,0.98,0.25,0.29
PF09068,PF09069:PF00639:PF16577:PF09445:PF12744,7,28,7,0,21,990,0.25,0.98,1.0,0.49,2,2,5,0,1011,1.0,1.0,0.29,0.53
PF01394,PF09268:PF00993:PF16196:PF04248:PF05831,8,10,3,5,7,1003,0.3,0.99,0.38,0.33,0,0,8,0,1010,0,0.99,0.0,0
PF02163,PF15019:PF13908:PF04769:PF16091:PF14977,10,11,2,8,9,999,0.18,0.98,0.2,0.18,0,0,10,0,1008,0,0.99,0.0,0
PF03131,PF08209:PF11911:PF09756:PF09494:PF05741,16,28,6,10,22,980,0.21,0.97,0.38,0.27,3,2,14,1,1001,0.67,0.99,0.12,0.28
PF12852,PF06719:PF08708:PF01514:PF05840:PF07021,2,3,2,0,1,1015,0.67,1.0,1.0,0.82,0,0,2,0,1016,0,1.0,0.0,0
PF02518,PF03924:PF00672:PF00183:PF00512:PF00989,75,87,59,16,28,915,0.68,0.96,0.79,0.71,16,16,59,0,943,1.0,0.94,0.21,0.45
PF14737,PF07929:PF04194:PF13392:PF14740:PF07034,10,23,4,6,19,989,0.17,0.98,0.4,0.25,2,2,8,0,1008,1.0,0.99,0.2,0.45
PF00287,PF06951:PF05351:PF15065:PF00821:PF08925,10,27,5,5,22,986,0.19,0.97,0.5,0.29,2,1,9,1,1007,0.5,0.99,0.1,0.22
PF09529,PF06798:PF03090:PF04463:PF02413:PF11863,0,2,0,0,2,1016,0.0,1.0,0,0,0,0,0,0,1018,0,1.0,0,0
PF00415,PF08005:PF10462:PF02493:PF02204:PF03256,67,70,34,33,36,915,0.49,0.93,0.51,0.46,6,6,61,0,951,1.0,0.94,0.09,0.29
PF00134,PF02984:PF08268:PF00847:PF07723:PF02373,69,83,49,20,34,915,0.59,0.95,0.71,0.62,8,7,62,1,948,0.88,0.94,0.1,0.29
PF07931,PF13810:PF10295:PF05841:PF11770:PF14040,3,4,1,2,3,1012,0.25,1.0,0.33,0.29,0,0,3,0,1015,0,1.0,0.0,0
PF08656,PF16594:PF07961:PF15715:PF15055:PF13933,2,1,0,2,1,1015,0.0,1.0,0.0,-0.0,0,0,2,0,1016,0,1.0,0.0,0
PF00708,PF15013:PF02285:PF07114:PF06799:PF08561,7,16,3,4,13,998,0.19,0.98,0.43,0.28,0,0,7,0,1011,0,0.99,0.0,0
PF00038,PF10042:PF16208:PF00932:PF04732:PF08757,22,16,10,12,6,990,0.62,0.98,0.45,0.52,1,1,21,0,996,1.0,0.98,0.05,0.21
PF01467,PF01121:PF07072:PF13656:PF01066:PF05739,37,65,17,20,48,933,0.26,0.93,0.46,0.31,9,8,29,1,980,0.89,0.97,0.22,0.43
PF12064,PF10513:PF17105:PF12157:PF06752:PF03172,3,31,1,2,30,985,0.03,0.97,0.33,0.1,2,1,2,1,1014,0.5,1.0,0.33,0.41
PF02778,PF01974:PF01648:PF13299:PF00874:PF10484,11,53,10,1,43,964,0.19,0.96,0.91,0.4,7,3,8,4,1003,0.43,0.99,0.27,0.34
PF16801,PF03546:PF15774:PF07199:PF14626:PF16756,0,2,0,0,2,1016,0.0,1.0,0,0,0,0,0,0,1018,0,1.0,0,0
PF04431,PF02789:PF03425:PF07975:PF08530:PF03442,4,38,2,2,36,978,0.05,0.96,0.5,0.15,3,1,3,2,1012,0.33,1.0,0.25,0.29
PF15809,PF15555:PF15119:PF15664:PF15680:PF14866,0,2,0,0,2,1016,0.0,1.0,0,0,0,0,0,0,1018,0,1.0,0,0
PF04962,PF02653:PF13732:PF08402:PF12399:PF08352,5,17,5,0,12,1001,0.29,0.99,1.0,0.54,5,3,2,2,1011,0.6,1.0,0.6,0.6
PF00239,PF13408:PF07508:PF05974:PF15518:PF03090,3,3,2,1,1,1014,0.67,1.0,0.67,0.67,0,0,3,0,1015,0,1.0,0.0,0
PF02269,PF04646:PF08609:PF15067:PF06830:PF05739,11,46,7,4,39,968,0.15,0.96,0.64,0.3,1,1,10,0,1007,1.0,0.99,0.09,0.3
PF00301,PF04367:PF11255:PF09419:PF02576:PF07939,2,14,0,2,14,1002,0.0,0.98,0.0,-0.01,0,0,2,0,1016,0,1.0,0.0,0
PF02631,PF08653:PF15553:PF17078:PF06485:PF03618,2,7,0,2,7,1009,0.0,0.99,0.0,-0.0,0,0,2,0,1016,0,1.0,0.0,0
PF07477,PF07488:PF03648:PF16126:PF02065:PF02278,4,11,4,0,7,1007,0.36,0.99,1.0,0.6,1,1,3,0,1014,1.0,1.0,0.25,0.5
PF10714,PF08497:PF14690:PF11019:PF12477:PF07805,3,1,0,3,1,1014,0.0,1.0,0.0,-0.0,0,0,3,0,1015,0,1.0,0.0,0
PF02275,PF15985:PF16682:PF09770:PF12260:PF14336,8,26,4,4,22,988,0.15,0.97,0.5,0.27,0,0,8,0,1010,0,0.99,0.0,0
PF10404,PF10403:PF10405:PF03835:PF16485:PF04721,7,13,7,0,6,1005,0.54,0.99,1.0,0.73,10,7,0,3,1008,0.7,1.0,1.0,0.84
PF05127,PF13718:PF13725:PF08351:PF00049:PF17176,15,20,12,3,8,995,0.6,0.99,0.8,0.69,12,12,3,0,1003,1.0,1.0,0.8,0.89
PF11875,PF14308:PF11926:PF14237:PF09976:PF00684,5,24,1,4,23,990,0.04,0.97,0.2,0.08,0,0,5,0,1013,0,1.0,0.0,0
PF05797,PF01752:PF04451:PF03050:PF03241:PF17206,0,4,0,0,4,1014,0.0,1.0,0,0,0,0,0,0,1018,0,1.0,0,0
PF12583,PF12580:PF12245:PF16470:PF06280:PF05922,1,37,1,0,36,981,0.03,0.96,1.0,0.16,2,1,0,1,1016,0.5,1.0,1.0,0.71
PF08299,PF14841:PF14882:PF14467:PF01706:PF03428,2,1,1,1,0,1016,1.0,1.0,0.5,0.71,0,0,2,0,1016,0,1.0,0.0,0
PF12753,PF08310:PF17084:PF04552:PF11614:PF04963,1,6,0,1,6,1011,0.0,0.99,0.0,-0.0,0,0,1,0,1017,0,1.0,0.0,0
PF16092,PF01493:PF14691:PF00310:PF04898:PF01645,7,17,2,5,15,996,0.12,0.98,0.29,0.17,7,2,5,5,1006,0.29,0.99,0.29,0.28
PF09556,PF12080:PF11775:PF10566:PF06070:PF01580,1,6,0,1,6,1011,0.0,0.99,0.0,-0.0,0,0,1,0,1017,0,1.0,0.0,0
PF08067,PF16274:PF16544:PF16275:PF10470:PF16568,4,11,2,2,9,1005,0.18,0.99,0.5,0.3,1,1,3,0,1014,1.0,1.0,0.25,0.5
PF02386,PF16655:PF12213:PF01373:PF15072:PF05687,16,23,5,11,18,984,0.22,0.97,0.31,0.25,1,1,15,0,1002,1.0,0.99,0.06,0.25
PF09072,PF16499:PF10632:PF03762:PF14200:PF15048,7,26,4,3,22,989,0.15,0.98,0.57,0.29,1,1,6,0,1011,1.0,0.99,0.14,0.38
PF08630,PF12927:PF08634:PF05841:PF16944:PF13810,3,8,0,3,8,1007,0.0,0.99,0.0,-0.0,0,0,3,0,1015,0,1.0,0.0,0
PF09162,PF03943:PF02136:PF05620:PF15706:PF15705,4,23,3,1,20,994,0.13,0.98,0.75,0.31,2,1,3,1,1013,0.5,1.0,0.25,0.35
PF03754,PF07939:PF07052:PF04949:PF02325:PF04367,2,20,0,2,20,996,0.0,0.98,0.0,-0.01,0,0,2,0,1016,0,1.0,0.0,0
PF01869,PF10294:PF14904:PF05721:PF01063:PF11696,14,78,10,4,68,936,0.13,0.93,0.71,0.28,7,5,9,2,1002,0.71,0.99,0.36,0.5
PF13470,PF11057:PF12686:PF15828:PF10315:PF15212,0,2,0,0,2,1016,0.0,1.0,0,0,0,0,0,0,1018,0,1.0,0,0
PF14824,PF13241:PF14823:PF10414:PF00590:PF05007,10,29,10,0,19,989,0.34,0.98,1.0,0.58,4,4,6,0,1008,1.0,0.99,0.4,0.63
PF03945,PF16401:PF12600:PF14022:PF15073:PF16692,3,6,0,3,6,1009,0.0,0.99,0.0,-0.0,0,0,3,0,1015,0,1.0,0.0,0
PF00487,PF01070:PF03404:PF04116:PF00174:PF11960,38,69,14,24,55,925,0.2,0.92,0.37,0.24,14,7,31,7,973,0.5,0.96,0.18,0.29
PF00133,PF08264:PF06827:PF09334:PF10458:PF13603,52,64,41,11,23,943,0.64,0.97,0.79,0.69,12,12,40,0,966,1.0,0.96,0.23,0.47
PF02058,PF01668:PF17112:PF10106:PF08093:PF08404,1,4,0,1,4,1013,0.0,1.0,0.0,-0.0,0,0,1,0,1017,0,1.0,0.0,0
PF13986,PF06167:PF11304:PF08479:PF03428:PF05229,1,1,1,0,0,1017,1.0,1.0,1.0,1.0,0,0,1,0,1017,0,1.0,0.0,0
PF14659,PF05666:PF03592:PF14841:PF03050:PF17193,2,1,0,2,1,1015,0.0,1.0,0.0,-0.0,0,0,2,0,1016,0,1.0,0.0,0
PF12109,PF09193:PF10413:PF03827:PF08983:PF09463,2,4,1,1,3,1013,0.25,1.0,0.5,0.35,1,1,1,0,1016,1.0,1.0,0.5,0.71
PF15303,PF07001:PF10482:PF15557:PF15914:PF14818,2,14,1,1,13,1003,0.07,0.99,0.5,0.19,1,1,1,0,1016,1.0,1.0,0.5,0.71
PF02178,PF12165:PF15285:PF03172:PF12269:PF00538,14,23,9,5,14,990,0.39,0.98,0.64,0.49,2,2,12,0,1004,1.0,0.99,0.14,0.38
PF14747,PF15550:PF02950:PF10994:PF15142:PF01947,0,3,0,0,3,1015,0.0,1.0,0,0,0,0,0,0,1018,0,1.0,0,0
PF08934,PF01857:PF11934:PF01858:PF04999:PF17189,0,17,0,0,17,1001,0.0,0.98,0,0,1,0,0,1,1017,0.0,1.0,0,0
PF06246,PF07019:PF02434:PF04230:PF16054:PF07491,12,43,7,5,36,970,0.16,0.96,0.58,0.29,3,2,10,1,1005,0.67,0.99,0.17,0.33
PF14449,PF04740:PF16888:PF08453:PF05947:PF06826,0,3,0,0,3,1015,0.0,1.0,0,0,0,0,0,0,1018,0,1.0,0,0
PF03858,PF16954:PF01147:PF09807:PF00220:PF06540,0,9,0,0,9,1009,0.0,0.99,0,0,0,0,0,0,1018,0,1.0,0,0
PF12737,PF12731:PF05722:PF07526:PF16493:PF03791,1,6,1,0,5,1012,0.17,1.0,1.0,0.41,1,1,0,0,1017,1.0,1.0,1.0,1.0
PF07419,PF02399:PF14588:PF13657:PF15976:PF06890,1,7,1,0,6,1011,0.14,0.99,1.0,0.38,0,0,1,0,1017,0,1.0,0.0,0
PF06537,PF00857:PF13902:PF04707:PF06689:PF10326,0,59,0,0,59,959,0.0,0.94,0,0,5,0,0,5,1013,0.0,1.0,0,0
PF00924,PF15996:PF03615:PF14611:PF04576:PF15280,14,24,6,8,18,986,0.25,0.97,0.43,0.32,1,0,14,1,1003,0.0,0.99,0.0,-0.0
PF03435,PF05222:PF04455:PF12769:PF16653:PF02233,23,23,10,13,13,982,0.43,0.97,0.43,0.42,8,3,20,5,990,0.38,0.98,0.13,0.21
PF10629,PF05782:PF07085:PF16321:PF10444:PF15374,3,16,2,1,14,1001,0.12,0.99,0.67,0.28,0,0,3,0,1015,0,1.0,0.0,0
PF12482,PF06357:PF06403:PF11245:PF07178:PF07409,1,3,1,0,2,1015,0.33,1.0,1.0,0.58,0,0,1,0,1017,0,1.0,0.0,0
PF06989,PF11460:PF12855:PF08653:PF13270:PF07051,0,6,0,0,6,1012,0.0,0.99,0,0,0,0,0,0,1018,0,1.0,0,0
PF14864,PF14863:PF16123:PF00874:PF10484:PF03772,4,28,4,0,24,990,0.14,0.98,1.0,0.37,1,1,3,0,1014,1.0,1.0,0.25,0.5
PF09997,PF11057:PF14645:PF14945:PF05399:PF13971,0,3,0,0,3,1015,0.0,1.0,0,0,0,0,0,0,1018,0,1.0,0,0
PF11931,PF12108:PF16837:PF16958:PF01745:PF12171,6,42,6,0,36,976,0.14,0.96,1.0,0.37,6,5,1,1,1011,0.83,1.0,0.83,0.83
PF05068,PF17188:PF04754:PF01752:PF08497:PF03401,0,4,0,0,4,1014,0.0,1.0,0,0,0,0,0,0,1018,0,1.0,0,0
PF03979,PF04546:PF00140:PF08281:PF04545:PF04539,6,26,6,0,20,992,0.23,0.98,1.0,0.48,5,5,1,0,1012,1.0,1.0,0.83,0.91
PF05768,PF01796:PF06315:PF02464:PF12221:PF04794,7,18,3,4,15,996,0.17,0.98,0.43,0.26,0,0,7,0,1011,0,0.99,0.0,0
PF02447,PF07963:PF01228:PF07476:PF00816:PF00712,8,10,3,5,7,1003,0.3,0.99,0.38,0.33,0,0,8,0,1010,0,0.99,0.0,0
PF04608,PF03082:PF09655:PF00241:PF02809:PF06203,1,50,0,1,50,967,0.0,0.95,0.0,-0.01,4,0,1,4,1013,0.0,1.0,0.0,-0.0
PF04547,PF16178:PF06733:PF09733:PF01841:PF13307,18,45,11,7,34,966,0.24,0.96,0.61,0.37,8,5,13,3,997,0.62,0.98,0.28,0.41
PF03095,PF04729:PF07798:PF15251:PF01679:PF01126,11,30,4,7,26,981,0.13,0.97,0.36,0.21,1,0,11,1,1006,0.0,0.99,0.0,-0.0
PF14996,PF15161:PF15938:PF16112:PF14114:PF04421,1,6,1,0,5,1012,0.17,1.0,1.0,0.41,1,1,0,0,1017,1.0,1.0,1.0,1.0
PF01527,PF04236:PF04218:PF09026:PF03221:PF09607,9,59,4,5,55,954,0.07,0.94,0.44,0.16,6,2,7,4,1005,0.33,0.99,0.22,0.27
PF11961,PF07540:PF05672:PF08920:PF03801:PF07765,2,28,2,0,26,990,0.07,0.97,1.0,0.26,2,1,1,1,1015,0.5,1.0,0.5,0.5
PF04365,PF10335:PF02556:PF14334:PF04289:PF05103,0,9,0,0,9,1009,0.0,0.99,0,0,0,0,0,0,1018,0,1.0,0,0
PF08615,PF11779:PF02046:PF03657:PF14770:PF00885,7,23,2,5,21,990,0.09,0.97,0.29,0.15,2,1,6,1,1010,0.5,0.99,0.14,0.26
PF07226,PF12207:PF01750:PF03038:PF05357:PF10816,0,2,0,0,2,1016,0.0,1.0,0,0,0,0,0,0,1018,0,1.0,0,0
PF02913,PF09265:PF04030:PF02873:PF04275:PF08031,29,68,17,12,51,938,0.25,0.94,0.59,0.36,6,5,24,1,988,0.83,0.98,0.17,0.37
PF03716,PF12384:PF07962:PF13340:PF11560:PF03319,2,11,2,0,9,1007,0.18,0.99,1.0,0.42,0,0,2,0,1016,0,1.0,0.0,0
PF12932,PF12931:PF11549:PF12935:PF07304:PF03920,11,15,10,1,5,1002,0.67,0.99,0.91,0.78,1,1,10,0,1007,1.0,0.99,0.09,0.3
PF08036,PF15041:PF15555:PF15809:PF15343:PF04754,0,3,0,0,3,1015,0.0,1.0,0,0,0,0,0,0,1018,0,1.0,0,0
PF08103,PF13632:PF00703:PF02836:PF10592:PF00100,0,74,0,0,74,944,0.0,0.93,0,0,12,0,0,12,1006,0.0,0.99,0,0
PF06399,PF04279:PF01316:PF11111:PF11681:PF06934,1,4,1,0,3,1014,0.25,1.0,1.0,0.5,0,0,1,0,1017,0,1.0,0.0,0
PF12108,PF11931:PF16958:PF16837:PF07504:PF17167,6,10,6,0,4,1008,0.6,1.0,1.0,0.77,3,3,3,0,1012,1.0,1.0,0.5,0.71
PF00052,PF15002:PF06009:PF00054:PF01607:PF06583,13,66,9,4,57,948,0.14,0.94,0.69,0.29,4,2,11,2,1003,0.5,0.99,0.15,0.27
PF14926,PF15504:PF15130:PF12264:PF15231:PF10856,1,6,1,0,5,1012,0.17,1.0,1.0,0.41,0,0,1,0,1017,0,1.0,0.0,0
PF00350,PF01031:PF02212:PF04799:PF16880:PF14764,66,58,50,16,8,944,0.86,0.98,0.76,0.8,7,7,59,0,952,1.0,0.94,0.11,0.32
PF00430,PF00124:PF00507:PF01058:PF00119:PF00115,5,30,3,2,27,986,0.1,0.97,0.6,0.24,6,2,3,4,1009,0.33,0.99,0.4,0.36
PF12188,PF14596:PF12162:PF06286:PF16416:PF05474,1,2,1,0,1,1016,0.5,1.0,1.0,0.71,0,0,1,0,1017,0,1.0,0.0,0
PF15054,PF10868:PF15173:PF17032:PF11029:PF14770,5,4,0,5,4,1009,0.0,0.99,0.0,-0.0,0,0,5,0,1013,0,1.0,0.0,0
PF14138,PF15936:PF09138:PF15552:PF09045:PF06456,10,23,2,8,21,987,0.09,0.97,0.2,0.12,1,1,9,0,1008,1.0,0.99,0.1,0.31
PF15299,PF05334:PF16019:PF04087:PF04516:PF04189,8,19,2,6,17,993,0.11,0.98,0.25,0.15,0,0,8,0,1010,0,0.99,0.0,0
PF08329,PF03427:PF02839:PF06483:PF14856:PF07382,1,19,0,1,19,998,0.0,0.98,0.0,-0.0,0,0,1,0,1017,0,1.0,0.0,0
PF00245,PF04430:PF15868:PF03211:PF08787:PF14808,15,42,10,5,32,971,0.24,0.96,0.67,0.38,0,0,15,0,1003,0,0.99,0.0,0
PF08075,PF10443:PF12220:PF04098:PF08081:PF12196,9,17,3,6,14,995,0.18,0.98,0.33,0.23,2,1,8,1,1008,0.5,0.99,0.11,0.23
PF16123,PF14864:PF14863:PF00753:PF10484:PF07521,13,90,13,0,77,928,0.14,0.92,1.0,0.37,7,4,9,3,1002,0.57,0.99,0.31,0.41
PF02895,PF08707:PF12081:PF03241:PF02277:PF04451,2,5,0,2,5,1011,0.0,0.99,0.0,-0.0,0,0,2,0,1016,0,1.0,0.0,0
PF02867,PF00317:PF03477:PF07047:PF03989:PF08343,14,23,11,3,12,992,0.48,0.99,0.79,0.61,5,5,9,0,1004,1.0,0.99,0.36,0.59
PF04650,PF13876:PF08021:PF07505:PF07476:PF02336,1,3,0,1,3,1014,0.0,1.0,0.0,-0.0,0,0,1,0,1017,0,1.0,0.0,0
PF06803,PF08941:PF15451:PF04757:PF15815:PF05495,9,37,4,5,33,976,0.11,0.96,0.44,0.21,4,3,6,1,1008,0.75,0.99,0.33,0.5
PF07728,PF08385:PF12780:PF08393:PF07726:PF12777,38,49,28,10,21,959,0.57,0.97,0.74,0.63,31,25,13,6,974,0.81,0.98,0.66,0.72
PF02660,PF12398:PF11465:PF06760:PF09027:PF00757,1,11,0,1,11,1006,0.0,0.99,0.0,-0.0,3,0,1,3,1014,0.0,1.0,0.0,-0.0
PF01110,PF01913:PF07505:PF03428:PF08497:PF07243,1,1,0,1,1,1016,0.0,1.0,0.0,-0.0,0,0,1,0,1017,0,1.0,0.0,0
PF03417,PF07542:PF09995:PF03583:PF00953:PF03022,6,36,2,4,34,978,0.06,0.96,0.33,0.12,3,1,5,2,1010,0.33,0.99,0.17,0.23
PF08752,PF16381:PF09066:PF14806:PF07718:PF14796,5,21,5,0,16,997,0.24,0.98,1.0,0.48,6,2,3,4,1009,0.33,0.99,0.4,0.36
PF11798,PF00817:PF13438:PF11799:PF06732:PF11626,6,37,6,0,31,981,0.16,0.97,1.0,0.4,3,2,4,1,1011,0.67,1.0,0.33,0.47
PF03964,PF03050:PF11736:PF06573:PF01752:PF15190,0,7,0,0,7,1011,0.0,0.99,0,0,1,0,0,1,1017,0.0,1.0,0,0
PF15068,PF16590:PF08730:PF00997:PF14534:PF15139,1,2,0,1,2,1015,0.0,1.0,0.0,-0.0,0,0,1,0,1017,0,1.0,0.0,0
PF01234,PF05497:PF11937:PF07160:PF10530:PF09807,5,15,3,2,12,1001,0.2,0.99,0.6,0.34,0,0,5,0,1013,0,1.0,0.0,0
PF10187,PF00473:PF15242:PF15991:PF07260:PF10571,9,7,2,7,5,1004,0.29,0.99,0.22,0.25,0,0,9,0,1009,0,0.99,0.0,0
PF15902,PF15901:PF06328:PF12772:PF09067:PF15149,13,10,9,4,1,1004,0.9,1.0,0.69,0.79,1,1,12,0,1005,1.0,0.99,0.08,0.28
PF15704,PF06232:PF06521:PF07333:PF11264:PF06351,3,9,1,2,8,1007,0.11,0.99,0.33,0.19,0,0,3,0,1015,0,1.0,0.0,0
PF08214,PF06001:PF02135:PF09030:PF15612:PF10537,22,39,19,3,20,976,0.49,0.98,0.86,0.64,8,7,15,1,995,0.88,0.98,0.32,0.52
PF09391,PF00533:PF12738:PF10144:PF01845:PF13936,0,57,0,0,57,961,0.0,0.94,0,0,5,0,0,5,1013,0.0,1.0,0,0
PF15231,PF10856:PF15685:PF15060:PF02951:PF06592,0,5,0,0,5,1013,0.0,1.0,0,0,0,0,0,0,1018,0,1.0,0,0
PF04798,PF09585:PF02655:PF16001:PF02977:PF11405,0,4,0,0,4,1014,0.0,1.0,0,0,0,0,0,0,1018,0,1.0,0,0
PF14662,PF14722:PF10377:PF14738:PF16043:PF11500,2,17,1,1,16,1000,0.06,0.98,0.5,0.17,0,0,2,0,1016,0,1.0,0.0,0
PF13847,PF08241:PF00155:PF05175:PF02353:PF01063,39,163,23,16,140,839,0.14,0.85,0.59,0.23,18,11,28,7,972,0.61,0.97,0.28,0.4
PF16037,PF07240:PF06875:PF15883:PF08040:PF06581,0,1,0,0,1,1017,0.0,1.0,0,0,0,0,0,0,1018,0,1.0,0,0
PF16206,PF16213:PF09324:PF12783:PF14222:PF14225,8,33,8,0,25,985,0.24,0.98,1.0,0.49,12,3,5,9,1001,0.25,0.99,0.38,0.3
PF15342,PF10571:PF00473:PF03193:PF12049:PF02576,4,9,1,3,8,1006,0.11,0.99,0.25,0.16,0,0,4,0,1014,0,1.0,0.0,0
PF13575,PF15097:PF08093:PF17206:PF15355:PF02058,0,4,0,0,4,1014,0.0,1.0,0,0,0,0,0,0,1018,0,1.0,0,0
PF07074,PF14290:PF07495:PF07881:PF06403:PF06514,8,3,0,8,3,1007,0.0,0.99,0.0,-0.0,0,0,8,0,1010,0,0.99,0.0,0
PF00026,PF07966:PF14543:PF00759:PF04505:PF14541,59,51,25,34,26,933,0.49,0.94,0.42,0.42,8,6,53,2,957,0.75,0.95,0.1,0.26
PF05208,PF07096:PF02133:PF01597:PF06172:PF01997,11,51,7,4,44,963,0.14,0.95,0.64,0.28,3,1,10,2,1005,0.33,0.99,0.09,0.17
PF03279,PF11138:PF15480:PF14885:PF16861:PF15032,2,5,0,2,5,1011,0.0,0.99,0.0,-0.0,0,0,2,0,1016,0,1.0,0.0,0
PF11306,PF09922:PF08173:PF00361:PF11046:PF14804,0,27,0,0,27,991,0.0,0.97,0,0,0,0,0,0,1018,0,1.0,0,0
PF14723,PF16756:PF08632:PF15774:PF12443:PF03832,1,9,0,1,9,1008,0.0,0.99,0.0,-0.0,0,0,1,0,1017,0,1.0,0.0,0
PF11549,PF17108:PF10647:PF17005:PF12531:PF12935,1,3,1,0,2,1015,0.33,1.0,1.0,0.58,1,1,0,0,1017,1.0,1.0,1.0,1.0
PF02542,PF07080:PF11909:PF08883:PF15325:PF01128,3,16,3,0,13,1002,0.19,0.99,1.0,0.43,2,1,2,1,1014,0.5,1.0,0.33,0.41
PF10171,PF01776:PF02060:PF00726:PF06679:PF13841,7,9,2,5,7,1004,0.22,0.99,0.29,0.25,0,0,7,0,1011,0,0.99,0.0,0
PF07298,PF09991:PF14279:PF02620:PF12646:PF03703,2,9,0,2,9,1007,0.0,0.99,0.0,-0.0,0,0,2,0,1016,0,1.0,0.0,0
PF06222,PF09722:PF15775:PF04349:PF10618:PF08291,0,0,0,0,0,1018,0,1.0,0,0,0,0,0,0,1018,0,1.0,0,0
PF14290,PF03745:PF17076:PF03238:PF02277:PF06890,0,3,0,0,3,1015,0.0,1.0,0,0,0,0,0,0,1018,0,1.0,0,0
PF12845,PF13870:PF15934:PF06211:PF12709:PF13096,7,6,0,7,6,1005,0.0,0.99,0.0,-0.01,0,0,7,0,1011,0,0.99,0.0,0
PF05656,PF15224:PF16168:PF12446:PF15464:PF08093,0,1,0,0,1,1017,0.0,1.0,0,0,0,0,0,0,1018,0,1.0,0,0
PF06165,PF17167:PF08302:PF09511:PF16761:PF12381,3,19,3,0,16,999,0.16,0.98,1.0,0.39,1,1,2,0,1015,1.0,1.0,0.33,0.58
PF02689,PF05970:PF13538:PF14214:PF04843:PF01443,7,54,7,0,47,964,0.13,0.95,1.0,0.35,5,2,5,3,1008,0.4,0.99,0.29,0.33
PF01641,PF05047:PF01625:PF01192:PF03501:PF01470,9,36,3,6,33,976,0.08,0.96,0.33,0.15,4,1,8,3,1006,0.25,0.99,0.11,0.16
PF08543,PF03070:PF02110:PF02152:PF05004:PF02581,18,32,13,5,19,981,0.41,0.98,0.72,0.53,2,2,16,0,1000,1.0,0.98,0.11,0.33
PF12585,PF08591:PF07961:PF10454:PF07464:PF08656,2,3,1,1,2,1014,0.33,1.0,0.5,0.41,0,0,2,0,1016,0,1.0,0.0,0
PF04042,PF00429:PF15072:PF03435:PF01399:PF07779,27,79,13,14,66,925,0.16,0.92,0.48,0.25,7,6,21,1,990,0.86,0.98,0.22,0.43
PF12409,PF12515:PF12424:PF09040:PF08282:PF02130,14,35,6,8,29,975,0.17,0.96,0.43,0.26,2,2,12,0,1004,1.0,0.99,0.14,0.38
PF15159,PF01316:PF12158:PF15505:PF00770:PF05355,1,6,0,1,6,1011,0.0,0.99,0.0,-0.0,0,0,1,0,1017,0,1.0,0.0,0
PF07956,PF15302:PF07279:PF03665:PF14931:PF16720,7,7,2,5,5,1006,0.29,0.99,0.29,0.28,0,0,7,0,1011,0,0.99,0.0,0
PF16641,PF01465:PF15908:PF12455:PF03469:PF04388,1,33,1,0,32,985,0.03,0.97,1.0,0.17,2,0,1,2,1015,0.0,1.0,0.0,-0.0
PF11601,PF11879:PF11933:PF11404:PF16885:PF03521,3,10,3,0,7,1008,0.3,0.99,1.0,0.55,1,1,2,0,1015,1.0,1.0,0.33,0.58
PF14671,PF09192:PF01331:PF07655:PF02940:PF16561,4,36,3,1,33,981,0.08,0.97,0.75,0.24,1,1,3,0,1014,1.0,1.0,0.25,0.5
PF16991,PF17007:PF05466:PF13505:PF06744:PF09249,0,2,0,0,2,1016,0.0,1.0,0,0,0,0,0,0,1018,0,1.0,0,0
PF09044,PF04232:PF15872:PF17085:PF16829:PF07279,2,4,0,2,4,1012,0.0,0.99,0.0,-0.0,0,0,2,0,1016,0,1.0,0.0,0
PF02718,PF01340:PF06185:PF03038:PF10946:PF08117,0,2,0,0,2,1016,0.0,1.0,0,0,0,0,0,0,1018,0,1.0,0,0
PF15157,PF10206:PF10014:PF08642:PF15050:PF02950,2,7,1,1,6,1010,0.14,0.99,0.5,0.26,1,1,1,0,1016,1.0,1.0,0.5,0.71
PF15764,PF15553:PF06485:PF15379:PF16036:PF11652,1,9,1,0,8,1009,0.11,0.99,1.0,0.33,0,0,1,0,1017,0,1.0,0.0,0
PF03562,PF08479:PF11304:PF05857:PF04865:PF11751,1,0,0,1,0,1017,0,1.0,0.0,0,0,0,1,0,1017,0,1.0,0.0,0
PF00191,PF08378:PF13344:PF10151:PF17039:PF02800,24,54,16,8,38,956,0.3,0.95,0.67,0.43,8,7,17,1,993,0.88,0.98,0.29,0.5
PF04444,PF10437:PF04572:PF17132:PF02537:PF01450,17,25,4,13,21,980,0.16,0.97,0.24,0.18,0,0,17,0,1001,0,0.98,0.0,0
PF13985,PF12431:PF01339:PF08667:PF12532:PF04397,1,7,0,1,7,1010,0.0,0.99,0.0,-0.0,0,0,1,0,1017,0,1.0,0.0,0
PF00199,PF06628:PF01965:PF01315:PF03492:PF02738,20,59,19,1,40,958,0.32,0.96,0.95,0.54,13,5,15,8,990,0.38,0.98,0.25,0.3
PF07004,PF04693:PF08535:PF12201:PF13103:PF07419,13,5,1,12,4,1001,0.2,0.98,0.08,0.12,0,0,13,0,1005,0,0.99,0.0,0
PF03985,PF00074:PF02422:PF06373:PF05216:PF05267,10,12,2,8,10,998,0.17,0.98,0.2,0.17,0,0,10,0,1008,0,0.99,0.0,0
PF15327,PF16051:PF09444:PF05547:PF15379:PF09818,2,3,0,2,3,1013,0.0,1.0,0.0,-0.0,0,0,2,0,1016,0,1.0,0.0,0
PF08298,PF14841:PF03241:PF07411:PF14842:PF03428,0,1,0,0,1,1017,0.0,1.0,0,0,0,0,0,0,1018,0,1.0,0,0
PF02761,PF02762:PF02262:PF08295:PF16879:PF04571,6,27,6,0,21,991,0.22,0.98,1.0,0.47,4,3,3,1,1011,0.75,1.0,0.5,0.61
PF08388,PF13655:PF06817:PF08284:PF01844:PF00552,6,32,6,0,26,986,0.19,0.97,1.0,0.43,4,3,3,1,1011,0.75,1.0,0.5,0.61
PF08719,PF01872:PF00383:PF08211:PF01249:PF01928,19,58,12,7,46,953,0.21,0.95,0.63,0.34,4,3,16,1,998,0.75,0.98,0.16,0.34
PF11717,PF01853:PF01388:PF08169:PF12701:PF01530,26,67,20,6,47,945,0.3,0.95,0.77,0.46,8,7,19,1,991,0.88,0.98,0.27,0.48
PF10456,PF08944:PF16621:PF12825:PF09325:PF13924,14,25,5,9,20,984,0.2,0.97,0.36,0.25,3,3,11,0,1004,1.0,0.99,0.21,0.46
PF02013,PF02156:PF16990:PF00734:PF03442:PF01341,5,44,5,0,39,974,0.11,0.96,1.0,0.33,6,3,2,3,1010,0.5,1.0,0.6,0.55
PF01265,PF09468:PF06172:PF06388:PF07106:PF04176,17,20,4,13,16,985,0.2,0.97,0.24,0.2,1,1,16,0,1001,1.0,0.98,0.06,0.24
PF15440,PF07260:PF07139:PF09755:PF15242:PF00473,3,13,3,0,10,1005,0.23,0.99,1.0,0.48,1,1,2,0,1015,1.0,1.0,0.33,0.58
PF12307,PF08808:PF17076:PF03244:PF02742:PF15976,2,3,0,2,3,1013,0.0,1.0,0.0,-0.0,0,0,2,0,1016,0,1.0,0.0,0
PF02979,PF02277:PF06890:PF17188:PF15817:PF07499,3,6,0,3,6,1009,0.0,0.99,0.0,-0.0,0,0,3,0,1015,0,1.0,0.0,0
PF05355,PF15119:PF02087:PF17124:PF14866:PF11771,3,3,1,2,2,1013,0.33,1.0,0.33,0.33,0,0,3,0,1015,0,1.0,0.0,0
PF00860,PF04724:PF02705:PF01866:PF12899:PF11744,31,32,9,22,23,964,0.28,0.96,0.29,0.26,2,2,29,0,987,1.0,0.97,0.06,0.25
PF00390,PF03949:PF04515:PF16401:PF01285:PF13824,19,32,14,5,18,981,0.44,0.98,0.74,0.56,2,1,18,1,998,0.5,0.98,0.05,0.16
PF16178,PF04547:PF04842:PF14288:PF15027:PF13355,10,31,9,1,22,986,0.29,0.98,0.9,0.5,1,1,9,0,1008,1.0,0.99,0.1,0.31
PF10426,PF12940:PF04757:PF08652:PF06237:PF05241,4,40,4,0,36,978,0.1,0.96,1.0,0.31,1,1,3,0,1014,1.0,1.0,0.25,0.5
PF10191,PF15964:PF00680:PF00073:PF14674:PF01043,7,15,4,3,11,1000,0.27,0.99,0.57,0.38,0,0,7,0,1011,0,0.99,0.0,0
PF04839,PF00468:PF00127:PF10542:PF15305:PF14279,1,10,1,0,9,1008,0.1,0.99,1.0,0.31,0,0,1,0,1017,0,1.0,0.0,0
PF05277,PF06463:PF04055:PF08600:PF03474:PF06886,17,68,8,9,60,941,0.12,0.93,0.47,0.21,1,0,17,1,1000,0.0,0.98,0.0,-0.0
PF14292,PF12080:PF15750:PF09829:PF13722:PF14711,1,1,0,1,1,1016,0.0,1.0,0.0,-0.0,0,0,1,0,1017,0,1.0,0.0,0
PF05428,PF04452:PF15289:PF09991:PF15973:PF06756,1,2,0,1,2,1015,0.0,1.0,0.0,-0.0,0,0,1,0,1017,0,1.0,0.0,0
PF10453,PF09816:PF08634:PF03467:PF12540:PF04087,7,16,1,6,15,996,0.06,0.98,0.14,0.09,1,0,7,1,1010,0.0,0.99,0.0,-0.0
PF05856,PF11017:PF13550:PF15668:PF14931:PF07464,6,4,0,6,4,1008,0.0,0.99,0.0,-0.0,0,0,6,0,1012,0,0.99,0.0,0
PF15750,PF05857:PF02951:PF14882:PF04865:PF08299,1,5,0,1,5,1012,0.0,0.99,0.0,-0.0,0,0,1,0,1017,0,1.0,0.0,0
PF14114,PF10566:PF07505:PF06007:PF06450:PF03428,1,3,0,1,3,1014,0.0,1.0,0.0,-0.0,0,0,1,0,1017,0,1.0,0.0,0
PF15821,PF15934:PF11831:PF15453:PF11291:PF10375,0,12,0,0,12,1006,0.0,0.99,0,0,0,0,0,0,1018,0,1.0,0,0
PF12919,PF06651:PF09669:PF03745:PF05962:PF11863,1,2,0,1,2,1015,0.0,1.0,0.0,-0.0,0,0,1,0,1017,0,1.0,0.0,0
PF05972,PF05923:PF05924:PF16704:PF12340:PF15804,7,17,7,0,10,1001,0.41,0.99,1.0,0.64,2,2,5,0,1011,1.0,1.0,0.29,0.53
PF15836,PF04352:PF12778:PF17092:PF15092:PF09204,1,7,0,1,7,1010,0.0,0.99,0.0,-0.0,0,0,1,0,1017,0,1.0,0.0,0
PF14047,PF14049:PF10488:PF10472:PF03458:PF15805,0,2,0,0,2,1016,0.0,1.0,0,0,0,0,0,0,1018,0,1.0,0,0
PF06220,PF12237:PF09445:PF10453:PF01846:PF10258,33,33,12,21,21,964,0.36,0.96,0.36,0.34,6,4,29,2,983,0.67,0.97,0.12,0.28
PF09227,PF00796:PF05728:PF08040:PF15182:PF12827,0,5,0,0,5,1013,0.0,1.0,0,0,0,0,0,0,1018,0,1.0,0,0
PF05786,PF02055:PF01288:PF02152:PF00809:PF01645,3,39,2,1,37,978,0.05,0.96,0.67,0.18,7,1,2,6,1009,0.14,0.99,0.33,0.21
PF03612,PF03829:PF03608:PF00455:PF08220:PF12488,2,6,2,0,4,1012,0.33,1.0,1.0,0.58,2,2,0,0,1016,1.0,1.0,1.0,1.0
PF03161,PF00831:PF06645:PF10775:PF08536:PF01279,9,19,1,8,18,991,0.05,0.97,0.11,0.06,0,0,9,0,1009,0,0.99,0.0,0
PF02714,PF13967:PF14703:PF12621:PF15783:PF15149,22,23,21,1,2,994,0.91,1.0,0.95,0.93,10,10,12,0,996,1.0,0.99,0.45,0.67
PF14255,PF03244:PF17076:PF15281:PF04342:PF15186,0,4,0,0,4,1014,0.0,1.0,0,0,0,0,0,0,1018,0,1.0,0,0
PF13372,PF00288:PF02826:PF13905:PF05199:PF13419,0,132,0,0,132,886,0.0,0.87,0,0,21,0,0,21,997,0.0,0.98,0,0
PF15847,PF08291:PF05962:PF14344:PF10951:PF11272,3,1,0,3,1,1014,0.0,1.0,0.0,-0.0,0,0,3,0,1015,0,1.0,0.0,0
PF08218,PF15815:PF08625:PF00642:PF17025:PF08941,1,76,0,1,76,941,0.0,0.92,0.0,-0.01,2,0,1,2,1015,0.0,1.0,0.0,-0.0
PF04351,PF11741:PF04350:PF08808:PF04466:PF03241,0,0,0,0,0,1018,0,1.0,0,0,0,0,0,0,1018,0,1.0,0,0
PF15374,PF16829:PF15238:PF15872:PF06429:PF05594,0,3,0,0,3,1015,0.0,1.0,0,0,0,0,0,0,1018,0,1.0,0,0
PF01565,PF04030:PF08031:PF09265:PF03109:PF06985,105,111,74,31,37,876,0.67,0.93,0.7,0.65,22,22,83,0,913,1.0,0.92,0.21,0.44
PF03358,PF06244:PF01987:PF04667:PF01627:PF00436,16,42,7,9,35,967,0.17,0.96,0.44,0.25,3,3,13,0,1002,1.0,0.99,0.19,0.43
PF08161,PF14952:PF12432:PF12169:PF10395:PF12231,5,10,2,3,8,1005,0.2,0.99,0.4,0.28,0,0,5,0,1013,0,1.0,0.0,0
PF12481,PF04690:PF08315:PF00733:PF07127:PF01195,8,40,4,4,36,974,0.1,0.96,0.5,0.21,3,1,7,2,1008,0.33,0.99,0.12,0.2
PF08751,PF13610:PF15662:PF15155:PF01882:PF03090,4,5,0,4,5,1009,0.0,0.99,0.0,-0.0,0,0,4,0,1014,0,1.0,0.0,0
PF04935,PF09511:PF08302:PF08303:PF03632:PF16875,8,19,0,8,19,991,0.0,0.97,0.0,-0.01,3,0,8,3,1007,0.0,0.99,0.0,-0.0
PF03314,PF02098:PF10323:PF10328:PF01674:PF10185,4,30,1,3,29,985,0.03,0.97,0.25,0.08,2,0,4,2,1012,0.0,0.99,0.0,-0.0
PF04789,PF15134:PF15068:PF16576:PF02073:PF15703,1,4,0,1,4,1013,0.0,1.0,0.0,-0.0,0,0,1,0,1017,0,1.0,0.0,0
PF03120,PF01653:PF03119:PF08605:PF11626:PF08599,6,13,6,0,7,1005,0.46,0.99,1.0,0.68,2,2,4,0,1012,1.0,1.0,0.33,0.58
PF16032,PF16003:PF03934:PF05134:PF06429:PF11690,0,5,0,0,5,1013,0.0,1.0,0,0,0,0,0,0,1018,0,1.0,0,0
PF12131,PF08773:PF08127:PF11705:PF03301:PF15371,2,18,2,0,16,1000,0.11,0.98,1.0,0.33,1,1,1,0,1016,1.0,1.0,0.5,0.71
PF00931,PF07725:PF01582:PF11835:PF07819:PF12061,82,49,33,49,16,920,0.67,0.94,0.4,0.49,4,4,78,0,936,1.0,0.92,0.05,0.21
PF03029,PF10178:PF00398:PF08231:PF09813:PF04900,22,44,12,10,32,964,0.27,0.96,0.55,0.37,2,2,20,0,996,1.0,0.98,0.09,0.3
PF15676,PF15134:PF11111:PF09074:PF01051:PF17022,0,3,0,0,3,1015,0.0,1.0,0,0,0,0,0,0,1018,0,1.0,0,0
PF14618,PF17124:PF09232:PF15055:PF02427:PF09690,0,0,0,0,0,1018,0,1.0,0,0,0,0,0,0,1018,0,1.0,0,0
PF07766,PF01985:PF13863:PF09730:PF04388:PF11559,15,29,6,9,23,980,0.21,0.97,0.4,0.27,2,2,13,0,1003,1.0,0.99,0.13,0.36
PF06945,PF17017:PF12615:PF05939:PF04445:PF05547,0,3,0,0,3,1015,0.0,1.0,0,0,0,0,0,0,1018,0,1.0,0,0
PF00005,PF06422:PF06472:PF14510:PF08370:PF00496,168,39,32,136,7,843,0.82,0.86,0.19,0.35,4,4,164,0,850,1.0,0.84,0.02,0.14
PF10496,PF05334:PF04087:PF12253:PF08634:PF12948,14,6,1,13,5,999,0.17,0.98,0.07,0.1,0,0,14,0,1004,0,0.99,0.0,0
PF11792,PF13403:PF15659:PF11585:PF10991:PF14066,0,0,0,0,0,1018,0,1.0,0,0,0,0,0,0,1018,0,1.0,0,0
PF09079,PF16725:PF14630:PF12002:PF08519:PF16193,10,30,3,7,27,981,0.1,0.97,0.3,0.16,5,2,8,3,1005,0.4,0.99,0.2,0.28
PF16530,PF11057:PF15837:PF08040:PF09997:PF15212,0,1,0,0,1,1017,0.0,1.0,0,0,0,0,0,0,1018,0,1.0,0,0
PF08826,PF12179:PF14593:PF12202:PF08311:PF11629,5,17,4,1,13,1000,0.24,0.99,0.8,0.43,3,3,2,0,1013,1.0,1.0,0.6,0.77
PF03406,PF09498:PF07805:PF14882:PF01706:PF03090,0,2,0,0,2,1016,0.0,1.0,0,0,0,0,0,0,1018,0,1.0,0,0
PF05299,PF05707:PF11245:PF08744:PF12477:PF03090,0,0,0,0,0,1018,0,1.0,0,0,0,0,0,0,1018,0,1.0,0,0
PF15629,PF15628:PF07394:PF00073:PF12381:PF08762,0,19,0,0,19,999,0.0,0.98,0,0,4,0,0,4,1014,0.0,1.0,0,0
PF14732,PF16191:PF16190:PF10585:PF00899:PF09358,7,57,7,0,50,961,0.12,0.95,1.0,0.34,4,1,6,3,1008,0.25,0.99,0.14,0.18
PF15505,PF15119:PF00770:PF14866:PF15141:PF14251,1,4,0,1,4,1013,0.0,1.0,0.0,-0.0,0,0,1,0,1017,0,1.0,0.0,0
PF11995,PF13118:PF14739:PF13931:PF05762:PF09247,4,12,3,1,9,1005,0.25,0.99,0.75,0.43,3,3,1,0,1014,1.0,1.0,0.75,0.87
PF12872,PF01936:PF17182:PF14418:PF11608:PF00567,13,38,8,5,30,975,0.21,0.97,0.62,0.35,3,2,11,1,1004,0.67,0.99,0.15,0.32
PF15064,PF05111:PF00865:PF02106:PF15467:PF02057,2,2,0,2,2,1014,0.0,1.0,0.0,-0.0,0,0,2,0,1016,0,1.0,0.0,0
PF07889,PF13225:PF11833:PF07816:PF01632:PF10218,12,12,3,9,9,997,0.25,0.98,0.25,0.24,0,0,12,0,1006,0,0.99,0.0,0
PF16233,PF16899:PF12428:PF04874:PF16500:PF14433,0,20,0,0,20,998,0.0,0.98,0,0,0,0,0,0,1018,0,1.0,0,0
PF00401,PF16886:PF12338:PF09323:PF09284:PF02268,1,32,1,0,31,986,0.03,0.97,1.0,0.17,1,1,0,0,1017,1.0,1.0,1.0,1.0
PF00485,PF01928:PF04859:PF03081:PF08652:PF01432,25,45,14,11,31,962,0.31,0.96,0.56,0.4,3,3,22,0,993,1.0,0.98,0.12,0.34
PF01152,PF00537:PF07740:PF01241:PF06541:PF12638,7,6,2,5,4,1007,0.33,0.99,0.29,0.3,0,0,7,0,1011,0,0.99,0.0,0
PF12384,PF05869:PF02337:PF15435:PF08284:PF03716,2,28,2,0,26,990,0.07,0.97,1.0,0.26,2,2,0,0,1016,1.0,1.0,1.0,1.0
PF12773,PF13287:PF16700:PF15808:PF00710:PF16553,3,24,3,0,21,994,0.12,0.98,1.0,0.35,1,1,2,0,1015,1.0,1.0,0.33,0.58
PF06431,PF02217:PF00669:PF14251:PF15775:PF10566,3,6,3,0,3,1012,0.5,1.0,1.0,0.71,0,0,3,0,1015,0,1.0,0.0,0
PF11443,PF03059:PF02684:PF04863:PF03030:PF00407,6,20,1,5,19,993,0.05,0.98,0.17,0.08,1,1,5,0,1012,1.0,1.0,0.17,0.41
PF01659,PF06412:PF10717:PF03531:PF16953:PF00016,0,25,0,0,25,993,0.0,0.98,0,0,0,0,0,0,1018,0,1.0,0,0
PF13396,PF10295:PF14040:PF08208:PF15749:PF09861,0,11,0,0,11,1007,0.0,0.99,0,0,0,0,0,0,1018,0,1.0,0,0
PF02812,PF05088:PF00208:PF02781:PF05221:PF06146,14,35,14,0,21,983,0.4,0.98,1.0,0.63,4,3,11,1,1003,0.75,0.99,0.21,0.4
PF05366,PF05541:PF01361:PF05937:PF05956:PF05792,1,4,0,1,4,1013,0.0,1.0,0.0,-0.0,0,0,1,0,1017,0,1.0,0.0,0
PF04484,PF12023:PF07011:PF06351:PF06232:PF01716,8,9,2,6,7,1003,0.22,0.99,0.25,0.23,0,0,8,0,1010,0,0.99,0.0,0
PF03455,PF03456:PF02141:PF10240:PF02893:PF02759,15,81,15,0,66,937,0.19,0.94,1.0,0.42,16,8,7,8,995,0.5,0.99,0.53,0.51
PF09851,PF05488:PF06210:PF11363:PF08595:PF08744,4,7,2,2,5,1009,0.29,0.99,0.5,0.37,0,0,4,0,1014,0,1.0,0.0,0
PF07413,PF17031:PF08879:PF03127:PF03759:PF05770,0,27,0,0,27,991,0.0,0.97,0,0,2,0,0,2,1016,0.0,1.0,0,0
PF13023,PF00831:PF08315:PF00159:PF08583:PF07106,9,39,5,4,34,975,0.13,0.96,0.56,0.25,3,3,6,0,1009,1.0,0.99,0.33,0.58
PF07112,PF07390:PF09361:PF01913:PF12477:PF15001,0,2,0,0,2,1016,0.0,1.0,0,0,0,0,0,0,1018,0,1.0,0,0
PF15138,PF07400:PF15211:PF14984:PF08792:PF15129,1,1,0,1,1,1016,0.0,1.0,0.0,-0.0,0,0,1,0,1017,0,1.0,0.0,0
PF08446,PF00672:PF08448:PF00512:PF13188:PF00158,13,53,13,0,40,965,0.25,0.96,1.0,0.49,9,7,6,2,1003,0.78,0.99,0.54,0.64
PF00058,PF16472:PF12662:PF07593:PF00057:PF12947,21,86,18,3,68,929,0.21,0.93,0.86,0.4,11,8,13,3,994,0.73,0.98,0.38,0.52
PF03205,PF02217:PF06744:PF03743:PF04954:PF06505,1,8,0,1,8,1009,0.0,0.99,0.0,-0.0,0,0,1,0,1017,0,1.0,0.0,0
PF00284,PF00223:PF00283:PF02419:PF00124:PF00119,2,16,1,1,15,1001,0.06,0.98,0.5,0.17,0,0,2,0,1016,0,1.0,0.0,0
PF06990,PF01244:PF02245:PF04006:PF00287:PF10510,13,40,7,6,33,972,0.17,0.96,0.54,0.29,3,2,11,1,1004,0.67,0.99,0.15,0.32
PF06505,PF06070:PF17206:PF01913:PF01580:PF10566,0,7,0,0,7,1011,0.0,0.99,0,0,0,0,0,0,1018,0,1.0,0,0
PF08690,PF05824:PF17050:PF08738:PF17124:PF02943,2,4,1,1,3,1013,0.25,1.0,0.5,0.35,0,0,2,0,1016,0,1.0,0.0,0
PF10307,PF10198:PF10446:PF05508:PF08624:PF09463,1,8,0,1,8,1009,0.0,0.99,0.0,-0.0,1,0,1,1,1016,0.0,1.0,0.0,-0.0
PF06695,PF15062:PF10063:PF11016:PF02361:PF02427,0,8,0,0,8,1010,0.0,0.99,0,0,0,0,0,0,1018,0,1.0,0,0
PF15057,PF13757:PF14771:PF08487:PF13768:PF14624,9,24,7,2,17,992,0.29,0.98,0.78,0.47,4,3,6,1,1008,0.75,0.99,0.33,0.5
PF15434,PF03745:PF17076:PF09669:PF09428:PF15340,1,4,0,1,4,1013,0.0,1.0,0.0,-0.0,0,0,1,0,1017,0,1.0,0.0,0
PF06143,PF00752:PF06916:PF14063:PF01401:PF08249,0,45,0,0,45,973,0.0,0.96,0,0,1,0,0,1,1017,0.0,1.0,0,0
PF06756,PF01810:PF11272:PF10951:PF03406:PF05939,0,8,0,0,8,1010,0.0,0.99,0,0,0,0,0,0,1018,0,1.0,0,0
PF04603,PF01774:PF02284:PF06108:PF11779:PF00321,4,20,2,2,18,996,0.1,0.98,0.5,0.22,0,0,4,0,1014,0,1.0,0.0,0
PF06858,PF08155:PF10179:PF02421:PF14868:PF10156,22,24,16,6,8,988,0.67,0.99,0.73,0.69,0,0,22,0,996,0,0.98,0.0,0
PF17157,PF16931:PF15039:PF02122:PF12255:PF06451,0,1,0,0,1,1017,0.0,1.0,0,0,0,0,0,0,1018,0,1.0,0,0
PF15747,PF15730:PF15080:PF12873:PF15343:PF15169,0,2,0,0,2,1016,0.0,1.0,0,0,0,0,0,0,1018,0,1.0,0,0
PF10623,PF04076:PF04740:PF15337:PF05065:PF07404,0,5,0,0,5,1013,0.0,1.0,0,0,0,0,0,0,1018,0,1.0,0,0
PF01011,PF13570:PF13360:PF07774:PF06464:PF16177,9,45,9,0,36,973,0.2,0.96,1.0,0.44,6,3,6,3,1006,0.5,0.99,0.33,0.4
PF00759,PF09478:PF00553:PF07855:PF02927:PF07966,19,19,5,14,14,985,0.26,0.97,0.26,0.25,1,1,18,0,999,1.0,0.98,0.05,0.23
PF01036,PF01987:PF09769:PF01627:PF06799:PF05281,9,15,3,6,12,997,0.2,0.98,0.33,0.25,2,2,7,0,1009,1.0,0.99,0.22,0.47
PF01795,PF02381:PF10512:PF00707:PF04719:PF09924,15,21,7,8,14,989,0.33,0.98,0.47,0.38,1,1,14,0,1003,1.0,0.99,0.07,0.26
PF15796,PF08912:PF15368:PF07765:PF11577:PF08587,4,23,4,0,19,995,0.17,0.98,1.0,0.41,3,3,1,0,1014,1.0,1.0,0.75,0.87
PF11260,PF12042:PF16763:PF03382:PF11466:PF03458,0,4,0,0,4,1014,0.0,1.0,0,0,0,0,0,0,1018,0,1.0,0,0
PF03157,PF13402:PF02769:PF16327:PF16748:PF15627,1,22,0,1,22,995,0.0,0.98,0.0,-0.0,0,0,1,0,1017,0,1.0,0.0,0
PF10452,PF03553:PF03275:PF15175:PF17062:PF15743,2,2,0,2,2,1014,0.0,1.0,0.0,-0.0,0,0,2,0,1016,0,1.0,0.0,0
PF07859,PF06350:PF06979:PF01063:PF00326:PF00930,69,62,24,45,38,911,0.39,0.92,0.35,0.32,6,6,63,0,949,1.0,0.94,0.09,0.29
PF14901,PF14308:PF05207:PF00684:PF09350:PF15990,2,29,2,0,27,989,0.07,0.97,1.0,0.26,1,0,2,1,1015,0.0,1.0,0.0,-0.0
PF12843,PF09951:PF08744:PF07209:PF08453:PF03525,0,3,0,0,3,1015,0.0,1.0,0,0,0,0,0,0,1018,0,1.0,0,0
PF01835,PF07677:PF07703:PF07678:PF10569:PF00207,9,21,9,0,12,997,0.43,0.99,1.0,0.65,12,9,0,3,1006,0.75,1.0,1.0,0.86
PF06794,PF14048:PF01429:PF12232:PF12533:PF01586,0,33,0,0,33,985,0.0,0.97,0,0,2,0,0,2,1016,0.0,1.0,0,0
PF15487,PF09310:PF09372:PF15898:PF11929:PF16553,3,5,1,2,4,1011,0.2,0.99,0.33,0.26,1,1,2,0,1015,1.0,1.0,0.33,0.58
PF15345,PF02253:PF15169:PF15750:PF04624:PF11138,1,3,0,1,3,1014,0.0,1.0,0.0,-0.0,0,0,1,0,1017,0,1.0,0.0,0
PF06865,PF09510:PF11214:PF02601:PF14344:PF11162,0,2,0,0,2,1016,0.0,1.0,0,0,0,0,0,0,1018,0,1.0,0,0
PF05308,PF14798:PF05197:PF07406:PF03298:PF15388,3,11,1,2,10,1005,0.09,0.99,0.33,0.17,1,1,2,0,1015,1.0,1.0,0.33,0.58
PF06197,PF09699:PF09614:PF00555:PF15545:PF12343,0,3,0,0,3,1015,0.0,1.0,0,0,0,0,0,0,1018,0,1.0,0,0
PF04252,PF08345:PF12080:PF14292:PF06131:PF15272,4,4,0,4,4,1010,0.0,0.99,0.0,-0.0,0,0,4,0,1014,0,1.0,0.0,0
PF02138,PF06469:PF14844:PF15787:PF02893:PF12657,34,56,24,10,32,952,0.43,0.96,0.71,0.53,4,4,30,0,984,1.0,0.97,0.12,0.34
PF14892,PF15559:PF00489:PF15339:PF02448:PF04402,4,7,1,3,6,1008,0.14,0.99,0.25,0.18,0,0,4,0,1014,0,1.0,0.0,0
PF13276,PF02022:PF01623:PF01141:PF09337:PF00552,7,15,2,5,13,998,0.13,0.98,0.29,0.19,4,0,7,4,1007,0.0,0.99,0.0,-0.01
PF09261,PF07748:PF01074:PF08541:PF08825:PF00186,21,37,20,1,17,980,0.54,0.98,0.95,0.71,5,5,16,0,997,1.0,0.98,0.24,0.48
PF04679,PF01068:PF10345:PF14743:PF04675:PF11411,18,19,18,0,1,999,0.95,1.0,1.0,0.97,8,7,11,1,999,0.88,0.99,0.39,0.58
PF03749,PF03601:PF17015:PF12628:PF15553:PF08795,2,0,0,2,0,1016,0,1.0,0.0,0,0,0,2,0,1016,0,1.0,0.0,0
PF15951,PF11851:PF01056:PF09427:PF14215:PF15372,3,20,2,1,18,997,0.1,0.98,0.67,0.25,1,1,2,0,1015,1.0,1.0,0.33,0.58
PF02426,PF03831:PF08274:PF02719:PF16216:PF06995,4,4,1,3,3,1011,0.25,0.99,0.25,0.25,0,0,4,0,1014,0,1.0,0.0,0
PF13187,PF13237:PF00507:PF00430:PF00124:PF00499,12,18,8,4,10,996,0.44,0.99,0.67,0.54,1,1,11,0,1006,1.0,0.99,0.08,0.29
PF02992,PF13960:PF13963:PF13952:PF03004:PF13251,13,28,11,2,17,988,0.39,0.98,0.85,0.57,3,3,10,0,1005,1.0,0.99,0.23,0.48
PF02012,PF02333:PF03527:PF15798:PF09992:PF12891,0,11,0,0,11,1007,0.0,0.99,0,0,0,0,0,0,1018,0,1.0,0,0
PF08650,PF16799:PF15318:PF03521:PF11404:PF03520,1,12,1,0,11,1006,0.08,0.99,1.0,0.29,1,1,0,0,1017,1.0,1.0,1.0,1.0
PF00972,PF05857:PF15518:PF05513:PF08021:PF08411,6,3,1,5,2,1010,0.33,0.99,0.17,0.23,0,0,6,0,1012,0,0.99,0.0,0
PF07557,PF06637:PF10506:PF12606:PF11831:PF08573,8,17,0,8,17,993,0.0,0.98,0.0,-0.01,0,0,8,0,1010,0,0.99,0.0,0
PF12356,PF09247:PF09288:PF07202:PF16059:PF07001,5,17,1,4,16,997,0.06,0.98,0.2,0.1,1,1,4,0,1013,1.0,1.0,0.2,0.45
PF11927,PF03162:PF00436:PF07896:PF07816:PF03358,13,34,4,9,30,975,0.12,0.96,0.31,0.17,3,2,11,1,1004,0.67,0.99,0.15,0.32
PF16639,PF01333:PF03118:PF10179:PF08542:PF14868,9,25,5,4,20,989,0.2,0.98,0.56,0.32,0,0,9,0,1009,0,0.99,0.0,0
PF02122,PF07705:PF11138:PF10279:PF03848:PF02635,1,0,0,1,0,1017,0,1.0,0.0,0,0,0,1,0,1017,0,1.0,0.0,0
PF03398,PF14075:PF08313:PF10033:PF05182:PF08729,21,29,6,15,23,974,0.21,0.96,0.29,0.22,1,1,20,0,997,1.0,0.98,0.05,0.22
PF00021,PF02988:PF03821:PF01457:PF02513:PF01630,5,18,2,3,16,997,0.11,0.98,0.4,0.2,0,0,5,0,1013,0,1.0,0.0,0
PF00370,PF02782:PF01144:PF08442:PF02886:PF04043,42,72,35,7,37,939,0.49,0.96,0.83,0.62,7,5,37,2,974,0.71,0.96,0.12,0.28
PF00745,PF05201:PF01488:PF08501:PF01487:PF00275,9,31,8,1,23,986,0.26,0.98,0.89,0.47,12,1,8,11,998,0.08,0.98,0.11,0.09
PF14669,PF15082:PF08183:PF04610:PF04632:PF10407,0,6,0,0,6,1012,0.0,0.99,0,0,0,0,0,0,1018,0,1.0,0,0
PF03902,PF00172:PF02679:PF10703:PF12013:PF16846,4,140,4,0,136,878,0.03,0.87,1.0,0.16,3,3,1,0,1014,1.0,1.0,0.75,0.87
PF11818,PF14684:PF16667:PF15153:PF07016:PF11160,2,2,2,0,0,1016,1.0,1.0,1.0,1.0,0,0,2,0,1016,0,1.0,0.0,0
PF08091,PF11312:PF12840:PF01303:PF17017:PF09365,0,3,0,0,3,1015,0.0,1.0,0,0,0,0,0,0,1018,0,1.0,0,0
PF04525,PF04674:PF04535:PF06749:PF04690:PF01264,4,18,2,2,16,998,0.11,0.98,0.5,0.23,2,2,2,0,1014,1.0,1.0,0.5,0.71
PF15183,PF05387:PF15576:PF15829:PF07392:PF15120,1,2,0,1,2,1015,0.0,1.0,0.0,-0.0,0,0,1,0,1017,0,1.0,0.0,0
PF12259,PF07530:PF16012:PF08284:PF00589:PF03732,5,83,5,0,78,935,0.06,0.92,1.0,0.24,8,4,1,4,1009,0.5,1.0,0.8,0.63
PF10722,PF04222:PF08479:PF00308:PF09826:PF07659,0,7,0,0,7,1011,0.0,0.99,0,0,0,0,0,0,1018,0,1.0,0,0
PF13675,PF12729:PF10279:PF11138:PF04738:PF11019,1,1,1,0,0,1017,1.0,1.0,1.0,1.0,0,0,1,0,1017,0,1.0,0.0,0
PF09596,PF12478:PF15232:PF15888:PF10384:PF15914,1,11,0,1,11,1006,0.0,0.99,0.0,-0.0,1,0,1,1,1016,0.0,1.0,0.0,-0.0
PF16725,PF09262:PF08519:PF09079:PF14532:PF09263,3,31,2,1,29,986,0.06,0.97,0.67,0.2,3,1,2,2,1013,0.33,1.0,0.33,0.33
PF04563,PF04561:PF06883:PF00562:PF10385:PF04560,21,22,16,5,6,991,0.73,0.99,0.76,0.74,8,6,15,2,995,0.75,0.98,0.29,0.46
PF08780,PF13645:PF01111:PF09793:PF07172:PF00159,0,14,0,0,14,1004,0.0,0.99,0,0,1,0,0,1,1017,0.0,1.0,0,0
PF09127,PF11940:PF11838:PF01433:PF03079:PF05347,7,74,7,0,67,944,0.09,0.93,1.0,0.3,16,3,4,13,998,0.19,0.98,0.43,0.28
PF02879,PF02880:PF00408:PF02878:PF08722:PF12696,34,40,33,1,7,977,0.82,0.99,0.97,0.89,26,23,11,3,981,0.88,0.99,0.68,0.77
PF05340,PF03219:PF05021:PF05020:PF10105:PF16044,2,18,1,1,17,999,0.06,0.98,0.5,0.16,3,0,2,3,1013,0.0,1.0,0.0,-0.0
PF01134,PF13932:PF16044:PF03343:PF04113:PF13341,18,31,17,1,14,986,0.55,0.99,0.94,0.71,4,4,14,0,1000,1.0,0.99,0.22,0.47
PF01439,PF05659:PF12061:PF11835:PF12442:PF03842,5,10,3,2,7,1006,0.3,0.99,0.6,0.42,1,1,4,0,1013,1.0,1.0,0.2,0.45
PF15205,PF09252:PF14986:PF03379:PF15055:PF04691,0,2,0,0,2,1016,0.0,1.0,0,0,0,0,0,0,1018,0,1.0,0,0
PF14674,PF14677:PF14680:PF14676:PF14679:PF14675,0,1,0,0,1,1017,0.0,1.0,0,0,1,0,0,1,1017,0.0,1.0,0,0
PF03180,PF16358:PF12241:PF09677:PF03320:PF08274,3,6,0,3,6,1009,0.0,0.99,0.0,-0.0,0,0,3,0,1015,0,1.0,0.0,0
PF00796,PF15207:PF03244:PF15758:PF03548:PF17076,0,4,0,0,4,1014,0.0,1.0,0,0,0,0,0,0,1018,0,1.0,0,0
PF16182,PF02209:PF16923:PF08158:PF04815:PF17167,6,45,3,3,42,970,0.07,0.96,0.5,0.17,3,1,5,2,1010,0.33,0.99,0.17,0.23
PF15688,PF15690:PF15689:PF15687:PF09051:PF09050,0,0,0,0,0,1018,0,1.0,0,0,0,0,0,0,1018,0,1.0,0,0
PF00193,PF09291:PF10570:PF02439:PF02124:PF02480,10,5,2,8,3,1005,0.4,0.99,0.2,0.28,0,0,10,0,1008,0,0.99,0.0,0
PF03991,PF07276:PF06753:PF03578:PF10284:PF10285,0,1,0,0,1,1017,0.0,1.0,0,0,0,0,0,0,1018,0,1.0,0,0
PF00062,PF06189:PF00223:PF05742:PF15008:PF14956,8,13,5,3,8,1002,0.38,0.99,0.62,0.49,0,0,8,0,1010,0,0.99,0.0,0
PF06657,PF10155:PF16545:PF03315:PF16692:PF09305,6,18,1,5,17,995,0.06,0.98,0.17,0.09,0,0,6,0,1012,0,0.99,0.0,0
PF06375,PF14796:PF14807:PF14797:PF09066:PF08752,4,15,4,0,11,1003,0.27,0.99,1.0,0.51,0,0,4,0,1014,0,1.0,0.0,0
PF12192,PF08404:PF15128:PF08497:PF15080:PF15355,0,1,0,0,1,1017,0.0,1.0,0,0,0,0,0,0,1018,0,1.0,0,0
PF11078,PF16176:PF12598:PF00907:PF16059:PF10477,2,24,2,0,22,994,0.08,0.98,1.0,0.29,1,1,1,0,1016,1.0,1.0,0.5,0.71
PF03934,PF02501:PF05134:PF04612:PF08461:PF11612,2,2,2,0,0,1016,1.0,1.0,1.0,1.0,2,2,0,0,1016,1.0,1.0,1.0,1.0
PF11362,PF15398:PF10630:PF02106:PF15087:PF15302,1,2,0,1,2,1015,0.0,1.0,0.0,-0.0,0,0,1,0,1017,0,1.0,0.0,0
PF15261,PF06210:PF00524:PF05065:PF14107:PF05164,1,5,0,1,5,1012,0.0,0.99,0.0,-0.0,0,0,1,0,1017,0,1.0,0.0,0
PF12851,PF15778:PF08729:PF12516:PF15244:PF09416,5,16,3,2,13,1000,0.19,0.99,0.6,0.33,0,0,5,0,1013,0,1.0,0.0,0
PF16990,PF02156:PF02013:PF00734:PF03442:PF12891,7,42,7,0,35,976,0.17,0.97,1.0,0.4,4,4,3,0,1011,1.0,1.0,0.57,0.75
PF14060,PF09685:PF03969:PF06702:PF09095:PF02304,0,24,0,0,24,994,0.0,0.98,0,0,0,0,0,0,1018,0,1.0,0,0
PF04669,PF14159:PF14547:PF01195:PF02681:PF04107,10,15,2,8,13,995,0.13,0.98,0.2,0.15,2,1,9,1,1007,0.5,0.99,0.1,0.22
PF02055,PF17189:PF05786:PF04885:PF16757:PF15048,17,23,13,4,10,991,0.57,0.99,0.76,0.65,0,0,17,0,1001,0,0.98,0.0,0
PF00104,PF00105:PF02166:PF02159:PF14046:PF07786,45,48,40,5,8,965,0.83,0.99,0.89,0.85,5,5,40,0,973,1.0,0.96,0.11,0.33
PF09732,PF09368:PF11970:PF15070:PF15539:PF04266,11,16,3,8,13,994,0.19,0.98,0.27,0.22,0,0,11,0,1007,0,0.99,0.0,0
PF16875,PF16874:PF02065:PF16711:PF16709:PF08303,1,10,1,0,9,1008,0.1,0.99,1.0,0.31,0,0,1,0,1017,0,1.0,0.0,0
PF15245,PF11623:PF03760:PF07797:PF08034:PF11282,0,7,0,0,7,1011,0.0,0.99,0,0,0,0,0,0,1018,0,1.0,0,0
PF04032,PF04640:PF12304:PF01922:PF10775:PF03760,8,14,3,5,11,999,0.21,0.98,0.38,0.28,1,0,8,1,1009,0.0,0.99,0.0,-0.0
PF12503,PF12467:PF14841:PF05016:PF03831:PF02399,5,6,5,0,1,1012,0.83,1.0,1.0,0.91,1,1,4,0,1013,1.0,1.0,0.2,0.45
PF00652,PF00535:PF00161:PF09837:PF15048:PF17039,48,72,38,10,34,936,0.53,0.96,0.79,0.63,5,4,44,1,969,0.8,0.96,0.08,0.25
PF00569,PF16577:PF16158:PF09030:PF08214:PF02135,43,36,22,21,14,961,0.61,0.97,0.51,0.54,8,8,35,0,975,1.0,0.97,0.19,0.42
PF09269,PF15086:PF05128:PF06780:PF08438:PF14714,4,9,3,1,6,1008,0.33,0.99,0.75,0.5,1,1,3,0,1014,1.0,1.0,0.25,0.5
PF16177,PF13193:PF07774:PF00668:PF00501:PF13570,14,129,14,0,115,889,0.11,0.89,1.0,0.31,34,8,6,26,978,0.24,0.97,0.57,0.35
PF17053,PF17049:PF17010:PF15776:PF04848:PF15748,0,6,0,0,6,1012,0.0,0.99,0,0,0,0,0,0,1018,0,1.0,0,0
PF15812,PF00714:PF04856:PF15109:PF02448:PF10716,1,2,0,1,2,1015,0.0,1.0,0.0,-0.0,0,0,1,0,1017,0,1.0,0.0,0
PF12732,PF03865:PF13530:PF05974:PF14564:PF13722,0,3,0,0,3,1015,0.0,1.0,0,0,0,0,0,0,1018,0,1.0,0,0
PF09454,PF05743:PF07334:PF07292:PF02866:PF02082,10,31,10,0,21,987,0.32,0.98,1.0,0.56,1,0,10,1,1007,0.0,0.99,0.0,-0.0
PF09816,PF07545:PF10332:PF13002:PF10188:PF15279,6,5,1,5,4,1008,0.2,0.99,0.17,0.18,0,0,6,0,1012,0,0.99,0.0,0
PF08483,PF05857:PF13247:PF12241:PF14882:PF08411,1,2,0,1,2,1015,0.0,1.0,0.0,-0.0,0,0,1,0,1017,0,1.0,0.0,0
PF12436,PF14533:PF13446:PF06337:PF00917:PF14836,10,41,10,0,31,977,0.24,0.97,1.0,0.49,6,5,5,1,1007,0.83,0.99,0.5,0.64
PF06841,PF02511:PF09428:PF02522:PF07960:PF07589,0,6,0,0,6,1012,0.0,0.99,0,0,0,0,0,0,1018,0,1.0,0,0
PF15720,PF15441:PF06395:PF12015:PF16523:PF09036,1,13,1,0,12,1005,0.08,0.99,1.0,0.28,2,1,0,1,1016,0.5,1.0,1.0,0.71
PF14798,PF05308:PF05197:PF03298:PF01294:PF00048,2,23,2,0,21,995,0.09,0.98,1.0,0.29,1,1,1,0,1016,1.0,1.0,0.5,0.71
PF09538,PF13965:PF01079:PF08399:PF11903:PF16573,0,32,0,0,32,986,0.0,0.97,0,0,2,0,0,2,1016,0.0,1.0,0,0
PF12037,PF14363:PF00004:PF01434:PF02190:PF09336,1,159,1,0,158,859,0.01,0.84,1.0,0.07,20,1,0,19,998,0.05,0.98,1.0,0.22
PF15920,PF16704:PF15253:PF02213:PF15246:PF12887,1,18,0,1,18,999,0.0,0.98,0.0,-0.0,1,0,1,1,1016,0.0,1.0,0.0,-0.0
PF14687,PF14688:PF07837:PF04961:PF02971:PF15350,8,15,8,0,7,1003,0.53,0.99,1.0,0.73,4,1,7,3,1007,0.25,0.99,0.12,0.17
PF10269,PF14901:PF11968:PF06842:PF09320:PF00684,3,28,0,3,28,987,0.0,0.97,0.0,-0.01,1,0,3,1,1014,0.0,1.0,0.0,-0.0
PF09323,PF03123:PF13876:PF14220:PF09648:PF10035,0,7,0,0,7,1011,0.0,0.99,0,0,0,0,0,0,1018,0,1.0,0,0
PF16334,PF17168:PF08760:PF16335:PF14746:PF03894,1,12,1,0,11,1006,0.08,0.99,1.0,0.29,4,1,0,3,1014,0.25,1.0,1.0,0.5
PF01027,PF01248:PF07542:PF04505:PF00828:PF01758,25,72,12,13,60,933,0.17,0.93,0.48,0.25,7,5,20,2,991,0.71,0.98,0.2,0.37
PF00377,PF01620:PF15973:PF11587:PF04452:PF05096,2,5,0,2,5,1011,0.0,0.99,0.0,-0.0,0,0,2,0,1016,0,1.0,0.0,0
PF02749,PF01729:PF12243:PF14693:PF03768:PF05173,10,19,10,0,9,999,0.53,0.99,1.0,0.72,0,0,10,0,1008,0,0.99,0.0,0
PF10513,PF12064:PF12157:PF11467:PF17105:PF00855,24,45,17,7,28,966,0.38,0.97,0.71,0.5,2,2,22,0,994,1.0,0.98,0.08,0.29
PF08495,PF04300:PF10442:PF12014:PF03048:PF09346,4,11,3,1,8,1006,0.27,0.99,0.75,0.45,1,1,3,0,1014,1.0,1.0,0.25,0.5
PF01507,PF00994:PF03453:PF03454:PF05903:PF15928,19,52,8,11,44,955,0.15,0.95,0.42,0.23,14,2,17,12,987,0.14,0.97,0.11,0.11
PF09809,PF04667:PF09769:PF00159:PF16906:PF10780,7,20,2,5,18,993,0.1,0.98,0.29,0.16,1,1,6,0,1011,1.0,0.99,0.14,0.38
PF12624,PF16910:PF16908:PF06650:PF09333:PF16909,27,37,24,3,13,978,0.65,0.98,0.89,0.75,18,13,14,5,986,0.72,0.98,0.48,0.58
PF16174,PF09598:PF02940:PF03715:PF08164:PF03509,1,30,0,1,30,987,0.0,0.97,0.0,-0.01,0,0,1,0,1017,0,1.0,0.0,0
PF04359,PF06485:PF12646:PF03907:PF15062:PF06989,1,5,0,1,5,1012,0.0,0.99,0.0,-0.0,0,0,1,0,1017,0,1.0,0.0,0
PF05535,PF06729:PF04691:PF10454:PF05836:PF09690,0,1,0,0,1,1017,0.0,1.0,0,0,0,0,0,0,1018,0,1.0,0,0
PF01447,PF16485:PF02868:PF00073:PF01989:PF14951,1,15,1,0,14,1003,0.07,0.99,1.0,0.26,0,0,1,0,1017,0,1.0,0.0,0
PF13903,PF03091:PF12020:PF09783:PF07984:PF05871,9,32,2,7,30,979,0.06,0.96,0.22,0.1,2,1,8,1,1008,0.5,0.99,0.11,0.23
PF15769,PF09108:PF03553:PF04625:PF02955:PF15480,0,6,0,0,6,1012,0.0,0.99,0,0,0,0,0,0,1018,0,1.0,0,0
PF03845,PF15518:PF02399:PF03930:PF09829:PF06890,8,3,0,8,3,1007,0.0,0.99,0.0,-0.0,0,0,8,0,1010,0,0.99,0.0,0
PF04707,PF03765:PF13897:PF00650:PF06687:PF10270,13,74,12,1,62,943,0.16,0.94,0.92,0.37,9,5,8,4,1001,0.56,0.99,0.38,0.46
PF16842,PF11627:PF08080:PF12196:PF08143:PF15519,1,11,1,0,10,1007,0.09,0.99,1.0,0.3,1,1,0,0,1017,1.0,1.0,1.0,1.0
PF08903,PF05138:PF10429:PF14715:PF16822:PF16868,0,2,0,0,2,1016,0.0,1.0,0,0,0,0,0,0,1018,0,1.0,0,0
PF03576,PF08738:PF09056:PF12351:PF10340:PF12716,0,7,0,0,7,1011,0.0,0.99,0,0,0,0,0,0,1018,0,1.0,0,0
PF14063,PF06143:PF09643:PF08908:PF07152:PF04961,0,4,0,0,4,1014,0.0,1.0,0,0,0,0,0,0,1018,0,1.0,0,0
PF09325,PF12828:PF12825:PF03700:PF13924:PF00787,19,80,19,0,61,938,0.24,0.94,1.0,0.47,3,2,17,1,998,0.67,0.98,0.11,0.26
PF03743,PF05939:PF08744:PF04740:PF02217:PF01913,7,4,2,5,2,1009,0.5,0.99,0.29,0.37,0,0,7,0,1011,0,0.99,0.0,0
PF05223,PF14344:PF10951:PF07209:PF08497:PF05962,1,2,0,1,2,1015,0.0,1.0,0.0,-0.0,0,0,1,0,1017,0,1.0,0.0,0
PF15630,PF15003:PF03760:PF08649:PF13564:PF12304,5,12,1,4,11,1002,0.08,0.99,0.2,0.12,0,0,5,0,1013,0,1.0,0.0,0
PF01535,PF01048:PF14432:PF02363:PF13762:PF13041,126,139,114,12,25,867,0.82,0.96,0.9,0.84,16,16,110,0,892,1.0,0.89,0.13,0.34
PF09370,PF02091:PF06792:PF15622:PF00517:PF11699,2,17,1,1,16,1000,0.06,0.98,0.5,0.17,0,0,2,0,1016,0,1.0,0.0,0
PF02953,PF04119:PF07706:PF06388:PF04419:PF14712,26,20,7,19,13,979,0.35,0.97,0.27,0.29,1,1,25,0,992,1.0,0.98,0.04,0.19
PF03866,PF13089:PF11892:PF09556:PF07520:PF13610,0,3,0,0,3,1015,0.0,1.0,0,0,0,0,0,0,1018,0,1.0,0,0
PF15429,PF07484:PF09818:PF06798:PF10951:PF17017,1,1,0,1,1,1016,0.0,1.0,0.0,-0.0,0,0,1,0,1017,0,1.0,0.0,0
PF15370,PF15071:PF15359:PF05039:PF07333:PF06351,3,4,0,3,4,1011,0.0,0.99,0.0,-0.0,0,0,3,0,1015,0,1.0,0.0,0
PF04139,PF09755:PF05346:PF04939:PF08316:PF11945,11,31,6,5,25,982,0.19,0.97,0.55,0.31,1,1,10,0,1007,1.0,0.99,0.09,0.3
PF10045,PF08744:PF06651:PF05887:PF02119:PF05901,0,2,0,0,2,1016,0.0,1.0,0,0,0,0,0,0,1018,0,1.0,0,0
PF03110,PF08313:PF05182:PF08729:PF12516:PF10309,5,32,2,3,30,983,0.06,0.97,0.4,0.15,4,2,3,2,1011,0.5,1.0,0.4,0.44
PF08797,PF12054:PF13892:PF15790:PF08774:PF07529,20,36,12,8,24,974,0.33,0.97,0.6,0.43,4,4,16,0,998,1.0,0.98,0.2,0.44
PF02773,PF00438:PF02772:PF02075:PF04862:PF14365,4,11,4,0,7,1007,0.36,0.99,1.0,0.6,3,3,1,0,1014,1.0,1.0,0.75,0.87
PF05562,PF01387:PF12056:PF09778:PF15252:PF09367,3,6,2,1,4,1011,0.33,1.0,0.67,0.47,0,0,3,0,1015,0,1.0,0.0,0
PF01331,PF02940:PF14671:PF03919:PF09192:PF07655,15,22,13,2,9,994,0.59,0.99,0.87,0.71,1,1,14,0,1003,1.0,0.99,0.07,0.26
PF02611,PF05488:PF03065:PF10279:PF15817:PF07157,1,2,0,1,2,1015,0.0,1.0,0.0,-0.0,0,0,1,0,1017,0,1.0,0.0,0
PF12782,PF15362:PF10578:PF02343:PF14692:PF03436,0,3,0,0,3,1015,0.0,1.0,0,0,0,0,0,0,1018,0,1.0,0,0
PF08938,PF06421:PF03144:PF10441:PF15787:PF04760,5,77,4,1,73,940,0.05,0.93,0.8,0.19,6,2,3,4,1009,0.33,0.99,0.4,0.36
PF13460,PF08547:PF01370:PF05368:PF10294:PF00282,49,133,35,14,98,871,0.26,0.89,0.71,0.39,18,15,34,3,966,0.83,0.96,0.31,0.49
PF14665,PF12129:PF10482:PF07001:PF15912:PF15326,0,13,0,0,13,1005,0.0,0.99,0,0,0,0,0,0,1018,0,1.0,0,0
PF08450,PF07350:PF14027:PF00756:PF04199:PF11807,22,42,14,8,28,968,0.33,0.96,0.64,0.44,8,7,15,1,995,0.88,0.98,0.32,0.52
PF02985,PF12755:PF12074:PF08506:PF14538:PF03810,35,65,21,14,44,939,0.32,0.94,0.6,0.41,6,5,30,1,982,0.83,0.97,0.14,0.34
PF00454,PF02259:PF00613:PF00794:PF00792:PF02260,63,59,51,12,8,947,0.86,0.98,0.81,0.83,21,21,42,0,955,1.0,0.96,0.33,0.57
PF16880,PF12761:PF12763:PF04799:PF00350:PF09822,15,80,15,0,65,938,0.19,0.94,1.0,0.42,7,5,10,2,1001,0.71,0.99,0.33,0.48
PF07415,PF08020:PF08686:PF06558:PF16834:PF04341,0,12,0,0,12,1006,0.0,0.99,0,0,0,0,0,0,1018,0,1.0,0,0
PF02818,PF12509:PF09441:PF14644:PF08811:PF15326,4,12,0,4,12,1002,0.0,0.98,0.0,-0.01,0,0,4,0,1014,0,1.0,0.0,0
PF02655,PF06890:PF08334:PF08795:PF02277:PF02413,2,4,0,2,4,1012,0.0,0.99,0.0,-0.0,0,0,2,0,1016,0,1.0,0.0,0
PF00719,PF00886:PF03942:PF00499:PF00213:PF08561,21,36,6,15,30,967,0.17,0.96,0.29,0.2,4,4,17,0,997,1.0,0.98,0.19,0.43
PF13204,PF12904:PF01114:PF15710:PF15302:PF02740,0,1,0,0,1,1017,0.0,1.0,0,0,0,0,0,0,1018,0,1.0,0,0
PF10962,PF12608:PF16639:PF03118:PF11769:PF01719,0,16,0,0,16,1002,0.0,0.98,0,0,0,0,0,0,1018,0,1.0,0,0
PF08507,PF08641:PF10280:PF12638:PF12643:PF11947,6,17,3,3,14,998,0.18,0.98,0.5,0.29,1,1,5,0,1012,1.0,1.0,0.17,0.41
PF01028,PF14370:PF02919:PF05392:PF02987:PF02357,7,12,6,1,6,1005,0.5,0.99,0.86,0.65,0,0,7,0,1011,0,0.99,0.0,0
PF15772,PF15119:PF06729:PF15340:PF09252:PF15192,0,3,0,0,3,1015,0.0,1.0,0,0,0,0,0,0,1018,0,1.0,0,0
PF10044,PF12585:PF15048:PF04138:PF15762:PF09962,0,5,0,0,5,1013,0.0,1.0,0,0,0,0,0,0,1018,0,1.0,0,0
PF08105,PF14200:PF09458:PF03318:PF08152:PF12344,0,27,0,0,27,991,0.0,0.97,0,0,2,0,0,2,1016,0.0,1.0,0,0
PF05874,PF03601:PF15553:PF03544:PF10999:PF15460,1,5,0,1,5,1012,0.0,0.99,0.0,-0.0,0,0,1,0,1017,0,1.0,0.0,0
PF12041,PF03514:PF13922:PF05066:PF12031:PF14309,3,32,1,2,31,984,0.03,0.97,0.33,0.09,4,0,3,4,1011,0.0,0.99,0.0,-0.0
PF01401,PF16959:PF08326:PF00289:PF02626:PF01039,12,53,6,6,47,959,0.11,0.95,0.5,0.22,14,2,10,12,994,0.14,0.98,0.17,0.14
PF03514,PF07887:PF12041:PF03181:PF04601:PF02892,20,35,13,7,22,976,0.37,0.97,0.65,0.48,4,3,17,1,997,0.75,0.98,0.15,0.33
PF00679,PF03764:PF06421:PF14492:PF16004:PF08364,50,51,41,9,10,958,0.8,0.98,0.82,0.8,12,12,38,0,968,1.0,0.96,0.24,0.48
PF00965,PF08561:PF12020:PF04716:PF10853:PF05915,6,19,1,5,18,994,0.05,0.98,0.17,0.08,2,1,5,1,1011,0.5,0.99,0.17,0.29
PF09996,PF15055:PF02202:PF17062:PF05558:PF14021,0,1,0,0,1,1017,0.0,1.0,0,0,0,0,0,0,1018,0,1.0,0,0
PF02616,PF07409:PF07157:PF14882:PF04984:PF08334,0,1,0,0,1,1017,0.0,1.0,0,0,0,0,0,0,1018,0,1.0,0,0
PF00098,PF02093:PF02337:PF07962:PF00607:PF12384,101,15,10,91,5,912,0.67,0.91,0.1,0.23,4,4,97,0,917,1.0,0.9,0.04,0.19
PF16680,PF11628:PF02189:PF00049:PF01296:PF14186,3,16,1,2,15,1000,0.06,0.98,0.33,0.14,1,0,3,1,1014,0.0,1.0,0.0,-0.0
PF12366,PF15927:PF08166:PF11597:PF08167:PF06333,2,15,2,0,13,1003,0.13,0.99,1.0,0.36,3,1,1,2,1014,0.33,1.0,0.5,0.41
PF04419,PF01907:PF07911:PF13564:PF15879:PF06645,11,24,6,5,18,989,0.25,0.98,0.55,0.36,2,2,9,0,1007,1.0,0.99,0.18,0.42
PF08708,PF17206:PF10566:PF03090:PF11751:PF03729,0,1,0,0,1,1017,0.0,1.0,0,0,0,0,0,0,1018,0,1.0,0,0
PF03706,PF06744:PF04865:PF14842:PF01136:PF08479,1,1,0,1,1,1016,0.0,1.0,0.0,-0.0,0,0,1,0,1017,0,1.0,0.0,0
PF14641,PF14632:PF14639:PF14635:PF14878:PF14633,12,14,12,0,2,1004,0.86,1.0,1.0,0.92,13,12,0,1,1005,0.92,1.0,1.0,0.96
PF16922,PF00525:PF10381:PF14803:PF03986:PF08079,6,25,4,2,21,991,0.16,0.98,0.67,0.32,1,1,5,0,1012,1.0,1.0,0.17,0.41
PF10558,PF16860:PF03073:PF02569:PF05197:PF07160,4,22,0,4,22,992,0.0,0.97,0.0,-0.01,0,0,4,0,1014,0,1.0,0.0,0
PF12689,PF09778:PF12223:PF16954:PF07096:PF10317,11,17,4,7,13,994,0.24,0.98,0.36,0.28,0,0,11,0,1007,0,0.99,0.0,0
PF00419,PF02277:PF06890:PF10554:PF03244:PF07409,1,3,0,1,3,1014,0.0,1.0,0.0,-0.0,0,0,1,0,1017,0,1.0,0.0,0
PF08404,PF07804:PF15483:PF08497:PF16325:PF02465,0,3,0,0,3,1015,0.0,1.0,0,0,0,0,0,0,1018,0,1.0,0,0
PF10061,PF12087:PF02577:PF04204:PF02151:PF11403,0,19,0,0,19,999,0.0,0.98,0,0,0,0,0,0,1018,0,1.0,0,0
PF02929,PF16353:PF02837:PF02836:PF16355:PF00703,5,31,5,0,26,987,0.16,0.97,1.0,0.4,14,5,0,9,1004,0.36,0.99,1.0,0.59
PF03803,PF05602:PF04831:PF16317:PF14159:PF01218,12,21,4,8,17,989,0.19,0.98,0.33,0.24,1,1,11,0,1006,1.0,0.99,0.08,0.29
PF11303,PF12328:PF15316:PF15503:PF04483:PF00127,1,11,0,1,11,1006,0.0,0.99,0.0,-0.0,0,0,1,0,1017,0,1.0,0.0,0
PF06035,PF14715:PF03922:PF04349:PF03043:PF07505,0,0,0,0,0,1018,0,1.0,0,0,0,0,0,0,1018,0,1.0,0,0
PF04062,PF07219:PF05527:PF07059:PF07721:PF03029,10,34,3,7,31,977,0.09,0.96,0.3,0.15,1,1,9,0,1008,1.0,0.99,0.1,0.31
PF02317,PF07479:PF07683:PF02132:PF14576:PF09290,7,36,4,3,32,979,0.11,0.97,0.57,0.24,1,0,7,1,1010,0.0,0.99,0.0,-0.0
PF16455,PF01599:PF16843:PF13373:PF09055:PF04758,8,22,3,5,19,991,0.14,0.98,0.38,0.22,1,1,7,0,1010,1.0,0.99,0.12,0.35
PF01302,PF14560:PF16641:PF15898:PF15808:PF11904,46,24,15,31,9,963,0.62,0.96,0.33,0.43,1,1,45,0,972,1.0,0.96,0.02,0.14
PF15705,PF15706:PF16070:PF00963:PF12448:PF16978,2,25,2,0,23,993,0.08,0.98,1.0,0.28,1,0,2,1,1015,0.0,1.0,0.0,-0.0
PF00457,PF10503:PF01083:PF03664:PF01670:PF02015,5,30,5,0,25,988,0.17,0.98,1.0,0.4,3,2,3,1,1012,0.67,1.0,0.4,0.51
PF13947,PF08488:PF14380:PF00139:PF01453:PF08515,19,58,13,6,45,954,0.22,0.95,0.68,0.37,6,6,13,0,999,1.0,0.99,0.32,0.56
PF09292,PF01149:PF06831:PF04422:PF17219:PF09305,4,16,4,0,12,1002,0.25,0.99,1.0,0.5,1,1,3,0,1014,1.0,1.0,0.25,0.5
PF04773,PF09327:PF04546:PF06826:PF03864:PF02748,7,8,3,4,5,1006,0.38,0.99,0.43,0.4,0,0,7,0,1011,0,0.99,0.0,0
PF02881,PF00448:PF02978:PF04086:PF07562:PF05392,31,47,30,1,17,970,0.64,0.98,0.97,0.78,11,11,20,0,987,1.0,0.98,0.35,0.59
PF10664,PF17062:PF03907:PF11371:PF15050:PF14494,1,2,0,1,2,1015,0.0,1.0,0.0,-0.0,0,0,1,0,1017,0,1.0,0.0,0
PF08642,PF15553:PF15460:PF03601:PF05874:PF12628,0,2,0,0,2,1016,0.0,1.0,0,0,0,0,0,0,1018,0,1.0,0,0
PF06251,PF06082:PF11902:PF04865:PF03090:PF07308,0,0,0,0,0,1018,0,1.0,0,0,0,0,0,0,1018,0,1.0,0,0
PF01226,PF15245:PF09716:PF11327:PF07797:PF11309,8,8,2,6,6,1004,0.25,0.99,0.25,0.24,0,0,8,0,1010,0,0.99,0.0,0
PF14861,PF17223:PF14654:PF02451:PF05287:PF07466,0,4,0,0,4,1014,0.0,1.0,0,0,0,0,0,0,1018,0,1.0,0,0
PF08711,PF07500:PF06881:PF15694:PF15693:PF01096,27,27,14,13,13,978,0.52,0.97,0.52,0.51,2,2,25,0,991,1.0,0.98,0.07,0.27
PF01477,PF02010:PF00305:PF08016:PF00151:PF07632,32,66,26,6,40,946,0.39,0.95,0.81,0.55,4,4,28,0,986,1.0,0.97,0.12,0.35
PF12362,PF15182:PF10106:PF09498:PF17206:PF08093,1,3,0,1,3,1014,0.0,1.0,0.0,-0.0,0,0,1,0,1017,0,1.0,0.0,0
PF12600,PF15073:PF04428:PF07282:PF15093:PF16967,0,7,0,0,7,1011,0.0,0.99,0,0,0,0,0,0,1018,0,1.0,0,0
PF03288,PF03745:PF11581:PF15312:PF02070:PF14494,0,0,0,0,0,1018,0,1.0,0,0,0,0,0,0,1018,0,1.0,0,0
PF10075,PF05191:PF09754:PF06244:PF05047:PF06127,13,30,7,6,23,982,0.23,0.97,0.54,0.34,3,3,10,0,1005,1.0,0.99,0.23,0.48
PF04220,PF15556:PF03548:PF03050:PF15772:PF01037,1,6,0,1,6,1011,0.0,0.99,0.0,-0.0,0,0,1,0,1017,0,1.0,0.0,0
PF02757,PF02756:PF00353:PF10937:PF17054:PF08207,1,16,0,1,16,1001,0.0,0.98,0.0,-0.0,0,0,1,0,1017,0,1.0,0.0,0
PF07261,PF15771:PF15207:PF03203:PF04174:PF01673,0,1,0,0,1,1017,0.0,1.0,0,0,0,0,0,0,1018,0,1.0,0,0
PF01949,PF01527:PF11917:PF00331:PF11799:PF00145,0,60,0,0,60,958,0.0,0.94,0,0,5,0,0,5,1013,0.0,1.0,0,0
PF10906,PF12615:PF06681:PF15775:PF01668:PF05778,2,3,0,2,3,1013,0.0,1.0,0.0,-0.0,0,0,2,0,1016,0,1.0,0.0,0
PF13373,PF10302:PF16843:PF01020:PF16455:PF09055,5,23,4,1,19,994,0.17,0.98,0.8,0.37,2,2,3,0,1013,1.0,1.0,0.4,0.63
PF06925,PF08660:PF04101:PF03033:PF02082:PF08375,4,38,4,0,34,980,0.11,0.97,1.0,0.32,6,2,2,4,1010,0.33,0.99,0.5,0.41
PF14577,PF14576:PF14767:PF04927:PF14768:PF14766,2,4,1,1,3,1013,0.25,1.0,0.5,0.35,0,0,2,0,1016,0,1.0,0.0,0
PF08573,PF07557:PF14775:PF15784:PF11559:PF16034,4,20,1,3,19,995,0.05,0.98,0.25,0.1,0,0,4,0,1014,0,1.0,0.0,0
PF15904,PF10428:PF11921:PF12799:PF12819:PF16095,2,62,1,1,61,955,0.02,0.94,0.5,0.08,4,1,1,3,1013,0.25,1.0,0.5,0.35
PF12196,PF08081:PF12220:PF08143:PF11627:PF12353,1,20,1,0,19,998,0.05,0.98,1.0,0.22,1,1,0,0,1017,1.0,1.0,1.0,1.0
PF12106,PF01514:PF12191:PF06070:PF02601:PF06505,1,3,0,1,3,1014,0.0,1.0,0.0,-0.0,0,0,1,0,1017,0,1.0,0.0,0
PF10114,PF05939:PF03739:PF06131:PF06798:PF02465,0,7,0,0,7,1011,0.0,0.99,0,0,0,0,0,0,1018,0,1.0,0,0
PF00902,PF00159:PF01097:PF10018:PF16541:PF00142,8,22,2,6,20,990,0.09,0.97,0.25,0.14,1,0,8,1,1009,0.0,0.99,0.0,-0.0
PF16591,PF03605:PF03994:PF11697:PF07195:PF04868,0,4,0,0,4,1014,0.0,1.0,0,0,0,0,0,0,1018,0,1.0,0,0
PF12020,PF04901:PF10244:PF00143:PF00965:PF05039,0,17,0,0,17,1001,0.0,0.98,0,0,0,0,0,0,1018,0,1.0,0,0
PF09367,PF17085:PF05658:PF10376:PF15252:PF15703,0,1,0,0,1,1017,0.0,1.0,0,0,0,0,0,0,1018,0,1.0,0,0
PF08356,PF08355:PF10149:PF00071:PF08652:PF16512,12,146,12,0,134,872,0.08,0.87,1.0,0.27,5,5,7,0,1006,1.0,0.99,0.42,0.64
PF13718,PF05127:PF13725:PF08351:PF17176:PF08746,13,20,13,0,7,998,0.65,0.99,1.0,0.8,12,12,1,0,1005,1.0,1.0,0.92,0.96
PF16035,PF01269:PF12751:PF16027:PF08639:PF00473,5,21,1,4,20,993,0.05,0.98,0.2,0.09,1,0,5,1,1012,0.0,0.99,0.0,-0.0
PF01479,PF16065:PF01929:PF01777:PF17136:PF03637,43,46,22,21,24,951,0.48,0.96,0.51,0.47,6,6,37,0,975,1.0,0.96,0.14,0.37
PF10322,PF02343:PF10319:PF15362:PF05238:PF05075,0,4,0,0,4,1014,0.0,1.0,0,0,0,0,0,0,1018,0,1.0,0,0
PF17177,PF16953:PF13812:PF12921:PF13762:PF02297,35,71,29,6,42,941,0.41,0.95,0.83,0.56,4,4,31,0,983,1.0,0.97,0.11,0.33
PF14906,PF13910:PF15027:PF17034:PF10441:PF15627,3,14,2,1,12,1003,0.14,0.99,0.67,0.3,0,0,3,0,1015,0,1.0,0.0,0
PF03326,PF13655:PF04473:PF08388:PF00552:PF05035,0,13,0,0,13,1005,0.0,0.99,0,0,1,0,0,1,1017,0.0,1.0,0,0
PF04847,PF14935:PF06658:PF12020:PF02046:PF00143,7,8,1,6,7,1004,0.12,0.99,0.14,0.13,0,0,7,0,1011,0,0.99,0.0,0
PF02351,PF00393:PF16656:PF02244:PF00438:PF02578,3,45,2,1,43,972,0.04,0.96,0.67,0.16,4,1,2,3,1012,0.25,1.0,0.33,0.29
PF05907,PF01423:PF07426:PF01015:PF05019:PF09774,10,79,9,1,70,938,0.11,0.93,0.9,0.31,5,1,9,4,1004,0.2,0.99,0.1,0.14
PF07647,PF00536:PF12485:PF16533:PF14847:PF00644,41,84,31,10,53,924,0.37,0.94,0.76,0.5,5,5,36,0,977,1.0,0.96,0.12,0.34
PF09673,PF03238:PF09074:PF06681:PF01638:PF14985,0,3,0,0,3,1015,0.0,1.0,0,0,0,0,0,0,1018,0,1.0,0,0
PF03561,PF04115:PF08622:PF17187:PF17132:PF13411,8,19,5,3,14,996,0.26,0.98,0.62,0.4,0,0,8,0,1010,0,0.99,0.0,0
PF03238,PF06681:PF03745:PF15212:PF17010:PF09962,0,1,0,0,1,1017,0.0,1.0,0,0,0,0,0,0,1018,0,1.0,0,0
PF00028,PF01049:PF02210:PF07953:PF00008:PF15974,48,88,38,10,50,920,0.43,0.94,0.79,0.56,7,6,42,1,969,0.86,0.96,0.12,0.32
PF14370,PF02919:PF01028:PF05392:PF12338:PF00140,6,17,6,0,11,1001,0.35,0.99,1.0,0.59,2,2,4,0,1012,1.0,1.0,0.33,0.58
PF15193,PF15107:PF15754:PF15114:PF15041:PF15119,0,2,0,0,2,1016,0.0,1.0,0,0,0,0,0,0,1018,0,1.0,0,0
PF17105,PF12157:PF12064:PF17035:PF12024:PF09247,4,25,3,1,22,992,0.12,0.98,0.75,0.29,1,1,3,0,1014,1.0,1.0,0.25,0.5
PF06244,PF06127:PF09769:PF04716:PF08561:PF10780,11,21,4,7,17,990,0.19,0.98,0.36,0.25,1,1,10,0,1007,1.0,0.99,0.09,0.3
PF05732,PF03742:PF06651:PF06681:PF12840:PF08691,0,1,0,0,1,1017,0.0,1.0,0,0,0,0,0,0,1018,0,1.0,0,0
PF00865,PF15467:PF16829:PF15398:PF15710:PF03458,0,2,0,0,2,1016,0.0,1.0,0,0,0,0,0,0,1018,0,1.0,0,0
PF02982,PF07464:PF06766:PF04736:PF15171:PF03576,5,5,0,5,5,1008,0.0,0.99,0.0,-0.0,0,0,5,0,1013,0,1.0,0.0,0
PF04927,PF01132:PF14577:PF09285:PF14576:PF14693,2,10,1,1,9,1007,0.1,0.99,0.5,0.22,1,1,1,0,1016,1.0,1.0,0.5,0.71
PF16719,PF00157:PF03792:PF12413:PF13293:PF11569,6,8,3,3,5,1007,0.38,0.99,0.5,0.43,1,1,5,0,1012,1.0,1.0,0.17,0.41
PF01243,PF10590:PF10342:PF06212:PF02537:PF10356,12,29,11,1,18,988,0.38,0.98,0.92,0.58,0,0,12,0,1006,0,0.99,0.0,0
PF15449,PF15302:PF12904:PF01114:PF15722:PF07956,1,8,0,1,8,1009,0.0,0.99,0.0,-0.0,0,0,1,0,1017,0,1.0,0.0,0
PF01512,PF10531:PF10589:PF01227:PF03074:PF13375,10,23,9,1,14,994,0.39,0.99,0.9,0.59,1,1,9,0,1008,1.0,0.99,0.1,0.31
PF11759,PF15480:PF06954:PF15119:PF15825:PF15814,0,3,0,0,3,1015,0.0,1.0,0,0,0,0,0,0,1018,0,1.0,0,0
PF00586,PF02843:PF02844:PF01071:PF02769:PF00551,12,39,11,1,28,978,0.28,0.97,0.92,0.5,13,7,5,6,1000,0.54,0.99,0.58,0.55
PF02796,PF01969:PF14659:PF15143:PF04764:PF15331,5,4,1,4,3,1010,0.25,0.99,0.2,0.22,0,0,5,0,1013,0,1.0,0.0,0
PF10703,PF01297:PF06719:PF12852:PF10566:PF02595,2,7,0,2,7,1009,0.0,0.99,0.0,-0.0,0,0,2,0,1016,0,1.0,0.0,0
PF04891,PF02217:PF14344:PF02557:PF15774:PF07589,1,5,0,1,5,1012,0.0,0.99,0.0,-0.0,0,0,1,0,1017,0,1.0,0.0,0
PF10160,PF04176:PF02284:PF04716:PF12020:PF05915,0,23,0,0,23,995,0.0,0.98,0,0,3,0,0,3,1015,0.0,1.0,0,0
PF02969,PF10491:PF07967:PF07923:PF10492:PF15996,8,18,3,5,15,995,0.17,0.98,0.38,0.24,2,0,8,2,1008,0.0,0.99,0.0,-0.0
PF15320,PF11029:PF15960:PF16716:PF15071:PF14653,3,2,0,3,2,1013,0.0,1.0,0.0,-0.0,0,0,3,0,1015,0,1.0,0.0,0
PF11638,PF14841:PF12019:PF05857:PF02741:PF06798,2,3,1,1,2,1014,0.33,1.0,0.5,0.41,0,0,2,0,1016,0,1.0,0.0,0
PF00336,PF07569:PF03669:PF14370:PF09358:PF04386,1,28,0,1,28,989,0.0,0.97,0.0,-0.01,3,0,1,3,1014,0.0,1.0,0.0,-0.0
PF09086,PF04339:PF12903:PF15681:PF15809:PF05596,0,5,0,0,5,1013,0.0,1.0,0,0,0,0,0,0,1018,0,1.0,0,0
PF08570,PF06890:PF09829:PF17049:PF15817:PF05939,2,2,1,1,1,1015,0.5,1.0,0.5,0.5,0,0,2,0,1016,0,1.0,0.0,0
PF12373,PF09991:PF09085:PF08848:PF15289:PF03703,0,1,0,0,1,1017,0.0,1.0,0,0,0,0,0,0,1018,0,1.0,0,0
PF15198,PF13737:PF09669:PF15139:PF05651:PF03843,0,2,0,0,2,1016,0.0,1.0,0,0,0,0,0,0,1018,0,1.0,0,0
PF08231,PF05046:PF15456:PF08507:PF10495:PF03801,11,23,0,11,23,984,0.0,0.97,0.0,-0.02,2,0,11,2,1005,0.0,0.99,0.0,-0.0
PF00181,PF07985:PF03947:PF01359:PF09747:PF03868,17,65,13,4,52,949,0.2,0.94,0.76,0.37,10,6,11,4,997,0.6,0.99,0.35,0.45
PF03983,PF12026:PF08397:PF09431:PF07815:PF08824,7,22,1,6,21,990,0.05,0.97,0.14,0.07,2,1,6,1,1010,0.5,0.99,0.14,0.26
PF05493,PF00543:PF09056:PF15071:PF15719:PF10161,18,11,5,13,6,994,0.45,0.98,0.28,0.35,0,0,18,0,1000,0,0.98,0.0,0
PF14328,PF01752:PF15483:PF06070:PF01943:PF01514,0,4,0,0,4,1014,0.0,1.0,0,0,0,0,0,0,1018,0,1.0,0,0
PF09859,PF15213:PF02283:PF03260:PF17013:PF02654,0,5,0,0,5,1013,0.0,1.0,0,0,0,0,0,0,1018,0,1.0,0,0
PF12471,PF00926:PF07958:PF00925:PF09598:PF14378,2,22,2,0,20,996,0.09,0.98,1.0,0.3,1,0,2,1,1015,0.0,1.0,0.0,-0.0
PF13995,PF10279:PF05857:PF06798:PF06890:PF04391,0,0,0,0,0,1018,0,1.0,0,0,0,0,0,0,1018,0,1.0,0,0
PF16273,PF09032:PF05002:PF14050:PF04968:PF14849,0,30,0,0,30,988,0.0,0.97,0,0,2,0,0,2,1016,0.0,1.0,0,0
PF12525,PF06902:PF08808:PF04076:PF10057:PF07337,0,0,0,0,0,1018,0,1.0,0,0,0,0,0,0,1018,0,1.0,0,0
PF01459,PF01894:PF07701:PF01283:PF00425:PF12481,14,63,7,7,56,948,0.11,0.94,0.5,0.21,4,2,12,2,1002,0.5,0.99,0.14,0.26
PF08890,PF00383:PF00749:PF07147:PF02788:PF13091,0,89,0,0,89,929,0.0,0.91,0,0,9,0,0,9,1009,0.0,0.99,0,0
PF10391,PF14792:PF14716:PF14791:PF12821:PF00126,15,28,15,0,13,990,0.54,0.99,1.0,0.73,13,11,4,2,1001,0.85,0.99,0.73,0.78
PF10728,PF11874:PF01673:PF11081:PF10566:PF00114,0,0,0,0,0,1018,0,1.0,0,0,0,0,0,0,1018,0,1.0,0,0
PF02380,PF12729:PF04738:PF05230:PF09374:PF08885,0,2,0,0,2,1016,0.0,1.0,0,0,0,0,0,0,1018,0,1.0,0,0
PF06789,PF14251:PF15775:PF15480:PF03548:PF02595,2,5,0,2,5,1011,0.0,0.99,0.0,-0.0,0,0,2,0,1016,0,1.0,0.0,0
PF12455,PF07989:PF04423:PF16034:PF03801:PF16830,7,24,2,5,22,989,0.08,0.97,0.29,0.14,1,1,6,0,1011,1.0,0.99,0.14,0.38
PF01609,PF04865:PF02211:PF00419:PF10410:PF11492,3,9,1,2,8,1007,0.11,0.99,0.33,0.19,0,0,3,0,1015,0,1.0,0.0,0
PF05351,PF08038:PF15171:PF14770:PF05612:PF02533,6,7,1,5,6,1006,0.14,0.99,0.17,0.15,0,0,6,0,1012,0,0.99,0.0,0
PF15225,PF08924:PF02638:PF13406:PF13610:PF15155,2,9,1,1,8,1008,0.11,0.99,0.5,0.23,0,0,2,0,1016,0,1.0,0.0,0
PF02995,PF13383:PF02958:PF00762:PF06159:PF13344,10,63,6,4,57,951,0.1,0.94,0.6,0.22,5,2,8,3,1005,0.4,0.99,0.2,0.28
PF15268,PF16415:PF12842:PF14676:PF14675:PF14680,1,13,0,1,13,1004,0.0,0.99,0.0,-0.0,1,0,1,1,1016,0.0,1.0,0.0,-0.0
PF07818,PF14610:PF07052:PF07051:PF15242:PF04949,10,22,4,6,18,990,0.18,0.98,0.4,0.26,0,0,10,0,1008,0,0.99,0.0,0
PF04069,PF12911:PF15319:PF04285:PF02951:PF13700,7,7,2,5,5,1006,0.29,0.99,0.29,0.28,0,0,7,0,1011,0,0.99,0.0,0
PF03909,PF08567:PF16978:PF12632:PF04109:PF02750,19,28,12,7,16,983,0.43,0.98,0.63,0.51,1,1,18,0,999,1.0,0.98,0.05,0.23
PF05605,PF14571:PF01715:PF15451:PF01466:PF01357,13,44,10,3,34,971,0.23,0.96,0.77,0.41,4,2,11,2,1003,0.5,0.99,0.15,0.27
PF05553,PF02701:PF10188:PF06886:PF09816:PF01868,7,25,5,2,20,991,0.2,0.98,0.71,0.37,0,0,7,0,1011,0,0.99,0.0,0
PF03818,PF00622:PF00829:PF00271:PF12861:PF00642,0,272,0,0,272,746,0.0,0.73,0,0,32,0,0,32,986,0.0,0.97,0,0
PF08108,PF04825:PF08416:PF16742:PF08919:PF12497,0,34,0,0,34,984,0.0,0.97,0,0,3,0,0,3,1015,0.0,1.0,0,0
PF14496,PF09699:PF11593:PF16217:PF03925:PF15529,1,3,0,1,3,1014,0.0,1.0,0.0,-0.0,0,0,1,0,1017,0,1.0,0.0,0
PF15456,PF11500:PF09444:PF12757:PF03344:PF16574,3,4,0,3,4,1011,0.0,0.99,0.0,-0.0,0,0,3,0,1015,0,1.0,0.0,0
PF11406,PF10106:PF03065:PF05418:PF17010:PF07209,0,4,0,0,4,1014,0.0,1.0,0,0,0,0,0,0,1018,0,1.0,0,0
PF10481,PF07926:PF12297:PF16830:PF05104:PF16574,4,10,0,4,10,1004,0.0,0.99,0.0,-0.01,0,0,4,0,1014,0,1.0,0.0,0
PF04646,PF06830:PF04833:PF01458:PF06414:PF12579,7,13,2,5,11,1000,0.15,0.98,0.29,0.2,0,0,7,0,1011,0,0.99,0.0,0
PF07573,PF11702:PF15518:PF12603:PF04196:PF10638,4,2,0,4,2,1012,0.0,0.99,0.0,-0.0,1,0,4,1,1013,0.0,1.0,0.0,-0.0
PF03498,PF05100:PF13742:PF06805:PF15212:PF11245,1,2,0,1,2,1015,0.0,1.0,0.0,-0.0,0,0,1,0,1017,0,1.0,0.0,0
PF09553,PF02863:PF08401:PF12191:PF04170:PF03831,2,2,0,2,2,1014,0.0,1.0,0.0,-0.0,0,0,2,0,1016,0,1.0,0.0,0
PF12017,PF05485:PF12596:PF14291:PF05699:PF07776,24,129,19,5,110,884,0.15,0.89,0.79,0.31,22,12,12,10,984,0.55,0.98,0.5,0.51
PF00771,PF04717:PF08298:PF05034:PF03241:PF14842,0,0,0,0,0,1018,0,1.0,0,0,0,0,0,0,1018,0,1.0,0,0
PF04418,PF15003:PF03386:PF05512:PF01922:PF06645,6,16,2,4,14,998,0.12,0.98,0.33,0.2,1,0,6,1,1011,0.0,0.99,0.0,-0.0
PF14398,PF07902:PF16463:PF16732:PF14109:PF03613,0,1,0,0,1,1017,0.0,1.0,0,0,0,0,0,0,1018,0,1.0,0,0
PF09384,PF14077:PF12265:PF08614:PF16699:PF05510,11,16,6,5,10,997,0.38,0.99,0.55,0.45,2,1,10,1,1006,0.5,0.99,0.09,0.21
PF12222,PF03981:PF01040:PF14159:PF12899:PF07542,9,47,6,3,41,968,0.13,0.96,0.67,0.28,2,1,8,1,1008,0.5,0.99,0.11,0.23
PF08358,PF03498:PF15756:PF04966:PF15356:PF02565,1,2,0,1,2,1015,0.0,1.0,0.0,-0.0,0,0,1,0,1017,0,1.0,0.0,0
PF15147,PF12510:PF09304:PF03271:PF10358:PF08580,1,30,1,0,29,988,0.03,0.97,1.0,0.18,1,1,0,0,1017,1.0,1.0,1.0,1.0
PF09723,PF15175:PF09074:PF11369:PF06407:PF17015,0,0,0,0,0,1018,0,1.0,0,0,0,0,0,0,1018,0,1.0,0,0
PF09733,PF01594:PF10505:PF15189:PF07839:PF09740,5,17,2,3,15,998,0.12,0.98,0.4,0.21,1,1,4,0,1013,1.0,1.0,0.2,0.45
PF02684,PF12904:PF07171:PF07909:PF05295:PF10285,1,3,0,1,3,1014,0.0,1.0,0.0,-0.0,0,0,1,0,1017,0,1.0,0.0,0
PF03867,PF10525:PF04617:PF12407:PF13293:PF12413,1,4,1,0,3,1014,0.25,1.0,1.0,0.5,1,1,0,0,1017,1.0,1.0,1.0,1.0
PF08855,PF14251:PF11751:PF04610:PF15548:PF08707,0,8,0,0,8,1010,0.0,0.99,0,0,0,0,0,0,1018,0,1.0,0,0
PF08217,PF02765:PF16418:PF06025:PF16417:PF08166,12,27,3,9,24,982,0.11,0.97,0.25,0.15,2,1,11,1,1005,0.5,0.99,0.08,0.2
PF15306,PF07889:PF07107:PF06351:PF11833:PF09419,3,23,3,0,20,995,0.13,0.98,1.0,0.36,1,1,2,0,1015,1.0,1.0,0.33,0.58
PF05193,PF00675:PF16187:PF08367:PF15098:PF04389,57,90,55,2,35,926,0.61,0.96,0.96,0.75,10,10,47,0,961,1.0,0.95,0.18,0.41
PF03762,PF14200:PF15048:PF10044:PF09072:PF15960,2,12,0,2,12,1004,0.0,0.99,0.0,-0.0,0,0,2,0,1016,0,1.0,0.0,0
PF02732,PF11977:PF14722:PF05182:PF14611:PF08729,25,30,10,15,20,973,0.33,0.97,0.4,0.35,4,3,22,1,992,0.75,0.98,0.12,0.29
PF06049,PF09049:PF00323:PF09051:PF01114:PF02740,1,1,0,1,1,1016,0.0,1.0,0.0,-0.0,0,0,1,0,1017,0,1.0,0.0,0
PF15364,PF06541:PF15715:PF15063:PF02527:PF04856,0,8,0,0,8,1010,0.0,0.99,0,0,0,0,0,0,1018,0,1.0,0,0
PF04382,PF05902:PF08736:PF11819:PF16705:PF09379,5,43,5,0,38,975,0.12,0.96,1.0,0.33,9,4,1,5,1008,0.44,0.99,0.8,0.59
PF15319,PF05025:PF12256:PF08411:PF16861:PF04624,0,10,0,0,10,1008,0.0,0.99,0,0,0,0,0,0,1018,0,1.0,0,0
PF08513,PF04494:PF11540:PF12341:PF03451:PF07304,26,31,17,9,14,978,0.55,0.98,0.65,0.59,2,2,24,0,992,1.0,0.98,0.08,0.27
PF11544,PF06586:PF05309:PF09444:PF11542:PF04354,0,4,0,0,4,1014,0.0,1.0,0,0,0,0,0,0,1018,0,1.0,0,0
PF12137,PF07652:PF14229:PF10927:PF03880:PF03461,4,11,3,1,8,1006,0.27,0.99,0.75,0.45,2,1,3,1,1013,0.5,1.0,0.25,0.35
PF05871,PF08704:PF03416:PF03091:PF03095:PF04893,11,47,6,5,41,966,0.13,0.95,0.55,0.25,5,3,8,2,1005,0.6,0.99,0.27,0.4
PF05393,PF08945:PF03203:PF17015:PF15175:PF09461,0,0,0,0,0,1018,0,1.0,0,0,0,0,0,0,1018,0,1.0,0,0
PF10361,PF12527:PF05841:PF08528:PF13810:PF15311,0,12,0,0,12,1006,0.0,0.99,0,0,0,0,0,0,1018,0,1.0,0,0
PF05981,PF06070:PF11124:PF15312:PF13331:PF09109,4,1,0,4,1,1013,0.0,1.0,0.0,-0.0,0,0,4,0,1014,0,1.0,0.0,0
PF15997,PF02200:PF15923:PF09038:PF14465:PF12478,0,8,0,0,8,1010,0.0,0.99,0,0,0,0,0,0,1018,0,1.0,0,0
PF09289,PF00050:PF10591:PF01469:PF09307:PF00219,4,32,4,0,28,986,0.12,0.97,1.0,0.35,2,1,3,1,1013,0.5,1.0,0.25,0.35
PF15803,PF15805:PF04422:PF07260:PF14049:PF16027,0,1,0,0,1,1017,0.0,1.0,0,0,0,0,0,0,1018,0,1.0,0,0
PF05349,PF01610:PF03743:PF06406:PF12604:PF16997,4,9,2,2,7,1007,0.22,0.99,0.5,0.33,0,0,4,0,1014,0,1.0,0.0,0
PF02865,PF01017:PF02864:PF14596:PF15148:PF12188,4,5,3,1,2,1012,0.6,1.0,0.75,0.67,1,1,3,0,1014,1.0,1.0,0.25,0.5
PF16903,PF02572:PF06798:PF13722:PF02565:PF02413,1,2,0,1,2,1015,0.0,1.0,0.0,-0.0,0,0,1,0,1017,0,1.0,0.0,0
PF12805,PF08497:PF14512:PF07209:PF06403:PF11697,0,2,0,0,2,1016,0.0,1.0,0,0,0,0,0,0,1018,0,1.0,0,0
PF00387,PF00388:PF09279:PF06631:PF03490:PF16457,18,29,17,1,12,988,0.59,0.99,0.94,0.74,6,6,12,0,1000,1.0,0.99,0.33,0.57
PF11956,PF03520:PF03521:PF11404:PF08412:PF11933,3,17,3,0,14,1001,0.18,0.99,1.0,0.42,1,1,2,0,1015,1.0,1.0,0.33,0.58
PF01064,PF08515:PF12179:PF14593:PF08917:PF12063,18,18,8,10,10,990,0.44,0.98,0.44,0.43,2,2,16,0,1000,1.0,0.98,0.11,0.33
PF03427,PF08329:PF02839:PF14856:PF06483:PF07382,3,19,2,1,17,998,0.11,0.98,0.67,0.26,0,0,3,0,1015,0,1.0,0.0,0
PF04926,PF04928:PF16979:PF11620:PF04621:PF00178,16,47,15,1,32,970,0.32,0.97,0.94,0.54,6,5,11,1,1001,0.83,0.99,0.31,0.51
PF02713,PF04949:PF06271:PF15264:PF14769:PF07052,1,22,0,1,22,995,0.0,0.98,0.0,-0.0,1,0,1,1,1016,0.0,1.0,0.0,-0.0
PF15494,PF09272:PF02983:PF16030:PF12032:PF09342,10,21,3,7,18,990,0.14,0.98,0.3,0.2,1,1,9,0,1008,1.0,0.99,0.1,0.31
PF08943,PF08894:PF04286:PF15029:PF05229:PF13751,1,5,0,1,5,1012,0.0,0.99,0.0,-0.0,0,0,1,0,1017,0,1.0,0.0,0
PF13869,PF01680:PF09468:PF06388:PF04901:PF07096,13,21,3,10,18,987,0.14,0.97,0.23,0.17,1,1,12,0,1005,1.0,0.99,0.08,0.28
PF05103,PF04225:PF08437:PF10118:PF10335:PF01258,2,18,1,1,17,999,0.06,0.98,0.5,0.16,0,0,2,0,1016,0,1.0,0.0,0
PF10263,PF05770:PF00194:PF04906:PF09808:PF12877,22,48,13,9,35,961,0.27,0.96,0.59,0.38,2,2,20,0,996,1.0,0.98,0.09,0.3
PF01501,PF06427:PF03016:PF03407:PF06241:PF04130,42,72,23,19,49,927,0.32,0.93,0.55,0.39,6,5,37,1,975,0.83,0.96,0.12,0.31
PF00412,PF15936:PF12315:PF06297:PF16182:PF02209,88,29,23,65,6,924,0.79,0.93,0.26,0.43,2,2,86,0,930,1.0,0.92,0.02,0.14
PF00160,PF13879:PF04641:PF15906:PF07719:PF03467,73,55,25,48,30,915,0.45,0.92,0.34,0.35,7,7,66,0,945,1.0,0.94,0.1,0.3
PF02826,PF00389:PF00800:PF03088:PF01063:PF01842,27,79,21,6,58,933,0.27,0.94,0.78,0.43,13,8,19,5,986,0.62,0.98,0.3,0.42
PF10775,PF10310:PF13741:PF08656:PF01279:PF15879,0,9,0,0,9,1009,0.0,0.99,0,0,2,0,0,2,1016,0.0,1.0,0,0
PF02736,PF01576:PF00063:PF14432:PF02363:PF12460,24,100,23,1,77,917,0.23,0.92,0.96,0.45,10,7,17,3,991,0.7,0.98,0.29,0.44
PF07652,PF10927:PF14229:PF12137:PF03880:PF03461,6,8,2,4,6,1006,0.25,0.99,0.33,0.28,2,1,5,1,1011,0.5,0.99,0.17,0.29
PF02591,PF12889:PF10865:PF16286:PF00518:PF01719,0,2,0,0,2,1016,0.0,1.0,0,0,0,0,0,0,1018,0,1.0,0,0
PF12194,PF08291:PF08744:PF15207:PF11402:PF05797,1,1,0,1,1,1016,0.0,1.0,0.0,-0.0,0,0,1,0,1017,0,1.0,0.0,0
PF03448,PF00893:PF01769:PF16118:PF04739:PF12798,4,10,1,3,9,1005,0.1,0.99,0.25,0.15,0,0,4,0,1014,0,1.0,0.0,0
PF00548,PF02226:PF08727:PF12381:PF09250:PF00073,12,13,12,0,1,1005,0.92,1.0,1.0,0.96,12,12,0,0,1006,1.0,1.0,1.0,1.0
PF11781,PF10441:PF14952:PF15027:PF12372:PF12231,6,15,2,4,13,999,0.13,0.98,0.33,0.2,0,0,6,0,1012,0,0.99,0.0,0
PF17047,PF15625:PF16056:PF11618:PF16165:PF08151,13,17,3,10,14,991,0.18,0.98,0.23,0.19,1,1,12,0,1005,1.0,0.99,0.08,0.28
PF00684,PF05099:PF14901:PF05207:PF14308:PF15990,2,25,0,2,25,991,0.0,0.97,0.0,-0.01,0,0,2,0,1016,0,1.0,0.0,0
PF03879,PF09696:PF05361:PF10244:PF05039:PF15359,6,16,2,4,14,998,0.12,0.98,0.33,0.2,2,1,5,1,1011,0.5,0.99,0.17,0.29
PF02115,PF09778:PF00197:PF06376:PF01775:PF01912,13,19,4,9,15,990,0.21,0.98,0.31,0.24,2,1,12,1,1004,0.5,0.99,0.08,0.19
PF07147,PF02872:PF16656:PF06584:PF13824:PF01285,9,40,6,3,34,975,0.15,0.96,0.67,0.3,2,1,8,1,1008,0.5,0.99,0.11,0.23
PF10033,PF16944:PF05030:PF00649:PF09429:PF14611,2,27,1,1,26,990,0.04,0.97,0.5,0.13,0,0,2,0,1016,0,1.0,0.0,0
PF00990,PF00563:PF00672:PF00015:PF08448:PF13188,13,29,10,3,19,986,0.34,0.98,0.77,0.51,8,7,6,1,1004,0.88,0.99,0.54,0.68
PF02204,PF01754:PF02493:PF00415:PF02338:PF08161,34,113,28,6,85,899,0.25,0.91,0.82,0.42,13,11,23,2,982,0.85,0.98,0.32,0.51
PF05671,PF04764:PF15851:PF15150:PF12241:PF11902,2,1,0,2,1,1015,0.0,1.0,0.0,-0.0,0,0,2,0,1016,0,1.0,0.0,0
PF01599,PF16455:PF10260:PF04758:PF16843:PF09055,6,22,3,3,19,993,0.14,0.98,0.5,0.25,1,1,5,0,1012,1.0,1.0,0.17,0.41
PF00277,PF00272:PF06679:PF06373:PF14935:PF00726,0,3,0,0,3,1015,0.0,1.0,0,0,0,0,0,0,1018,0,1.0,0,0
PF02780,PF00456:PF02779:PF13292:PF08213:PF00676,32,61,32,0,29,957,0.52,0.97,1.0,0.71,2,2,30,0,986,1.0,0.97,0.06,0.25
PF03884,PF02886:PF13300:PF07808:PF11467:PF00190,1,41,1,0,40,977,0.02,0.96,1.0,0.15,1,0,1,1,1016,0.0,1.0,0.0,-0.0
PF08497,PF07805:PF02465:PF10908:PF03050:PF11245,0,1,0,0,1,1017,0.0,1.0,0,0,0,0,0,0,1018,0,1.0,0,0
PF17062,PF10664:PF15343:PF17015:PF15175:PF15776,0,3,0,0,3,1015,0.0,1.0,0,0,0,0,0,0,1018,0,1.0,0,0
PF04265,PF04263:PF03868:PF04248:PF05173:PF14693,14,37,14,0,23,981,0.38,0.98,1.0,0.61,1,1,13,0,1004,1.0,0.99,0.07,0.27
PF15555,PF15809:PF14866:PF12724:PF10994:PF15216,1,1,0,1,1,1016,0.0,1.0,0.0,-0.0,0,0,1,0,1017,0,1.0,0.0,0
PF17201,PF01000:PF12496:PF00169:PF03007:PF08138,0,147,0,0,147,871,0.0,0.86,0,0,2,0,0,2,1016,0.0,1.0,0,0
PF13610,PF11751:PF09432:PF07505:PF08751:PF07804,1,5,0,1,5,1012,0.0,0.99,0.0,-0.0,0,0,1,0,1017,0,1.0,0.0,0
PF14384,PF02633:PF07157:PF09278:PF03922:PF06251,0,4,0,0,4,1014,0.0,1.0,0,0,0,0,0,0,1018,0,1.0,0,0
PF03511,PF15865:PF11229:PF10493:PF08631:PF15979,0,21,0,0,21,997,0.0,0.98,0,0,0,0,0,0,1018,0,1.0,0,0
PF09038,PF15997:PF14465:PF06513:PF12178:PF07891,0,4,0,0,4,1014,0.0,1.0,0,0,0,0,0,0,1018,0,1.0,0,0
PF15399,PF02253:PF04264:PF12081:PF02955:PF11412,0,5,0,0,5,1013,0.0,1.0,0,0,0,0,0,0,1018,0,1.0,0,0
PF01201,PF06658:PF15251:PF07106:PF09468:PF01680,12,21,6,6,15,991,0.29,0.98,0.5,0.37,1,1,11,0,1006,1.0,0.99,0.08,0.29
PF04326,PF09848:PF00273:PF12735:PF16061:PF16983,5,16,4,1,12,1001,0.25,0.99,0.8,0.44,0,0,5,0,1013,0,1.0,0.0,0
PF09084,PF02653:PF08402:PF05141:PF00528:PF12399,18,45,10,8,35,965,0.22,0.96,0.56,0.33,5,3,15,2,998,0.6,0.98,0.17,0.31
PF13287,PF12773:PF15898:PF16553:PF09310:PF09372,5,5,2,3,3,1010,0.4,0.99,0.4,0.4,1,1,4,0,1013,1.0,1.0,0.2,0.45
PF12006,PF14087:PF10340:PF03379:PF07327:PF08576,6,13,1,5,12,1000,0.08,0.98,0.17,0.11,0,0,6,0,1012,0,0.99,0.0,0
PF09676,PF00994:PF01802:PF07295:PF16519:PF05730,0,54,0,0,54,964,0.0,0.95,0,0,2,0,0,2,1016,0.0,1.0,0,0
PF15831,PF15063:PF06907:PF15055:PF02202:PF13933,0,2,0,0,2,1016,0.0,1.0,0,0,0,0,0,0,1018,0,1.0,0,0
PF03939,PF00525:PF08674:PF02751:PF08365:PF09637,15,24,4,11,20,983,0.17,0.97,0.27,0.2,0,0,15,0,1003,0,0.99,0.0,0
PF00039,PF00040:PF09396:PF00878:PF12714:PF12453,3,30,3,0,27,988,0.1,0.97,1.0,0.31,3,1,2,2,1013,0.33,1.0,0.33,0.33
PF09012,PF11975:PF16216:PF10035:PF00482:PF07157,3,10,1,2,9,1006,0.1,0.99,0.33,0.18,0,0,3,0,1015,0,1.0,0.0,0
PF14604,PF00018:PF08824:PF12026:PF03114:PF11555,68,105,51,17,54,896,0.49,0.93,0.75,0.57,3,3,65,0,950,1.0,0.94,0.04,0.2
PF02973,PF11697:PF16411:PF13750:PF12477:PF04740,1,1,0,1,1,1016,0.0,1.0,0.0,-0.0,0,0,1,0,1017,0,1.0,0.0,0
PF16833,PF04865:PF15150:PF02501:PF10410:PF04984,0,6,0,0,6,1012,0.0,0.99,0,0,0,0,0,0,1018,0,1.0,0,0
PF11699,PF15622:PF07394:PF15395:PF01660:PF10279,6,10,0,6,10,1002,0.0,0.98,0.0,-0.01,0,0,6,0,1012,0,0.99,0.0,0
PF02634,PF12931:PF00335:PF08614:PF02138:PF06813,1,82,0,1,82,935,0.0,0.92,0.0,-0.01,7,0,1,7,1010,0.0,0.99,0.0,-0.0
PF08482,PF08148:PF16204:PF16739:PF07717:PF00271,3,234,3,0,231,784,0.01,0.77,1.0,0.1,9,2,1,7,1008,0.22,0.99,0.67,0.38
PF02066,PF06892:PF00353:PF02607:PF02965:PF14186,0,9,0,0,9,1009,0.0,0.99,0,0,1,0,0,1,1017,0.0,1.0,0,0
PF01923,PF16053:PF06516:PF12597:PF06026:PF10244,7,29,2,5,27,984,0.07,0.97,0.29,0.13,1,1,6,0,1011,1.0,0.99,0.14,0.38
PF01922,PF04852:PF10775:PF10248:PF03760:PF15879,8,11,3,5,8,1002,0.27,0.99,0.38,0.31,0,0,8,0,1010,0,0.99,0.0,0
PF10661,PF01696:PF15821:PF15453:PF10375:PF10490,0,5,0,0,5,1013,0.0,1.0,0,0,0,0,0,0,1018,0,1.0,0,0
PF13840,PF10000:PF00742:PF03447:PF00696:PF01958,11,50,5,6,45,962,0.1,0.95,0.45,0.2,9,3,8,6,1001,0.33,0.99,0.27,0.29
PF00772,PF13662:PF06350:PF01807:PF08275:PF02132,6,13,4,2,9,1003,0.31,0.99,0.67,0.45,4,1,5,3,1009,0.25,0.99,0.17,0.2
PF09785,PF08156:PF01798:PF16387:PF14647:PF09844,5,32,5,0,27,986,0.16,0.97,1.0,0.39,3,1,4,2,1011,0.33,0.99,0.2,0.26
PF07516,PF01043:PF15994:PF15995:PF13764:PF00680,3,22,3,0,19,996,0.14,0.98,1.0,0.37,0,0,3,0,1015,0,1.0,0.0,0
PF04782,PF08234:PF11708:PF02083:PF01980:PF10234,14,19,3,11,16,988,0.16,0.97,0.21,0.17,0,0,14,0,1004,0,0.99,0.0,0
PF14327,PF05383:PF08081:PF04098:PF12220:PF13865,12,35,4,8,31,975,0.11,0.96,0.33,0.18,2,2,10,0,1006,1.0,0.99,0.17,0.41
PF12162,PF14596:PF12188:PF08947:PF09267:PF16454,2,8,1,1,7,1009,0.12,0.99,0.5,0.25,1,1,1,0,1016,1.0,1.0,0.5,0.71
PF08393,PF12780:PF08385:PF12777:PF03028:PF10350,36,48,33,3,15,967,0.69,0.98,0.92,0.79,37,30,6,7,975,0.81,0.99,0.83,0.82
PF08127,PF08773:PF12131:PF03301:PF08660:PF08246,3,41,3,0,38,977,0.07,0.96,1.0,0.27,1,1,2,0,1015,1.0,1.0,0.33,0.58
PF12716,PF06912:PF09056:PF11029:PF15071:PF03576,0,9,0,0,9,1009,0.0,0.99,0,0,0,0,0,0,1018,0,1.0,0,0
PF06986,PF01867:PF15226:PF04487:PF14914:PF00715,0,10,0,0,10,1008,0.0,0.99,0,0,0,0,0,0,1018,0,1.0,0,0
PF16072,PF15669:PF15264:PF04004:PF15369:PF02116,1,13,1,0,12,1005,0.08,0.99,1.0,0.28,0,0,1,0,1017,0,1.0,0.0,0
PF12542,PF16741:PF16099:PF11521:PF07217:PF15539,12,10,3,9,7,999,0.3,0.98,0.25,0.27,0,0,12,0,1006,0,0.99,0.0,0
PF04834,PF06381:PF15085:PF13013:PF12707:PF08847,0,3,0,0,3,1015,0.0,1.0,0,0,0,0,0,0,1018,0,1.0,0,0
PF17075,PF15144:PF10467:PF13519:PF10796:PF11750,0,36,0,0,36,982,0.0,0.96,0,0,0,0,0,0,1018,0,1.0,0,0
PF08725,PF07965:PF17205:PF00362:PF06484:PF15636,9,12,9,0,3,1006,0.75,1.0,1.0,0.86,4,4,5,0,1009,1.0,1.0,0.44,0.67
PF15740,PF12886:PF15622:PF12885:PF15620:PF12884,1,3,0,1,3,1014,0.0,1.0,0.0,-0.0,1,0,1,1,1016,0.0,1.0,0.0,-0.0
PF06738,PF14231:PF00345:PF15750:PF12461:PF13657,5,8,1,4,7,1006,0.12,0.99,0.2,0.15,0,0,5,0,1013,0,1.0,0.0,0
PF12335,PF02141:PF03456:PF02893:PF06602:PF16016,7,83,7,0,76,935,0.08,0.93,1.0,0.28,14,5,2,9,1002,0.36,0.99,0.71,0.5
PF01526,PF16732:PF13482:PF11862:PF16586:PF06744,1,2,0,1,2,1015,0.0,1.0,0.0,-0.0,0,0,1,0,1017,0,1.0,0.0,0
PF12513,PF16783:PF10927:PF07652:PF12344:PF08147,8,16,3,5,13,997,0.19,0.98,0.38,0.26,3,1,7,2,1008,0.33,0.99,0.12,0.2
PF15213,PF05830:PF02654:PF02283:PF15217:PF04501,0,7,0,0,7,1011,0.0,0.99,0,0,0,0,0,0,1018,0,1.0,0,0
PF15862,PF08578:PF12169:PF14611:PF10336:PF11331,2,14,1,1,13,1003,0.07,0.99,0.5,0.19,0,0,2,0,1016,0,1.0,0.0,0
PF03243,PF01316:PF15555:PF10994:PF03548:PF17010,3,6,0,3,6,1009,0.0,0.99,0.0,-0.0,0,0,3,0,1015,0,1.0,0.0,0
PF11217,PF08021:PF13751:PF10974:PF05513:PF15823,2,2,1,1,1,1015,0.5,1.0,0.5,0.5,0,0,2,0,1016,0,1.0,0.0,0
PF14678,PF14674:PF14680:PF14676:PF14677:PF14675,4,1,1,3,0,1014,1.0,1.0,0.25,0.5,1,1,3,0,1014,1.0,1.0,0.25,0.5
PF00715,PF10422:PF16804:PF06222:PF07209:PF04370,2,2,0,2,2,1014,0.0,1.0,0.0,-0.0,0,0,2,0,1016,0,1.0,0.0,0
PF16484,PF00755:PF04587:PF15824:PF16197:PF01087,6,63,6,0,57,955,0.1,0.94,1.0,0.3,9,4,2,5,1007,0.44,0.99,0.67,0.54
PF11880,PF04932:PF11862:PF13098:PF00308:PF08274,3,10,0,3,10,1005,0.0,0.99,0.0,-0.01,0,0,3,0,1015,0,1.0,0.0,0
PF00248,PF00701:PF01042:PF11807:PF04199:PF05153,76,53,29,47,24,918,0.55,0.93,0.38,0.42,12,11,65,1,941,0.92,0.94,0.14,0.35
PF06753,PF10285:PF10284:PF07276:PF03578:PF15722,1,0,0,1,0,1017,0,1.0,0.0,0,0,0,1,0,1017,0,1.0,0.0,0
PF17108,PF17005:PF10647:PF11549:PF15355:PF04966,1,4,1,0,3,1014,0.25,1.0,1.0,0.5,1,1,0,0,1017,1.0,1.0,1.0,1.0
PF06804,PF03412:PF07123:PF00950:PF01032:PF05936,4,12,2,2,10,1004,0.17,0.99,0.5,0.28,2,1,3,1,1013,0.5,1.0,0.25,0.35
PF11892,PF14793:PF06082:PF11775:PF14258:PF13421,0,0,0,0,0,1018,0,1.0,0,0,0,0,0,0,1018,0,1.0,0,0
PF03644,PF02449:PF12308:PF07034:PF14764:PF10022,13,25,4,9,21,984,0.16,0.97,0.31,0.21,0,0,13,0,1005,0,0.99,0.0,0
PF12265,PF16699:PF14077:PF08614:PF09384:PF04158,7,21,3,4,18,993,0.14,0.98,0.43,0.24,2,1,6,1,1010,0.5,0.99,0.14,0.26
PF00214,PF14473:PF00236:PF15063:PF00714:PF06541,1,2,1,0,1,1016,0.5,1.0,1.0,0.71,0,0,1,0,1017,0,1.0,0.0,0
PF15519,PF12220:PF08080:PF08081:PF11627:PF08143,10,6,2,8,4,1004,0.33,0.99,0.2,0.25,1,1,9,0,1008,1.0,0.99,0.1,0.31
PF14724,PF10221:PF00241:PF04188:PF01139:PF10504,3,45,3,0,42,973,0.07,0.96,1.0,0.25,2,1,2,1,1014,0.5,1.0,0.33,0.41
PF10131,PF15340:PF08808:PF13011:PF14534:PF11111,0,3,0,0,3,1015,0.0,1.0,0,0,0,0,0,0,1018,0,1.0,0,0
PF08781,PF16421:PF02319:PF03479:PF03760:PF08636,11,31,10,1,21,986,0.32,0.98,0.91,0.53,0,0,11,0,1007,0,0.99,0.0,0
PF08922,PF09074:PF11272:PF14903:PF14052:PF01325,1,3,1,0,2,1015,0.33,1.0,1.0,0.58,0,0,1,0,1017,0,1.0,0.0,0
PF06299,PF03815:PF01825:PF00530:PF00020:PF12773,0,73,0,0,73,945,0.0,0.93,0,0,7,0,0,7,1011,0.0,0.99,0,0
PF11940,PF09127:PF11838:PF01433:PF03079:PF05347,5,74,5,0,69,944,0.07,0.93,1.0,0.25,19,3,2,16,997,0.16,0.98,0.6,0.3
PF08147,PF03880:PF07652:PF03461:PF12029:PF10927,10,11,3,7,8,1000,0.27,0.99,0.3,0.28,2,2,8,0,1008,1.0,0.99,0.2,0.45
PF06306,PF15876:PF09673:PF15832:PF01638:PF15730,0,2,0,0,2,1016,0.0,1.0,0,0,0,0,0,0,1018,0,1.0,0,0
PF16550,PF14831:PF04683:PF08164:PF05129:PF01910,3,27,3,0,24,991,0.11,0.98,1.0,0.33,1,1,2,0,1015,1.0,1.0,0.33,0.58
PF15652,PF15756:PF07157:PF14196:PF15775:PF05466,0,1,0,0,1,1017,0.0,1.0,0,0,0,0,0,0,1018,0,1.0,0,0
PF01391,PF01410:PF07452:PF03523:PF01475:PF04789,74,19,12,62,7,937,0.63,0.93,0.16,0.3,0,0,74,0,944,0,0.93,0.0,0
PF12740,PF04414:PF11264:PF01128:PF11326:PF10494,8,19,2,6,17,993,0.11,0.98,0.25,0.15,0,0,8,0,1010,0,0.99,0.0,0
PF12709,PF13096:PF05837:PF06211:PF02083:PF12845,2,11,0,2,11,1005,0.0,0.99,0.0,-0.0,0,0,2,0,1016,0,1.0,0.0,0
PF04338,PF02609:PF15423:PF10683:PF02892:PF04937,0,39,0,0,39,979,0.0,0.96,0,0,2,0,0,2,1016,0.0,1.0,0,0
PF01145,PF01066:PF13813:PF00156:PF00429:PF01762,40,87,24,16,63,915,0.28,0.92,0.6,0.37,11,10,30,1,977,0.91,0.97,0.25,0.47
PF08849,PF12805:PF06745:PF07209:PF11697:PF08093,0,2,0,0,2,1016,0.0,1.0,0,0,0,0,0,0,1018,0,1.0,0,0
PF10339,PF14743:PF11793:PF04250:PF04376:PF01288,0,24,0,0,24,994,0.0,0.98,0,0,1,0,0,1,1017,0.0,1.0,0,0
PF05769,PF05346:PF08552:PF07797:PF10595:PF05301,8,28,5,3,23,987,0.18,0.97,0.62,0.33,1,1,7,0,1010,1.0,0.99,0.12,0.35
PF08501,PF01487:PF01488:PF00745:PF05201:PF00275,17,30,15,2,15,986,0.5,0.98,0.88,0.66,12,5,12,7,994,0.42,0.98,0.29,0.34
PF00681,PF06202:PF14699:PF14702:PF14701:PF12215,7,11,2,5,9,1002,0.18,0.99,0.29,0.22,2,0,7,2,1009,0.0,0.99,0.0,-0.0
PF09252,PF15085:PF02087:PF05151:PF06875:PF11493,0,4,0,0,4,1014,0.0,1.0,0,0,0,0,0,0,1018,0,1.0,0,0
PF16166,PF05996:PF08507:PF01023:PF03992:PF13164,2,34,1,1,33,983,0.03,0.97,0.5,0.12,3,1,1,2,1014,0.33,1.0,0.5,0.41
PF07209,PF03713:PF05962:PF11124:PF09461:PF12843,1,1,0,1,1,1016,0.0,1.0,0.0,-0.0,0,0,1,0,1017,0,1.0,0.0,0
PF16294,PF14443:PF10172:PF01465:PF10495:PF03941,5,32,3,2,29,984,0.09,0.97,0.6,0.23,1,0,5,1,1012,0.0,0.99,0.0,-0.0
PF04377,PF04376:PF02750:PF02112:PF09532:PF14160,7,26,6,1,20,991,0.23,0.98,0.86,0.44,1,1,6,0,1011,1.0,0.99,0.14,0.38
PF02563,PF10481:PF11767:PF07926:PF12297:PF03864,3,19,0,3,19,996,0.0,0.98,0.0,-0.01,0,0,3,0,1015,0,1.0,0.0,0
PF00949,PF00972:PF05309:PF05513:PF02056:PF05509,6,14,6,0,8,1004,0.43,0.99,1.0,0.65,1,0,6,1,1011,0.0,0.99,0.0,-0.0
PF03739,PF17193:PF15281:PF06798:PF01312:PF05974,5,3,0,5,3,1010,0.0,0.99,0.0,-0.0,0,0,5,0,1013,0,1.0,0.0,0
PF03327,PF13619:PF15501:PF05999:PF13600:PF17009,1,4,0,1,4,1013,0.0,1.0,0.0,-0.0,0,0,1,0,1017,0,1.0,0.0,0
PF05297,PF11981:PF07074:PF01880:PF15178:PF06360,0,10,0,0,10,1008,0.0,0.99,0,0,0,0,0,0,1018,0,1.0,0,0
PF12210,PF11464:PF16696:PF00790:PF04366:PF11409,5,42,4,1,38,975,0.1,0.96,0.8,0.27,2,1,4,1,1012,0.5,1.0,0.2,0.31
PF02574,PF02607:PF00809:PF02310:PF02965:PF01642,17,15,7,10,8,993,0.47,0.98,0.41,0.43,6,5,12,1,1000,0.83,0.99,0.29,0.49
PF15140,PF07248:PF08524:PF14991:PF05435:PF04830,6,10,1,5,9,1003,0.1,0.99,0.17,0.12,0,0,6,0,1012,0,0.99,0.0,0
PF00661,PF09538:PF00035:PF00933:PF13691:PF16504,1,71,0,1,71,946,0.0,0.93,0.0,-0.01,7,0,1,7,1010,0.0,0.99,0.0,-0.0
PF16040,PF03359:PF05508:PF14909:PF04109:PF05178,7,22,1,6,21,990,0.05,0.97,0.14,0.07,3,1,6,2,1009,0.33,0.99,0.14,0.21
PF13559,PF15460:PF08795:PF03601:PF06724:PF08642,1,1,0,1,1,1016,0.0,1.0,0.0,-0.0,0,0,1,0,1017,0,1.0,0.0,0
PF11086,PF03860:PF13401:PF01130:PF08587:PF02833,0,43,0,0,43,975,0.0,0.96,0,0,5,0,0,5,1013,0.0,1.0,0,0
PF02393,PF02427:PF07961:PF02950:PF15883:PF08040,0,2,0,0,2,1016,0.0,1.0,0,0,0,0,0,0,1018,0,1.0,0,0
PF00463,PF01274:PF10317:PF08925:PF05189:PF11693,10,23,5,5,18,990,0.22,0.98,0.5,0.32,1,0,10,1,1007,0.0,0.99,0.0,-0.0
PF15851,PF04865:PF14882:PF06761:PF14690:PF15021,0,0,0,0,0,1018,0,1.0,0,0,0,0,0,0,1018,0,1.0,0,0
PF06415,PF10143:PF01676:PF05038:PF09984:PF06719,4,20,4,0,16,998,0.2,0.98,1.0,0.44,0,0,4,0,1014,0,1.0,0.0,0
PF14087,PF07327:PF09252:PF08576:PF03379:PF15104,9,5,1,8,4,1005,0.2,0.99,0.11,0.14,0,0,9,0,1009,0,0.99,0.0,0
PF02024,PF00727:PF00489:PF16716:PF14653:PF06446,1,5,0,1,5,1012,0.0,0.99,0.0,-0.0,0,0,1,0,1017,0,1.0,0.0,0
PF08295,PF02671:PF16879:PF02762:PF02262:PF02761,17,32,16,1,16,985,0.5,0.98,0.94,0.68,5,3,14,2,999,0.6,0.98,0.18,0.32
PF09511,PF08302:PF08303:PF06165:PF17167:PF05285,10,20,4,6,16,992,0.2,0.98,0.4,0.27,1,1,9,0,1008,1.0,0.99,0.1,0.31
PF09519,PF00001:PF08320:PF04236:PF04784:PF10961,2,142,1,1,141,875,0.01,0.86,0.5,0.05,6,0,2,6,1010,0.0,0.99,0.0,-0.0
PF12731,PF12737:PF05722:PF07526:PF16493:PF03789,1,5,1,0,4,1013,0.2,1.0,1.0,0.45,1,1,0,0,1017,1.0,1.0,1.0,1.0
PF12894,PF04192:PF12341:PF03451:PF08662:PF08596,54,37,22,32,15,949,0.59,0.95,0.41,0.47,4,4,50,0,964,1.0,0.95,0.07,0.27
PF01165,PF07816:PF11833:PF09754:PF07896:PF09597,4,12,2,2,10,1004,0.17,0.99,0.5,0.28,1,1,3,0,1014,1.0,1.0,0.25,0.5
PF00080,PF00403:PF01347:PF09172:PF06090:PF06448,19,49,11,8,38,961,0.22,0.95,0.58,0.34,9,4,15,5,994,0.44,0.98,0.21,0.3
PF07465,PF05797:PF02572:PF12805:PF15281:PF14436,0,5,0,0,5,1013,0.0,1.0,0,0,0,0,0,0,1018,0,1.0,0,0
PF05887,PF03944:PF01790:PF01514:PF15281:PF08497,0,7,0,0,7,1011,0.0,0.99,0,0,0,0,0,0,1018,0,1.0,0,0
PF16181,PF16180:PF00554:PF01609:PF16179:PF15661,3,20,3,0,17,998,0.15,0.98,1.0,0.38,3,2,1,1,1014,0.67,1.0,0.67,0.67
PF08738,PF03576:PF01947:PF09056:PF06875:PF09232,0,4,0,0,4,1014,0.0,1.0,0,0,0,0,0,0,1018,0,1.0,0,0
PF11623,PF11282:PF08636:PF07052:PF16007:PF08034,0,15,0,0,15,1003,0.0,0.99,0,0,0,0,0,0,1018,0,1.0,0,0
PF01175,PF07159:PF15350:PF16709:PF16712:PF16711,4,7,1,3,6,1008,0.14,0.99,0.25,0.18,1,0,4,1,1013,0.0,1.0,0.0,-0.0
PF05733,PF02087:PF09461:PF12158:PF14866:PF02950,1,3,0,1,3,1014,0.0,1.0,0.0,-0.0,0,0,1,0,1017,0,1.0,0.0,0
PF00268,PF02284:PF04176:PF01470:PF01327:PF10160,15,27,4,11,23,980,0.15,0.97,0.27,0.18,3,1,14,2,1001,0.33,0.98,0.07,0.14
PF12871,PF14849:PF11567:PF10576:PF01455:PF04187,5,6,0,5,6,1007,0.0,0.99,0.0,-0.01,0,0,5,0,1013,0,1.0,0.0,0
PF12572,PF09350:PF09320:PF05099:PF00684:PF15990,11,19,3,8,16,991,0.16,0.98,0.27,0.2,0,0,11,0,1007,0,0.99,0.0,0
PF06201,PF15928:PF07449:PF10961:PF05903:PF07912,18,25,2,16,23,977,0.08,0.96,0.11,0.08,0,0,18,0,1000,0,0.98,0.0,0
PF15254,PF03306:PF15703:PF08964:PF07957:PF14992,1,7,0,1,7,1010,0.0,0.99,0.0,-0.0,0,0,1,0,1017,0,1.0,0.0,0
PF08946,PF02452:PF03180:PF13876:PF02753:PF08274,1,9,1,0,8,1009,0.11,0.99,1.0,0.33,0,0,1,0,1017,0,1.0,0.0,0
PF09180,PF00458:PF03950:PF03129:PF00749:PF04558,8,62,8,0,54,956,0.13,0.95,1.0,0.35,19,6,2,13,997,0.32,0.99,0.75,0.48
PF15239,PF11017:PF15377:PF01959:PF01701:PF08038,1,5,1,0,4,1013,0.2,1.0,1.0,0.45,0,0,1,0,1017,0,1.0,0.0,0
PF14237,PF11926:PF11875:PF13355:PF17034:PF15627,6,15,3,3,12,1000,0.2,0.99,0.5,0.31,0,0,6,0,1012,0,0.99,0.0,0
PF06070,PF01580:PF06505:PF16325:PF10566:PF17006,1,6,0,1,6,1011,0.0,0.99,0.0,-0.0,0,0,1,0,1017,0,1.0,0.0,0
PF14837,PF14838:PF16875:PF06165:PF02128:PF07504,2,10,2,0,8,1008,0.2,0.99,1.0,0.45,1,0,2,1,1015,0.0,1.0,0.0,-0.0
PF12260,PF14875:PF01012:PF15985:PF06312:PF01769,10,35,4,6,31,977,0.11,0.96,0.4,0.2,1,1,9,0,1008,1.0,0.99,0.1,0.31
PF08586,PF05204:PF09249:PF03848:PF11713:PF02635,0,8,0,0,8,1010,0.0,0.99,0,0,0,0,0,0,1018,0,1.0,0,0
PF04181,PF08733:PF15862:PF08624:PF11500:PF14197,8,14,3,5,11,999,0.21,0.98,0.38,0.28,0,0,8,0,1010,0,0.99,0.0,0
PF00998,PF00516:PF09163:PF09677:PF06007:PF15725,2,2,0,2,2,1014,0.0,1.0,0.0,-0.0,0,0,2,0,1016,0,1.0,0.0,0
PF12076,PF08079:PF13687:PF04116:PF01070:PF11960,5,66,5,0,61,952,0.08,0.94,1.0,0.27,9,2,3,7,1006,0.22,0.99,0.4,0.29
PF02961,PF09307:PF10511:PF08831:PF15384:PF12903,3,4,1,2,3,1012,0.25,1.0,0.33,0.29,0,0,3,0,1015,0,1.0,0.0,0
PF16517,PF09235:PF00788:PF15000:PF08947:PF15151,7,52,6,1,46,965,0.12,0.95,0.86,0.3,0,0,7,0,1011,0,0.99,0.0,0
PF15893,PF03458:PF02740:PF11035:PF10630:PF16829,0,4,0,0,4,1014,0.0,1.0,0,0,0,0,0,0,1018,0,1.0,0,0
PF00529,PF04984:PF16473:PF01807:PF08411:PF06429,3,9,0,3,9,1006,0.0,0.99,0.0,-0.01,0,0,3,0,1015,0,1.0,0.0,0
PF08827,PF05437:PF07277:PF04672:PF04608:PF00800,0,16,0,0,16,1002,0.0,0.98,0,0,0,0,0,0,1018,0,1.0,0,0
PF02158,PF07204:PF11465:PF03921:PF16920:PF12355,4,8,2,2,6,1008,0.25,0.99,0.5,0.35,2,2,2,0,1014,1.0,1.0,0.5,0.71
PF16062,PF00821:PF08925:PF10266:PF02326:PF12150,3,18,1,2,17,998,0.06,0.98,0.33,0.13,0,0,3,0,1015,0,1.0,0.0,0
PF01261,PF12296:PF06244:PF04667:PF00810:PF02284,22,33,3,19,30,966,0.09,0.95,0.14,0.09,1,0,22,1,995,0.0,0.98,0.0,-0.0
PF02376,PF16534:PF16557:PF16719:PF00157:PF12045,8,12,4,4,8,1002,0.33,0.99,0.5,0.4,2,2,6,0,1010,1.0,0.99,0.25,0.5
PF00712,PF02768:PF08275:PF07963:PF02767:PF04546,7,12,7,0,5,1006,0.58,1.0,1.0,0.76,4,4,3,0,1011,1.0,1.0,0.57,0.75
PF06445,PF09397:PF09677:PF16325:PF01706:PF06995,5,6,1,4,5,1008,0.17,0.99,0.2,0.18,0,0,5,0,1013,0,1.0,0.0,0
PF03324,PF13750:PF03090:PF03241:PF01312:PF06805,0,0,0,0,0,1018,0,1.0,0,0,0,0,0,0,1018,0,1.0,0,0
PF01746,PF12298:PF11250:PF02234:PF10217:PF07052,18,25,4,14,21,979,0.16,0.97,0.22,0.17,1,0,18,1,999,0.0,0.98,0.0,-0.0
PF07817,PF11527:PF13851:PF11831:PF10226:PF15877,5,19,1,4,18,995,0.05,0.98,0.2,0.09,0,0,5,0,1013,0,1.0,0.0,0
PF10370,PF05913:PF04993:PF13026:PF02589:PF11860,1,7,1,0,6,1011,0.14,0.99,1.0,0.38,0,0,1,0,1017,0,1.0,0.0,0
PF01575,PF08354:PF16073:PF02036:PF00106:PF00698,34,200,27,7,173,811,0.14,0.82,0.79,0.28,25,17,17,8,976,0.68,0.98,0.5,0.57
PF10205,PF17045:PF15905:PF09762:PF10481:PF11577,2,11,1,1,10,1006,0.09,0.99,0.5,0.21,0,0,2,0,1016,0,1.0,0.0,0
PF07549,PF02355:PF14882:PF08299:PF12302:PF03428,4,8,3,1,5,1009,0.38,0.99,0.75,0.53,0,0,4,0,1014,0,1.0,0.0,0
PF11231,PF17028:PF10807:PF03476:PF02281:PF00266,0,55,0,0,55,963,0.0,0.95,0,0,0,0,0,0,1018,0,1.0,0,0
PF16010,PF04526:PF03188:PF10348:PF00331:PF05199,17,82,15,2,67,934,0.18,0.93,0.88,0.38,9,5,12,4,997,0.56,0.98,0.29,0.4
PF09463,PF10446:PF10198:PF10336:PF08655:PF10307,0,12,0,0,12,1006,0.0,0.99,0,0,0,0,0,0,1018,0,1.0,0,0
PF00625,PF02828:PF00595:PF11957:PF10608:PF11374,40,125,27,13,98,880,0.22,0.89,0.68,0.34,3,3,37,0,978,1.0,0.96,0.07,0.27
PF09834,PF13362:PF05065:PF09594:PF00524:PF09979,0,6,0,0,6,1012,0.0,0.99,0,0,0,0,0,0,1018,0,1.0,0,0
PF06074,PF17206:PF04233:PF07505:PF17164:PF04222,0,1,0,0,1,1017,0.0,1.0,0,0,0,0,0,0,1018,0,1.0,0,0
PF04696,PF12511:PF10234:PF04880:PF09302:PF12632,12,19,5,7,14,992,0.26,0.98,0.42,0.32,0,0,12,0,1006,0,0.99,0.0,0
PF00848,PF08802:PF04305:PF08417:PF02921:PF09165,13,27,7,6,20,985,0.26,0.97,0.54,0.36,3,3,10,0,1005,1.0,0.99,0.23,0.48
PF00043,PF14497:PF04399:PF13417:PF03540:PF13409,49,79,36,13,43,926,0.46,0.94,0.73,0.55,7,6,43,1,968,0.86,0.96,0.12,0.31
PF06984,PF09793:PF01279:PF10248:PF07939:PF00468,11,15,1,10,14,993,0.07,0.98,0.09,0.07,0,0,11,0,1007,0,0.99,0.0,0
PF14688,PF14687:PF04056:PF07488:PF16712:PF16711,9,20,8,1,12,997,0.4,0.99,0.89,0.59,0,0,9,0,1009,0,0.99,0.0,0
PF13851,PF12180:PF13870:PF13166:PF13096:PF06211,3,5,0,3,5,1010,0.0,0.99,0.0,-0.0,0,0,3,0,1015,0,1.0,0.0,0
PF08760,PF16335:PF17168:PF16334:PF09363:PF03894,5,6,4,1,2,1011,0.67,1.0,0.8,0.73,1,1,4,0,1013,1.0,1.0,0.2,0.45
PF06147,PF05480:PF07445:PF06230:PF15338:PF15423,0,0,0,0,0,1018,0,1.0,0,0,0,0,0,0,1018,0,1.0,0,0
PF16210,PF15234:PF12571:PF15851:PF08298:PF15726,1,0,0,1,0,1017,0,1.0,0.0,0,0,0,1,0,1017,0,1.0,0.0,0
PF05721,PF14027:PF04479:PF11807:PF12311:PF03328,38,42,15,23,27,953,0.36,0.95,0.39,0.35,12,11,27,1,979,0.92,0.97,0.29,0.51
PF14340,PF06936:PF04205:PF00462:PF02556:PF04224,2,54,2,0,52,964,0.04,0.95,1.0,0.19,3,2,0,1,1015,0.67,1.0,1.0,0.82
PF00984,PF03720:PF03721:PF00273:PF03483:PF03484,7,24,7,0,17,994,0.29,0.98,1.0,0.54,1,1,6,0,1011,1.0,0.99,0.14,0.38
PF12213,PF08418:PF16002:PF08451:PF03633:PF03636,7,15,5,2,10,1001,0.33,0.99,0.71,0.48,0,0,7,0,1011,0,0.99,0.0,0
PF06342,PF14799:PF14935:PF15260:PF10853:PF05612,1,11,0,1,11,1006,0.0,0.99,0.0,-0.0,1,0,1,1,1016,0.0,1.0,0.0,-0.0
PF14858,PF10650:PF15651:PF16830:PF12814:PF16574,0,12,0,0,12,1006,0.0,0.99,0,0,1,0,0,1,1017,0.0,1.0,0,0
PF15503,PF15062:PF06695:PF13270:PF02427:PF11016,1,3,0,1,3,1014,0.0,1.0,0.0,-0.0,0,0,1,0,1017,0,1.0,0.0,0
PF10630,PF15234:PF06670:PF15398:PF15060:PF15015,0,1,0,0,1,1017,0.0,1.0,0,0,0,0,0,0,1018,0,1.0,0,0
PF10672,PF12955:PF13396:PF16091:PF10253:PF11510,3,11,0,3,11,1004,0.0,0.99,0.0,-0.01,2,0,3,2,1013,0.0,1.0,0.0,-0.0
PF12621,PF13967:PF02714:PF14703:PF16759:PF16213,10,43,10,0,33,975,0.23,0.97,1.0,0.47,21,10,0,11,997,0.48,0.99,1.0,0.69
PF15846,PF07117:PF03548:PF15856:PF00739:PF15825,3,5,0,3,5,1010,0.0,0.99,0.0,-0.0,0,0,3,0,1015,0,1.0,0.0,0
PF03348,PF05251:PF07745:PF00148:PF08661:PF02175,16,16,6,10,10,992,0.38,0.98,0.38,0.37,0,0,16,0,1002,0,0.98,0.0,0
PF05991,PF03703:PF10571:PF02620:PF12049:PF03193,3,14,1,2,13,1002,0.07,0.99,0.33,0.15,0,0,3,0,1015,0,1.0,0.0,0
PF10070,PF01936:PF06892:PF00347:PF07829:PF07046,0,30,0,0,30,988,0.0,0.97,0,0,1,0,0,1,1017,0.0,1.0,0,0
PF13406,PF07409:PF05787:PF01913:PF17006:PF03406,1,1,0,1,1,1016,0.0,1.0,0.0,-0.0,0,0,1,0,1017,0,1.0,0.0,0
PF15092,PF11593:PF10106:PF15832:PF03238:PF11210,4,3,0,4,3,1011,0.0,0.99,0.0,-0.0,0,0,4,0,1014,0,1.0,0.0,0
PF03283,PF02990:PF05938:PF09353:PF04525:PF04979,19,47,8,11,39,960,0.17,0.95,0.42,0.25,7,3,16,4,995,0.43,0.98,0.16,0.25
PF06159,PF07542:PF10218:PF00830:PF01632:PF06083,2,20,2,0,18,998,0.1,0.98,1.0,0.31,0,0,2,0,1016,0,1.0,0.0,0
PF00612,PF10580:PF06614:PF13178:PF00063:PF15157,62,75,40,22,35,921,0.53,0.94,0.65,0.56,1,1,61,0,956,1.0,0.94,0.02,0.12
PF02257,PF12031:PF09743:PF12552:PF08729:PF01388,18,39,8,10,31,969,0.21,0.96,0.44,0.28,2,1,17,1,999,0.5,0.98,0.06,0.16
PF11579,PF15334:PF05448:PF15770:PF01668:PF15312,0,4,0,0,4,1014,0.0,1.0,0,0,0,0,0,0,1018,0,1.0,0,0
PF12077,PF12628:PF01051:PF15032:PF15023:PF10906,0,3,0,0,3,1015,0.0,1.0,0,0,0,0,0,0,1018,0,1.0,0,0
PF09458,PF14200:PF00754:PF12248:PF05592:PF11980,12,62,6,6,56,950,0.1,0.94,0.5,0.2,5,2,10,3,1003,0.4,0.99,0.17,0.25
PF12178,PF10407:PF15235:PF01430:PF15082:PF17096,2,5,0,2,5,1011,0.0,0.99,0.0,-0.0,0,0,2,0,1016,0,1.0,0.0,0
PF01166,PF15910:PF06446:PF16541:PF06373:PF01279,6,4,0,6,4,1008,0.0,0.99,0.0,-0.0,0,0,6,0,1012,0,0.99,0.0,0
PF05839,PF01428:PF02063:PF14342:PF01754:PF09138,4,36,2,2,34,980,0.06,0.96,0.5,0.16,2,1,3,1,1013,0.5,1.0,0.25,0.35
PF16077,PF10188:PF01868:PF13002:PF05063:PF13391,11,39,6,5,33,974,0.15,0.96,0.55,0.28,1,1,10,0,1007,1.0,0.99,0.09,0.3
PF09790,PF15247:PF08209:PF15991:PF04939:PF15369,5,24,3,2,21,992,0.12,0.98,0.6,0.27,0,0,5,0,1013,0,1.0,0.0,0
PF03998,PF03214:PF06219:PF15165:PF01387:PF15691,9,6,1,8,5,1004,0.17,0.99,0.11,0.13,0,0,9,0,1009,0,0.99,0.0,0
PF16355,PF16353:PF02929:PF02837:PF02836:PF16338,7,22,7,0,15,996,0.32,0.99,1.0,0.56,5,1,6,4,1007,0.2,0.99,0.14,0.16
PF16165,PF08150:PF08165:PF08151:PF15625:PF08372,8,16,5,3,11,999,0.31,0.99,0.62,0.44,2,1,7,1,1009,0.5,0.99,0.12,0.25
PF08008,PF02217:PF08093:PF11039:PF15485:PF06651,0,4,0,0,4,1014,0.0,1.0,0,0,0,0,0,0,1018,0,1.0,0,0
PF11651,PF10460:PF16286:PF03420:PF12400:PF10691,0,6,0,0,6,1012,0.0,0.99,0,0,0,0,0,0,1018,0,1.0,0,0
PF15005,PF14049:PF07111:PF10173:PF14047:PF01878,6,15,3,3,12,1000,0.2,0.99,0.5,0.31,1,0,6,1,1011,0.0,0.99,0.0,-0.0
PF08142,PF04950:PF04065:PF10189:PF12422:PF16529,14,30,14,0,16,988,0.47,0.98,1.0,0.68,3,2,12,1,1003,0.67,0.99,0.14,0.3
PF09983,PF09664:PF05109:PF09498:PF08334:PF14258,3,4,3,0,1,1014,0.75,1.0,1.0,0.87,0,0,3,0,1015,0,1.0,0.0,0
PF13640,PF08336:PF04406:PF01553:PF01753:PF00246,39,129,28,11,101,878,0.22,0.89,0.72,0.35,23,18,21,5,974,0.78,0.97,0.46,0.59
PF08421,PF08484:PF11967:PF07409:PF02616:PF13247,2,2,2,0,0,1016,1.0,1.0,1.0,1.0,0,0,2,0,1016,0,1.0,0.0,0
PF01663,PF04987:PF01223:PF07035:PF07819:PF03190,38,52,24,14,28,952,0.46,0.96,0.63,0.52,3,3,35,0,980,1.0,0.97,0.08,0.28
PF00602,PF06122:PF00524:PF05138:PF12236:PF08651,1,4,0,1,4,1013,0.0,1.0,0.0,-0.0,0,0,1,0,1017,0,1.0,0.0,0
PF15270,PF09937:PF16980:PF00571:PF05437:PF08096,1,59,0,1,59,958,0.0,0.94,0.0,-0.01,0,0,1,0,1017,0,1.0,0.0,0
PF12904,PF13204:PF01114:PF15302:PF08027:PF07085,0,8,0,0,8,1010,0.0,0.99,0,0,0,0,0,0,1018,0,1.0,0,0
PF06437,PF08591:PF11677:PF15063:PF02943:PF14986,3,1,0,3,1,1014,0.0,1.0,0.0,-0.0,0,0,3,0,1015,0,1.0,0.0,0
PF07302,PF07499:PF12101:PF13090:PF03745:PF12080,0,4,0,0,4,1014,0.0,1.0,0,0,0,0,0,0,1018,0,1.0,0,0
PF15398,PF15467:PF16829:PF15872:PF15130:PF10630,1,1,0,1,1,1016,0.0,1.0,0.0,-0.0,0,0,1,0,1017,0,1.0,0.0,0
PF07409,PF07157:PF13722:PF11751:PF06890:PF03090,0,0,0,0,0,1018,0,1.0,0,0,0,0,0,0,1018,0,1.0,0,0
PF07011,PF11947:PF15063:PF10839:PF00537:PF06541,0,4,0,0,4,1014,0.0,1.0,0,0,0,0,0,0,1018,0,1.0,0,0
PF09027,PF06760:PF08917:PF03623:PF11555:PF08919,2,15,2,0,13,1003,0.13,0.99,1.0,0.36,2,1,1,1,1015,0.5,1.0,0.5,0.5
PF06434,PF11791:PF00694:PF00330:PF02754:PF11870,2,43,2,0,41,975,0.05,0.96,1.0,0.21,2,1,1,1,1015,0.5,1.0,0.5,0.5
PF08124,PF02278:PF02884:PF04425:PF04426:PF16485,2,6,2,0,4,1012,0.33,1.0,1.0,0.58,0,0,2,0,1016,0,1.0,0.0,0
PF13716,PF01661:PF09036:PF15720:PF10193:PF03836,29,47,17,12,30,959,0.36,0.96,0.59,0.44,4,4,25,0,989,1.0,0.98,0.14,0.37
PF02429,PF05111:PF10578:PF11386:PF06567:PF08444,0,4,0,0,4,1014,0.0,1.0,0,0,0,0,0,0,1018,0,1.0,0,0
PF15938,PF14996:PF15161:PF16112:PF04794:PF03883,1,7,1,0,6,1011,0.14,0.99,1.0,0.38,1,1,0,0,1017,1.0,1.0,1.0,1.0
PF05544,PF02162:PF07086:PF04371:PF04414:PF15872,2,9,1,1,8,1008,0.11,0.99,0.5,0.23,0,0,2,0,1016,0,1.0,0.0,0
PF03670,PF03488:PF06313:PF02827:PF04691:PF08089,5,3,0,5,3,1010,0.0,0.99,0.0,-0.0,0,0,5,0,1013,0,1.0,0.0,0
PF04692,PF14554:PF15800:PF03128:PF00341:PF09598,1,9,1,0,8,1009,0.11,0.99,1.0,0.33,1,1,0,0,1017,1.0,1.0,1.0,1.0
PF04545,PF04539:PF08281:PF00140:PF04542:PF03979,22,27,20,2,7,989,0.74,0.99,0.91,0.82,5,5,17,0,996,1.0,0.98,0.23,0.47
PF12442,PF11264:PF00543:PF11347:PF00945:PF02713,5,9,2,3,7,1006,0.22,0.99,0.4,0.29,0,0,5,0,1013,0,1.0,0.0,0
PF02906,PF12617:PF02256:PF12139:PF12838:PF12800,13,25,8,5,17,988,0.32,0.98,0.62,0.43,0,0,13,0,1005,0,0.99,0.0,0
PF14593,PF11629:PF12063:PF12202:PF12179:PF06479,3,24,3,0,21,994,0.12,0.98,1.0,0.35,4,3,0,1,1014,0.75,1.0,1.0,0.87
PF09637,PF00220:PF06449:PF00126:PF15671:PF14852,7,16,1,6,15,996,0.06,0.98,0.14,0.09,0,0,7,0,1011,0,0.99,0.0,0
PF03104,PF00136:PF14260:PF12254:PF08996:PF08490,36,37,35,1,2,980,0.95,1.0,0.97,0.96,14,14,22,0,982,1.0,0.98,0.39,0.62
PF15690,PF15689:PF15688:PF15687:PF09049:PF09050,0,0,0,0,0,1018,0,1.0,0,0,0,0,0,0,1018,0,1.0,0,0
PF00572,PF01192:PF10780:PF01470:PF10224:PF09631,20,24,8,12,16,982,0.33,0.97,0.4,0.35,2,2,18,0,998,1.0,0.98,0.1,0.31
PF00978,PF01443:PF08706:PF01660:PF15082:PF04610,5,15,5,0,10,1003,0.33,0.99,1.0,0.57,2,1,4,1,1012,0.5,1.0,0.2,0.31
PF05191,PF11789:PF12483:PF04089:PF10075:PF14997,12,23,6,6,17,989,0.26,0.98,0.5,0.35,2,2,10,0,1006,1.0,0.99,0.17,0.41
PF02779,PF00456:PF02780:PF13292:PF16078:PF00676,41,54,38,3,16,961,0.7,0.98,0.93,0.8,4,4,37,0,977,1.0,0.96,0.1,0.31
PF01485,PF05773:PF16678:PF08572:PF03256:PF04757,60,67,27,33,40,918,0.4,0.93,0.45,0.39,5,4,56,1,957,0.8,0.94,0.07,0.22
PF08572,PF06544:PF09186:PF01205:PF05773:PF01480,4,56,4,0,52,962,0.07,0.95,1.0,0.26,7,2,2,5,1009,0.29,0.99,0.5,0.37
PF10295,PF13810:PF15696:PF05841:PF03525:PF11770,3,1,0,3,1,1014,0.0,1.0,0.0,-0.0,0,0,3,0,1015,0,1.0,0.0,0
PF08333,PF12009:PF14529:PF08284:PF02994:PF13655,9,76,6,3,70,939,0.08,0.93,0.67,0.21,7,4,5,3,1006,0.57,0.99,0.44,0.5
PF05137,PF04917:PF05513:PF11751:PF04738:PF02565,0,2,0,0,2,1016,0.0,1.0,0,0,0,0,0,0,1018,0,1.0,0,0
PF04618,PF04617:PF04731:PF10525:PF03867:PF12407,3,5,1,2,4,1011,0.2,0.99,0.33,0.26,1,1,2,0,1015,1.0,1.0,0.33,0.58
PF13543,PF09128:PF09469:PF16018:PF02196:PF08683,2,21,1,1,20,996,0.05,0.98,0.5,0.15,1,0,2,1,1015,0.0,1.0,0.0,-0.0
PF02171,PF16488:PF16487:PF16486:PF02170:PF08699,50,48,42,8,6,962,0.88,0.99,0.84,0.85,34,32,18,2,966,0.94,0.98,0.64,0.77
PF08183,PF15082:PF04610:PF15407:PF10407:PF04001,0,6,0,0,6,1012,0.0,0.99,0,0,0,0,0,0,1018,0,1.0,0,0
PF00956,PF01214:PF05197:PF16969:PF16054:PF01922,22,35,9,13,26,970,0.26,0.96,0.41,0.31,4,4,18,0,996,1.0,0.98,0.18,0.42
PF01669,PF15762:PF09428:PF03745:PF02070:PF00918,1,2,0,1,2,1015,0.0,1.0,0.0,-0.0,0,0,1,0,1017,0,1.0,0.0,0
PF03786,PF14882:PF07476:PF04865:PF15750:PF13007,1,1,0,1,1,1016,0.0,1.0,0.0,-0.0,0,0,1,0,1017,0,1.0,0.0,0
PF09129,PF11880:PF04740:PF11849:PF12835:PF04349,2,4,2,0,2,1014,0.5,1.0,1.0,0.71,0,0,2,0,1016,0,1.0,0.0,0
PF13473,PF13340:PF08894:PF09684:PF02719:PF07178,3,8,3,0,5,1010,0.38,1.0,1.0,0.61,0,0,3,0,1015,0,1.0,0.0,0
PF12891,PF11214:PF15798:PF09510:PF08291:PF16967,2,0,0,2,0,1016,0,1.0,0.0,0,0,0,2,0,1016,0,1.0,0.0,0
PF10321,PF02118:PF03409:PF10323:PF10325:PF10317,7,23,4,3,19,992,0.17,0.98,0.57,0.31,1,1,6,0,1011,1.0,0.99,0.14,0.38
PF08652,PF01066:PF06237:PF04833:PF07786:PF13813,5,48,4,1,44,969,0.08,0.96,0.8,0.25,0,0,5,0,1013,0,1.0,0.0,0
PF12477,PF11130:PF09677:PF03241:PF01913:PF02572,0,3,0,0,3,1015,0.0,1.0,0,0,0,0,0,0,1018,0,1.0,0,0
PF01476,PF14856:PF01551:PF00704:PF03427:PF01657,39,77,28,11,49,930,0.36,0.94,0.72,0.48,6,6,33,0,979,1.0,0.97,0.15,0.39
PF02534,PF03524:PF12868:PF05100:PF15179:PF15480,7,9,7,0,2,1009,0.78,1.0,1.0,0.88,0,0,7,0,1011,0,0.99,0.0,0
PF13506,PF03088:PF01731:PF04109:PF02544:PF10179,8,44,1,7,43,967,0.02,0.95,0.12,0.04,3,0,8,3,1007,0.0,0.99,0.0,-0.0
PF03976,PF15817:PF08730:PF16586:PF04370:PF09461,0,1,0,0,1,1017,0.0,1.0,0,0,0,0,0,0,1018,0,1.0,0,0
PF04281,PF05347:PF07491:PF11176:PF00296:PF05071,3,52,1,2,51,964,0.02,0.95,0.33,0.07,8,1,2,7,1008,0.12,0.99,0.33,0.2
PF05124,PF10129:PF02653:PF10414:PF06804:PF10151,0,22,0,0,22,996,0.0,0.98,0,0,0,0,0,0,1018,0,1.0,0,0
PF08023,PF16047:PF16048:PF08018:PF12121:PF07440,0,0,0,0,0,1018,0,1.0,0,0,0,0,0,0,1018,0,1.0,0,0
PF14376,PF12080:PF11794:PF03090:PF01913:PF01580,3,6,0,3,6,1009,0.0,0.99,0.0,-0.0,0,0,3,0,1015,0,1.0,0.0,0
PF16523,PF15441:PF15720:PF12026:PF03983:PF06395,2,16,2,0,14,1002,0.12,0.99,1.0,0.35,2,2,0,0,1016,1.0,1.0,1.0,1.0
PF03172,PF16737:PF12269:PF14061:PF12165:PF14051,4,17,2,2,15,999,0.12,0.98,0.5,0.24,1,1,3,0,1014,1.0,1.0,0.25,0.5
PF02268,PF02751:PF15689:PF17048:PF15690:PF15688,13,21,12,1,9,996,0.57,0.99,0.92,0.72,0,0,13,0,1005,0,0.99,0.0,0
PF13843,PF13842:PF12259:PF07530:PF04724:PF05890,49,20,12,37,8,961,0.6,0.96,0.24,0.36,2,2,47,0,969,1.0,0.95,0.04,0.2
PF12617,PF12139:PF12800:PF02906:PF11953:PF08352,0,15,0,0,15,1003,0.0,0.99,0,0,1,0,0,1,1017,0.0,1.0,0,0
PF01068,PF04679:PF04675:PF10345:PF14743:PF11411,19,19,19,0,0,999,1.0,1.0,1.0,1.0,7,7,12,0,999,1.0,0.99,0.37,0.6
PF06838,PF02534:PF11759:PF17085:PF02371:PF10009,1,9,0,1,9,1008,0.0,0.99,0.0,-0.0,0,0,1,0,1017,0,1.0,0.0,0
PF13931,PF16540:PF14739:PF11995:PF15908:PF16796,8,15,5,3,10,1000,0.33,0.99,0.62,0.45,3,3,5,0,1010,1.0,1.0,0.38,0.61
PF05694,PF08229:PF06624:PF01022:PF06052:PF04371,6,14,1,5,13,999,0.07,0.98,0.17,0.1,0,0,6,0,1012,0,0.99,0.0,0
PF15189,PF09733:PF07839:PF15386:PF04468:PF07904,5,16,3,2,13,1000,0.19,0.99,0.6,0.33,1,1,4,0,1013,1.0,1.0,0.2,0.45
PF11069,PF16972:PF02401:PF17043:PF12298:PF01160,3,12,0,3,12,1003,0.0,0.99,0.0,-0.01,1,0,3,1,1014,0.0,1.0,0.0,-0.0
PF01408,PF17132:PF03118:PF08652:PF08409:PF00891,40,45,14,26,31,947,0.31,0.94,0.35,0.3,3,2,38,1,977,0.67,0.96,0.05,0.18
PF16577,PF12744:PF16158:PF00569:PF09069:PF09030,2,50,2,0,48,968,0.04,0.95,1.0,0.2,4,2,0,2,1014,0.5,1.0,1.0,0.71
PF02580,PF05817:PF09734:PF02101:PF01780:PF06283,15,25,7,8,18,985,0.28,0.97,0.47,0.35,4,3,12,1,1002,0.75,0.99,0.2,0.38
PF04777,PF00085:PF15928:PF05903:PF08216:PF01507,26,120,22,4,98,894,0.18,0.9,0.85,0.37,2,1,25,1,991,0.5,0.97,0.04,0.13
PF13877,PF15867:PF16546:PF04049:PF05279:PF07721,7,28,3,4,25,986,0.11,0.97,0.43,0.2,2,1,6,1,1010,0.5,0.99,0.14,0.26
PF10718,PF01303:PF06725:PF09187:PF03238:PF15334,0,1,0,0,1,1017,0.0,1.0,0,0,0,0,0,0,1018,0,1.0,0,0
PF07533,PF07744:PF07529:PF15790:PF13907:PF07500,18,44,15,3,29,971,0.34,0.97,0.83,0.52,6,6,12,0,1000,1.0,0.99,0.33,0.57
PF05203,PF15624:PF15914:PF09441:PF15082:PF09322,7,11,3,4,8,1003,0.27,0.99,0.43,0.34,0,0,7,0,1011,0,0.99,0.0,0
PF08204,PF04549:PF01114:PF06736:PF16196:PF02165,0,2,0,0,2,1016,0.0,1.0,0,0,0,0,0,0,1018,0,1.0,0,0
PF13016,PF04788:PF00473:PF01245:PF01786:PF00212,2,24,1,1,23,993,0.04,0.98,0.5,0.14,3,1,1,2,1014,0.33,1.0,0.5,0.41
PF14421,PF08762:PF01660:PF14307:PF08706:PF00978,0,12,0,0,12,1006,0.0,0.99,0,0,2,0,0,2,1016,0.0,1.0,0,0
PF10043,PF13677:PF13721:PF06834:PF06995:PF09611,0,3,0,0,3,1015,0.0,1.0,0,0,0,0,0,0,1018,0,1.0,0,0
PF09527,PF16096:PF03724:PF09090:PF03423:PF16321,0,17,0,0,17,1001,0.0,0.98,0,0,0,0,0,0,1018,0,1.0,0,0
PF13389,PF10856:PF15623:PF02979:PF15823:PF13588,0,5,0,0,5,1013,0.0,1.0,0,0,0,0,0,0,1018,0,1.0,0,0
PF01053,PF04828:PF08544:PF02656:PF05899:PF02502,34,64,18,16,46,938,0.28,0.94,0.53,0.36,9,9,25,0,984,1.0,0.98,0.26,0.51
PF05633,PF16803:PF17187:PF01439:PF12061:PF00764,6,20,3,3,17,995,0.15,0.98,0.5,0.27,3,2,4,1,1011,0.67,1.0,0.33,0.47
PF12052,PF02208:PF08733:PF15737:PF08687:PF08688,6,10,3,3,7,1005,0.3,0.99,0.5,0.38,1,1,5,0,1012,1.0,1.0,0.17,0.41
PF17217,PF09034:PF10461:PF00791:PF11957:PF00007,3,23,3,0,20,995,0.13,0.98,1.0,0.36,2,1,2,1,1014,0.5,1.0,0.33,0.41
PF07730,PF09239:PF06580:PF16359:PF08448:PF17203,7,21,4,3,17,994,0.19,0.98,0.57,0.32,1,0,7,1,1010,0.0,0.99,0.0,-0.0
PF06723,PF10712:PF00012:PF09259:PF04279:PF10268,5,72,2,3,70,943,0.03,0.93,0.4,0.09,3,2,3,1,1012,0.67,1.0,0.4,0.51
PF14989,PF10195:PF15011:PF14832:PF03612:PF12488,2,12,0,2,12,1004,0.0,0.99,0.0,-0.0,0,0,2,0,1016,0,1.0,0.0,0
PF11051,PF04189:PF08155:PF01416:PF05971:PF00346,10,49,6,4,43,965,0.12,0.95,0.6,0.26,5,2,8,3,1005,0.4,0.99,0.2,0.28
PF00695,PF10335:PF05973:PF06873:PF08115:PF12226,0,2,0,0,2,1016,0.0,1.0,0,0,0,0,0,0,1018,0,1.0,0,0
PF07474,PF12662:PF06119:PF09307:PF02412:PF08831,8,32,8,0,24,986,0.25,0.98,1.0,0.49,3,2,6,1,1009,0.67,0.99,0.25,0.41
PF07489,PF01776:PF00014:PF13648:PF09426:PF16856,0,52,0,0,52,966,0.0,0.95,0,0,1,0,0,1,1017,0.0,1.0,0,0
PF01981,PF01451:PF03208:PF05529:PF04176:PF09280,15,35,6,9,29,974,0.17,0.96,0.4,0.25,3,3,12,0,1003,1.0,0.99,0.2,0.44
PF15751,PF02955:PF03930:PF15518:PF15150:PF14882,1,5,0,1,5,1012,0.0,0.99,0.0,-0.0,0,0,1,0,1017,0,1.0,0.0,0
PF04037,PF04910:PF11708:PF06886:PF03352:PF09816,4,27,1,3,26,988,0.04,0.97,0.25,0.09,1,0,4,1,1013,0.0,1.0,0.0,-0.0
PF04856,PF00714:PF14653:PF06875:PF06541:PF15173,0,1,0,0,1,1017,0.0,1.0,0,0,0,0,0,0,1018,0,1.0,0,0
PF06382,PF02101:PF07253:PF09784:PF05438:PF15390,1,9,0,1,9,1008,0.0,0.99,0.0,-0.0,0,0,1,0,1017,0,1.0,0.0,0
PF04885,PF04674:PF07966:PF09478:PF02055:PF00709,1,36,0,1,36,981,0.0,0.96,0.0,-0.01,3,0,1,3,1014,0.0,1.0,0.0,-0.0
PF10173,PF10217:PF05615:PF07052:PF08227:PF15313,5,29,3,2,26,987,0.1,0.97,0.6,0.24,1,1,4,0,1013,1.0,1.0,0.2,0.45
PF00186,PF00303:PF12940:PF09261:PF01853:PF14779,9,56,6,3,50,959,0.11,0.95,0.67,0.25,2,1,8,1,1008,0.5,0.99,0.11,0.23
PF08736,PF04382:PF09380:PF09379:PF05902:PF11819,15,43,15,0,28,975,0.35,0.97,1.0,0.58,13,10,5,3,1000,0.77,0.99,0.67,0.71
PF10155,PF14441:PF11698:PF01755:PF16692:PF14764,6,32,2,4,30,982,0.06,0.97,0.33,0.13,1,0,6,1,1011,0.0,0.99,0.0,-0.0
PF01213,PF08603:PF01288:PF00809:PF02152:PF02607,11,26,10,1,16,991,0.38,0.98,0.91,0.59,5,2,9,3,1004,0.4,0.99,0.18,0.26
PF04632,PF16967:PF07610:PF06745:PF04428:PF08291,0,3,0,0,3,1015,0.0,1.0,0,0,0,0,0,0,1018,0,1.0,0,0
PF07012,PF14362:PF14028:PF04848:PF15776:PF08724,0,5,0,0,5,1013,0.0,1.0,0,0,0,0,0,0,1018,0,1.0,0,0
PF09820,PF07444:PF15109:PF07368:PF01666:PF06581,4,0,0,4,0,1014,0,1.0,0.0,0,0,0,4,0,1014,0,1.0,0.0,0
PF01660,PF15476:PF12255:PF09327:PF04196:PF07523,6,1,1,5,0,1012,1.0,1.0,0.17,0.41,0,0,6,0,1012,0,0.99,0.0,0
PF01625,PF05047:PF02284:PF06749:PF04520:PF05915,20,20,4,16,16,982,0.2,0.97,0.2,0.18,2,2,18,0,998,1.0,0.98,0.1,0.31
PF07809,PF15298:PF04367:PF02576:PF14279:PF11255,0,2,0,0,2,1016,0.0,1.0,0,0,0,0,0,0,1018,0,1.0,0,0
PF10241,PF03604:PF05162:PF08122:PF09280:PF04794,5,24,2,3,22,991,0.08,0.98,0.4,0.17,1,1,4,0,1013,1.0,1.0,0.2,0.45
PF05176,PF07063:PF03652:PF01680:PF06516:PF04299,3,24,0,3,24,991,0.0,0.97,0.0,-0.01,1,0,3,1,1014,0.0,1.0,0.0,-0.0
PF11827,PF15518:PF08411:PF12603:PF15272:PF08011,0,2,0,0,2,1016,0.0,1.0,0,0,0,0,0,0,1018,0,1.0,0,0
PF15940,PF02881:PF05926:PF05661:PF03550:PF10717,0,31,0,0,31,987,0.0,0.97,0,0,0,0,0,0,1018,0,1.0,0,0
PF16179,PF00554:PF16180:PF03020:PF16181:PF15808,16,22,16,0,6,996,0.73,0.99,1.0,0.85,2,2,14,0,1002,1.0,0.99,0.12,0.35
PF17193,PF01312:PF11245:PF03739:PF17206:PF10106,0,7,0,0,7,1011,0.0,0.99,0,0,0,0,0,0,1018,0,1.0,0,0
PF06411,PF04989:PF07142:PF09796:PF03625:PF07189,0,17,0,0,17,1001,0.0,0.98,0,0,1,0,0,1,1017,0.0,1.0,0,0
PF00438,PF02773:PF02772:PF14365:PF04862:PF02075,5,11,5,0,6,1007,0.45,0.99,1.0,0.67,3,3,2,0,1013,1.0,1.0,0.6,0.77
PF02754,PF02589:PF11870:PF02652:PF11880:PF07746,7,9,7,0,2,1009,0.78,1.0,1.0,0.88,1,1,6,0,1011,1.0,0.99,0.14,0.38
PF14958,PF10253:PF15877:PF15311:PF15558:PF06637,0,9,0,0,9,1009,0.0,0.99,0,0,0,0,0,0,1018,0,1.0,0,0
PF03162,PF07896:PF04410:PF11927:PF07816:PF03350,4,37,2,2,35,979,0.05,0.96,0.5,0.16,1,1,3,0,1014,1.0,1.0,0.25,0.5
PF12346,PF00319:PF02665:PF12347:PF09729:PF01873,1,31,1,0,30,987,0.03,0.97,1.0,0.18,4,0,1,4,1013,0.0,1.0,0.0,-0.0
PF02728,PF02727:PF01179:PF09248:PF00699:PF00547,18,33,18,0,15,985,0.55,0.99,1.0,0.73,5,5,13,0,1000,1.0,0.99,0.28,0.52
PF05620,PF03943:PF09162:PF17085:PF09367:PF03437,4,8,3,1,5,1009,0.38,0.99,0.75,0.53,0,0,4,0,1014,0,1.0,0.0,0
PF09465,PF01222:PF08504:PF10846:PF16181:PF02750,7,28,6,1,22,989,0.21,0.98,0.86,0.42,2,2,5,0,1011,1.0,1.0,0.29,0.53
PF11914,PF11970:PF09732:PF16741:PF11521:PF14718,0,19,0,0,19,999,0.0,0.98,0,0,0,0,0,0,1018,0,1.0,0,0
PF09782,PF15377:PF07464:PF15139:PF11105:PF11017,6,3,1,5,2,1010,0.33,0.99,0.17,0.23,0,0,6,0,1012,0,0.99,0.0,0
PF09324,PF12783:PF16213:PF16206:PF14222:PF08638,12,41,12,0,29,977,0.29,0.97,1.0,0.53,10,6,6,4,1002,0.6,0.99,0.5,0.54
PF08061,PF03880:PF11648:PF03461:PF10927:PF08072,2,18,2,0,16,1000,0.11,0.98,1.0,0.33,2,2,0,0,1016,1.0,1.0,1.0,1.0
PF06799,PF09597:PF06376:PF00321:PF12023:PF06351,3,8,2,1,6,1009,0.25,0.99,0.67,0.41,0,0,3,0,1015,0,1.0,0.0,0
PF06751,PF08708:PF07805:PF10566:PF06403:PF09951,1,2,0,1,2,1015,0.0,1.0,0.0,-0.0,0,0,1,0,1017,0,1.0,0.0,0
PF13584,PF14479:PF01011:PF17109:PF11546:PF06479,0,26,0,0,26,992,0.0,0.97,0,0,4,0,0,4,1014,0.0,1.0,0,0
PF13144,PF12446:PF11039:PF13451:PF13205:PF03390,0,6,0,0,6,1012,0.0,0.99,0,0,0,0,0,0,1018,0,1.0,0,0
PF15158,PF15055:PF15333:PF14986:PF15664:PF05399,0,0,0,0,0,1018,0,1.0,0,0,0,0,0,0,1018,0,1.0,0,0
PF08073,PF06465:PF06461:PF08074:PF07529:PF14619,12,27,12,0,15,991,0.44,0.99,1.0,0.66,11,10,2,1,1005,0.91,1.0,0.83,0.87
PF06725,PF13753:PF12081:PF12477:PF08497:PF02465,1,0,0,1,0,1017,0,1.0,0.0,0,0,0,1,0,1017,0,1.0,0.0,0
PF01282,PF00159:PF01198:PF00499:PF09809:PF04667,6,36,3,3,33,979,0.08,0.96,0.5,0.19,1,1,5,0,1012,1.0,1.0,0.17,0.41
PF16048,PF08018:PF16047:PF08023:PF12121:PF07440,0,0,0,0,0,1018,0,1.0,0,0,0,0,0,0,1018,0,1.0,0,0
PF11861,PF07780:PF10691:PF14978:PF00978:PF16114,15,24,14,1,10,993,0.58,0.99,0.93,0.73,2,2,13,0,1003,1.0,0.99,0.13,0.36
PF06067,PF10517:PF01175:PF11793:PF15037:PF16742,0,15,0,0,15,1003,0.0,0.99,0,0,1,0,0,1,1017,0.0,1.0,0,0
PF01702,PF10231:PF01896:PF04819:PF10255:PF04104,14,34,6,8,28,976,0.18,0.96,0.43,0.26,4,2,12,2,1002,0.5,0.99,0.14,0.26
PF08031,PF04030:PF09265:PF02913:PF14498:PF01565,41,110,41,0,69,908,0.37,0.93,1.0,0.59,13,9,32,4,973,0.69,0.96,0.22,0.38
PF13360,PF13570:PF07774:PF01011:PF13193:PF16177,26,91,20,6,71,921,0.22,0.92,0.77,0.39,6,6,20,0,992,1.0,0.98,0.23,0.48
PF02318,PF04698:PF16056:PF15625:PF16562:PF08151,8,16,6,2,10,1000,0.38,0.99,0.75,0.53,1,1,7,0,1010,1.0,0.99,0.12,0.35
PF10236,PF05602:PF02186:PF01786:PF05637:PF01871,7,43,5,2,38,973,0.12,0.96,0.71,0.28,4,4,3,0,1011,1.0,1.0,0.57,0.75
PF12043,PF03085:PF11770:PF10127:PF08731:PF13810,2,3,0,2,3,1013,0.0,1.0,0.0,-0.0,0,0,2,0,1016,0,1.0,0.0,0
PF07140,PF09294:PF01108:PF14161:PF06736:PF03868,2,17,2,0,15,1001,0.12,0.99,1.0,0.34,1,1,1,0,1016,1.0,1.0,0.5,0.71
PF06122,PF05065:PF05962:PF15775:PF03739:PF11751,0,7,0,0,7,1011,0.0,0.99,0,0,0,0,0,0,1018,0,1.0,0,0
PF04561,PF10385:PF06883:PF04563:PF00562:PF04565,4,28,4,0,24,990,0.14,0.98,1.0,0.37,18,3,1,15,999,0.17,0.98,0.75,0.35
PF04702,PF15675:PF00190:PF06718:PF04390:PF03772,1,21,1,0,20,997,0.05,0.98,1.0,0.22,0,0,1,0,1017,0,1.0,0.0,0
PF01648,PF01974:PF02778:PF04140:PF07470:PF12929,29,48,13,16,35,954,0.27,0.95,0.45,0.32,9,4,25,5,984,0.44,0.97,0.14,0.24
PF03846,PF06910:PF15081:PF15217:PF13628:PF15755,0,5,0,0,5,1013,0.0,1.0,0,0,0,0,0,0,1018,0,1.0,0,0
PF10118,PF04225:PF08437:PF14685:PF04335:PF06476,4,16,0,4,16,998,0.0,0.98,0.0,-0.01,0,0,4,0,1014,0,1.0,0.0,0
PF02365,PF04577:PF15996:PF12576:PF13890:PF00924,30,36,10,20,26,962,0.28,0.95,0.33,0.28,2,2,28,0,988,1.0,0.97,0.07,0.25
PF08519,PF16725:PF09079:PF16193:PF06480:PF09336,14,44,8,6,36,968,0.18,0.96,0.57,0.31,2,1,13,1,1003,0.5,0.99,0.07,0.19
PF12489,PF15965:PF00910:PF13329:PF15146:PF00073,3,27,0,3,27,988,0.0,0.97,0.0,-0.01,0,0,3,0,1015,0,1.0,0.0,0
PF07523,PF09327:PF06458:PF04740:PF15518:PF04196,0,1,0,0,1,1017,0.0,1.0,0,0,0,0,0,0,1018,0,1.0,0,0
PF08782,PF15223:PF04818:PF02040:PF02437:PF09469,10,40,10,0,30,978,0.25,0.97,1.0,0.49,0,0,10,0,1008,0,0.99,0.0,0
PF10639,PF09415:PF01025:PF01679:PF08137:PF08566,14,31,3,11,28,976,0.1,0.96,0.21,0.13,0,0,14,0,1004,0,0.99,0.0,0
PF13634,PF12110:PF04096:PF05064:PF13874:PF03735,19,33,16,3,17,982,0.48,0.98,0.84,0.63,4,4,15,0,999,1.0,0.99,0.21,0.46
PF04065,PF00649:PF07001:PF09429:PF11261:PF15678,7,23,3,4,20,991,0.13,0.98,0.43,0.23,0,0,7,0,1011,0,0.99,0.0,0
PF11071,PF17010:PF08691:PF14985:PF02972:PF06745,0,2,0,0,2,1016,0.0,1.0,0,0,0,0,0,0,1018,0,1.0,0,0
PF05536,PF00475:PF13419:PF01687:PF10508:PF04826,3,71,3,0,68,947,0.04,0.93,1.0,0.2,4,1,2,3,1012,0.25,1.0,0.33,0.29
PF02935,PF14866:PF06514:PF15041:PF11210:PF15036,6,2,0,6,2,1010,0.0,0.99,0.0,-0.0,0,0,6,0,1012,0,0.99,0.0,0
PF15219,PF03243:PF01337:PF08193:PF17064:PF06934,1,9,0,1,9,1008,0.0,0.99,0.0,-0.0,0,0,1,0,1017,0,1.0,0.0,0
PF02350,PF00480:PF02065:PF16874:PF16875:PF17167,2,18,0,2,18,998,0.0,0.98,0.0,-0.01,1,0,2,1,1015,0.0,1.0,0.0,-0.0
PF15295,PF12830:PF12295:PF08767:PF12717:PF15290,0,43,0,0,43,975,0.0,0.96,0,0,2,0,0,2,1016,0.0,1.0,0,0
PF03102,PF08666:PF14918:PF16173:PF04295:PF14919,2,12,1,1,11,1005,0.08,0.99,0.5,0.2,0,0,2,0,1016,0,1.0,0.0,0
PF17066,PF09428:PF15141:PF03548:PF17049:PF15482,1,5,0,1,5,1012,0.0,0.99,0.0,-0.0,0,0,1,0,1017,0,1.0,0.0,0
PF06228,PF06956:PF08404:PF01292:PF05778:PF05754,0,9,0,0,9,1009,0.0,0.99,0,0,0,0,0,0,1018,0,1.0,0,0
PF12355,PF06583:PF05473:PF12453:PF12567:PF11465,1,7,1,0,6,1011,0.14,0.99,1.0,0.38,1,1,0,0,1017,1.0,1.0,1.0,1.0
PF10312,PF10998:PF05334:PF04000:PF10496:PF12214,12,34,7,5,27,979,0.21,0.97,0.58,0.33,0,0,12,0,1006,0,0.99,0.0,0
PF00762,PF02104:PF00210:PF05995:PF00213:PF02284,18,38,8,10,30,970,0.21,0.96,0.44,0.29,4,4,14,0,1000,1.0,0.99,0.22,0.47
PF06450,PF03831:PF11794:PF02554:PF04717:PF01913,1,1,0,1,1,1016,0.0,1.0,0.0,-0.0,0,0,1,0,1017,0,1.0,0.0,0
PF15474,PF07833:PF06114:PF11975:PF01914:PF10618,1,15,0,1,15,1002,0.0,0.98,0.0,-0.0,0,0,1,0,1017,0,1.0,0.0,0
PF16678,PF09409:PF01485:PF09186:PF06012:PF11470,8,74,8,0,66,944,0.11,0.94,1.0,0.32,4,2,6,2,1008,0.5,0.99,0.25,0.35
PF12287,PF00386:PF03523:PF12308:PF12160:PF08702,1,27,0,1,27,990,0.0,0.97,0.0,-0.01,1,0,1,1,1016,0.0,1.0,0.0,-0.0
PF16058,PF08674:PF14518:PF11095:PF12751:PF02112,4,13,1,3,12,1002,0.08,0.99,0.25,0.13,0,0,4,0,1014,0,1.0,0.0,0
PF00910,PF00680:PF12381:PF12231:PF00073:PF10441,14,20,12,2,8,996,0.6,0.99,0.86,0.71,4,4,10,0,1004,1.0,0.99,0.29,0.53
PF14347,PF15186:PF01514:PF10974:PF03401:PF16731,0,2,0,0,2,1016,0.0,1.0,0,0,0,0,0,0,1018,0,1.0,0,0
PF00952,PF14534:PF17010:PF16647:PF15091:PF09677,0,1,0,0,1,1017,0.0,1.0,0,0,0,0,0,0,1018,0,1.0,0,0
PF04799,PF01031:PF00350:PF01321:PF16880:PF16910,5,81,5,0,76,937,0.06,0.93,1.0,0.24,14,1,4,13,1000,0.07,0.98,0.2,0.11
PF15545,PF02741:PF01706:PF03729:PF03994:PF15518,0,4,0,0,4,1014,0.0,1.0,0,0,0,0,0,0,1018,0,1.0,0,0
PF05507,PF08768:PF01549:PF05086:PF05823:PF05283,7,44,3,4,41,970,0.07,0.96,0.43,0.16,0,0,7,0,1011,0,0.99,0.0,0
PF05454,PF10383:PF06662:PF08161:PF15966:PF16788,2,15,1,1,14,1002,0.07,0.99,0.5,0.18,2,0,2,2,1014,0.0,1.0,0.0,-0.0
PF00340,PF00711:PF03784:PF01387:PF03032:PF01147,2,3,0,2,3,1013,0.0,1.0,0.0,-0.0,0,0,2,0,1016,0,1.0,0.0,0
PF16731,PF00770:PF15555:PF17112:PF00796:PF14862,0,2,0,0,2,1016,0.0,1.0,0,0,0,0,0,0,1018,0,1.0,0,0
PF14051,PF14061:PF12998:PF16737:PF12269:PF03172,8,27,4,4,23,987,0.15,0.97,0.5,0.26,2,1,7,1,1009,0.5,0.99,0.12,0.25
PF15328,PF02116:PF11255:PF13270:PF04664:PF11460,0,5,0,0,5,1013,0.0,1.0,0,0,0,0,0,0,1018,0,1.0,0,0
PF12053,PF09045:PF15737:PF13945:PF08687:PF07001,4,10,1,3,9,1005,0.1,0.99,0.25,0.15,1,1,3,0,1014,1.0,1.0,0.25,0.5
PF09988,PF02295:PF05010:PF15255:PF04821:PF12474,0,24,0,0,24,994,0.0,0.98,0,0,1,0,0,1,1017,0.0,1.0,0,0
PF10694,PF07399:PF04260:PF07706:PF09029:PF00392,3,24,3,0,21,994,0.12,0.98,1.0,0.35,1,1,2,0,1015,1.0,1.0,0.33,0.58
PF08186,PF06070:PF14052:PF10995:PF11272:PF01706,1,2,0,1,2,1015,0.0,1.0,0.0,-0.0,0,0,1,0,1017,0,1.0,0.0,0
PF00314,PF03822:PF05938:PF00139:PF14368:PF02519,21,38,15,6,23,974,0.39,0.97,0.71,0.52,4,4,17,0,997,1.0,0.98,0.19,0.43
PF03577,PF05191:PF01980:PF12483:PF05859:PF09496,4,19,1,3,18,996,0.05,0.98,0.25,0.11,2,0,4,2,1012,0.0,0.99,0.0,-0.0
PF13579,PF13439:PF12038:PF04413:PF15924:PF00862,2,34,1,1,33,983,0.03,0.97,0.5,0.12,1,0,2,1,1015,0.0,1.0,0.0,-0.0
PF13505,PF17164:PF06505:PF06744:PF06070:PF07804,0,2,0,0,2,1016,0.0,1.0,0,0,0,0,0,0,1018,0,1.0,0,0
PF06629,PF12192:PF15355:PF10429:PF15212:PF04966,0,1,0,0,1,1017,0.0,1.0,0,0,0,0,0,0,1018,0,1.0,0,0
PF15805,PF15803:PF04422:PF14049:PF07260:PF14047,0,1,0,0,1,1017,0.0,1.0,0,0,0,0,0,0,1018,0,1.0,0,0
PF01080,PF04184:PF08577:PF16839:PF03268:PF15806,12,6,1,11,5,1001,0.17,0.98,0.08,0.11,0,0,12,0,1006,0,0.99,0.0,0
PF00613,PF00792:PF00454:PF00794:PF02259:PF02260,33,70,32,1,38,947,0.46,0.96,0.97,0.65,35,21,12,14,971,0.6,0.97,0.64,0.6
PF04987,PF01663:PF16347:PF12411:PF01676:PF10338,16,44,14,2,30,972,0.32,0.97,0.88,0.52,5,5,11,0,1002,1.0,0.99,0.31,0.56
PF11833,PF10218:PF07816:PF01632:PF07896:PF00321,4,10,3,1,7,1007,0.3,0.99,0.75,0.47,0,0,4,0,1014,0,1.0,0.0,0
PF12998,PF14051:PF16737:PF09302:PF04139:PF16944,19,21,7,12,14,985,0.33,0.97,0.37,0.34,1,1,18,0,999,1.0,0.98,0.05,0.23
PF07021,PF08497:PF14251:PF08708:PF03238:PF01514,1,2,0,1,2,1015,0.0,1.0,0.0,-0.0,0,0,1,0,1017,0,1.0,0.0,0
PF11016,PF06695:PF15062:PF12646:PF08692:PF07107,0,1,0,0,1,1017,0.0,1.0,0,0,0,0,0,0,1018,0,1.0,0,0
PF07988,PF08558:PF16496:PF09316:PF06640:PF04433,1,29,1,0,28,989,0.03,0.97,1.0,0.18,2,0,1,2,1015,0.0,1.0,0.0,-0.0
PF15576,PF15829:PF15120:PF03823:PF07259:PF15839,1,5,0,1,5,1012,0.0,0.99,0.0,-0.0,1,0,1,1,1016,0.0,1.0,0.0,-0.0
PF00083,PF07690:PF01966:PF06624:PF06985:PF06609,133,261,95,38,166,719,0.36,0.8,0.71,0.41,23,21,112,2,883,0.91,0.89,0.16,0.35
PF08223,PF08093:PF02425:PF09365:PF13753:PF04174,0,3,0,0,3,1015,0.0,1.0,0,0,0,0,0,0,1018,0,1.0,0,0
PF03259,PF06522:PF10075:PF03657:PF01791:PF07114,12,25,8,4,17,989,0.32,0.98,0.67,0.45,5,4,8,1,1005,0.8,0.99,0.33,0.51
PF01554,PF14667:PF04833:PF12928:PF06237:PF05978,28,30,11,17,19,971,0.37,0.96,0.39,0.36,0,0,28,0,990,0,0.97,0.0,0
PF01597,PF06244:PF04716:PF01470:PF02284:PF08561,23,35,11,12,24,971,0.31,0.96,0.48,0.37,3,3,20,0,995,1.0,0.98,0.13,0.36
PF02548,PF11779:PF05042:PF01680:PF06172:PF01784,13,18,4,9,14,991,0.22,0.98,0.31,0.25,1,1,12,0,1005,1.0,0.99,0.08,0.28
PF11379,PF14328:PF01475:PF04052:PF16804:PF09861,1,4,0,1,4,1013,0.0,1.0,0.0,-0.0,0,0,1,0,1017,0,1.0,0.0,0
PF09311,PF03528:PF16696:PF11464:PF11409:PF12210,6,19,5,1,14,998,0.26,0.99,0.83,0.46,1,1,5,0,1012,1.0,1.0,0.17,0.41
PF10334,PF10337:PF12449:PF17167:PF10293:PF11915,7,35,7,0,28,983,0.2,0.97,1.0,0.44,1,0,7,1,1010,0.0,0.99,0.0,-0.0
PF05709,PF03522:PF00310:PF04898:PF09286:PF05525,0,40,0,0,40,978,0.0,0.96,0,0,2,0,0,2,1016,0.0,1.0,0,0
PF04506,PF14953:PF12465:PF16672:PF05233:PF01770,9,15,4,5,11,998,0.27,0.98,0.44,0.34,1,1,8,0,1009,1.0,0.99,0.11,0.33
PF04445,PF05939:PF03238:PF15312:PF03544:PF03553,2,5,0,2,5,1011,0.0,0.99,0.0,-0.0,0,0,2,0,1016,0,1.0,0.0,0
PF10690,PF11061:PF07906:PF14452:PF15201:PF06440,0,2,0,0,2,1016,0.0,1.0,0,0,0,0,0,0,1018,0,1.0,0,0
PF15856,PF14251:PF17049:PF15775:PF04451:PF00669,1,4,0,1,4,1013,0.0,1.0,0.0,-0.0,0,0,1,0,1017,0,1.0,0.0,0
PF04495,PF15279:PF04087:PF09808:PF04910:PF14909,5,13,3,2,10,1003,0.23,0.99,0.6,0.37,0,0,5,0,1013,0,1.0,0.0,0
PF00502,PF00427:PF01383:PF12853:PF07846:PF04927,0,9,0,0,9,1009,0.0,0.99,0,0,0,0,0,0,1018,0,1.0,0,0
PF16347,PF12411:PF12548:PF08019:PF04987:PF00884,8,51,8,0,43,967,0.16,0.96,1.0,0.39,2,2,6,0,1010,1.0,0.99,0.25,0.5
PF14829,PF16076:PF16094:PF08806:PF01098:PF07109,2,38,1,1,37,979,0.03,0.96,0.5,0.11,4,1,1,3,1013,0.25,1.0,0.5,0.35
PF10150,PF09371:PF16921:PF08206:PF08529:PF14878,4,17,2,2,15,999,0.12,0.98,0.5,0.24,2,1,3,1,1013,0.5,1.0,0.25,0.35
PF12382,PF14465:PF16071:PF03235:PF15082:PF10933,0,8,0,0,8,1010,0.0,0.99,0,0,0,0,0,0,1018,0,1.0,0,0
PF14941,PF14931:PF06679:PF00726:PF15053:PF11759,0,4,0,0,4,1014,0.0,1.0,0,0,0,0,0,0,1018,0,1.0,0,0
PF05016,PF03831:PF14841:PF14842:PF08411:PF15272,0,2,0,0,2,1016,0.0,1.0,0,0,0,0,0,0,1018,0,1.0,0,0
PF07092,PF12456:PF08952:PF16726:PF16776:PF02383,6,37,3,3,34,978,0.08,0.96,0.5,0.19,2,1,5,1,1011,0.5,0.99,0.17,0.29
PF11496,PF09762:PF17045:PF12757:PF15368:PF15066,9,3,0,9,3,1006,0.0,0.99,0.0,-0.01,0,0,9,0,1009,0,0.99,0.0,0
PF03837,PF08203:PF07243:PF15202:PF08093:PF12101,1,2,0,1,2,1015,0.0,1.0,0.0,-0.0,0,0,1,0,1017,0,1.0,0.0,0
PF00455,PF07476:PF08483:PF08299:PF14841:PF13247,3,2,0,3,2,1013,0.0,1.0,0.0,-0.0,1,0,3,1,1014,0.0,1.0,0.0,-0.0
PF02277,PF15281:PF03241:PF07157:PF06890:PF11751,3,3,0,3,3,1012,0.0,0.99,0.0,-0.0,0,0,3,0,1015,0,1.0,0.0,0
PF01429,PF10440:PF05964:PF05965:PF03172:PF12269,23,26,12,11,14,981,0.46,0.98,0.52,0.48,4,4,19,0,995,1.0,0.98,0.17,0.41
PF02172,PF08941:PF09030:PF16207:PF08214:PF06803,13,38,12,1,26,979,0.32,0.97,0.92,0.53,5,4,9,1,1004,0.8,0.99,0.31,0.49
PF10579,PF13441:PF06547:PF16669:PF07721:PF15419,9,14,3,6,11,998,0.21,0.98,0.33,0.26,2,2,7,0,1009,1.0,0.99,0.22,0.47
PF04925,PF04795:PF10156:PF03081:PF04859:PF03359,7,31,3,4,28,983,0.1,0.97,0.43,0.19,3,1,6,2,1009,0.33,0.99,0.14,0.21
PF04729,PF07798:PF15251:PF03095:PF10276:PF03479,7,23,3,4,20,991,0.13,0.98,0.43,0.23,0,0,7,0,1011,0,0.99,0.0,0
PF15346,PF14279:PF11016:PF15503:PF00127:PF11255,2,4,0,2,4,1012,0.0,0.99,0.0,-0.0,0,0,2,0,1016,0,1.0,0.0,0
PF05426,PF09424:PF08787:PF06912:PF06108:PF12716,4,18,1,3,17,997,0.06,0.98,0.25,0.11,0,0,4,0,1014,0,1.0,0.0,0
PF14221,PF02212:PF07617:PF05015:PF07317:PF00433,0,58,0,0,58,960,0.0,0.94,0,0,0,0,0,0,1018,0,1.0,0,0
PF12850,PF01470:PF08561:PF01097:PF04442:PF03942,13,35,5,8,30,975,0.14,0.96,0.38,0.22,3,2,11,1,1004,0.67,0.99,0.15,0.32
PF12425,PF08093:PF15482:PF05939:PF14251:PF06626,0,4,0,0,4,1014,0.0,1.0,0,0,0,0,0,0,1018,0,1.0,0,0
PF04674,PF04398:PF04525:PF07712:PF04690:PF14476,5,12,1,4,11,1002,0.08,0.99,0.2,0.12,1,1,4,0,1013,1.0,1.0,0.2,0.45
PF12935,PF08579:PF11549:PF10395:PF12531:PF12449,0,6,0,0,6,1012,0.0,0.99,0,0,0,0,0,0,1018,0,1.0,0,0
PF09791,PF01613:PF02898:PF00175:PF06999:PF00970,7,83,4,3,79,932,0.05,0.92,0.57,0.15,18,3,4,15,996,0.17,0.98,0.43,0.26
PF10912,PF15847:PF11341:PF14539:PF06514:PF07294,1,6,0,1,6,1011,0.0,0.99,0.0,-0.0,0,0,1,0,1017,0,1.0,0.0,0
PF14745,PF14744:PF14746:PF03894:PF09051:PF09363,6,10,6,0,4,1008,0.6,1.0,1.0,0.77,0,0,6,0,1012,0,0.99,0.0,0
PF04461,PF05783:PF12549:PF11352:PF17121:PF04023,0,16,0,0,16,1002,0.0,0.98,0,0,0,0,0,0,1018,0,1.0,0,0
PF02037,PF14443:PF02891:PF16294:PF03467:PF05383,61,37,19,42,18,939,0.51,0.94,0.31,0.37,6,6,55,0,957,1.0,0.95,0.1,0.3
PF08498,PF12589:PF13532:PF05050:PF05093:PF07109,11,67,7,4,60,947,0.1,0.94,0.64,0.24,4,2,9,2,1005,0.5,0.99,0.18,0.3
PF08699,PF16486:PF02170:PF05831:PF16488:PF16487,42,45,39,3,6,970,0.87,0.99,0.93,0.89,31,30,12,1,975,0.97,0.99,0.71,0.83
PF15742,PF12240:PF13870:PF14988:PF15821:PF15248,2,8,0,2,8,1008,0.0,0.99,0.0,-0.0,0,0,2,0,1016,0,1.0,0.0,0
PF14610,PF11282:PF02325:PF15810:PF04852:PF01878,3,15,1,2,14,1001,0.07,0.98,0.33,0.14,0,0,3,0,1015,0,1.0,0.0,0
PF06825,PF03386:PF05512:PF13741:PF05676:PF10310,4,10,0,4,10,1004,0.0,0.99,0.0,-0.01,1,0,4,1,1013,0.0,1.0,0.0,-0.0
PF10408,PF04564:PF08606:PF13019:PF04826:PF05536,11,64,10,1,54,953,0.16,0.95,0.91,0.36,4,3,8,1,1006,0.75,0.99,0.27,0.45
PF07617,PF13599:PF10758:PF14602:PF12464:PF06426,0,36,0,0,36,982,0.0,0.96,0,0,6,0,0,6,1012,0.0,0.99,0,0
PF01225,PF02875:PF07361:PF01098:PF09179:PF02132,11,24,10,1,14,993,0.42,0.99,0.91,0.61,1,1,10,0,1007,1.0,0.99,0.09,0.3
PF11765,PF15146:PF08811:PF05203:PF11699:PF12381,1,19,0,1,19,998,0.0,0.98,0.0,-0.0,0,0,1,0,1017,0,1.0,0.0,0
PF09032,PF16273:PF05002:PF14050:PF04968:PF14280,3,29,2,1,27,988,0.07,0.97,0.67,0.21,1,0,3,1,1014,0.0,1.0,0.0,-0.0
PF11909,PF02531:PF05355:PF15339:PF08092:PF06514,1,6,0,1,6,1011,0.0,0.99,0.0,-0.0,0,0,1,0,1017,0,1.0,0.0,0
PF01753,PF09273:PF14740:PF07034:PF00856:PF14441,66,116,40,26,76,876,0.34,0.9,0.61,0.41,4,4,62,0,952,1.0,0.94,0.06,0.24
PF05303,PF15044:PF13236:PF12807:PF07721:PF13374,4,58,4,0,54,960,0.07,0.95,1.0,0.26,5,3,1,2,1012,0.6,1.0,0.75,0.67
PF15277,PF09763:PF11707:PF16201:PF14699:PF14702,9,14,7,2,7,1002,0.5,0.99,0.78,0.62,0,0,9,0,1009,0,0.99,0.0,0
PF16764,PF08604:PF17219:PF00641:PF08325:PF03467,2,56,2,0,54,962,0.04,0.95,1.0,0.18,3,2,0,1,1015,0.67,1.0,1.0,0.82
PF09265,PF02913:PF04030:PF02873:PF08031:PF04275,15,72,7,8,65,938,0.1,0.93,0.47,0.19,8,4,11,4,999,0.5,0.99,0.27,0.36
PF08631,PF15979:PF12612:PF11915:PF08696:PF02368,7,42,6,1,36,975,0.14,0.96,0.86,0.34,5,1,6,4,1007,0.2,0.99,0.14,0.16
PF11780,PF16510:PF04352:PF01752:PF08453:PF11304,0,2,0,0,2,1016,0.0,1.0,0,0,0,0,0,0,1018,0,1.0,0,0
PF12529,PF02485:PF09362:PF03229:PF11790:PF01822,2,62,2,0,60,956,0.03,0.94,1.0,0.17,4,0,2,4,1012,0.0,0.99,0.0,-0.0
PF14944,PF09303:PF09049:PF09051:PF09050:PF15689,4,2,0,4,2,1012,0.0,0.99,0.0,-0.0,0,0,4,0,1014,0,1.0,0.0,0
PF02769,PF00586:PF02844:PF02843:PF01071:PF03157,16,22,11,5,11,991,0.5,0.98,0.69,0.58,13,7,9,6,996,0.54,0.99,0.44,0.48
PF08094,PF10456:PF05571:PF12825:PF12828:PF12440,1,21,0,1,21,996,0.0,0.98,0.0,-0.0,3,0,1,3,1014,0.0,1.0,0.0,-0.0
PF11974,PF02655:PF05488:PF15322:PF11967:PF10279,1,2,0,1,2,1015,0.0,1.0,0.0,-0.0,0,0,1,0,1017,0,1.0,0.0,0
PF04404,PF11863:PF16325:PF14842:PF04865:PF01580,1,6,0,1,6,1011,0.0,0.99,0.0,-0.0,0,0,1,0,1017,0,1.0,0.0,0
PF03936,PF01397:PF00278:PF06237:PF04043:PF01095,22,57,20,2,37,959,0.35,0.96,0.91,0.55,5,4,18,1,995,0.8,0.98,0.18,0.38
PF05139,PF09424:PF14770:PF03576:PF06912:PF06108,0,18,0,0,18,1000,0.0,0.98,0,0,0,0,0,0,1018,0,1.0,0,0
PF04680,PF12121:PF16048:PF16047:PF08023:PF07440,1,0,0,1,0,1017,0,1.0,0.0,0,0,0,1,0,1017,0,1.0,0.0,0
PF05063,PF05346:PF04000:PF06886:PF04908:PF04801,22,46,11,11,35,961,0.24,0.95,0.5,0.33,4,3,19,1,995,0.75,0.98,0.14,0.31
PF05918,PF15808:PF16179:PF16700:PF15539:PF15112,3,20,1,2,19,996,0.05,0.98,0.33,0.12,1,1,2,0,1015,1.0,1.0,0.33,0.58
PF15504,PF06890:PF11751:PF07157:PF07409:PF15823,1,0,0,1,0,1017,0,1.0,0.0,0,0,0,1,0,1017,0,1.0,0.0,0
PF00868,PF00927:PF01841:PF13910:PF04721:PF15296,7,29,7,0,22,989,0.24,0.98,1.0,0.49,4,4,3,0,1011,1.0,1.0,0.57,0.75
PF00812,PF03195:PF07172:PF13841:PF10248:PF15795,6,12,4,2,8,1004,0.33,0.99,0.67,0.47,0,0,6,0,1012,0,0.99,0.0,0
PF11503,PF00954:PF13965:PF04474:PF11900:PF00961,0,34,0,0,34,984,0.0,0.97,0,0,3,0,0,3,1015,0.0,1.0,0,0
PF12787,PF10917:PF07411:PF06761:PF00798:PF07660,2,4,2,0,2,1014,0.5,1.0,1.0,0.71,0,0,2,0,1016,0,1.0,0.0,0
PF07488,PF07477:PF03648:PF16126:PF02065:PF16875,4,9,4,0,5,1009,0.44,1.0,1.0,0.67,1,1,3,0,1014,1.0,1.0,0.25,0.5
PF04224,PF14759:PF04324:PF14962:PF14721:PF16020,3,16,1,2,15,1000,0.06,0.98,0.33,0.14,2,1,2,1,1014,0.5,1.0,0.33,0.41
PF00703,PF02836:PF02837:PF02929:PF16353:PF16355,27,22,18,9,4,987,0.82,0.99,0.67,0.73,8,7,20,1,990,0.88,0.98,0.26,0.47
PF02787,PF00115:PF01578:PF01039:PF00117:PF00177,20,111,15,5,96,902,0.14,0.9,0.75,0.29,11,2,18,9,989,0.18,0.97,0.1,0.12
PF15088,PF14866:PF08843:PF15119:PF15085:PF15772,0,3,0,0,3,1015,0.0,1.0,0,0,0,0,0,0,1018,0,1.0,0,0
PF13948,PF01508:PF05572:PF04952:PF11617:PF15789,5,13,1,4,12,1001,0.08,0.98,0.2,0.12,0,0,5,0,1013,0,1.0,0.0,0
PF15161,PF14996:PF15938:PF16112:PF04421:PF14114,2,6,2,0,4,1012,0.33,1.0,1.0,0.58,1,1,1,0,1016,1.0,1.0,0.5,0.71
PF00001,PF13306:PF01348:PF08983:PF00935:PF07281,133,58,34,99,24,861,0.59,0.88,0.26,0.33,4,4,129,0,885,1.0,0.87,0.03,0.16
PF11698,PF10155:PF09822:PF14764:PF01755:PF14441,10,25,0,10,25,983,0.0,0.97,0.0,-0.02,2,0,10,2,1006,0.0,0.99,0.0,-0.0
PF02378,PF09648:PF11870:PF03123:PF10410:PF03180,8,9,2,6,7,1003,0.22,0.99,0.25,0.23,0,0,8,0,1010,0,0.99,0.0,0
PF00662,PF06455:PF01010:PF10350:PF14498:PF12530,3,18,1,2,17,998,0.06,0.98,0.33,0.13,2,0,3,2,1013,0.0,1.0,0.0,-0.0
PF03463,PF03464:PF03465:PF04927:PF14577:PF14576,9,11,8,1,3,1006,0.73,1.0,0.89,0.8,1,1,8,0,1009,1.0,0.99,0.11,0.33
PF06780,PF05128:PF15086:PF10662:PF09269:PF00358,1,13,1,0,12,1005,0.08,0.99,1.0,0.28,1,1,0,0,1017,1.0,1.0,1.0,1.0
PF08813,PF05125:PF13701:PF02991:PF07584:PF00377,0,17,0,0,17,1001,0.0,0.98,0,0,0,0,0,0,1018,0,1.0,0,0
PF03968,PF05853:PF17051:PF08945:PF15046:PF03275,1,5,0,1,5,1012,0.0,0.99,0.0,-0.0,0,0,1,0,1017,0,1.0,0.0,0
PF01073,PF02453:PF01370:PF14934:PF05368:PF04137,21,99,18,3,81,916,0.18,0.92,0.86,0.37,6,4,17,2,995,0.67,0.98,0.19,0.35
PF00482,PF07963:PF06864:PF04612:PF11614:PF16861,1,8,1,0,7,1010,0.12,0.99,1.0,0.35,1,1,0,0,1017,1.0,1.0,1.0,1.0
PF15393,PF15478:PF01475:PF15460:PF15391:PF15182,6,7,2,4,5,1007,0.29,0.99,0.33,0.3,0,0,6,0,1012,0,0.99,0.0,0
PF00936,PF15470:PF03326:PF13990:PF12327:PF00109,0,63,0,0,63,955,0.0,0.94,0,0,0,0,0,0,1018,0,1.0,0,0
PF15852,PF07359:PF03819:PF08040:PF14539:PF15809,0,2,0,0,2,1016,0.0,1.0,0,0,0,0,0,0,1018,0,1.0,0,0
PF14753,PF15390:PF03298:PF15388:PF06382:PF05129,4,14,2,2,12,1002,0.14,0.99,0.5,0.26,0,0,4,0,1014,0,1.0,0.0,0
PF07688,PF10318:PF00241:PF10319:PF02118:PF09027,0,38,0,0,38,980,0.0,0.96,0,0,3,0,0,3,1015,0.0,1.0,0,0
PF04959,PF04153:PF15396:PF13914:PF07742:PF14075,17,24,8,9,16,985,0.33,0.98,0.47,0.38,3,3,14,0,1001,1.0,0.99,0.18,0.42
PF07734,PF08268:PF10442:PF03478:PF12014:PF07723,16,41,11,5,30,972,0.27,0.97,0.69,0.42,4,3,13,1,1001,0.75,0.99,0.19,0.37
PF03876,PF08292:PF00575:PF08206:PF14878:PF09371,16,39,11,5,28,974,0.28,0.97,0.69,0.43,2,2,14,0,1002,1.0,0.99,0.12,0.35
PF00908,PF02397:PF02719:PF11803:PF02426:PF02753,6,11,3,3,8,1004,0.27,0.99,0.5,0.36,2,2,4,0,1012,1.0,1.0,0.33,0.58
PF04030,PF08031:PF02913:PF09265:PF04275:PF02873,21,69,10,11,59,938,0.14,0.93,0.48,0.24,8,5,16,3,994,0.62,0.98,0.24,0.38
PF12311,PF07350:PF04667:PF12296:PF11807:PF14027,4,30,2,2,28,986,0.07,0.97,0.5,0.17,2,1,3,1,1013,0.5,1.0,0.25,0.35
PF05957,PF03901:PF05916:PF00834:PF01161:PF00285,0,76,0,0,76,942,0.0,0.93,0,0,12,0,0,12,1006,0.0,0.99,0,0
PF03533,PF09664:PF09983:PF02875:PF01225:PF13473,3,21,3,0,18,997,0.14,0.98,1.0,0.37,2,2,1,0,1015,1.0,1.0,0.67,0.82
PF00859,PF10524:PF03166:PF03165:PF11882:PF15509,2,23,2,0,21,995,0.09,0.98,1.0,0.29,3,2,0,1,1015,0.67,1.0,1.0,0.82
PF05000,PF04983:PF04998:PF04990:PF00623:PF14432,31,63,31,0,32,955,0.49,0.97,1.0,0.69,28,28,3,0,987,1.0,1.0,0.9,0.95
PF06875,PF14653:PF15173:PF15550:PF06581:PF09252,0,0,0,0,0,1018,0,1.0,0,0,0,0,0,0,1018,0,1.0,0,0
PF15082,PF09322:PF08183:PF15392:PF10407:PF15407,3,0,0,3,0,1015,0,1.0,0.0,0,0,0,3,0,1015,0,1.0,0.0,0
PF13679,PF04577:PF13417:PF02798:PF00346:PF13506,24,96,15,9,81,913,0.16,0.91,0.62,0.28,13,5,19,8,986,0.38,0.97,0.21,0.27
PF06252,PF02080:PF09795:PF02479:PF02649:PF02254,0,19,0,0,19,999,0.0,0.98,0,0,0,0,0,0,1018,0,1.0,0,0
PF07713,PF12457:PF13821:PF09750:PF07842:PF11952,11,34,6,5,28,979,0.18,0.97,0.55,0.3,5,4,7,1,1006,0.8,0.99,0.36,0.54
PF07692,PF15872:PF10856:PF00603:PF15703:PF15130,2,3,0,2,3,1013,0.0,1.0,0.0,-0.0,0,0,2,0,1016,0,1.0,0.0,0
PF04119,PF12900:PF10310:PF13741:PF11264:PF10705,3,8,0,3,8,1007,0.0,0.99,0.0,-0.0,1,0,3,1,1014,0.0,1.0,0.0,-0.0
PF05405,PF02284:PF04716:PF15860:PF01632:PF08561,8,29,4,4,25,985,0.14,0.97,0.5,0.25,1,0,8,1,1009,0.0,0.99,0.0,-0.0
PF15042,PF04308:PF02232:PF15029:PF04868:PF01609,0,5,0,0,5,1013,0.0,1.0,0,0,0,0,0,0,1018,0,1.0,0,0
PF09360,PF10660:PF00525:PF10261:PF00101:PF12338,16,11,4,12,7,995,0.36,0.98,0.25,0.29,1,1,15,0,1002,1.0,0.99,0.06,0.25
PF01735,PF15625:PF05664:PF16056:PF08150:PF10540,16,26,4,12,22,980,0.15,0.97,0.25,0.18,2,1,15,1,1001,0.5,0.98,0.06,0.17
PF05933,PF15089:PF08708:PF00669:PF15529:PF09826,2,3,0,2,3,1013,0.0,1.0,0.0,-0.0,0,0,2,0,1016,0,1.0,0.0,0
PF03789,PF12731:PF05722:PF12737:PF03791:PF07526,2,6,1,1,5,1011,0.17,0.99,0.5,0.29,1,1,1,0,1016,1.0,1.0,0.5,0.71
PF00717,PF04667:PF02284:PF10181:PF01016:PF15454,33,26,11,22,15,970,0.42,0.96,0.33,0.36,2,2,31,0,985,1.0,0.97,0.06,0.24
PF09172,PF06448:PF01347:PF09175:PF12491:PF00094,10,44,10,0,34,974,0.23,0.97,1.0,0.47,5,4,6,1,1007,0.8,0.99,0.4,0.56
PF09130,PF14833:PF00393:PF17042:PF07005:PF07831,4,31,2,2,29,985,0.06,0.97,0.5,0.17,6,2,2,4,1010,0.33,0.99,0.5,0.41
PF10437,PF02237:PF09825:PF10210:PF12590:PF08029,2,16,2,0,14,1002,0.12,0.99,1.0,0.35,0,0,2,0,1016,0,1.0,0.0,0
PF12718,PF00261:PF03285:PF13851:PF04710:PF09775,1,12,1,0,11,1006,0.08,0.99,1.0,0.29,0,0,1,0,1017,0,1.0,0.0,0
PF15071,PF15370:PF11029:PF02285:PF06351:PF00727,0,13,0,0,13,1005,0.0,0.99,0,0,0,0,0,0,1018,0,1.0,0,0
PF05296,PF00103:PF01387:PF06524:PF02084:PF03032,2,9,0,2,9,1007,0.0,0.99,0.0,-0.0,0,0,2,0,1016,0,1.0,0.0,0
PF00883,PF02789:PF03385:PF04515:PF03441:PF16401,26,38,21,5,17,975,0.55,0.98,0.81,0.66,1,1,25,0,992,1.0,0.98,0.04,0.19
PF06955,PF15886:PF04833:PF06880:PF00722:PF04859,8,48,8,0,40,970,0.17,0.96,1.0,0.4,1,0,8,1,1009,0.0,0.99,0.0,-0.0
PF03312,PF03888:PF06493:PF03241:PF16967:PF00915,1,1,0,1,1,1016,0.0,1.0,0.0,-0.0,0,0,1,0,1017,0,1.0,0.0,0
PF02561,PF13722:PF03865:PF04984:PF01514:PF08345,0,1,0,0,1,1017,0.0,1.0,0,0,0,0,0,0,1018,0,1.0,0,0
PF06224,PF09614:PF08707:PF15182:PF09428:PF16804,0,2,0,0,2,1016,0.0,1.0,0,0,0,0,0,0,1018,0,1.0,0,0
PF15919,PF00351:PF03417:PF03022:PF14957:PF09737,0,36,0,0,36,982,0.0,0.96,0,0,1,0,0,1,1017,0.0,1.0,0,0
PF12215,PF04685:PF04840:PF04841:PF03097:PF14222,8,48,6,2,42,968,0.12,0.96,0.75,0.3,5,3,5,2,1008,0.6,0.99,0.38,0.47
PF10399,PF14163:PF07954:PF07308:PF15271:PF03971,3,4,2,1,2,1013,0.5,1.0,0.67,0.58,0,0,3,0,1015,0,1.0,0.0,0
PF08447,PF11413:PF08778:PF16279:PF08815:PF08832,25,11,6,19,5,988,0.55,0.98,0.24,0.35,6,3,22,3,990,0.5,0.98,0.12,0.24
PF03145,PF08511:PF03878:PF07896:PF10213:PF09335,15,41,11,4,30,973,0.27,0.97,0.73,0.43,3,3,12,0,1003,1.0,0.99,0.2,0.44
PF12792,PF00376:PF09278:PF13644:PF00114:PF06082,2,2,2,0,0,1016,1.0,1.0,1.0,1.0,1,1,1,0,1016,1.0,1.0,0.5,0.71
PF01582,PF07725:PF00931:PF15627:PF07819:PF12036,40,90,29,11,61,917,0.32,0.93,0.72,0.45,3,3,37,0,978,1.0,0.96,0.07,0.27
PF07348,PF16033:PF07105:PF07992:PF05613:PF00562,0,93,0,0,93,925,0.0,0.91,0,0,4,0,0,4,1014,0.0,1.0,0,0
PF02364,PF14288:PF14498:PF06964:PF11919:PF11916,9,34,9,0,25,984,0.26,0.98,1.0,0.51,3,2,7,1,1008,0.67,0.99,0.22,0.38
PF13804,PF09003:PF13356:PF13683:PF01609:PF01141,5,14,4,1,10,1003,0.29,0.99,0.8,0.47,1,0,5,1,1012,0.0,0.99,0.0,-0.0
PF08473,PF06668:PF08399:PF02743:PF13768:PF08487,5,34,5,0,29,984,0.15,0.97,1.0,0.38,8,4,1,4,1009,0.5,1.0,0.8,0.63
PF03951,PF12437:PF04909:PF16952:PF00120:PF01333,10,50,10,0,40,968,0.2,0.96,1.0,0.44,3,2,8,1,1007,0.67,0.99,0.2,0.36
PF14739,PF13931:PF11995:PF16540:PF15908:PF13118,3,15,3,0,12,1003,0.2,0.99,1.0,0.44,3,3,0,0,1015,1.0,1.0,1.0,1.0
PF04690,PF04720:PF06206:PF07911:PF02681:PF13841,2,14,0,2,14,1002,0.0,0.98,0.0,-0.01,0,0,2,0,1016,0,1.0,0.0,0
PF04285,PF14841:PF01514:PF05513:PF08479:PF16449,0,2,0,0,2,1016,0.0,1.0,0,0,0,0,0,0,1018,0,1.0,0,0
PF15259,PF15241:PF15082:PF09322:PF14465:PF08183,1,5,1,0,4,1013,0.2,1.0,1.0,0.45,0,0,1,0,1017,0,1.0,0.0,0
PF03045,PF07816:PF07896:PF10018:PF07939:PF06083,8,19,4,4,15,995,0.21,0.98,0.5,0.32,2,1,7,1,1009,0.5,0.99,0.12,0.25
PF14513,PF00609:PF16901:PF00036:PF08976:PF08726,7,58,5,2,53,958,0.09,0.95,0.71,0.24,6,3,4,3,1008,0.5,0.99,0.43,0.46
PF08840,PF04775:PF00674:PF12470:PF05782:PF01174,4,11,2,2,9,1005,0.18,0.99,0.5,0.3,0,0,4,0,1014,0,1.0,0.0,0
PF05940,PF03992:PF00994:PF02668:PF01553:PF00903,0,120,0,0,120,898,0.0,0.88,0,0,19,0,0,19,999,0.0,0.98,0,0
PF11642,PF15685:PF01254:PF08964:PF07149:PF03058,0,1,0,0,1,1017,0.0,1.0,0,0,0,0,0,0,1018,0,1.0,0,0
PF06937,PF10856:PF15703:PF09187:PF02951:PF06592,0,5,0,0,5,1013,0.0,1.0,0,0,0,0,0,0,1018,0,1.0,0,0
PF01529,PF00710:PF01734:PF17175:PF11904:PF15898,56,69,25,31,44,918,0.36,0.93,0.45,0.36,5,5,51,0,962,1.0,0.95,0.09,0.29
PF12833,PF02311:PF03480:PF12625:PF00873:PF05506,26,22,12,14,10,982,0.55,0.98,0.46,0.49,1,1,25,0,992,1.0,0.98,0.04,0.19
PF12855,PF07051:PF06989:PF08653:PF11460:PF15863,2,3,1,1,2,1014,0.33,1.0,0.5,0.41,0,0,2,0,1016,0,1.0,0.0,0
PF01355,PF09826:PF17060:PF09798:PF01913:PF06070,2,5,1,1,4,1012,0.2,1.0,0.5,0.31,0,0,2,0,1016,0,1.0,0.0,0
PF12174,PF00644:PF02825:PF05406:PF02877:PF15808,7,61,5,2,56,955,0.08,0.94,0.71,0.23,18,2,5,16,995,0.11,0.98,0.29,0.17
PF04163,PF15877:PF15515:PF01076:PF16670:PF10979,3,2,0,3,2,1013,0.0,1.0,0.0,-0.0,0,0,3,0,1015,0,1.0,0.0,0
PF14986,PF15055:PF15333:PF07448:PF02448:PF15115,0,0,0,0,0,1018,0,1.0,0,0,0,0,0,0,1018,0,1.0,0,0
PF08309,PF08622:PF17187:PF11958:PF08283:PF08125,1,15,0,1,15,1002,0.0,0.98,0.0,-0.0,0,0,1,0,1017,0,1.0,0.0,0
PF17182,PF14418:PF01936:PF11608:PF12872:PF13871,0,23,0,0,23,995,0.0,0.98,0,0,4,0,0,4,1014,0.0,1.0,0,0
PF02123,PF09227:PF13331:PF12488:PF08654:PF12158,2,3,0,2,3,1013,0.0,1.0,0.0,-0.0,0,0,2,0,1016,0,1.0,0.0,0
PF07863,PF00141:PF08115:PF14402:PF04386:PF11306,0,37,0,0,37,981,0.0,0.96,0,0,0,0,0,0,1018,0,1.0,0,0
PF01617,PF01228:PF02901:PF10105:PF12345:PF03958,12,9,3,9,6,1000,0.33,0.99,0.25,0.28,2,2,10,0,1006,1.0,0.99,0.17,0.41
PF14103,PF15756:PF15340:PF05836:PF16311:PF02025,0,5,0,0,5,1013,0.0,1.0,0,0,0,0,0,0,1018,0,1.0,0,0
PF12767,PF08652:PF05916:PF04143:PF12430:PF04828,3,38,2,1,36,979,0.05,0.96,0.67,0.18,4,1,2,3,1012,0.25,1.0,0.33,0.29
PF16463,PF14489:PF12192:PF06745:PF07804:PF05466,0,2,0,0,2,1016,0.0,1.0,0,0,0,0,0,0,1018,0,1.0,0,0
PF06413,PF15247:PF10180:PF15264:PF02116:PF07797,7,22,3,4,19,992,0.14,0.98,0.43,0.23,0,0,7,0,1011,0,0.99,0.0,0
PF11531,PF05185:PF11591:PF01799:PF16332:PF03070,2,46,2,0,44,972,0.04,0.96,1.0,0.2,5,0,2,5,1011,0.0,0.99,0.0,-0.0
PF09472,PF14421:PF06057:PF15441:PF14642:PF05953,1,4,0,1,4,1013,0.0,1.0,0.0,-0.0,0,0,1,0,1017,0,1.0,0.0,0
PF16209,PF16212:PF00690:PF12409:PF12515:PF08282,42,95,40,2,55,921,0.42,0.94,0.95,0.61,11,7,35,4,972,0.64,0.96,0.17,0.31
PF02774,PF01118:PF09290:PF13840:PF02894:PF00742,14,46,11,3,35,969,0.24,0.96,0.79,0.42,1,0,14,1,1003,0.0,0.99,0.0,-0.0
PF01420,PF11751:PF16861:PF13588:PF07157:PF05016,2,5,2,0,3,1013,0.4,1.0,1.0,0.63,0,0,2,0,1016,0,1.0,0.0,0
PF03454,PF03453:PF06844:PF00994:PF01507:PF08668,16,53,15,1,38,964,0.28,0.96,0.94,0.5,5,3,13,2,1000,0.6,0.99,0.19,0.33
PF13430,PF09232:PF17032:PF02950:PF09252:PF11909,3,2,0,3,2,1013,0.0,1.0,0.0,-0.0,0,0,3,0,1015,0,1.0,0.0,0
PF07051,PF12855:PF06989:PF11460:PF11255:PF13270,1,4,0,1,4,1013,0.0,1.0,0.0,-0.0,0,0,1,0,1017,0,1.0,0.0,0
PF02038,PF04831:PF12301:PF04505:PF06083:PF14839,6,19,2,4,17,995,0.11,0.98,0.33,0.18,1,0,6,1,1011,0.0,0.99,0.0,-0.0
PF07782,PF13890:PF07810:PF09733:PF07910:PF10155,12,35,3,9,32,974,0.09,0.96,0.25,0.13,2,1,11,1,1005,0.5,0.99,0.08,0.2
PF15133,PF17076:PF15281:PF14290:PF15194:PF04451,1,5,0,1,5,1012,0.0,0.99,0.0,-0.0,0,0,1,0,1017,0,1.0,0.0,0
PF00632,PF00658:PF07035:PF10350:PF12036:PF13402,61,27,12,49,15,942,0.44,0.94,0.2,0.27,2,2,59,0,957,1.0,0.94,0.03,0.18
PF08585,PF16099:PF09429:PF16944:PF10427:PF11470,13,18,5,8,13,992,0.28,0.98,0.38,0.32,0,0,13,0,1005,0,0.99,0.0,0
PF06994,PF10583:PF00865:PF03458:PF00879:PF14047,0,1,0,0,1,1017,0.0,1.0,0,0,0,0,0,0,1018,0,1.0,0,0
PF00822,PF07803:PF02038:PF04831:PF04505:PF13088,9,26,4,5,22,987,0.15,0.97,0.44,0.25,1,1,8,0,1009,1.0,0.99,0.11,0.33
PF00276,PF02733:PF13718:PF13725:PF00283:PF05019,25,31,10,15,21,972,0.32,0.96,0.4,0.34,4,3,22,1,992,0.75,0.98,0.12,0.29
PF03629,PF06206:PF06404:PF05498:PF00074:PF16974,4,10,1,3,9,1005,0.1,0.99,0.25,0.15,0,0,4,0,1014,0,1.0,0.0,0
PF10923,PF02489:PF05664:PF13401:PF07971:PF01434,2,62,2,0,60,956,0.03,0.94,1.0,0.17,6,2,0,4,1012,0.33,1.0,1.0,0.58
PF16879,PF08295:PF02671:PF04571:PF12129:PF04118,15,44,15,0,29,974,0.34,0.97,1.0,0.58,4,3,12,1,1002,0.75,0.99,0.2,0.38
PF09932,PF14433:PF11478:PF04023:PF11730:PF06560,0,2,0,0,2,1016,0.0,1.0,0,0,0,0,0,0,1018,0,1.0,0,0
PF05988,PF16011:PF03323:PF02554:PF02413:PF05673,2,8,0,2,8,1008,0.0,0.99,0.0,-0.0,0,0,2,0,1016,0,1.0,0.0,0
PF03604,PF06373:PF15359:PF01099:PF10681:PF05912,10,8,1,9,7,1001,0.12,0.98,0.1,0.1,0,0,10,0,1008,0,0.99,0.0,0
PF07725,PF12061:PF05659:PF00931:PF01582:PF11835,14,95,14,0,81,923,0.15,0.92,1.0,0.37,5,5,9,0,1004,1.0,0.99,0.36,0.59
PF08236,PF11764:PF12237:PF09445:PF00639:PF05965,14,40,9,5,31,973,0.23,0.96,0.64,0.37,3,2,12,1,1003,0.67,0.99,0.14,0.3
PF08146,PF13001:PF12397:PF11916:PF11915:PF11919,10,43,10,0,33,975,0.23,0.97,1.0,0.47,4,3,7,1,1007,0.75,0.99,0.3,0.47
PF12095,PF08843:PF15825:PF11317:PF15809:PF14519,1,0,0,1,0,1017,0,1.0,0.0,0,0,0,1,0,1017,0,1.0,0.0,0
PF01470,PF04716:PF04667:PF08561:PF00159:PF10780,12,22,4,8,18,988,0.18,0.97,0.33,0.23,1,1,11,0,1006,1.0,0.99,0.08,0.29
PF01435,PF16491:PF04833:PF08652:PF06830:PF04859,24,23,15,9,8,986,0.65,0.98,0.62,0.63,0,0,24,0,994,0,0.98,0.0,0
PF04731,PF10525:PF04617:PF12407:PF11569:PF12413,2,4,1,1,3,1013,0.25,1.0,0.5,0.35,1,1,1,0,1016,1.0,1.0,0.5,0.71
PF14258,PF03241:PF13722:PF07499:PF08497:PF01514,0,2,0,0,2,1016,0.0,1.0,0,0,0,0,0,0,1018,0,1.0,0,0
PF05652,PF06414:PF10179:PF01432:PF10672:PF05450,11,43,7,4,36,971,0.16,0.96,0.64,0.31,2,1,10,1,1006,0.5,0.99,0.09,0.21
PF14691,PF04898:PF00310:PF01493:PF14721:PF01645,10,14,5,5,9,999,0.36,0.99,0.5,0.42,7,5,5,2,1006,0.71,0.99,0.5,0.59
PF13325,PF15276:PF15308:PF16508:PF16697:PF00498,5,82,3,2,79,934,0.04,0.92,0.6,0.13,3,3,2,0,1013,1.0,1.0,0.6,0.77
PF11522,PF14621:PF11640:PF15785:PF15557:PF06972,3,16,2,1,14,1001,0.12,0.99,0.67,0.28,1,1,2,0,1015,1.0,1.0,0.33,0.58
PF08995,PF11934:PF01857:PF08934:PF01858:PF01433,0,55,0,0,55,963,0.0,0.95,0,0,1,0,0,1,1017,0.0,1.0,0,0
PF04485,PF15212:PF15135:PF15472:PF08857:PF11111,0,2,0,0,2,1016,0.0,1.0,0,0,0,0,0,0,1018,0,1.0,0,0
PF12596,PF12017:PF05485:PF14949:PF04583:PF13613,5,70,4,1,66,947,0.06,0.93,0.8,0.2,8,4,1,4,1009,0.5,1.0,0.8,0.63
PF08950,PF17049:PF08026:PF01316:PF15085:PF12158,0,5,0,0,5,1013,0.0,1.0,0,0,0,0,0,0,1018,0,1.0,0,0
PF16940,PF10177:PF03546:PF10198:PF08578:PF09332,5,13,0,5,13,1000,0.0,0.98,0.0,-0.01,1,0,5,1,1012,0.0,0.99,0.0,-0.0
PF13867,PF04422:PF16740:PF10581:PF03458:PF15397,6,9,1,5,8,1004,0.11,0.99,0.17,0.13,0,0,6,0,1012,0,0.99,0.0,0
PF11626,PF08914:PF06732:PF16727:PF09197:PF13438,7,20,7,0,13,998,0.35,0.99,1.0,0.59,0,0,7,0,1011,0,0.99,0.0,0
PF08879,PF08880:PF10497:PF02928:PF12031:PF00853,4,30,3,1,27,987,0.1,0.97,0.75,0.27,3,2,2,1,1013,0.67,1.0,0.5,0.58
PF12831,PF07976:PF06314:PF08491:PF01494:PF02910,9,97,9,0,88,921,0.09,0.91,1.0,0.29,8,4,5,4,1005,0.5,0.99,0.44,0.47
PF11371,PF07259:PF08945:PF10664:PF15125:PF07392,0,5,0,0,5,1013,0.0,1.0,0,0,0,0,0,0,1018,0,1.0,0,0
PF04015,PF05930:PF09856:PF03831:PF15529:PF05232,3,0,0,3,0,1015,0,1.0,0.0,0,0,0,3,0,1015,0,1.0,0.0,0
PF05630,PF01774:PF02284:PF04176:PF06658:PF05995,4,23,1,3,22,992,0.04,0.98,0.25,0.1,3,0,4,3,1011,0.0,0.99,0.0,-0.0
PF03048,PF12014:PF10209:PF09699:PF11187:PF07321,1,3,1,0,2,1015,0.33,1.0,1.0,0.58,1,1,0,0,1017,1.0,1.0,1.0,1.0
PF10216,PF16836:PF03243:PF11027:PF17112:PF14885,0,6,0,0,6,1012,0.0,0.99,0,0,0,0,0,0,1018,0,1.0,0,0
PF12130,PF15949:PF10358:PF12510:PF03271:PF15147,9,32,3,6,29,980,0.09,0.97,0.33,0.16,1,1,8,0,1009,1.0,0.99,0.11,0.33
PF13607,PF13380:PF06466:PF02567:PF15161:PF14996,2,25,2,0,23,993,0.08,0.98,1.0,0.28,4,1,1,3,1013,0.25,1.0,0.5,0.35
PF06744,PF01752:PF11863:PF07494:PF12477:PF03428,0,3,0,0,3,1015,0.0,1.0,0,0,0,0,0,0,1018,0,1.0,0,0
PF06230,PF11764:PF11616:PF05266:PF15811:PF04262,0,14,0,0,14,1004,0.0,0.99,0,0,1,0,0,1,1017,0.0,1.0,0,0
PF16158,PF16577:PF04718:PF00569:PF12744:PF09069,11,47,6,5,41,966,0.13,0.95,0.55,0.25,3,2,9,1,1006,0.67,0.99,0.18,0.34
PF02434,PF05679:PF06246:PF00884:PF16077:PF07019,28,67,22,6,45,945,0.33,0.95,0.79,0.49,9,9,19,0,990,1.0,0.98,0.32,0.56
PF08613,PF13908:PF02701:PF14719:PF12579:PF08265,23,24,4,19,20,975,0.17,0.96,0.17,0.15,1,1,22,0,995,1.0,0.98,0.04,0.21
PF14957,PF00568:PF12620:PF05210:PF04126:PF09816,6,28,3,3,25,987,0.11,0.97,0.5,0.22,2,2,4,0,1012,1.0,1.0,0.33,0.58
PF15208,PF16590:PF15340:PF01668:PF15772:PF15139,1,6,0,1,6,1011,0.0,0.99,0.0,-0.0,0,0,1,0,1017,0,1.0,0.0,0
PF08825,PF16420:PF00899:PF16191:PF16190:PF10585,6,57,6,0,51,961,0.11,0.95,1.0,0.32,3,1,5,2,1010,0.33,0.99,0.17,0.23
PF00278,PF02784:PF03936:PF01397:PF02812:PF03952,19,50,18,1,32,967,0.36,0.97,0.95,0.57,10,4,15,6,993,0.4,0.98,0.21,0.28
PF14718,PF15075:PF05280:PF08298:PF00308:PF10410,1,12,0,1,12,1005,0.0,0.99,0.0,-0.0,0,0,1,0,1017,0,1.0,0.0,0
PF10105,PF11230:PF11842:PF12345:PF06962:PF13597,2,4,2,0,2,1014,0.5,1.0,1.0,0.71,2,2,0,0,1016,1.0,1.0,1.0,1.0
PF05219,PF10245:PF03901:PF11927:PF08615:PF04110,5,57,3,2,54,959,0.05,0.94,0.6,0.17,2,1,4,1,1012,0.5,1.0,0.2,0.31
PF15100,PF12686:PF04222:PF03831:PF13689:PF01752,0,2,0,0,2,1016,0.0,1.0,0,0,0,0,0,0,1018,0,1.0,0,0
PF08969,PF11470:PF00581:PF16674:PF08153:PF13012,11,71,11,0,60,947,0.15,0.94,1.0,0.38,4,2,9,2,1005,0.5,0.99,0.18,0.3
PF06670,PF01254:PF15150:PF04223:PF05671:PF03058,0,4,0,0,4,1014,0.0,1.0,0,0,0,0,0,0,1018,0,1.0,0,0
PF03403,PF07470:PF10503:PF00457:PF03664:PF07247,21,39,12,9,27,970,0.31,0.96,0.57,0.4,4,2,19,2,995,0.5,0.98,0.1,0.21
PF13349,PF06581:PF06541:PF06875:PF07961:PF05824,1,2,0,1,2,1015,0.0,1.0,0.0,-0.0,0,0,1,0,1017,0,1.0,0.0,0
PF00545,PF09056:PF11029:PF01741:PF08738:PF03576,3,7,1,2,6,1009,0.14,0.99,0.33,0.21,0,0,3,0,1015,0,1.0,0.0,0
PF02436,PF08502:PF00682:PF02785:PF07836:PF08326,3,48,3,0,45,970,0.06,0.96,1.0,0.24,4,3,0,1,1014,0.75,1.0,1.0,0.87
PF05129,PF03760:PF15003:PF10203:PF08636:PF03386,10,9,1,9,8,1000,0.11,0.98,0.1,0.1,0,0,10,0,1008,0,0.99,0.0,0
PF10247,PF04051:PF00118:PF06825:PF04690:PF01906,4,65,2,2,63,951,0.03,0.94,0.5,0.11,2,0,4,2,1012,0.0,0.99,0.0,-0.0
PF16931,PF10279:PF04355:PF07157:PF04738:PF08021,0,0,0,0,0,1018,0,1.0,0,0,0,0,0,0,1018,0,1.0,0,0
PF00685,PF12062:PF00141:PF02485:PF16332:PF02949,40,75,20,20,55,923,0.27,0.93,0.5,0.33,9,8,32,1,977,0.89,0.97,0.2,0.41
PF17079,PF04966:PF16756:PF08691:PF13482:PF11162,0,2,0,0,2,1016,0.0,1.0,0,0,0,0,0,0,1018,0,1.0,0,0
PF16846,PF08493:PF10703:PF11951:PF04082:PF03851,2,182,2,0,180,836,0.01,0.82,1.0,0.1,9,2,0,7,1009,0.22,0.99,1.0,0.47
PF08220,PF03829:PF00455:PF03608:PF03786:PF11870,5,4,3,2,1,1012,0.75,1.0,0.6,0.67,2,2,3,0,1013,1.0,1.0,0.4,0.63
PF14602,PF12464:PF06426:PF13720:PF00132:PF01050,26,65,26,0,39,953,0.4,0.96,1.0,0.62,4,4,22,0,992,1.0,0.98,0.15,0.39
PF15670,PF12527:PF04988:PF15257:PF08014:PF05841,1,6,0,1,6,1011,0.0,0.99,0.0,-0.0,1,0,1,1,1016,0.0,1.0,0.0,-0.0
PF07448,PF14986:PF09232:PF15559:PF14866:PF09252,0,0,0,0,0,1018,0,1.0,0,0,0,0,0,0,1018,0,1.0,0,0
PF05986,PF01421:PF01562:PF15913:PF01681:PF08685,14,43,11,3,32,972,0.26,0.97,0.79,0.44,7,6,8,1,1003,0.86,0.99,0.43,0.6
PF00077,PF08284:PF00692:PF00607:PF02337:PF12384,13,33,8,5,25,980,0.24,0.97,0.62,0.37,6,6,7,0,1005,1.0,0.99,0.46,0.68
PF00333,PF03719:PF01132:PF09285:PF14693:PF16740,20,29,18,2,11,987,0.62,0.99,0.9,0.74,3,1,19,2,996,0.33,0.98,0.05,0.12
PF01503,PF01502:PF00815:PF14652:PF14558:PF11597,15,28,11,4,17,986,0.39,0.98,0.73,0.53,3,2,13,1,1002,0.67,0.99,0.13,0.29
PF14683,PF06045:PF14686:PF09284:PF16712:PF16711,17,16,15,2,1,1000,0.94,1.0,0.88,0.91,0,0,17,0,1001,0,0.98,0.0,0
PF06844,PF03454:PF03453:PF08668:PF15751:PF08310,0,31,0,0,31,987,0.0,0.97,0,0,1,0,0,1,1017,0.0,1.0,0,0
PF01231,PF01070:PF13875:PF15161:PF04568:PF01730,18,49,12,6,37,963,0.24,0.96,0.67,0.39,1,1,17,0,1000,1.0,0.98,0.06,0.23
PF15265,PF15302:PF01114:PF09051:PF15087:PF12904,0,2,0,0,2,1016,0.0,1.0,0,0,0,0,0,0,1018,0,1.0,0,0
PF01228,PF02901:PF07963:PF04232:PF03958:PF02447,2,18,2,0,16,1000,0.11,0.98,1.0,0.33,0,0,2,0,1016,0,1.0,0.0,0
PF08028,PF12806:PF09317:PF12418:PF00441:PF14749,3,65,3,0,62,953,0.05,0.94,1.0,0.21,3,3,0,0,1015,1.0,1.0,1.0,1.0
PF08668,PF13098:PF08274:PF14841:PF14882:PF10139,5,6,0,5,6,1007,0.0,0.99,0.0,-0.01,0,0,5,0,1013,0,1.0,0.0,0
PF08496,PF10108:PF07326:PF16586:PF15169:PF04624,3,3,1,2,2,1013,0.33,1.0,0.33,0.33,0,0,3,0,1015,0,1.0,0.0,0
PF07812,PF08454:PF16558:PF02825:PF06459:PF00632,0,82,0,0,82,936,0.0,0.92,0,0,7,0,0,7,1011,0.0,0.99,0,0
PF16416,PF07963:PF10410:PF12299:PF03963:PF07149,0,7,0,0,7,1011,0.0,0.99,0,0,0,0,0,0,1018,0,1.0,0,0
PF01078,PF00243:PF15266:PF02083:PF01731:PF17043,0,13,0,0,13,1005,0.0,0.99,0,0,0,0,0,0,1018,0,1.0,0,0
PF02946,PF01159:PF12509:PF12480:PF04499:PF00311,7,41,3,4,38,973,0.07,0.96,0.43,0.16,4,2,5,2,1009,0.5,0.99,0.29,0.37
PF09970,PF03051:PF16020:PF01684:PF12442:PF06248,0,22,0,0,22,996,0.0,0.98,0,0,0,0,0,0,1018,0,1.0,0,0
PF00086,PF09307:PF08831:PF00095:PF10511:PF10591,25,37,15,10,22,971,0.41,0.97,0.6,0.48,1,1,24,0,993,1.0,0.98,0.04,0.2
PF03960,PF15114:PF10567:PF05838:PF11593:PF07505,1,2,0,1,2,1015,0.0,1.0,0.0,-0.0,0,0,1,0,1017,0,1.0,0.0,0
PF04209,PF03386:PF06825:PF04006:PF05176:PF13741,12,17,6,6,11,995,0.35,0.98,0.5,0.41,0,0,12,0,1006,0,0.99,0.0,0
PF01116,PF07005:PF17042:PF14833:PF03446:PF16188,19,42,9,10,33,966,0.21,0.96,0.47,0.3,8,5,14,3,996,0.62,0.98,0.26,0.4
PF03248,PF06404:PF05216:PF04756:PF15008:PF03690,6,25,2,4,23,989,0.08,0.97,0.33,0.15,1,0,6,1,1011,0.0,0.99,0.0,-0.0
PF02267,PF12301:PF00277:PF00726:PF00103:PF06951,4,16,1,3,15,999,0.06,0.98,0.25,0.12,0,0,4,0,1014,0,1.0,0.0,0
PF10461,PF09034:PF17217:PF11957:PF10428:PF12721,1,13,1,0,12,1005,0.08,0.99,1.0,0.28,1,1,0,0,1017,1.0,1.0,1.0,1.0
PF02366,PF16192:PF02815:PF15012:PF01365:PF08709,13,28,13,0,15,990,0.46,0.99,1.0,0.68,9,2,11,7,998,0.22,0.98,0.15,0.18
PF09122,PF11127:PF06617:PF13972:PF12368:PF01455,0,11,0,0,11,1007,0.0,0.99,0,0,0,0,0,0,1018,0,1.0,0,0
PF13284,PF06406:PF13876:PF10035:PF03123:PF04917,0,6,0,0,6,1012,0.0,0.99,0,0,0,0,0,0,1018,0,1.0,0,0
PF16096,PF16097:PF12235:PF16098:PF05266:PF09005,2,15,2,0,13,1003,0.13,0.99,1.0,0.36,1,1,1,0,1016,1.0,1.0,0.5,0.71
PF11790,PF09362:PF09451:PF01670:PF05808:PF03229,8,22,3,5,19,991,0.14,0.98,0.38,0.22,1,1,7,0,1010,1.0,0.99,0.12,0.35
PF03618,PF06485:PF17078:PF15895:PF08642:PF03907,2,6,1,1,5,1011,0.17,0.99,0.5,0.29,0,0,2,0,1016,0,1.0,0.0,0
PF04568,PF00833:PF06516:PF01923:PF09468:PF12638,5,32,4,1,28,985,0.12,0.97,0.8,0.31,3,3,2,0,1013,1.0,1.0,0.6,0.77
PF03063,PF01402:PF03406:PF10974:PF04868:PF03244,2,3,1,1,2,1014,0.33,1.0,0.5,0.41,0,0,2,0,1016,0,1.0,0.0,0
PF03795,PF01828:PF07543:PF09424:PF04199:PF12680,9,29,6,3,23,986,0.21,0.97,0.67,0.36,6,4,5,2,1007,0.67,0.99,0.44,0.54
PF06968,PF13597:PF12345:PF16881:PF06969:PF11842,8,13,2,6,11,999,0.15,0.98,0.25,0.19,2,2,6,0,1010,1.0,0.99,0.25,0.5
PF12015,PF15082:PF15407:PF09441:PF15392:PF09462,1,6,0,1,6,1011,0.0,0.99,0.0,-0.0,0,0,1,0,1017,0,1.0,0.0,0
PF06211,PF13096:PF02083:PF13870:PF12709:PF05837,1,9,0,1,9,1008,0.0,0.99,0.0,-0.0,0,0,1,0,1017,0,1.0,0.0,0
PF05362,PF03226:PF12002:PF02933:PF02359:PF16193,20,37,9,11,28,970,0.24,0.96,0.45,0.31,7,4,16,3,995,0.57,0.98,0.2,0.33
PF03987,PF03986:PF10381:PF01106:PF01287:PF01191,15,42,12,3,30,973,0.29,0.97,0.8,0.47,5,3,12,2,1001,0.6,0.99,0.2,0.34
PF12531,PF06745:PF01580:PF07610:PF02601:PF12477,0,8,0,0,8,1010,0.0,0.99,0,0,0,0,0,0,1018,0,1.0,0,0
PF02394,PF05324:PF08023:PF00837:PF06540:PF09349,2,11,0,2,11,1005,0.0,0.99,0.0,-0.0,0,0,2,0,1016,0,1.0,0.0,0
PF08502,PF02436:PF00682:PF07836:PF02785:PF08326,9,48,9,0,39,970,0.19,0.96,1.0,0.42,4,3,6,1,1008,0.75,0.99,0.33,0.5
PF01272,PF06429:PF03963:PF07963:PF15096:PF02369,10,4,1,9,3,1005,0.25,0.99,0.1,0.15,0,0,10,0,1008,0,0.99,0.0,0
PF03477,PF00317:PF02867:PF08343:PF03989:PF12338,6,23,6,0,17,995,0.26,0.98,1.0,0.51,6,5,1,1,1011,0.83,1.0,0.83,0.83
PF00093,PF07452:PF00007:PF12947:PF00219:PF02822,24,38,18,6,20,974,0.47,0.97,0.75,0.58,5,5,19,0,994,1.0,0.98,0.21,0.45
PF03266,PF15741:PF15252:PF01959:PF15551:PF02371,3,6,1,2,5,1010,0.17,0.99,0.33,0.23,0,0,3,0,1015,0,1.0,0.0,0
PF01177,PF01230:PF02540:PF00795:PF01491:PF02416,8,76,6,2,70,940,0.08,0.93,0.75,0.23,10,4,4,6,1004,0.4,0.99,0.5,0.44
PF05728,PF13094:PF15032:PF05707:PF06724:PF04370,4,1,0,4,1,1013,0.0,1.0,0.0,-0.0,0,0,4,0,1014,0,1.0,0.0,0
PF07500,PF08711:PF15694:PF06881:PF15693:PF07533,16,37,13,3,24,978,0.35,0.97,0.81,0.52,2,1,15,1,1001,0.5,0.98,0.06,0.17
PF11351,PF15040:PF07295:PF10941:PF00662:PF10263,0,24,0,0,24,994,0.0,0.98,0,0,0,0,0,0,1018,0,1.0,0,0
PF16317,PF15383:PF07248:PF15998:PF12298:PF03803,5,26,2,3,24,989,0.08,0.97,0.4,0.17,2,1,4,1,1012,0.5,1.0,0.2,0.31
PF01595,PF00654:PF00571:PF00893:PF04739:PF14611,18,66,11,7,55,945,0.17,0.94,0.61,0.3,5,2,16,3,997,0.4,0.98,0.11,0.2
PF08069,PF05019:PF00312:PF03979:PF14204:PF03766,12,42,10,2,32,974,0.24,0.97,0.83,0.43,2,2,10,0,1006,1.0,0.99,0.17,0.41
PF14121,PF02820:PF07657:PF08434:PF03952:PF00113,0,37,0,0,37,981,0.0,0.96,0,0,4,0,0,4,1014,0.0,1.0,0,0
PF08694,PF16843:PF13446:PF05162:PF16674:PF09055,3,12,1,2,11,1004,0.08,0.99,0.33,0.16,1,0,3,1,1014,0.0,1.0,0.0,-0.0
PF12057,PF16843:PF09055:PF05162:PF08325:PF12148,2,18,1,1,17,999,0.06,0.98,0.5,0.16,1,1,1,0,1016,1.0,1.0,0.5,0.71
PF05762,PF10407:PF09967:PF09462:PF11542:PF03344,4,5,1,3,4,1010,0.2,0.99,0.25,0.22,0,0,4,0,1014,0,1.0,0.0,0
PF08283,PF00799:PF14232:PF08275:PF13808:PF16871,1,7,1,0,6,1011,0.14,0.99,1.0,0.38,0,0,1,0,1017,0,1.0,0.0,0
PF02656,PF03124:PF00939:PF03600:PF03105:PF11807,22,46,13,9,33,963,0.28,0.96,0.59,0.39,4,3,19,1,995,0.75,0.98,0.14,0.31
PF15811,PF11616:PF11764:PF02064:PF05033:PF03353,7,34,3,4,31,980,0.09,0.97,0.43,0.18,4,2,5,2,1009,0.5,0.99,0.29,0.37
PF00872,PF01610:PF10532:PF11202:PF14690:PF15608,4,3,1,3,2,1012,0.33,1.0,0.25,0.29,0,0,4,0,1014,0,1.0,0.0,0
PF01943,PF02465:PF10566:PF08497:PF16325:PF11245,0,1,0,0,1,1017,0.0,1.0,0,0,0,0,0,0,1018,0,1.0,0,0
PF14295,PF00024:PF08277:PF08562:PF10528:PF12708,38,59,25,13,34,946,0.42,0.95,0.66,0.51,4,3,35,1,979,0.75,0.96,0.08,0.24
PF13350,PF13026:PF12146:PF04083:PF03982:PF03959,7,86,4,3,82,929,0.05,0.92,0.57,0.15,10,3,4,7,1004,0.3,0.99,0.43,0.35
PF04214,PF01249:PF01484:PF03211:PF08511:PF09507,0,60,0,0,60,958,0.0,0.94,0,0,5,0,0,5,1013,0.0,1.0,0,0
PF06113,PF15008:PF01327:PF14935:PF06658:PF05612,4,12,1,3,11,1003,0.08,0.99,0.25,0.14,0,0,4,0,1014,0,1.0,0.0,0
PF15839,PF07259:PF15829:PF15576:PF15849:PF03823,1,5,0,1,5,1012,0.0,0.99,0.0,-0.0,0,0,1,0,1017,0,1.0,0.0,0
PF01779,PF05129:PF04418:PF15003:PF09748:PF03386,9,24,2,7,22,987,0.08,0.97,0.22,0.12,1,0,9,1,1008,0.0,0.99,0.0,-0.0
PF13759,PF09187:PF10138:PF04562:PF14216:PF09684,9,4,1,8,3,1006,0.25,0.99,0.11,0.16,0,0,9,0,1009,0,0.99,0.0,0
PF00554,PF16179:PF16180:PF16181:PF03020:PF08198,18,19,16,2,3,997,0.84,1.0,0.89,0.86,2,2,16,0,1000,1.0,0.98,0.11,0.33
PF09110,PF09111:PF13892:PF11648:PF08061:PF03461,14,25,14,0,11,993,0.56,0.99,1.0,0.74,4,4,10,0,1004,1.0,0.99,0.29,0.53
PF02253,PF15750:PF04865:PF02211:PF08411:PF06639,1,5,0,1,5,1012,0.0,0.99,0.0,-0.0,0,0,1,0,1017,0,1.0,0.0,0
PF05401,PF03428:PF06798:PF07499:PF05939:PF06744,1,2,0,1,2,1015,0.0,1.0,0.0,-0.0,0,0,1,0,1017,0,1.0,0.0,0
PF01728,PF07780:PF01585:PF07842:PF11861:PF00849,37,94,26,11,68,913,0.28,0.92,0.7,0.41,15,11,26,4,977,0.73,0.97,0.3,0.46
PF12886,PF12884:PF14438:PF12885:PF15016:PF16794,3,22,3,0,19,996,0.14,0.98,1.0,0.37,1,1,2,0,1015,1.0,1.0,0.33,0.58
PF14893,PF16297:PF02093:PF01107:PF00607:PF02337,5,15,2,3,13,1000,0.13,0.98,0.4,0.22,4,2,3,2,1011,0.5,1.0,0.4,0.44
PF07222,PF15093:PF07891:PF15280:PF06047:PF03546,2,12,1,1,11,1005,0.08,0.99,0.5,0.2,0,0,2,0,1016,0,1.0,0.0,0
PF09950,PF04917:PF02399:PF07523:PF05034:PF14842,0,2,0,0,2,1016,0.0,1.0,0,0,0,0,0,0,1018,0,1.0,0,0
PF02556,PF13972:PF06617:PF14340:PF09122:PF12368,5,11,2,3,9,1004,0.18,0.99,0.4,0.26,0,0,5,0,1013,0,1.0,0.0,0
PF15218,PF15837:PF15100:PF15828:PF15192:PF09207,0,2,0,0,2,1016,0.0,1.0,0,0,0,0,0,0,1018,0,1.0,0,0
PF00728,PF14845:PF07555:PF02838:PF03174:PF03173,36,27,25,11,2,980,0.93,0.99,0.69,0.8,3,3,33,0,982,1.0,0.97,0.08,0.28
PF10974,PF01514:PF01752:PF05857:PF17188:PF03050,0,2,0,0,2,1016,0.0,1.0,0,0,0,0,0,0,1018,0,1.0,0,0
PF16516,PF04440:PF12180:PF08234:PF13870:PF06211,5,6,1,4,5,1008,0.17,0.99,0.2,0.18,0,0,5,0,1013,0,1.0,0.0,0
PF07243,PF03428:PF01913:PF10566:PF10412:PF11593,0,3,0,0,3,1015,0.0,1.0,0,0,0,0,0,0,1018,0,1.0,0,0
PF11532,PF15861:PF13355:PF15027:PF10441:PF16748,1,9,1,0,8,1009,0.11,0.99,1.0,0.33,0,0,1,0,1017,0,1.0,0.0,0
PF04520,PF06376:PF00321:PF05915:PF12734:PF06749,0,10,0,0,10,1008,0.0,0.99,0,0,1,0,0,1,1017,0.0,1.0,0,0
PF08327,PF09229:PF16174:PF16791:PF14875:PF03509,17,19,16,1,3,998,0.84,1.0,0.94,0.89,0,0,17,0,1001,0,0.98,0.0,0
PF11980,PF00629:PF09458:PF00754:PF00959:PF05823,0,74,0,0,74,944,0.0,0.93,0,0,5,0,0,5,1013,0.0,1.0,0,0
PF09334,PF10458:PF08264:PF09635:PF00133:PF06827,33,61,19,14,42,943,0.31,0.94,0.58,0.4,8,6,27,2,983,0.75,0.97,0.18,0.36
PF03299,PF15929:PF04801:PF06991:PF06413:PF09713,10,32,5,5,27,981,0.16,0.97,0.5,0.27,2,2,8,0,1008,1.0,0.99,0.2,0.45
PF01430,PF09967:PF12178:PF16051:PF13482:PF12628,1,5,0,1,5,1012,0.0,0.99,0.0,-0.0,0,0,1,0,1017,0,1.0,0.0,0
PF04716,PF01632:PF08561:PF10218:PF05915:PF09769,13,13,3,10,10,995,0.23,0.98,0.23,0.22,1,1,12,0,1005,1.0,0.99,0.08,0.28
PF04985,PF05939:PF12834:PF08093:PF08497:PF13663,0,3,0,0,3,1015,0.0,1.0,0,0,0,0,0,0,1018,0,1.0,0,0
PF08163,PF15785:PF11640:PF08064:PF02259:PF10441,11,37,8,3,29,978,0.22,0.97,0.73,0.39,6,3,8,3,1004,0.5,0.99,0.27,0.36
PF15243,PF05039:PF10839:PF15359:PF02285:PF01716,0,7,0,0,7,1011,0.0,0.99,0,0,0,0,0,0,1018,0,1.0,0,0
PF04081,PF09459:PF07544:PF09348:PF01947:PF05014,8,11,0,8,11,999,0.0,0.98,0.0,-0.01,0,0,8,0,1010,0,0.99,0.0,0
PF02074,PF10856:PF15823:PF07157:PF07409:PF15834,1,0,0,1,0,1017,0,1.0,0.0,0,0,0,1,0,1017,0,1.0,0.0,0
PF07017,PF04465:PF06794:PF07565:PF04065:PF12084,0,11,0,0,11,1007,0.0,0.99,0,0,0,0,0,0,1018,0,1.0,0,0
PF01471,PF00045:PF00413:PF08924:PF11857:PF15225,32,37,26,6,11,975,0.7,0.98,0.81,0.75,3,3,29,0,986,1.0,0.97,0.09,0.3
PF06522,PF04110:PF01828:PF10853:PF09749:PF10780,3,23,2,1,21,994,0.09,0.98,0.67,0.24,1,1,2,0,1015,1.0,1.0,0.33,0.58
PF17084,PF04612:PF11369:PF02741:PF08461:PF03729,0,2,0,0,2,1016,0.0,1.0,0,0,0,0,0,0,1018,0,1.0,0,0
PF06800,PF13296:PF15319:PF02979:PF14508:PF02616,1,4,0,1,4,1013,0.0,1.0,0.0,-0.0,0,0,1,0,1017,0,1.0,0.0,0
PF04049,PF16546:PF14280:PF07219:PF02388:PF05279,12,14,4,8,10,996,0.29,0.98,0.33,0.3,1,1,11,0,1006,1.0,0.99,0.08,0.29
PF10172,PF09692:PF03760:PF16294:PF10471:PF10775,5,12,1,4,11,1002,0.08,0.99,0.2,0.12,0,0,5,0,1013,0,1.0,0.0,0
PF00200,PF08516:PF16698:PF01562:PF01421:PF02333,29,44,26,3,18,971,0.59,0.98,0.9,0.72,17,16,13,1,988,0.94,0.99,0.55,0.71
PF08277,PF00024:PF08391:PF14295:PF00912:PF09064,9,71,8,1,63,946,0.11,0.94,0.89,0.3,6,3,6,3,1006,0.5,0.99,0.33,0.4
PF00169,PF00620:PF00130:PF01237:PF09128:PF08916,137,127,79,58,48,833,0.62,0.9,0.58,0.54,14,12,125,2,879,0.86,0.88,0.09,0.25
PF10511,PF08831:PF09307:PF02961:PF09014:PF00095,1,32,1,0,31,986,0.03,0.97,1.0,0.17,2,1,0,1,1016,0.5,1.0,1.0,0.71
PF11619,PF07710:PF08563:PF00870:PF16019:PF05971,1,13,1,0,12,1005,0.08,0.99,1.0,0.28,2,1,0,1,1016,0.5,1.0,1.0,0.71
PF04308,PF04764:PF01254:PF05671:PF06773:PF11412,0,3,0,0,3,1015,0.0,1.0,0,0,0,0,0,0,1018,0,1.0,0,0
PF02205,PF12828:PF12825:PF08776:PF05210:PF00568,33,27,14,19,13,972,0.52,0.97,0.42,0.45,1,1,32,0,985,1.0,0.97,0.03,0.17
PF03200,PF16923:PF08158:PF09511:PF17167:PF07159,10,25,8,2,17,991,0.32,0.98,0.8,0.5,4,3,7,1,1007,0.75,0.99,0.3,0.47
PF03037,PF12840:PF11312:PF17192:PF17148:PF08956,0,1,0,0,1,1017,0.0,1.0,0,0,0,0,0,0,1018,0,1.0,0,0
PF13664,PF09769:PF06127:PF09754:PF06244:PF00436,9,38,3,6,35,974,0.08,0.96,0.33,0.15,2,1,8,1,1008,0.5,0.99,0.11,0.23
PF08338,PF00908:PF14934:PF11803:PF10329:PF05704,8,18,4,4,14,996,0.22,0.98,0.5,0.33,0,0,8,0,1010,0,0.99,0.0,0
PF13631,PF00033:PF04140:PF06159:PF01789:PF13085,2,48,2,0,46,970,0.04,0.95,1.0,0.2,1,1,1,0,1016,1.0,1.0,0.5,0.71
PF08682,PF01721:PF16489:PF07305:PF01802:PF11938,0,29,0,0,29,989,0.0,0.97,0,0,0,0,0,0,1018,0,1.0,0,0
PF12255,PF12256:PF03534:PF09327:PF04917:PF16967,0,1,0,0,1,1017,0.0,1.0,0,0,0,0,0,0,1018,0,1.0,0,0
PF07402,PF13471:PF13277:PF13286:PF14691:PF05534,0,21,0,0,21,997,0.0,0.98,0,0,0,0,0,0,1018,0,1.0,0,0
PF00047,PF13895:PF03921:PF01403:PF02158:PF05790,37,44,24,13,20,961,0.55,0.97,0.65,0.58,3,3,34,0,981,1.0,0.97,0.08,0.28
PF15412,PF11116:PF14971:PF08439:PF08309:PF13878,6,8,1,5,7,1005,0.12,0.99,0.17,0.14,0,0,6,0,1012,0,0.99,0.0,0
PF00870,PF08563:PF07710:PF11619:PF04516:PF16533,5,10,4,1,6,1007,0.4,0.99,0.8,0.56,2,2,3,0,1013,1.0,1.0,0.4,0.63
PF11899,PF12036:PF16862:PF06964:PF08216:PF04842,4,36,1,3,35,979,0.03,0.96,0.25,0.07,0,0,4,0,1014,0,1.0,0.0,0
PF06521,PF11264:PF15071:PF06351:PF10868:PF11029,1,4,0,1,4,1013,0.0,1.0,0.0,-0.0,0,0,1,0,1017,0,1.0,0.0,0
PF02166,PF02155:PF02159:PF12743:PF02161:PF12577,6,12,5,1,7,1005,0.42,0.99,0.83,0.59,5,5,1,0,1012,1.0,1.0,0.83,0.91
PF07546,PF00147:PF16034:PF00386:PF12455:PF09992,5,65,4,1,61,952,0.06,0.94,0.8,0.21,4,1,4,3,1010,0.25,0.99,0.2,0.22
PF04440,PF16516:PF08234:PF00835:PF14802:PF06607,0,10,0,0,10,1008,0.0,0.99,0,0,0,0,0,0,1018,0,1.0,0,0
PF14396,PF12399:PF08352:PF08402:PF03895:PF01032,3,17,3,0,14,1001,0.18,0.99,1.0,0.42,3,2,1,1,1014,0.67,1.0,0.67,0.67
PF05198,PF11567:PF04432:PF14849:PF12471:PF00926,10,12,3,7,9,999,0.25,0.98,0.3,0.27,0,0,10,0,1008,0,0.99,0.0,0
PF16190,PF16191:PF10585:PF16195:PF09358:PF14732,3,20,3,0,17,998,0.15,0.98,1.0,0.38,1,1,2,0,1015,1.0,1.0,0.33,0.58
PF16854,PF04100:PF12932:PF06662:PF08532:PF11699,0,27,0,0,27,991,0.0,0.97,0,0,1,0,0,1,1017,0.0,1.0,0,0
PF12873,PF14251:PF12658:PF07209:PF15775:PF00669,0,5,0,0,5,1013,0.0,1.0,0,0,0,0,0,0,1018,0,1.0,0,0
PF15502,PF14021:PF05387:PF07259:PF15576:PF15314,0,2,0,0,2,1016,0.0,1.0,0,0,0,0,0,0,1018,0,1.0,0,0
PF00398,PF09813:PF14828:PF03029:PF07896:PF04178,19,35,9,10,26,973,0.26,0.96,0.47,0.33,4,4,15,0,999,1.0,0.99,0.21,0.46
PF09327,PF12256:PF12421:PF07523:PF15518:PF04196,0,1,0,0,1,1017,0.0,1.0,0,0,0,0,0,0,1018,0,1.0,0,0
PF07836,PF13809:PF08502:PF01313:PF14508:PF03401,2,10,1,1,9,1007,0.1,0.99,0.5,0.22,0,0,2,0,1016,0,1.0,0.0,0
PF09677,PF12477:PF11130:PF16325:PF01580:PF17206,0,6,0,0,6,1012,0.0,0.99,0,0,0,0,0,0,1018,0,1.0,0,0
PF00179,PF07933:PF10520:PF09288:PF05529:PF10208,98,26,17,81,9,911,0.65,0.91,0.17,0.31,2,2,96,0,920,1.0,0.91,0.02,0.14
PF08088,PF15676:PF14512:PF10974:PF07421:PF04754,0,2,0,0,2,1016,0.0,1.0,0,0,0,0,0,0,1018,0,1.0,0,0
PF11037,PF17022:PF05962:PF10412:PF01668:PF16804,0,3,0,0,3,1015,0.0,1.0,0,0,0,0,0,0,1018,0,1.0,0,0
PF05700,PF12638:PF15704:PF15054:PF14825:PF14565,9,19,4,5,15,994,0.21,0.98,0.44,0.3,0,0,9,0,1009,0,0.99,0.0,0
PF02511,PF15763:PF12194:PF15848:PF05418:PF15207,2,3,0,2,3,1013,0.0,1.0,0.0,-0.0,0,0,2,0,1016,0,1.0,0.0,0
PF08675,PF04857:PF08636:PF07798:PF11623:PF03066,4,32,4,0,28,986,0.12,0.97,1.0,0.35,0,0,4,0,1014,0,1.0,0.0,0
PF00407,PF03032:PF07712:PF03030:PF05562:PF07276,7,15,4,3,11,1000,0.27,0.99,0.57,0.38,1,1,6,0,1011,1.0,0.99,0.14,0.38
PF08276,PF00954:PF01453:PF11883:PF12398:PF00314,20,49,19,1,30,968,0.39,0.97,0.95,0.6,12,12,8,0,998,1.0,0.99,0.6,0.77
PF05624,PF14909:PF10198:PF05508:PF05030:PF08624,1,16,0,1,16,1001,0.0,0.98,0.0,-0.0,1,0,1,1,1016,0.0,1.0,0.0,-0.0
PF12903,PF15681:PF10216:PF05135:PF15825:PF15756,0,4,0,0,4,1014,0.0,1.0,0,0,0,0,0,0,1018,0,1.0,0,0
PF15228,PF06592:PF09470:PF07149:PF15137:PF16590,2,3,0,2,3,1013,0.0,1.0,0.0,-0.0,0,0,2,0,1016,0,1.0,0.0,0
PF05766,PF07022:PF05969:PF07310:PF12615:PF01110,0,3,0,0,3,1015,0.0,1.0,0,0,0,0,0,0,1018,0,1.0,0,0
PF01090,PF02285:PF14954:PF15884:PF14935:PF15475,12,10,1,11,9,997,0.1,0.98,0.08,0.08,0,0,12,0,1006,0,0.99,0.0,0
PF05836,PF15760:PF15085:PF14519:PF15097:PF04691,0,4,0,0,4,1014,0.0,1.0,0,0,0,0,0,0,1018,0,1.0,0,0
PF05524,PF02896:PF00391:PF00358:PF01326:PF06165,7,28,7,0,21,990,0.25,0.98,1.0,0.49,10,3,4,7,1004,0.3,0.99,0.43,0.35
PF08156,PF09785:PF07001:PF06972:PF12129:PF15303,25,16,3,22,13,980,0.19,0.97,0.12,0.13,0,0,25,0,993,0,0.98,0.0,0
PF03384,PF14922:PF13694:PF11727:PF16801:PF13388,3,4,1,2,3,1012,0.25,1.0,0.33,0.29,0,0,3,0,1015,0,1.0,0.0,0
PF15375,PF10276:PF10018:PF12319:PF15910:PF07939,8,18,5,3,13,997,0.28,0.98,0.62,0.41,0,0,8,0,1010,0,0.99,0.0,0
PF15814,PF06729:PF02977:PF15825:PF15119:PF15142,0,3,0,0,3,1015,0.0,1.0,0,0,0,0,0,0,1018,0,1.0,0,0
PF06313,PF04856:PF00714:PF00489:PF15172:PF15109,0,3,0,0,3,1015,0.0,1.0,0,0,0,0,0,0,1018,0,1.0,0,0
PF15371,PF02200:PF07610:PF13482:PF15082:PF06513,4,6,0,4,6,1008,0.0,0.99,0.0,-0.0,0,0,4,0,1014,0,1.0,0.0,0
PF11578,PF14612:PF04229:PF03595:PF04148:PF07247,12,40,7,5,33,973,0.17,0.96,0.58,0.31,0,0,12,0,1006,0,0.99,0.0,0
PF10634,PF10080:PF08021:PF15143:PF04954:PF03090,0,0,0,0,0,1018,0,1.0,0,0,0,0,0,0,1018,0,1.0,0,0
PF00879,PF00323:PF04643:PF05436:PF01296:PF01114,0,4,0,0,4,1014,0.0,1.0,0,0,0,0,0,0,1018,0,1.0,0,0
PF15549,PF14986:PF15333:PF02950:PF08089:PF02941,1,2,0,1,2,1015,0.0,1.0,0.0,-0.0,0,0,1,0,1017,0,1.0,0.0,0
PF09262,PF16725:PF05695:PF09263:PF12372:PF10441,12,20,7,5,13,993,0.35,0.98,0.58,0.44,2,2,10,0,1006,1.0,0.99,0.17,0.41
PF01977,PF12973:PF07543:PF03576:PF17124:PF07080,6,10,0,6,10,1002,0.0,0.98,0.0,-0.01,0,0,6,0,1012,0,0.99,0.0,0
PF09807,PF05497:PF10261:PF01234:PF03858:PF16954,4,14,1,3,13,1001,0.07,0.98,0.25,0.13,0,0,4,0,1014,0,1.0,0.0,0
PF00804,PF09177:PF11416:PF05739:PF02269:PF04101,27,50,21,6,29,962,0.42,0.97,0.78,0.56,7,5,22,2,989,0.71,0.98,0.19,0.36
PF13367,PF11341:PF06695:PF09690:PF17056:PF15478,3,3,0,3,3,1012,0.0,0.99,0.0,-0.0,0,0,3,0,1015,0,1.0,0.0,0
PF15866,PF15248:PF12240:PF14988:PF08227:PF11291,5,11,3,2,8,1005,0.27,0.99,0.6,0.4,1,1,4,0,1013,1.0,1.0,0.2,0.45
PF01455,PF01706:PF06834:PF04350:PF10995:PF03406,0,1,0,0,1,1017,0.0,1.0,0,0,0,0,0,0,1018,0,1.0,0,0
PF10612,PF12037:PF16582:PF02684:PF13249:PF02634,0,19,0,0,19,999,0.0,0.98,0,0,0,0,0,0,1018,0,1.0,0,0
PF16987,PF08495:PF16866:PF14299:PF10442:PF05048,14,18,6,8,12,992,0.33,0.98,0.43,0.37,1,1,13,0,1004,1.0,0.99,0.07,0.27
PF02080,PF02254:PF08619:PF06826:PF12462:PF02011,3,17,2,1,15,1000,0.12,0.98,0.67,0.28,0,0,3,0,1015,0,1.0,0.0,0
PF09775,PF01286:PF12659:PF13408:PF12461:PF02753,0,8,0,0,8,1010,0.0,0.99,0,0,0,0,0,0,1018,0,1.0,0,0
PF02753,PF11614:PF08299:PF13954:PF13746:PF10139,3,9,3,0,6,1009,0.33,0.99,1.0,0.58,0,0,3,0,1015,0,1.0,0.0,0
PF08227,PF15248:PF14988:PF12240:PF08286:PF15866,6,9,2,4,7,1005,0.22,0.99,0.33,0.27,1,1,5,0,1012,1.0,1.0,0.17,0.41
PF14908,PF13020:PF12726:PF11028:PF14469:PF00451,5,13,3,2,10,1003,0.23,0.99,0.6,0.37,0,0,5,0,1013,0,1.0,0.0,0
PF04041,PF07400:PF13406:PF02367:PF11759:PF15138,2,4,0,2,4,1012,0.0,0.99,0.0,-0.0,0,0,2,0,1016,0,1.0,0.0,0
PF08432,PF02399:PF13995:PF17014:PF02565:PF04196,0,3,0,0,3,1015,0.0,1.0,0,0,0,0,0,0,1018,0,1.0,0,0
PF14547,PF14159:PF03168:PF04759:PF03350:PF04669,1,23,0,1,23,994,0.0,0.98,0.0,-0.0,0,0,1,0,1017,0,1.0,0.0,0
PF15354,PF05292:PF07676:PF09902:PF02080:PF13378,0,46,0,0,46,972,0.0,0.95,0,0,3,0,0,3,1015,0.0,1.0,0,0
PF15105,PF03050:PF05797:PF09669:PF17076:PF00796,0,1,0,0,1,1017,0.0,1.0,0,0,0,0,0,0,1018,0,1.0,0,0
PF00285,PF08442:PF02629:PF00549:PF06971:PF05493,24,46,16,8,30,964,0.35,0.96,0.67,0.46,8,6,18,2,992,0.75,0.98,0.25,0.43
PF07850,PF05450:PF12735:PF17132:PF16114:PF09265,12,27,4,8,23,983,0.15,0.97,0.33,0.21,2,0,12,2,1004,0.0,0.99,0.0,-0.0
PF03719,PF00333:PF09285:PF01132:PF00347:PF08207,22,36,20,2,16,980,0.56,0.98,0.91,0.7,7,4,18,3,993,0.57,0.98,0.18,0.31
PF03350,PF07816:PF14159:PF07896:PF10018:PF11833,1,19,0,1,19,998,0.0,0.98,0.0,-0.0,2,0,1,2,1015,0.0,1.0,0.0,-0.0
PF15273,PF15997:PF11261:PF15249:PF12509:PF12478,1,22,1,0,21,996,0.05,0.98,1.0,0.21,0,0,1,0,1017,0,1.0,0.0,0
PF03904,PF13553:PF09169:PF12721:PF09270:PF16423,0,24,0,0,24,994,0.0,0.98,0,0,3,0,0,3,1015,0.0,1.0,0,0
PF01532,PF02225:PF04258:PF04389:PF05867:PF09747,40,80,25,15,55,923,0.31,0.93,0.62,0.41,11,9,31,2,976,0.82,0.97,0.23,0.42
PF02371,PF10994:PF15162:PF16590:PF09585:PF06592,3,3,0,3,3,1012,0.0,0.99,0.0,-0.0,0,0,3,0,1015,0,1.0,0.0,0
PF00536,PF07647:PF10534:PF09246:PF14847:PF12485,62,42,28,34,14,942,0.67,0.95,0.45,0.53,1,1,61,0,956,1.0,0.94,0.02,0.12
PF01366,PF05343:PF03122:PF08247:PF04978:PF00166,0,28,0,0,28,990,0.0,0.97,0,0,1,0,0,1,1017,0.0,1.0,0,0
PF01018,PF08701:PF13167:PF06071:PF16360:PF05128,10,16,3,7,13,995,0.19,0.98,0.3,0.23,1,1,9,0,1008,1.0,0.99,0.1,0.31
PF00004,PF12037:PF05362:PF14629:PF01434:PF03226,157,58,50,107,8,853,0.86,0.89,0.32,0.48,9,9,148,0,861,1.0,0.85,0.06,0.22
PF13333,PF01514:PF15976:PF04559:PF08334:PF10566,0,1,0,0,1,1017,0.0,1.0,0,0,0,0,0,0,1018,0,1.0,0,0
PF14749,PF01756:PF09317:PF08028:PF12806:PF02770,14,69,13,1,56,948,0.19,0.94,0.93,0.4,3,2,12,1,1003,0.67,0.99,0.14,0.3
PF01814,PF04405:PF05495:PF13436:PF13441:PF13705,14,13,2,12,11,993,0.15,0.98,0.14,0.14,2,2,12,0,1004,1.0,0.99,0.14,0.38
PF11879,PF11601:PF16526:PF03521:PF11933:PF16885,4,15,3,1,12,1002,0.2,0.99,0.75,0.38,1,1,3,0,1014,1.0,1.0,0.25,0.5
PF00139,PF03822:PF14593:PF00314:PF12605:PF12063,23,29,12,11,17,978,0.41,0.97,0.52,0.45,3,3,20,0,995,1.0,0.98,0.13,0.36
PF06309,PF07542:PF01758:PF01733:PF01731:PF11025,4,36,2,2,34,980,0.06,0.96,0.5,0.16,2,0,4,2,1012,0.0,0.99,0.0,-0.0
PF03174,PF03173:PF02838:PF14845:PF00728:PF16712,3,37,3,0,34,981,0.08,0.97,1.0,0.28,5,3,0,2,1013,0.6,1.0,1.0,0.77
PF12098,PF08885:PF10951:PF05962:PF01514:PF08308,0,2,0,0,2,1016,0.0,1.0,0,0,0,0,0,0,1018,0,1.0,0,0
PF13448,PF05894:PF15082:PF07610:PF15856:PF08291,0,5,0,0,5,1013,0.0,1.0,0,0,0,0,0,0,1018,0,1.0,0,0
PF01422,PF13902:PF02195:PF03946:PF02060:PF05267,11,35,6,5,29,978,0.17,0.97,0.55,0.29,0,0,11,0,1007,0,0.99,0.0,0
PF04192,PF15512:PF13271:PF11816:PF09453:PF03451,8,35,4,4,31,979,0.11,0.97,0.5,0.23,4,2,6,2,1008,0.5,0.99,0.25,0.35
PF04147,PF07975:PF04056:PF16712:PF16711:PF05994,13,15,5,8,10,995,0.33,0.98,0.38,0.35,2,1,12,1,1004,0.5,0.99,0.08,0.19
PF03087,PF04674:PF03492:PF02519:PF00197:PF04525,6,24,3,3,21,991,0.12,0.98,0.5,0.24,1,0,6,1,1011,0.0,0.99,0.0,-0.0
PF01082,PF03712:PF03351:PF10517:PF01436:PF03527,19,47,18,1,29,970,0.38,0.97,0.95,0.59,10,9,10,1,998,0.9,0.99,0.47,0.65
PF06653,PF15556:PF10994:PF15828:PF03548:PF06549,2,5,1,1,4,1012,0.2,1.0,0.5,0.31,0,0,2,0,1016,0,1.0,0.0,0
PF16494,PF03733:PF01699:PF03160:PF16076:PF01368,1,70,1,0,69,948,0.01,0.93,1.0,0.12,10,1,0,9,1008,0.1,0.99,1.0,0.31
PF00904,PF10583:PF00879:PF05436:PF02343:PF15087,0,4,0,0,4,1014,0.0,1.0,0,0,0,0,0,0,1018,0,1.0,0,0
PF07317,PF01750:PF02281:PF06299:PF07210:PF00530,0,41,0,0,41,977,0.0,0.96,0,0,0,0,0,0,1018,0,1.0,0,0
PF02460,PF16414:PF12349:PF03176:PF00368:PF13323,44,45,28,16,17,957,0.62,0.97,0.64,0.61,4,4,40,0,974,1.0,0.96,0.09,0.3
PF17002,PF17206:PF11697:PF08093:PF01316:PF15716,0,4,0,0,4,1014,0.0,1.0,0,0,0,0,0,0,1018,0,1.0,0,0
PF13092,PF13225:PF15346:PF00468:PF08598:PF07787,7,18,2,5,16,995,0.11,0.98,0.29,0.17,1,1,6,0,1011,1.0,0.99,0.14,0.38
PF01915,PF00933:PF14310:PF14498:PF06964:PF03552,33,52,33,0,19,966,0.63,0.98,1.0,0.79,13,13,20,0,985,1.0,0.98,0.39,0.62
PF09728,PF10595:PF10234:PF15264:PF15237:PF10217,10,10,5,5,5,1003,0.5,0.99,0.5,0.5,0,0,10,0,1008,0,0.99,0.0,0
PF00682,PF02436:PF08502:PF02785:PF01039:PF10937,22,56,14,8,42,954,0.25,0.95,0.64,0.38,3,3,19,0,996,1.0,0.98,0.14,0.37
PF08685,PF01681:PF05986:PF08686:PF06594:PF04308,6,19,3,3,16,996,0.16,0.98,0.5,0.27,0,0,6,0,1012,0,0.99,0.0,0
PF02100,PF08559:PF04367:PF04839:PF02915:PF07809,5,7,2,3,5,1008,0.29,0.99,0.4,0.33,0,0,5,0,1013,0,1.0,0.0,0
PF09243,PF02357:PF16493:PF12298:PF14768:PF14496,13,10,1,12,9,996,0.1,0.98,0.08,0.08,0,0,13,0,1005,0,0.99,0.0,0
PF00270,PF16783:PF13959:PF10927:PF11719:PF12513,179,32,31,148,1,838,0.97,0.85,0.17,0.38,4,4,175,0,839,1.0,0.83,0.02,0.14
PF07714,PF00069:PF12036:PF00696:PF13458:PF13882,180,351,146,34,205,633,0.42,0.77,0.81,0.45,7,6,174,1,837,0.86,0.83,0.03,0.15
PF09493,PF08497:PF05418:PF15826:PF05234:PF16822,0,2,0,0,2,1016,0.0,1.0,0,0,0,0,0,0,1018,0,1.0,0,0
PF11999,PF16716:PF07544:PF02024:PF00545:PF00737,2,10,1,1,9,1007,0.1,0.99,0.5,0.22,0,0,2,0,1016,0,1.0,0.0,0
PF00654,PF01595:PF00571:PF04739:PF07228:PF00893,34,71,30,4,41,943,0.42,0.96,0.88,0.59,4,4,30,0,984,1.0,0.97,0.12,0.34
PF06320,PF10542:PF03918:PF10868:PF00537:PF15305,7,4,1,6,3,1008,0.25,0.99,0.14,0.18,0,0,7,0,1011,0,0.99,0.0,0
PF09763,PF15277:PF11707:PF16201:PF06202:PF14702,8,15,7,1,8,1002,0.47,0.99,0.88,0.64,0,0,8,0,1010,0,0.99,0.0,0
PF01534,PF01392:PF06121:PF06482:PF12330:PF14240,8,36,6,2,30,980,0.17,0.97,0.75,0.34,3,2,6,1,1009,0.67,0.99,0.25,0.41
PF15521,PF09011:PF09815:PF00195:PF00033:PF03087,0,54,0,0,54,964,0.0,0.95,0,0,4,0,0,4,1014,0.0,1.0,0,0
PF00591,PF07831:PF02885:PF08125:PF05683:PF01232,5,17,5,0,12,1001,0.29,0.99,1.0,0.54,2,0,5,2,1011,0.0,0.99,0.0,-0.0
PF03611,PF02302:PF00874:PF02909:PF01047:PF08659,2,54,1,1,53,963,0.02,0.95,0.5,0.09,3,0,2,3,1013,0.0,1.0,0.0,-0.0
PF09204,PF10106:PF15212:PF05115:PF03888:PF08497,1,3,0,1,3,1014,0.0,1.0,0.0,-0.0,0,0,1,0,1017,0,1.0,0.0,0
PF01624,PF05188:PF05192:PF05190:PF00488:PF01541,28,56,28,0,28,962,0.5,0.97,1.0,0.7,25,24,4,1,989,0.96,1.0,0.86,0.9
PF04258,PF02225:PF01532:PF04389:PF03441:PF01757,24,106,18,6,88,906,0.17,0.91,0.75,0.33,19,8,16,11,983,0.42,0.97,0.33,0.36
PF04643,PF00323:PF04644:PF02740:PF00879:PF05436,2,3,1,1,2,1014,0.33,1.0,0.5,0.41,0,0,2,0,1016,0,1.0,0.0,0
PF04945,PF13296:PF04963:PF05513:PF15518:PF16967,1,3,0,1,3,1014,0.0,1.0,0.0,-0.0,0,0,1,0,1017,0,1.0,0.0,0
PF02585,PF10183:PF07722:PF01632:PF10252:PF00213,13,30,6,7,24,981,0.2,0.97,0.46,0.29,1,0,13,1,1004,0.0,0.99,0.0,-0.0
PF16824,PF16822:PF08497:PF09498:PF07505:PF06082,0,0,0,0,0,1018,0,1.0,0,0,0,0,0,0,1018,0,1.0,0,0
PF15279,PF14909:PF09816:PF04087:PF05508:PF04109,0,16,0,0,16,1002,0.0,0.98,0,0,2,0,0,2,1016,0.0,1.0,0,0
PF12532,PF01339:PF12431:PF07695:PF08667:PF12010,0,6,0,0,6,1012,0.0,0.99,0,0,1,0,0,1,1017,0.0,1.0,0,0
PF15789,PF11765:PF16047:PF04680:PF08023:PF08248,0,2,0,0,2,1016,0.0,1.0,0,0,0,0,0,0,1018,0,1.0,0,0
PF05811,PF10195:PF14989:PF06080:PF03612:PF15011,4,16,2,2,14,1000,0.12,0.98,0.5,0.24,0,0,4,0,1014,0,1.0,0.0,0
PF06479,PF14593:PF12063:PF11629:PF12179:PF08311,10,16,4,6,12,996,0.25,0.98,0.4,0.31,3,3,7,0,1008,1.0,0.99,0.3,0.55
PF02076,PF08618:PF04934:PF07798:PF04729:PF02234,4,32,0,4,32,982,0.0,0.96,0.0,-0.01,1,0,4,1,1013,0.0,1.0,0.0,-0.0
PF02425,PF17078:PF15553:PF05874:PF15052:PF15762,0,5,0,0,5,1013,0.0,1.0,0,0,0,0,0,0,1018,0,1.0,0,0
PF06009,PF06008:PF00055:PF00054:PF02210:PF16469,2,54,2,0,52,964,0.04,0.95,1.0,0.19,8,2,0,6,1010,0.25,0.99,1.0,0.5
PF12308,PF02191:PF12287:PF02449:PF03644:PF14764,2,35,1,1,34,982,0.03,0.97,0.5,0.11,0,0,2,0,1016,0,1.0,0.0,0
PF15305,PF02427:PF06271:PF06581:PF02448:PF00127,2,5,0,2,5,1011,0.0,0.99,0.0,-0.0,0,0,2,0,1016,0,1.0,0.0,0
PF00480,PF02350:PF17167:PF08303:PF16875:PF09511,10,15,1,9,14,994,0.07,0.98,0.1,0.07,1,0,10,1,1007,0.0,0.99,0.0,-0.0
PF13205,PF07494:PF10566:PF06798:PF06744:PF03729,3,1,0,3,1,1014,0.0,1.0,0.0,-0.0,0,0,3,0,1015,0,1.0,0.0,0
PF03810,PF08767:PF03378:PF08389:PF13001:PF11865,48,54,31,17,23,947,0.57,0.96,0.65,0.59,6,6,42,0,970,1.0,0.96,0.12,0.35
PF12398,PF11883:PF08917:PF08276:PF06760:PF00757,4,26,4,0,22,992,0.15,0.98,1.0,0.39,2,2,2,0,1014,1.0,1.0,0.5,0.71
PF02383,PF08952:PF03372:PF12456:PF07092:PF04031,35,77,22,13,55,928,0.29,0.93,0.63,0.39,6,6,29,0,983,1.0,0.97,0.17,0.41
PF03230,PF04964:PF08105:PF01674:PF01459:PF11033,0,19,0,0,19,999,0.0,0.98,0,0,0,0,0,0,1018,0,1.0,0,0
PF08071,PF16121:PF00900:PF17136:PF01777:PF00467,14,35,12,2,23,981,0.34,0.98,0.86,0.53,8,6,8,2,1002,0.75,0.99,0.43,0.56
PF11577,PF16574:PF09762:PF17045:PF16830:PF15368,4,4,0,4,4,1010,0.0,0.99,0.0,-0.0,0,0,4,0,1014,0,1.0,0.0,0
PF01562,PF00200:PF16698:PF01421:PF05986:PF08516,32,45,31,1,14,972,0.69,0.99,0.97,0.81,20,16,16,4,982,0.8,0.98,0.5,0.62
PF02089,PF02284:PF01198:PF05724:PF07065:PF00143,12,41,7,5,34,972,0.17,0.96,0.58,0.3,2,0,12,2,1004,0.0,0.99,0.0,-0.0
PF05838,PF09951:PF06505:PF04355:PF01752:PF00669,0,3,0,0,3,1015,0.0,1.0,0,0,0,0,0,0,1018,0,1.0,0,0
PF04185,PF03647:PF03358:PF07816:PF00436:PF09335,15,53,7,8,46,957,0.13,0.95,0.47,0.23,4,1,14,3,1000,0.25,0.98,0.07,0.12
PF02005,PF06881:PF02586:PF09425:PF09924:PF08552,10,29,4,6,25,983,0.14,0.97,0.4,0.22,1,0,10,1,1007,0.0,0.99,0.0,-0.0
PF03493,PF03520:PF16519:PF11404:PF11956:PF07885,11,68,10,1,58,949,0.15,0.94,0.91,0.35,4,2,9,2,1005,0.5,0.99,0.18,0.3
PF01048,PF17107:PF13374:PF06985:PF07819:PF00931,30,144,26,4,118,870,0.18,0.88,0.87,0.36,26,17,13,9,979,0.65,0.98,0.57,0.6
PF04578,PF13968:PF07731:PF01757:PF01301:PF00251,16,102,16,0,86,916,0.16,0.92,1.0,0.38,15,8,8,7,995,0.53,0.99,0.5,0.51
PF13542,PF00669:PF17164:PF04392:PF06805:PF05488,0,3,0,0,3,1015,0.0,1.0,0,0,0,0,0,0,1018,0,1.0,0,0
PF15865,PF03511:PF12612:PF12530:PF15979:PF10493,0,24,0,0,24,994,0.0,0.98,0,0,2,0,0,2,1016,0.0,1.0,0,0
PF02758,PF14484:PF13553:PF02760:PF00619:PF13355,9,35,7,2,28,981,0.2,0.97,0.78,0.39,2,2,7,0,1009,1.0,0.99,0.22,0.47
PF10988,PF13722:PF06890:PF05488:PF06798:PF02211,0,3,0,0,3,1015,0.0,1.0,0,0,0,0,0,0,1018,0,1.0,0,0
PF01590,PF00233:PF00360:PF00989:PF08446:PF00512,35,79,33,2,46,937,0.42,0.95,0.94,0.61,12,12,23,0,983,1.0,0.98,0.34,0.58
PF16488,PF16487:PF02171:PF16486:PF05831:PF08699,31,55,31,0,24,963,0.56,0.98,1.0,0.74,31,29,2,2,985,0.94,1.0,0.94,0.93
PF09686,PF15168:PF04384:PF12255:PF13482:PF05947,0,4,0,0,4,1014,0.0,1.0,0,0,0,0,0,0,1018,0,1.0,0,0
PF15135,PF15207:PF15175:PF03238:PF03553:PF00796,1,2,0,1,2,1015,0.0,1.0,0.0,-0.0,0,0,1,0,1017,0,1.0,0.0,0
PF02578,PF01669:PF12153:PF02070:PF08334:PF07559,2,3,0,2,3,1013,0.0,1.0,0.0,-0.0,0,0,2,0,1016,0,1.0,0.0,0
PF08544,PF10509:PF00288:PF07959:PF05038:PF01676,35,50,33,2,17,966,0.66,0.98,0.94,0.78,4,4,31,0,983,1.0,0.97,0.11,0.33
PF11316,PF08707:PF09677:PF12477:PF03592:PF11751,0,1,0,0,1,1017,0.0,1.0,0,0,0,0,0,0,1018,0,1.0,0,0
PF00517,PF12600:PF15073:PF04428:PF15093:PF07263,5,6,0,5,6,1007,0.0,0.99,0.0,-0.01,0,0,5,0,1013,0,1.0,0.0,0
PF08140,PF03769:PF17054:PF12853:PF03768:PF06449,1,16,0,1,16,1001,0.0,0.98,0.0,-0.0,0,0,1,0,1017,0,1.0,0.0,0
PF15006,PF06907:PF08656:PF03488:PF15053:PF14972,4,7,2,2,5,1009,0.29,0.99,0.5,0.37,0,0,4,0,1014,0,1.0,0.0,0
PF16126,PF14307:PF08762:PF04196:PF08275:PF08706,1,12,0,1,12,1005,0.0,0.99,0.0,-0.0,0,0,1,0,1017,0,1.0,0.0,0
PF09202,PF12169:PF15862:PF11331:PF15678:PF08578,10,10,3,7,7,1001,0.3,0.99,0.3,0.29,0,0,10,0,1008,0,0.99,0.0,0
PF14887,PF13775:PF09667:PF12336:PF08347:PF12067,7,6,2,5,4,1007,0.33,0.99,0.29,0.3,0,0,7,0,1011,0,0.99,0.0,0
PF04370,PF15621:PF08291:PF06724:PF12628:PF15482,0,0,0,0,0,1018,0,1.0,0,0,0,0,0,0,1018,0,1.0,0,0
PF00798,PF15608:PF02211:PF01668:PF08497:PF11876,2,5,0,2,5,1011,0.0,0.99,0.0,-0.0,0,0,2,0,1016,0,1.0,0.0,0
PF15357,PF04754:PF14539:PF15041:PF15480:PF04911,0,3,0,0,3,1015,0.0,1.0,0,0,1,0,0,1,1017,0.0,1.0,0,0
PF09684,PF06082:PF06070:PF03729:PF05939:PF01580,1,6,0,1,6,1011,0.0,0.99,0.0,-0.0,0,0,1,0,1017,0,1.0,0.0,0
PF03766,PF12590:PF06298:PF02224:PF05196:PF02751,1,20,0,1,20,997,0.0,0.98,0.0,-0.0,0,0,1,0,1017,0,1.0,0.0,0
PF08529,PF13184:PF08206:PF09876:PF09371:PF14878,4,17,4,0,13,1001,0.24,0.99,1.0,0.48,1,1,3,0,1014,1.0,1.0,0.25,0.5
PF02558,PF08546:PF00120:PF04572:PF02772:PF10355,27,41,22,5,19,972,0.54,0.98,0.81,0.65,3,3,24,0,991,1.0,0.98,0.11,0.33
PF00791,PF00531:PF09034:PF17217:PF01335:PF11957,14,43,11,3,32,972,0.26,0.97,0.79,0.44,4,3,11,1,1003,0.75,0.99,0.21,0.4
PF00892,PF13127:PF00891:PF05652:PF04646:PF08100,35,42,13,22,29,954,0.31,0.95,0.37,0.31,3,2,33,1,982,0.67,0.97,0.06,0.19
PF03963,PF07559:PF06429:PF07499:PF13588:PF08411,1,7,1,0,6,1011,0.14,0.99,1.0,0.38,0,0,1,0,1017,0,1.0,0.0,0
PF07263,PF15427:PF12264:PF04428:PF12255:PF08762,0,8,0,0,8,1010,0.0,0.99,0,0,0,0,0,0,1018,0,1.0,0,0
PF02449,PF09822:PF14764:PF16401:PF10022:PF03945,11,20,4,7,16,991,0.2,0.98,0.36,0.26,0,0,11,0,1007,0,0.99,0.0,0
PF08083,PF08084:PF08082:PF12134:PF10596:PF10598,13,18,13,0,5,1000,0.72,1.0,1.0,0.85,13,13,0,0,1005,1.0,1.0,1.0,1.0
PF00782,PF14671:PF05631:PF01416:PF06617:PF12368,74,35,20,54,15,929,0.57,0.93,0.27,0.36,3,3,71,0,944,1.0,0.93,0.04,0.19
PF05756,PF10106:PF15485:PF08744:PF10933:PF08691,0,1,0,0,1,1017,0.0,1.0,0,0,0,0,0,0,1018,0,1.0,0,0
PF09372,PF09310:PF16553:PF15898:PF15487:PF11929,1,7,1,0,6,1011,0.14,0.99,1.0,0.38,1,1,0,0,1017,1.0,1.0,1.0,1.0
PF02670,PF13288:PF08436:PF09328:PF00674:PF17187,11,14,11,0,3,1004,0.79,1.0,1.0,0.89,2,1,10,1,1006,0.5,0.99,0.09,0.21
PF06423,PF03478:PF05827:PF06237:PF05978:PF04083,15,64,10,5,54,949,0.16,0.94,0.67,0.3,3,0,15,3,1000,0.0,0.98,0.0,-0.01
PF15883,PF07240:PF09252:PF00489:PF02393:PF15664,0,1,0,0,1,1017,0.0,1.0,0,0,0,0,0,0,1018,0,1.0,0,0
PF06651,PF03745:PF15482:PF08708:PF12919:PF08795,0,1,0,0,1,1017,0.0,1.0,0,0,0,0,0,0,1018,0,1.0,0,0
PF10537,PF15612:PF15613:PF02791:PF12157:PF17105,11,30,11,0,19,988,0.37,0.98,1.0,0.6,10,6,5,4,1003,0.6,0.99,0.55,0.57
PF10330,PF06420:PF11489:PF03596:PF08508:PF10104,2,11,0,2,11,1005,0.0,0.99,0.0,-0.0,0,0,2,0,1016,0,1.0,0.0,0
PF12461,PF11975:PF15272:PF01706:PF01364:PF12603,0,12,0,0,12,1006,0.0,0.99,0,0,0,0,0,0,1018,0,1.0,0,0
PF00074,PF02422:PF05498:PF06404:PF07172:PF06206,2,12,1,1,11,1005,0.08,0.99,0.5,0.2,0,0,2,0,1016,0,1.0,0.0,0
PF01029,PF17125:PF17126:PF01189:PF09446:PF01472,5,38,3,2,35,978,0.08,0.96,0.6,0.21,7,2,3,5,1008,0.29,0.99,0.4,0.33
PF16188,PF01321:PF14826:PF05195:PF15801:PF08644,6,34,6,0,28,984,0.18,0.97,1.0,0.41,4,2,4,2,1010,0.5,0.99,0.33,0.41
PF11970,PF02112:PF08600:PF11710:PF04139:PF07217,3,33,3,0,30,985,0.09,0.97,1.0,0.3,1,0,3,1,1014,0.0,1.0,0.0,-0.0
PF15216,PF15555:PF15107:PF14985:PF15550:PF12724,1,3,0,1,3,1014,0.0,1.0,0.0,-0.0,0,0,1,0,1017,0,1.0,0.0,0
PF04755,PF14547:PF02590:PF07887:PF14159:PF12899,15,15,5,10,10,993,0.33,0.98,0.33,0.32,0,0,15,0,1003,0,0.99,0.0,0
PF05985,PF03900:PF10834:PF07343:PF01288:PF07339,1,22,0,1,22,995,0.0,0.98,0.0,-0.0,0,0,1,0,1017,0,1.0,0.0,0
PF07301,PF05979:PF04352:PF05229:PF15153:PF15726,0,0,0,0,0,1018,0,1.0,0,0,0,0,0,0,1018,0,1.0,0,0
PF06365,PF15045:PF08528:PF15369:PF04090:PF04988,6,10,3,3,7,1005,0.3,0.99,0.5,0.38,1,0,6,1,1011,0.0,0.99,0.0,-0.0
PF13436,PF13441:PF15419:PF13705:PF06547:PF07576,2,14,2,0,12,1004,0.14,0.99,1.0,0.38,2,2,0,0,1016,1.0,1.0,1.0,1.0
PF14240,PF15491:PF05990:PF15235:PF15395:PF15888,5,1,0,5,1,1012,0.0,0.99,0.0,-0.0,0,0,5,0,1013,0,1.0,0.0,0
PF03331,PF01959:PF02175:PF15377:PF06217:PF02605,1,4,0,1,4,1013,0.0,1.0,0.0,-0.0,0,0,1,0,1017,0,1.0,0.0,0
PF04355,PF02565:PF10109:PF17014:PF07157:PF04451,0,1,0,0,1,1017,0.0,1.0,0,0,0,0,0,0,1018,0,1.0,0,0
PF02272,PF01411:PF07973:PF01695:PF14577:PF12566,16,41,11,5,30,972,0.27,0.97,0.69,0.42,5,3,13,2,1000,0.6,0.99,0.19,0.33
PF04533,PF04311:PF08213:PF01142:PF15375:PF15470,0,22,0,0,22,996,0.0,0.98,0,0,0,0,0,0,1018,0,1.0,0,0
PF11030,PF02632:PF14760:PF05416:PF01668:PF08761,0,11,0,0,11,1007,0.0,0.99,0,0,0,0,0,0,1018,0,1.0,0,0
PF13281,PF14593:PF12202:PF11629:PF08311:PF16797,7,17,4,3,13,998,0.24,0.98,0.57,0.36,3,3,4,0,1011,1.0,1.0,0.43,0.65
PF15108,PF01943:PF15483:PF05326:PF16836:PF07495,2,2,0,2,2,1014,0.0,1.0,0.0,-0.0,0,0,2,0,1016,0,1.0,0.0,0
PF07755,PF17083:PF02313:PF10612:PF17009:PF05130,0,1,0,0,1,1017,0.0,1.0,0,0,0,0,0,0,1018,0,1.0,0,0
PF10608,PF10600:PF09058:PF09007:PF04629:PF09060,1,10,1,0,9,1008,0.1,0.99,1.0,0.31,1,1,0,0,1017,1.0,1.0,1.0,1.0
PF06566,PF06567:PF10630:PF15622:PF15064:PF15467,1,3,1,0,2,1015,0.33,1.0,1.0,0.58,0,0,1,0,1017,0,1.0,0.0,0
PF05919,PF09216:PF15062:PF06695:PF11341:PF09690,2,2,0,2,2,1014,0.0,1.0,0.0,-0.0,0,0,2,0,1016,0,1.0,0.0,0
PF01180,PF16020:PF14721:PF00310:PF14691:PF07992,22,90,13,9,77,919,0.14,0.92,0.59,0.26,7,1,21,6,990,0.14,0.97,0.05,0.07
PF11597,PF06333:PF15927:PF08167:PF15950:PF04118,5,20,5,0,15,998,0.25,0.99,1.0,0.5,1,1,4,0,1013,1.0,1.0,0.2,0.45
PF00899,PF16420:PF10585:PF08825:PF16190:PF14732,57,19,19,38,0,961,1.0,0.96,0.33,0.57,2,2,55,0,961,1.0,0.95,0.04,0.18
PF14985,PF00770:PF05754:PF15216:PF15680:PF02972,2,2,0,2,2,1014,0.0,1.0,0.0,-0.0,0,0,2,0,1016,0,1.0,0.0,0
PF07377,PF06674:PF05280:PF14882:PF13247:PF06070,3,5,3,0,2,1013,0.6,1.0,1.0,0.77,0,0,3,0,1015,0,1.0,0.0,0
PF16740,PF11703:PF15703:PF15672:PF11321:PF01959,4,4,1,3,3,1011,0.25,0.99,0.25,0.25,0,0,4,0,1014,0,1.0,0.0,0
PF01171,PF00266:PF10288:PF06041:PF16503:PF03473,20,64,13,7,51,947,0.2,0.94,0.65,0.34,5,4,16,1,997,0.8,0.98,0.2,0.4
PF02196,PF09128:PF13543:PF06395:PF16646:PF08833,12,14,4,8,10,996,0.29,0.98,0.33,0.3,0,0,12,0,1006,0,0.99,0.0,0
PF06407,PF06890:PF05359:PF12080:PF09074:PF13750,0,0,0,0,0,1018,0,1.0,0,0,0,0,0,0,1018,0,1.0,0,0
PF08037,PF07888:PF15501:PF14973:PF10212:PF05781,1,13,0,1,13,1004,0.0,0.99,0.0,-0.0,1,0,1,1,1016,0.0,1.0,0.0,-0.0
PF10188,PF09816:PF10332:PF15929:PF01868:PF13002,0,18,0,0,18,1000,0.0,0.98,0,0,0,0,0,0,1018,0,1.0,0,0
PF03479,PF04934:PF07052:PF02234:PF15991:PF04714,6,32,3,3,29,983,0.09,0.97,0.5,0.21,0,0,6,0,1012,0,0.99,0.0,0
PF15925,PF12625:PF06983:PF17192:PF03882:PF04119,1,7,0,1,7,1010,0.0,0.99,0.0,-0.0,0,0,1,0,1017,0,1.0,0.0,0
PF03268,PF15556:PF01947:PF15838:PF17032:PF15550,0,0,0,0,0,1018,0,1.0,0,0,0,0,0,0,1018,0,1.0,0,0
PF15007,PF05841:PF15241:PF13810:PF03235:PF12443,0,5,0,0,5,1013,0.0,1.0,0,0,0,0,0,0,1018,0,1.0,0,0
PF11116,PF05202:PF04671:PF16325:PF16997:PF03241,0,2,0,0,2,1016,0.0,1.0,0,0,0,0,0,0,1018,0,1.0,0,0
PF00392,PF07702:PF07729:PF07706:PF09029:PF10797,19,20,17,2,3,996,0.85,1.0,0.89,0.87,1,1,18,0,999,1.0,0.98,0.05,0.23
PF05617,PF02519:PF02681:PF04535:PF00197:PF10604,3,30,2,1,28,987,0.07,0.97,0.67,0.2,1,0,3,1,1014,0.0,1.0,0.0,-0.0
PF00115,PF00119:PF00124:PF00507:PF00499:PF00430,17,17,10,7,7,994,0.59,0.99,0.59,0.58,1,1,16,0,1001,1.0,0.98,0.06,0.24
PF04586,PF07016:PF08274:PF11863:PF04717:PF17206,1,1,0,1,1,1016,0.0,1.0,0.0,-0.0,0,0,1,0,1017,0,1.0,0.0,0
PF09692,PF01878:PF08228:PF15245:PF13933:PF11282,1,13,1,0,12,1005,0.08,0.99,1.0,0.28,0,0,1,0,1017,0,1.0,0.0,0
PF01160,PF15346:PF13092:PF15344:PF17043:PF09443,1,9,0,1,9,1008,0.0,0.99,0.0,-0.0,1,0,1,1,1016,0.0,1.0,0.0,-0.0
PF09697,PF15141:PF05151:PF15758:PF14534:PF11493,0,0,0,0,0,1018,0,1.0,0,0,0,0,0,0,1018,0,1.0,0,0
PF03893,PF01098:PF01225:PF03734:PF07109:PF05128,4,22,1,3,21,993,0.05,0.98,0.25,0.1,0,0,4,0,1014,0,1.0,0.0,0
PF02486,PF04451:PF04355:PF08707:PF06626:PF08334,2,4,0,2,4,1012,0.0,0.99,0.0,-0.0,0,0,2,0,1016,0,1.0,0.0,0
PF12063,PF11629:PF14593:PF12202:PF12179:PF08311,9,17,3,6,14,995,0.18,0.98,0.33,0.23,3,2,7,1,1008,0.67,0.99,0.22,0.38
PF04473,PF03234:PF03326:PF09311:PF05928:PF03049,0,13,0,0,13,1005,0.0,0.99,0,0,0,0,0,0,1018,0,1.0,0,0
PF06276,PF04183:PF11693:PF14232:PF14231:PF08657,2,6,2,0,4,1012,0.33,1.0,1.0,0.58,0,0,2,0,1016,0,1.0,0.0,0
PF12544,PF05707:PF17206:PF14328:PF11130:PF15633,0,1,0,0,1,1017,0.0,1.0,0,0,0,0,0,0,1018,0,1.0,0,0
PF16090,PF09667:PF13775:PF12444:PF08517:PF08347,4,8,1,3,7,1007,0.12,0.99,0.25,0.17,0,0,4,0,1014,0,1.0,0.0,0
PF10521,PF12627:PF06414:PF13735:PF01103:PF17043,10,39,5,5,34,974,0.13,0.96,0.5,0.24,0,0,10,0,1008,0,0.99,0.0,0
PF02112,PF11970:PF07217:PF11885:PF09729:PF07967,4,23,1,3,22,992,0.04,0.98,0.25,0.1,5,1,3,4,1010,0.2,0.99,0.25,0.22
PF07706,PF09029:PF00392:PF10797:PF15925:PF12625,2,21,1,1,20,996,0.05,0.98,0.5,0.15,1,1,1,0,1016,1.0,1.0,0.5,0.71
PF03819,PF15809:PF00770:PF08040:PF15186:PF08591,1,3,0,1,3,1014,0.0,1.0,0.0,-0.0,0,0,1,0,1017,0,1.0,0.0,0
PF00032,PF03980:PF08561:PF01185:PF04106:PF01097,11,28,3,8,25,982,0.11,0.97,0.27,0.16,1,0,11,1,1006,0.0,0.99,0.0,-0.0
PF09618,PF14982:PF07505:PF10514:PF05969:PF15322,1,0,0,1,0,1017,0,1.0,0.0,0,0,0,1,0,1017,0,1.0,0.0,0
PF02916,PF11604:PF09093:PF07916:PF10279:PF12255,1,1,0,1,1,1016,0.0,1.0,0.0,-0.0,0,0,1,0,1017,0,1.0,0.0,0
PF07376,PF02659:PF10281:PF02913:PF01565:PF03283,0,113,0,0,113,905,0.0,0.89,0,0,10,0,0,10,1008,0.0,0.99,0,0
PF14748,PF03807:PF11221:PF01619:PF01794:PF08022,6,60,6,0,54,958,0.1,0.95,1.0,0.31,13,3,3,10,1002,0.23,0.99,0.5,0.33
PF12682,PF15097:PF07209:PF17006:PF12805:PF12873,1,2,0,1,2,1015,0.0,1.0,0.0,-0.0,0,0,1,0,1017,0,1.0,0.0,0
PF01189,PF17125:PF01029:PF01472:PF16198:PF09446,28,29,15,13,14,976,0.52,0.97,0.54,0.51,3,3,25,0,990,1.0,0.98,0.11,0.32
PF01062,PF03619:PF05653:PF02423:PF08613:PF05730,26,67,14,12,53,939,0.21,0.94,0.54,0.31,7,3,23,4,988,0.43,0.97,0.12,0.21
PF13925,PF09453:PF15512:PF08232:PF08614:PF14077,6,26,4,2,22,990,0.15,0.98,0.67,0.31,2,1,5,1,1011,0.5,0.99,0.17,0.29
PF00498,PF15308:PF13325:PF15276:PF12423:PF16508,82,26,24,58,2,934,0.92,0.94,0.29,0.5,2,2,80,0,936,1.0,0.92,0.02,0.15
PF00816,PF07476:PF07149:PF08310:PF07494:PF14882,1,2,0,1,2,1015,0.0,1.0,0.0,-0.0,0,0,1,0,1017,0,1.0,0.0,0
PF02157,PF15502:PF13826:PF15462:PF06907:PF14936,7,3,0,7,3,1008,0.0,0.99,0.0,-0.0,0,0,7,0,1011,0,0.99,0.0,0
PF15880,PF00737:PF07281:PF00537:PF15559:PF15172,3,7,0,3,7,1008,0.0,0.99,0.0,-0.0,0,0,3,0,1015,0,1.0,0.0,0
PF10419,PF02234:PF04908:PF07200:PF03647:PF01126,7,40,3,4,37,974,0.07,0.96,0.43,0.17,3,1,6,2,1009,0.33,0.99,0.14,0.21
PF00324,PF03522:PF08403:PF13520:PF07875:PF08216,50,85,32,18,53,915,0.38,0.93,0.64,0.46,2,2,48,0,968,1.0,0.95,0.04,0.2
PF00474,PF01545:PF00884:PF05971:PF02517:PF00282,39,108,21,18,87,892,0.19,0.9,0.54,0.28,14,9,30,5,974,0.64,0.97,0.23,0.37
PF11640,PF15785:PF08163:PF11522:PF08064:PF14621,5,25,3,2,22,991,0.12,0.98,0.6,0.26,3,2,3,1,1012,0.67,1.0,0.4,0.51
PF03392,PF08122:PF00965:PF06083:PF04527:PF04176,2,18,0,2,18,998,0.0,0.98,0.0,-0.01,0,0,2,0,1016,0,1.0,0.0,0
PF02931,PF02932:PF04406:PF06237:PF08007:PF07786,78,85,67,11,18,922,0.79,0.97,0.86,0.81,6,6,72,0,940,1.0,0.93,0.08,0.27
PF02668,PF10609:PF05141:PF06155:PF01883:PF13419,38,80,19,19,61,919,0.24,0.92,0.5,0.31,8,7,31,1,979,0.88,0.97,0.18,0.39
PF09320,PF09350:PF12572:PF00684:PF14901:PF07743,12,30,5,7,25,981,0.17,0.97,0.42,0.25,1,1,11,0,1006,1.0,0.99,0.08,0.29
PF07443,PF13892:PF09111:PF09110:PF15790:PF08658,5,24,4,1,20,993,0.17,0.98,0.8,0.36,11,4,1,7,1006,0.36,0.99,0.8,0.54
PF06089,PF02604:PF02767:PF07419:PF02768:PF12503,8,11,1,7,10,1000,0.09,0.98,0.12,0.1,1,0,8,1,1009,0.0,0.99,0.0,-0.0
PF15156,PF17061:PF16001:PF06952:PF15814:PF15952,1,1,0,1,1,1016,0.0,1.0,0.0,-0.0,0,0,1,0,1017,0,1.0,0.0,0
PF10493,PF08696:PF07539:PF17034:PF15027:PF02368,4,24,3,1,21,993,0.12,0.98,0.75,0.3,2,2,2,0,1014,1.0,1.0,0.5,0.71
PF00690,PF16209:PF00689:PF12515:PF12409:PF00122,63,114,62,1,52,903,0.54,0.95,0.98,0.71,27,25,38,2,953,0.93,0.96,0.4,0.59
PF01475,PF15483:PF15976:PF13247:PF17206:PF08334,4,3,0,4,3,1011,0.0,0.99,0.0,-0.0,0,0,4,0,1014,0,1.0,0.0,0
PF00841,PF04892:PF15775:PF03739:PF05135:PF15756,1,6,0,1,6,1011,0.0,0.99,0.0,-0.0,0,0,1,0,1017,0,1.0,0.0,0
PF08713,PF04691:PF08040:PF15055:PF02950:PF02393,0,3,0,0,3,1015,0.0,1.0,0,0,0,0,0,0,1018,0,1.0,0,0
PF05235,PF10412:PF04264:PF15128:PF03065:PF15206,0,1,0,0,1,1017,0.0,1.0,0,0,0,0,0,0,1018,0,1.0,0,0
PF04376,PF04377:PF16978:PF08068:PF08567:PF12701,7,33,6,1,27,984,0.18,0.97,0.86,0.39,3,2,5,1,1010,0.67,0.99,0.29,0.43
PF08098,PF03891:PF03898:PF08278:PF06224:PF07073,1,4,0,1,4,1013,0.0,1.0,0.0,-0.0,0,0,1,0,1017,0,1.0,0.0,0
PF12533,PF01586:PF09427:PF15372:PF07527:PF12232,3,9,1,2,8,1007,0.11,0.99,0.33,0.19,2,1,2,1,1014,0.5,1.0,0.33,0.41
PF07475,PF09432:PF10279:PF03729:PF05299:PF03613,4,0,0,4,0,1014,0,1.0,0.0,0,0,0,4,0,1014,0,1.0,0.0,0
PF08580,PF04988:PF16043:PF12606:PF10361:PF06637,2,7,0,2,7,1009,0.0,0.99,0.0,-0.0,0,0,2,0,1016,0,1.0,0.0,0
PF13576,PF08744:PF10933:PF11988:PF15997:PF02016,0,6,0,0,6,1012,0.0,0.99,0,0,0,0,0,0,1018,0,1.0,0,0
PF13787,PF04911:PF03548:PF04392:PF15976:PF14113,0,6,0,0,6,1012,0.0,0.99,0,0,0,0,0,0,1018,0,1.0,0,0
PF17210,PF00746:PF00526:PF14910:PF15489:PF14961,6,6,0,6,6,1006,0.0,0.99,0.0,-0.01,0,0,6,0,1012,0,0.99,0.0,0
PF08242,PF00109:PF14765:PF08659:PF16073:PF02801,37,64,28,9,36,945,0.44,0.96,0.76,0.56,45,24,13,21,960,0.53,0.97,0.65,0.57
PF07106,PF00159:PF10780:PF04667:PF09631:PF16906,7,26,4,3,22,989,0.15,0.98,0.57,0.29,1,0,7,1,1010,0.0,0.99,0.0,-0.0
PF12925,PF02177:PF10515:PF03494:PF12924:PF14816,8,15,8,0,7,1003,0.53,0.99,1.0,0.73,8,8,0,0,1010,1.0,1.0,1.0,1.0
PF10451,PF02938:PF09170:PF09924:PF01336:PF08784,1,56,0,1,56,961,0.0,0.94,0.0,-0.01,4,0,1,4,1013,0.0,1.0,0.0,-0.0
PF01462,PF01463:PF12534:PF11921:PF13855:PF13306,8,154,8,0,146,864,0.05,0.86,1.0,0.21,7,6,2,1,1009,0.86,1.0,0.75,0.8
PF04151,PF14841:PF08795:PF15312:PF00555:PF11593,0,5,0,0,5,1013,0.0,1.0,0,0,0,0,0,0,1018,0,1.0,0,0
PF01579,PF15002:PF10325:PF10328:PF03383:PF04184,5,28,1,4,27,986,0.04,0.97,0.2,0.07,0,0,5,0,1013,0,1.0,0.0,0
PF10863,PF15776:PF15143:PF15135:PF15207:PF03238,0,4,0,0,4,1014,0.0,1.0,0,0,0,0,0,0,1018,0,1.0,0,0
PF16878,PF00157:PF03792:PF13293:PF02183:PF12284,14,10,4,10,6,998,0.4,0.98,0.29,0.33,3,2,12,1,1003,0.67,0.99,0.14,0.3
PF06679,PF04736:PF00726:PF15724:PF06954:PF03488,0,3,0,0,3,1015,0.0,1.0,0,0,0,0,0,0,1018,0,1.0,0,0
PF04565,PF04561:PF00562:PF10385:PF04567:PF04563,19,27,18,1,9,990,0.67,0.99,0.95,0.79,13,13,6,0,999,1.0,0.99,0.68,0.82
PF01657,PF14380:PF01476:PF14786:PF08515:PF08276,22,57,11,11,46,950,0.19,0.94,0.5,0.29,5,4,18,1,995,0.8,0.98,0.18,0.38
PF02788,PF00016:PF01328:PF16401:PF00928:PF02244,2,61,2,0,59,957,0.03,0.94,1.0,0.18,6,0,2,6,1010,0.0,0.99,0.0,-0.0
PF03790,PF03791:PF12737:PF07526:PF16493:PF05722,1,6,1,0,5,1012,0.17,1.0,1.0,0.41,1,1,0,0,1017,1.0,1.0,1.0,1.0
PF16899,PF02984:PF13825:PF08781:PF15183:PF02777,10,62,5,5,57,951,0.08,0.94,0.5,0.18,3,0,10,3,1005,0.0,0.99,0.0,-0.01
PF08116,PF15844:PF07152:PF14092:PF05565:PF05613,0,0,0,0,0,1018,0,1.0,0,0,0,0,0,0,1018,0,1.0,0,0
PF16700,PF15808:PF15898:PF09310:PF16553:PF09372,2,6,1,1,5,1011,0.17,0.99,0.5,0.29,0,0,2,0,1016,0,1.0,0.0,0
PF12507,PF12158:PF15380:PF15832:PF08654:PF15186,1,3,0,1,3,1014,0.0,1.0,0.0,-0.0,0,0,1,0,1017,0,1.0,0.0,0
PF06791,PF14706:PF11471:PF13737:PF16966:PF11317,0,2,0,0,2,1016,0.0,1.0,0,0,0,0,0,0,1018,0,1.0,0,0
PF10637,PF10369:PF00351:PF01842:PF07971:PF16200,7,62,6,1,56,955,0.1,0.94,0.86,0.28,5,1,6,4,1007,0.2,0.99,0.14,0.16
PF15998,PF09756:PF07939:PF09805:PF10276:PF14610,8,17,2,6,15,995,0.12,0.98,0.25,0.16,2,1,7,1,1009,0.5,0.99,0.12,0.25
PF06356,PF06724:PF05939:PF14841:PF12080:PF10995,0,1,0,0,1,1017,0.0,1.0,0,0,0,0,0,0,1018,0,1.0,0,0
PF10192,PF05826:PF01207:PF07528:PF15455:PF04831,8,47,5,3,42,968,0.11,0.96,0.62,0.25,3,1,7,2,1008,0.33,0.99,0.12,0.2
PF10547,PF06699:PF04023:PF03747:PF00617:PF10626,0,58,0,0,58,960,0.0,0.94,0,0,3,0,0,3,1015,0.0,1.0,0,0
PF02079,PF14903:PF10554:PF16861:PF16590:PF15214,1,6,0,1,6,1011,0.0,0.99,0.0,-0.0,0,0,1,0,1017,0,1.0,0.0,0
PF11272,PF04963:PF14052:PF17206:PF09826:PF10951,0,2,0,0,2,1016,0.0,1.0,0,0,1,0,0,1,1017,0.0,1.0,0,0
PF04117,PF03556:PF04819:PF07542:PF01513:PF11025,40,33,11,29,22,956,0.33,0.95,0.28,0.28,3,3,37,0,978,1.0,0.96,0.07,0.27
PF08225,PF08187:PF08348:PF17004:PF03839:PF13926,0,17,0,0,17,1001,0.0,0.98,0,0,1,0,0,1,1017,0.0,1.0,0,0
PF05892,PF13330:PF01033:PF01223:PF11743:PF15034,0,36,0,0,36,982,0.0,0.96,0,0,5,0,0,5,1013,0.0,1.0,0,0
PF13254,PF12520:PF12830:PF04811:PF15296:PF07064,2,41,1,1,40,976,0.02,0.96,0.5,0.1,2,0,2,2,1014,0.0,1.0,0.0,-0.0
PF00187,PF00967:PF00182:PF03427:PF08329:PF14856,13,22,8,5,14,991,0.36,0.98,0.62,0.46,1,1,12,0,1005,1.0,0.99,0.08,0.28
PF03473,PF03476:PF00266:PF03475:PF00941:PF00111,16,77,16,0,61,941,0.21,0.94,1.0,0.44,16,9,7,7,995,0.56,0.99,0.56,0.56
PF08776,PF05210:PF00568:PF02205:PF00786:PF15279,10,64,10,0,54,954,0.16,0.95,1.0,0.38,7,5,5,2,1006,0.71,0.99,0.5,0.59
PF10933,PF08744:PF16071:PF08291:PF11223:PF04562,0,1,0,0,1,1017,0.0,1.0,0,0,0,0,0,0,1018,0,1.0,0,0
PF09287,PF01337:PF03883:PF07804:PF09365:PF10073,0,5,0,0,5,1013,0.0,1.0,0,0,0,0,0,0,1018,0,1.0,0,0
PF04941,PF12477:PF09611:PF07610:PF14814:PF16967,2,1,0,2,1,1015,0.0,1.0,0.0,-0.0,0,0,2,0,1016,0,1.0,0.0,0
PF07679,PF07645:PF06582:PF00057:PF14953:PF07474,92,99,51,41,48,878,0.52,0.91,0.55,0.49,5,5,87,0,926,1.0,0.91,0.05,0.22
PF07950,PF12243:PF10785:PF14232:PF03769:PF08140,4,8,0,4,8,1006,0.0,0.99,0.0,-0.01,0,0,4,0,1014,0,1.0,0.0,0
PF12480,PF08729:PF12516:PF12509:PF08123:PF12090,4,17,1,3,16,998,0.06,0.98,0.25,0.11,1,0,4,1,1013,0.0,1.0,0.0,-0.0
PF04567,PF04565:PF04561:PF06883:PF10385:PF14226,12,46,12,0,34,972,0.26,0.97,1.0,0.5,7,4,8,3,1003,0.57,0.99,0.33,0.43
PF15096,PF15623:PF04624:PF00997:PF02501:PF10793,0,3,0,0,3,1015,0.0,1.0,0,0,0,0,0,0,1018,0,1.0,0,0
PF09736,PF15280:PF08624:PF14611:PF10336:PF15862,5,11,0,5,11,1002,0.0,0.98,0.0,-0.01,0,0,5,0,1013,0,1.0,0.0,0
PF07718,PF14806:PF09066:PF08752:PF14796:PF16381,8,21,8,0,13,997,0.38,0.99,1.0,0.61,4,3,5,1,1009,0.75,0.99,0.38,0.53
PF03066,PF00707:PF03479:PF15005:PF08910:PF08746,6,22,2,4,20,992,0.09,0.98,0.33,0.17,1,0,6,1,1011,0.0,0.99,0.0,-0.0
PF01521,PF01025:PF07896:PF07816:PF04800:PF01016,19,34,8,11,26,973,0.24,0.96,0.42,0.3,2,2,17,0,999,1.0,0.98,0.11,0.32
PF15235,PF07891:PF12178:PF01057:PF16756:PF05990,1,4,1,0,3,1014,0.25,1.0,1.0,0.5,0,0,1,0,1017,0,1.0,0.0,0
PF10169,PF15916:PF14803:PF09297:PF09296:PF05026,3,20,2,1,18,997,0.1,0.98,0.67,0.25,3,1,2,2,1013,0.33,1.0,0.33,0.33
PF02560,PF09424:PF12900:PF02195:PF10244:PF14935,5,25,2,3,23,990,0.08,0.97,0.4,0.17,1,1,4,0,1013,1.0,1.0,0.2,0.45
PF06941,PF07298:PF04839:PF15346:PF12263:PF11255,9,6,1,8,5,1004,0.17,0.99,0.11,0.13,0,0,9,0,1009,0,0.99,0.0,0
PF06282,PF17100:PF07736:PF10396:PF13676:PF16095,0,51,0,0,51,967,0.0,0.95,0,0,7,0,0,7,1011,0.0,0.99,0,0
PF02926,PF01170:PF00125:PF04788:PF09995:PF00301,12,56,7,5,49,957,0.12,0.95,0.58,0.25,5,4,8,1,1005,0.8,0.99,0.33,0.51
PF06899,PF14340:PF14452:PF10037:PF04568:PF06624,0,14,0,0,14,1004,0.0,0.99,0,0,0,0,0,0,1018,0,1.0,0,0
PF13943,PF10063:PF14021:PF02575:PF12646:PF16001,4,8,1,3,7,1007,0.12,0.99,0.25,0.17,0,0,4,0,1014,0,1.0,0.0,0
PF14281,PF04881:PF05728:PF15047:PF08194:PF11630,0,5,0,0,5,1013,0.0,1.0,0,0,0,0,0,0,1018,0,1.0,0,0
PF12870,PF15712:PF06890:PF04352:PF01874:PF03589,0,3,0,0,3,1015,0.0,1.0,0,0,0,0,0,0,1018,0,1.0,0,0
PF04504,PF01868:PF13864:PF15311:PF04004:PF07545,8,23,3,5,20,990,0.13,0.98,0.38,0.21,3,1,7,2,1008,0.33,0.99,0.12,0.2
PF02885,PF07831:PF00591:PF05683:PF08125:PF05681,6,16,5,1,11,1001,0.31,0.99,0.83,0.51,0,0,6,0,1012,0,0.99,0.0,0
PF02217,PF06505:PF01752:PF04740:PF11751:PF11863,3,2,0,3,2,1013,0.0,1.0,0.0,-0.0,0,0,3,0,1015,0,1.0,0.0,0
PF07344,PF03242:PF05512:PF09748:PF03386:PF03298,0,17,0,0,17,1001,0.0,0.98,0,0,0,0,0,0,1018,0,1.0,0,0
PF10373,PF09469:PF10374:PF00649:PF16528:PF02732,14,47,12,2,35,969,0.26,0.96,0.86,0.46,3,3,11,0,1004,1.0,0.99,0.21,0.46
PF08600,PF07967:PF03715:PF02112:PF11970:PF11710,5,35,5,0,30,983,0.14,0.97,1.0,0.37,4,1,4,3,1010,0.25,0.99,0.2,0.22
PF06732,PF08914:PF11626:PF09197:PF16589:PF13438,5,28,4,1,24,989,0.14,0.98,0.8,0.33,7,0,5,7,1006,0.0,0.99,0.0,-0.01
PF11769,PF14233:PF14433:PF10962:PF01843:PF00619,0,43,0,0,43,975,0.0,0.96,0,0,0,0,0,0,1018,0,1.0,0,0
PF09939,PF00425:PF00117:PF00958:PF06794:PF00697,0,75,0,0,75,943,0.0,0.93,0,0,3,0,0,3,1015,0.0,1.0,0,0
PF10176,PF15503:PF02427:PF04359:PF06695:PF17056,5,2,0,5,2,1011,0.0,0.99,0.0,-0.0,0,0,5,0,1013,0,1.0,0.0,0
PF01865,PF09738:PF08250:PF05523:PF05633:PF05278,0,7,0,0,7,1011,0.0,0.99,0,0,1,0,0,1,1017,0.0,1.0,0,0
PF14699,PF06202:PF14701:PF14702:PF05285:PF12530,1,18,1,0,17,1000,0.06,0.98,1.0,0.23,2,0,1,2,1015,0.0,1.0,0.0,-0.0
PF06769,PF02197:PF00621:PF04883:PF04365:PF05872,1,91,0,1,91,926,0.0,0.91,0.0,-0.01,0,0,1,0,1017,0,1.0,0.0,0
PF04296,PF14690:PF13751:PF11245:PF12856:PF06725,0,4,0,0,4,1014,0.0,1.0,0,0,0,0,0,0,1018,0,1.0,0,0
PF01255,PF02089:PF00810:PF02284:PF01791:PF05042,22,37,5,17,32,964,0.14,0.95,0.23,0.15,3,2,20,1,995,0.67,0.98,0.09,0.24
PF10503,PF00457:PF01083:PF03664:PF02015:PF01341,10,24,3,7,21,987,0.12,0.97,0.3,0.18,4,2,8,2,1006,0.5,0.99,0.2,0.31
PF11905,PF03647:PF05859:PF03851:PF04695:PF15311,32,33,12,20,21,965,0.36,0.96,0.38,0.35,4,3,29,1,985,0.75,0.97,0.09,0.26
PF03033,PF13579:PF06925:PF00201:PF09440:PF04101,23,74,19,4,55,940,0.26,0.94,0.83,0.44,4,3,20,1,994,0.75,0.98,0.13,0.31
PF06268,PF06229:PF01087:PF00150:PF00195:PF04862,8,72,6,2,66,944,0.08,0.93,0.75,0.24,6,0,8,6,1004,0.0,0.99,0.0,-0.01
PF15824,PF11863:PF07411:PF06744:PF05109:PF01580,1,5,0,1,5,1012,0.0,0.99,0.0,-0.0,0,0,1,0,1017,0,1.0,0.0,0
PF17046,PF11558:PF17106:PF17111:PF07367:PF17109,5,23,5,0,18,995,0.22,0.98,1.0,0.46,1,1,4,0,1013,1.0,1.0,0.2,0.45
PF06212,PF03853:PF08229:PF01256:PF11711:PF15006,1,36,0,1,36,981,0.0,0.96,0.0,-0.01,0,0,1,0,1017,0,1.0,0.0,0
PF16076,PF14829:PF08806:PF16094:PF17039:PF03951,22,33,14,8,19,977,0.42,0.97,0.64,0.51,3,2,20,1,995,0.67,0.98,0.09,0.24
PF08991,PF14777:PF08398:PF15141:PF09047:PF14886,5,6,3,2,3,1010,0.5,1.0,0.6,0.55,1,1,4,0,1013,1.0,1.0,0.2,0.45
PF12534,PF11921:PF10428:PF01462:PF15904:PF03736,4,17,3,1,14,1000,0.18,0.99,0.75,0.36,1,1,3,0,1014,1.0,1.0,0.25,0.5
PF05928,PF08240:PF00004:PF03106:PF01909:PF01545,0,219,0,0,219,799,0.0,0.78,0,0,31,0,0,31,987,0.0,0.97,0,0
PF06816,PF07684:PF00066:PF16553:PF09372:PF11929,5,14,5,0,9,1004,0.36,0.99,1.0,0.59,1,1,4,0,1013,1.0,1.0,0.2,0.45
PF08209,PF02234:PF02116:PF15247:PF06413:PF11250,10,22,3,7,19,989,0.14,0.97,0.3,0.19,1,0,10,1,1007,0.0,0.99,0.0,-0.0
PF09034,PF11957:PF12721:PF01335:PF10461:PF17217,2,18,1,1,17,999,0.06,0.98,0.5,0.16,3,1,1,2,1014,0.33,1.0,0.5,0.41
PF08167,PF08166:PF11597:PF06333:PF15927:PF09743,5,16,3,2,13,1000,0.19,0.99,0.6,0.33,3,1,4,2,1011,0.33,0.99,0.2,0.26
PF03931,PF01466:PF01725:PF01169:PF00578:PF00828,25,83,22,3,61,932,0.27,0.94,0.88,0.46,9,7,18,2,991,0.78,0.98,0.28,0.46
PF09159,PF07080:PF11909:PF01194:PF09587:PF00489,1,13,0,1,13,1004,0.0,0.99,0.0,-0.0,0,0,1,0,1017,0,1.0,0.0,0
PF10514,PF15085:PF15114:PF15343:PF01303:PF05836,0,2,0,0,2,1016,0.0,1.0,0,0,0,0,0,0,1018,0,1.0,0,0
PF03118,PF01333:PF16639:PF01000:PF00306:PF03951,6,30,4,2,26,986,0.13,0.97,0.67,0.29,3,1,5,2,1010,0.33,0.99,0.17,0.23
PF03872,PF04314:PF15732:PF02830:PF15774:PF04122,1,0,0,1,0,1017,0,1.0,0.0,0,0,0,1,0,1017,0,1.0,0.0,0
PF09383,PF01032:PF08352:PF09821:PF16326:PF12857,2,10,2,0,8,1008,0.2,0.99,1.0,0.45,2,2,0,0,1016,1.0,1.0,1.0,1.0
PF09184,PF09302:PF09816:PF09808:PF08733:PF05182,9,28,0,9,28,981,0.0,0.96,0.0,-0.02,1,0,9,1,1008,0.0,0.99,0.0,-0.0
PF08033,PF04815:PF04811:PF04810:PF00839:PF16182,24,35,24,0,11,983,0.69,0.99,1.0,0.82,22,21,3,1,993,0.95,1.0,0.88,0.91
PF06023,PF06305:PF08317:PF03589:PF10912:PF13400,0,8,0,0,8,1010,0.0,0.99,0,0,0,0,0,0,1018,0,1.0,0,0
PF00313,PF14437:PF12752:PF02337:PF08922:PF07962,38,25,11,27,14,966,0.44,0.96,0.29,0.34,1,1,37,0,980,1.0,0.96,0.03,0.16
PF13236,PF15044:PF12807:PF05303:PF07721:PF13374,11,57,10,1,47,960,0.18,0.95,0.91,0.39,4,4,7,0,1007,1.0,0.99,0.36,0.6
PF02104,PF02284:PF04176:PF04667:PF04716:PF05915,7,28,1,6,27,984,0.04,0.97,0.14,0.06,3,0,7,3,1008,0.0,0.99,0.0,-0.0
PF05131,PF12451:PF17122:PF10366:PF11571:PF04437,5,29,4,1,25,988,0.14,0.97,0.8,0.33,6,2,3,4,1009,0.33,0.99,0.4,0.36
PF07539,PF17034:PF10350:PF02368:PF03190:PF12612,11,31,7,4,24,983,0.23,0.97,0.64,0.37,4,2,9,2,1005,0.5,0.99,0.18,0.3
PF07499,PF06798:PF12080:PF03090:PF11751:PF13722,2,0,0,2,0,1016,0,1.0,0.0,0,0,0,2,0,1016,0,1.0,0.0,0
PF16839,PF05912:PF15724:PF09117:PF06679:PF06377,0,5,0,0,5,1013,0.0,1.0,0,0,0,0,0,0,1018,0,1.0,0,0
PF03256,PF11515:PF10557:PF00888:PF06701:PF16558,16,49,9,7,40,962,0.18,0.95,0.56,0.3,11,5,11,6,996,0.45,0.98,0.31,0.37
PF04801,PF03299:PF06886:PF04000:PF04910:PF12214,14,31,2,12,29,975,0.06,0.96,0.14,0.08,3,0,14,3,1001,0.0,0.98,0.0,-0.01
PF07173,PF12422:PF10189:PF06662:PF15273:PF08161,6,14,3,3,11,1001,0.21,0.99,0.5,0.32,1,1,5,0,1012,1.0,1.0,0.17,0.41
PF00218,PF00697:PF00977:PF04715:PF08252:PF06418,4,42,3,1,39,975,0.07,0.96,0.75,0.22,3,1,3,2,1012,0.33,1.0,0.25,0.29
PF13387,PF03726:PF08083:PF08084:PF08082:PF12134,0,24,0,0,24,994,0.0,0.98,0,0,13,0,0,13,1005,0.0,0.99,0,0
PF05130,PF06621:PF17009:PF12114:PF05236:PF00990,1,27,1,0,26,991,0.04,0.97,1.0,0.19,2,1,0,1,1016,0.5,1.0,1.0,0.71
PF10287,PF10290:PF16173:PF07831:PF12933:PF16116,3,3,1,2,2,1013,0.33,1.0,0.33,0.33,0,0,3,0,1015,0,1.0,0.0,0
PF17216,PF17215:PF13638:PF07504:PF02128:PF15636,9,17,7,2,10,999,0.41,0.99,0.78,0.56,1,1,8,0,1009,1.0,0.99,0.11,0.33
PF00643,PF03915:PF12126:PF13445:PF00622:PF15451,55,100,43,12,57,906,0.43,0.93,0.78,0.55,5,4,51,1,962,0.8,0.95,0.07,0.23
PF10546,PF00970:PF12030:PF04333:PF02424:PF06253,0,40,0,0,40,978,0.0,0.96,0,0,0,0,0,0,1018,0,1.0,0,0
PF14565,PF00714:PF00727:PF06351:PF00489:PF00236,1,9,0,1,9,1008,0.0,0.99,0.0,-0.0,0,0,1,0,1017,0,1.0,0.0,0
PF10158,PF06907:PF15115:PF07448:PF11805:PF15109,5,2,0,5,2,1011,0.0,0.99,0.0,-0.0,0,0,5,0,1013,0,1.0,0.0,0
PF02861,PF02577:PF10431:PF02151:PF07724:PF05362,9,50,9,0,41,968,0.18,0.96,1.0,0.42,8,5,4,3,1006,0.62,0.99,0.56,0.59
PF11707,PF16201:PF15277:PF09763:PF08696:PF11915,2,36,2,0,34,982,0.06,0.97,1.0,0.23,3,0,2,3,1013,0.0,1.0,0.0,-0.0
PF07287,PF14330:PF17132:PF02515:PF07103:PF12735,10,37,6,4,31,977,0.16,0.97,0.6,0.3,2,2,8,0,1008,1.0,0.99,0.2,0.45
PF00994,PF01507:PF03453:PF03454:PF06844:PF02765,36,44,25,11,19,963,0.57,0.97,0.69,0.61,5,5,31,0,982,1.0,0.97,0.14,0.37
PF14968,PF05238:PF15691:PF01387:PF08569:PF00879,2,7,0,2,7,1009,0.0,0.99,0.0,-0.0,0,0,2,0,1016,0,1.0,0.0,0
PF09813,PF00398:PF14828:PF08507:PF12643:PF05197,3,31,3,0,28,987,0.1,0.97,1.0,0.31,1,0,3,1,1014,0.0,1.0,0.0,-0.0
PF13865,PF08081:PF12414:PF12220:PF12923:PF08143,11,18,6,5,12,995,0.33,0.98,0.55,0.42,2,2,9,0,1007,1.0,0.99,0.18,0.42
PF10178,PF06127:PF06644:PF10224:PF01196:PF15454,6,29,4,2,25,987,0.14,0.97,0.67,0.3,2,2,4,0,1012,1.0,1.0,0.33,0.58
PF08262,PF10735:PF10626:PF03826:PF03529:PF02709,0,31,0,0,31,987,0.0,0.97,0,0,1,0,0,1,1017,0.0,1.0,0,0
PF00153,PF13833:PF13499:PF13202:PF00036:PF13405,125,161,65,60,96,797,0.4,0.85,0.52,0.37,42,30,95,12,881,0.71,0.89,0.24,0.37
PF15697,PF06533:PF04618:PF05562:PF09367:PF01228,4,8,1,3,7,1007,0.12,0.99,0.25,0.17,0,0,4,0,1014,0,1.0,0.0,0
PF08442,PF02629:PF00285:PF00549:PF16114:PF06971,16,43,15,1,28,974,0.35,0.97,0.94,0.56,8,5,11,3,999,0.62,0.99,0.31,0.44
PF01306,PF01292:PF14993:PF15212:PF05418:PF15662,0,7,0,0,7,1011,0.0,0.99,0,0,0,0,0,0,1018,0,1.0,0,0
PF03239,PF13741:PF03386:PF07767:PF05129:PF07253,7,21,2,5,19,992,0.1,0.98,0.29,0.16,1,0,7,1,1010,0.0,0.99,0.0,-0.0
PF12273,PF06912:PF12716:PF10224:PF12328:PF06108,10,16,2,8,14,994,0.12,0.98,0.2,0.15,0,0,10,0,1008,0,0.99,0.0,0
PF15964,PF16704:PF04108:PF15908:PF10212:PF15905,0,7,0,0,7,1011,0.0,0.99,0,0,1,0,0,1,1017,0.0,1.0,0,0
PF14868,PF06414:PF10253:PF12018:PF10156:PF10179,0,21,0,0,21,997,0.0,0.98,0,0,2,0,0,2,1016,0.0,1.0,0,0
PF02357,PF12656:PF11942:PF01777:PF17136:PF03439,2,41,1,1,40,976,0.02,0.96,0.5,0.1,4,1,1,3,1013,0.25,1.0,0.5,0.35
PF02020,PF04613:PF02847:PF13720:PF12804:PF06426,32,39,14,18,25,961,0.36,0.96,0.44,0.37,3,3,29,0,986,1.0,0.97,0.09,0.3
PF17172,PF10568:PF10806:PF04092:PF06814:PF09737,6,25,3,3,22,990,0.12,0.98,0.5,0.24,3,2,4,1,1011,0.67,1.0,0.33,0.47
PF13342,PF11304:PF01628:PF04865:PF08479:PF05598,2,4,1,1,3,1013,0.25,1.0,0.5,0.35,0,0,2,0,1016,0,1.0,0.0,0
PF02504,PF14983:PF03406:PF08548:PF13946:PF04932,3,3,0,3,3,1012,0.0,0.99,0.0,-0.0,0,0,3,0,1015,0,1.0,0.0,0
PF00484,PF04178:PF06244:PF00504:PF05916:PF11913,19,55,10,9,45,954,0.18,0.95,0.53,0.29,7,6,13,1,998,0.86,0.99,0.32,0.52
PF12965,PF02557:PF09867:PF05887:PF00555:PF03589,0,5,0,0,5,1013,0.0,1.0,0,0,0,0,0,0,1018,0,1.0,0,0
PF01456,PF10322:PF02420:PF02084:PF15252:PF10325,2,3,0,2,3,1013,0.0,1.0,0.0,-0.0,0,0,2,0,1016,0,1.0,0.0,0
PF05923,PF05924:PF05972:PF05956:PF05937:PF16689,8,9,7,1,2,1008,0.78,1.0,0.88,0.82,3,3,5,0,1010,1.0,1.0,0.38,0.61
PF00977,PF00697:PF04715:PF00425:PF00958:PF00218,16,37,7,9,30,972,0.19,0.96,0.44,0.27,3,2,14,1,1001,0.67,0.99,0.12,0.28
PF14921,PF12470:PF14875:PF04775:PF06535:PF01085,0,14,0,0,14,1004,0.0,0.99,0,0,1,0,0,1,1017,0.0,1.0,0,0
PF12301,PF00272:PF12020:PF06951:PF13841:PF02267,1,14,0,1,14,1003,0.0,0.99,0.0,-0.0,0,0,1,0,1017,0,1.0,0.0,0
PF14252,PF06395:PF15720:PF15441:PF16523:PF03048,5,8,2,3,6,1007,0.25,0.99,0.4,0.31,2,2,3,0,1013,1.0,1.0,0.4,0.63
PF15353,PF04087:PF05178:PF15999:PF15279:PF07222,5,12,1,4,11,1002,0.08,0.99,0.2,0.12,0,0,5,0,1013,0,1.0,0.0,0
PF03710,PF00419:PF02277:PF08964:PF13588:PF06798,3,6,0,3,6,1009,0.0,0.99,0.0,-0.0,0,0,3,0,1015,0,1.0,0.0,0
PF16422,PF16423:PF09271:PF09270:PF03859:PF08337,4,26,3,1,23,991,0.12,0.98,0.75,0.29,3,3,1,0,1014,1.0,1.0,0.75,0.87
PF07732,PF07731:PF00394:PF05691:PF05592:PF13402,51,67,47,4,20,947,0.7,0.98,0.92,0.79,12,11,40,1,966,0.92,0.96,0.22,0.43
PF02706,PF04085:PF02108:PF05065:PF11300:PF07957,1,2,0,1,2,1015,0.0,1.0,0.0,-0.0,0,0,1,0,1017,0,1.0,0.0,0
PF17124,PF07327:PF05355:PF03379:PF09232:PF02950,0,6,0,0,6,1012,0.0,0.99,0,0,0,0,0,0,1018,0,1.0,0,0
PF05485,PF12017:PF12596:PF07776:PF13613:PF14291,59,79,32,27,47,912,0.41,0.93,0.54,0.43,10,10,49,0,959,1.0,0.95,0.17,0.4
PF07460,PF07453:PF01541:PF11793:PF14528:PF00961,12,29,11,1,18,988,0.38,0.98,0.92,0.58,3,2,10,1,1005,0.67,0.99,0.17,0.33
PF14981,PF08334:PF15029:PF12852:PF06745:PF03944,0,5,0,0,5,1013,0.0,1.0,0,0,0,0,0,0,1018,0,1.0,0,0
PF04549,PF08204:PF01114:PF00865:PF02165:PF01386,0,3,0,0,3,1015,0.0,1.0,0,0,0,0,0,0,1018,0,1.0,0,0
PF00683,PF06816:PF00066:PF12661:PF16472:PF00998,7,47,7,0,40,971,0.15,0.96,1.0,0.38,5,3,4,2,1009,0.6,0.99,0.43,0.5
PF16953,PF17177:PF02297:PF12921:PF13812:PF13762,13,72,8,5,64,941,0.11,0.93,0.62,0.24,6,4,9,2,1003,0.67,0.99,0.31,0.45
PF05939,PF06805:PF03428:PF01913:PF06798:PF03090,0,1,0,0,1,1017,0.0,1.0,0,0,0,0,0,0,1018,0,1.0,0,0
PF10161,PF15884:PF11029:PF04402:PF15071:PF00727,1,10,0,1,10,1007,0.0,0.99,0.0,-0.0,1,0,1,1,1016,0.0,1.0,0.0,-0.0
PF04095,PF00472:PF03462:PF11635:PF01702:PF02788,11,53,3,8,50,957,0.06,0.94,0.27,0.1,5,2,9,3,1004,0.4,0.99,0.18,0.26
PF00857,PF14923:PF13499:PF00886:PF00036:PF08726,36,138,26,10,112,870,0.19,0.88,0.72,0.33,7,4,32,3,979,0.57,0.97,0.11,0.24
PF05459,PF12240:PF15934:PF10490:PF16782:PF02108,0,6,0,0,6,1012,0.0,0.99,0,0,0,0,0,0,1018,0,1.0,0,0
PF15271,PF14841:PF15529:PF03241:PF01706:PF08479,0,1,0,0,1,1017,0.0,1.0,0,0,0,0,0,0,1018,0,1.0,0,0
PF00413,PF01471:PF08924:PF00045:PF08007:PF13895,35,59,31,4,28,955,0.53,0.97,0.89,0.67,10,10,25,0,983,1.0,0.98,0.29,0.53
PF00927,PF00868:PF01841:PF04721:PF02836:PF02837,9,40,9,0,31,978,0.23,0.97,1.0,0.47,9,3,6,6,1003,0.33,0.99,0.33,0.33
PF13090,PF02503:PF13089:PF03090:PF02336:PF13722,2,4,2,0,2,1014,0.5,1.0,1.0,0.71,0,0,2,0,1016,0,1.0,0.0,0
PF15709,PF06890:PF17061:PF10856:PF07308:PF15427,0,1,0,0,1,1017,0.0,1.0,0,0,0,0,0,0,1018,0,1.0,0,0
PF01695,PF13269:PF08479:PF12461:PF15518:PF15150,7,1,0,7,1,1010,0.0,0.99,0.0,-0.0,0,0,7,0,1011,0,0.99,0.0,0
PF03832,PF04965:PF13929:PF03729:PF02217:PF01580,4,6,1,3,5,1009,0.17,0.99,0.25,0.2,0,0,4,0,1014,0,1.0,0.0,0
PF01151,PF00048:PF01124:PF12643:PF03690:PF06749,11,35,6,5,29,978,0.17,0.97,0.55,0.29,2,2,9,0,1007,1.0,0.99,0.18,0.42
PF07408,PF04999:PF03746:PF03135:PF06286:PF11412,1,6,0,1,6,1011,0.0,0.99,0.0,-0.0,0,0,1,0,1017,0,1.0,0.0,0
PF12727,PF02522:PF07505:PF03063:PF15199:PF13103,0,7,0,0,7,1011,0.0,0.99,0,0,0,0,0,0,1018,0,1.0,0,0
PF11386,PF05111:PF02429:PF10578:PF12782:PF05914,0,3,0,0,3,1015,0.0,1.0,0,0,0,0,0,0,1018,0,1.0,0,0
PF11466,PF11587:PF08023:PF16047:PF01372:PF08018,0,1,0,0,1,1017,0.0,1.0,0,0,0,0,0,0,1018,0,1.0,0,0
PF05300,PF16954:PF12301:PF02267:PF16860:PF14941,4,10,1,3,9,1005,0.1,0.99,0.25,0.15,0,0,4,0,1014,0,1.0,0.0,0
PF00024,PF08277:PF14295:PF00051:PF09118:PF01453,52,81,36,16,45,921,0.44,0.94,0.69,0.53,12,12,40,0,966,1.0,0.96,0.23,0.47
PF01283,PF06404:PF04690:PF01997:PF07712:PF00272,19,12,4,15,8,991,0.33,0.98,0.21,0.25,0,0,19,0,999,0,0.98,0.0,0
PF00595,PF00625:PF09058:PF06456:PF08687:PF08688,115,51,36,79,15,888,0.71,0.91,0.31,0.43,1,1,114,0,903,1.0,0.89,0.01,0.09
PF15289,PF09991:PF12646:PF13367:PF04681:PF02361,0,11,0,0,11,1007,0.0,0.99,0,0,0,0,0,0,1018,0,1.0,0,0
PF07103,PF02353:PF07287:PF07247:PF02027:PF12928,3,35,2,1,33,982,0.06,0.97,0.67,0.19,4,1,2,3,1012,0.25,1.0,0.33,0.29
PF14028,PF13322:PF03888:PF03428:PF01752:PF01292,0,8,0,0,8,1010,0.0,0.99,0,0,0,0,0,0,1018,0,1.0,0,0
PF01328,PF09949:PF13813:PF02449:PF10022:PF06985,15,82,13,2,69,934,0.16,0.93,0.87,0.35,5,3,12,2,1001,0.6,0.99,0.2,0.34
PF16825,PF10924:PF15485:PF13094:PF04233:PF16071,0,1,0,0,1,1017,0.0,1.0,0,0,0,0,0,0,1018,0,1.0,0,0
PF04556,PF07496:PF04425:PF02008:PF07352:PF10440,2,34,1,1,33,983,0.03,0.97,0.5,0.12,2,0,2,2,1014,0.0,1.0,0.0,-0.0
PF00753,PF16123:PF07521:PF10996:PF12706:PF01613,72,71,35,37,36,910,0.49,0.93,0.49,0.45,12,10,62,2,944,0.83,0.94,0.14,0.32
PF13446,PF14533:PF14836:PF06337:PF12436:PF16674,4,23,2,2,21,993,0.09,0.98,0.5,0.2,5,2,2,3,1011,0.4,1.0,0.5,0.44
PF13808,PF15518:PF14841:PF01706:PF08411:PF07476,2,3,0,2,3,1013,0.0,1.0,0.0,-0.0,0,0,2,0,1016,0,1.0,0.0,0
PF05301,PF15991:PF09756:PF15264:PF12319:PF10217,3,10,1,2,9,1006,0.1,0.99,0.33,0.18,0,0,3,0,1015,0,1.0,0.0,0
PF11054,PF07276:PF06753:PF03778:PF10285:PF03578,1,1,0,1,1,1016,0.0,1.0,0.0,-0.0,0,0,1,0,1017,0,1.0,0.0,0
PF01276,PF03711:PF03709:PF12381:PF15629:PF00680,7,18,7,0,11,1000,0.39,0.99,1.0,0.62,0,0,7,0,1011,0,0.99,0.0,0
PF08883,PF05419:PF06679:PF10868:PF09056:PF07544,11,9,3,8,6,1001,0.33,0.99,0.27,0.29,0,0,11,0,1007,0,0.99,0.0,0
PF11954,PF07930:PF01427:PF06176:PF00144:PF07311,5,69,5,0,64,949,0.07,0.94,1.0,0.26,0,0,5,0,1013,0,1.0,0.0,0
PF15453,PF10375:PF10490:PF13096:PF11291:PF15821,0,5,0,0,5,1013,0.0,1.0,0,0,0,0,0,0,1018,0,1.0,0,0
PF14880,PF15055:PF14986:PF02950:PF09996:PF02941,5,2,0,5,2,1011,0.0,0.99,0.0,-0.0,0,0,5,0,1013,0,1.0,0.0,0
PF08195,PF05811:PF08096:PF10327:PF10322:PF00162,0,27,0,0,27,991,0.0,0.97,0,0,0,0,0,0,1018,0,1.0,0,0
PF04272,PF03275:PF15046:PF07119:PF11044:PF10452,2,6,0,2,6,1010,0.0,0.99,0.0,-0.0,0,0,2,0,1016,0,1.0,0.0,0
PF01399,PF06237:PF04515:PF01757:PF00485:PF00201,59,101,29,30,72,887,0.29,0.9,0.49,0.33,8,7,52,1,958,0.88,0.95,0.12,0.31
PF08107,PF15576:PF02202:PF09802:PF03823:PF15849,0,5,0,0,5,1013,0.0,1.0,0,0,0,0,0,0,1018,0,1.0,0,0
PF05777,PF07385:PF14065:PF17016:PF00867:PF04129,0,46,0,0,46,972,0.0,0.95,0,0,0,0,0,0,1018,0,1.0,0,0
PF00787,PF09325:PF12825:PF00794:PF13091:PF12828,78,56,33,45,23,917,0.59,0.93,0.42,0.47,8,8,70,0,940,1.0,0.93,0.1,0.31
PF00518,PF16886:PF07497:PF00995:PF12733:PF06792,1,39,1,0,38,979,0.03,0.96,1.0,0.16,3,0,1,3,1014,0.0,1.0,0.0,-0.0
PF14735,PF02401:PF03383:PF07298:PF00918:PF01669,4,9,0,4,9,1005,0.0,0.99,0.0,-0.01,0,0,4,0,1014,0,1.0,0.0,0
PF02776,PF02775:PF00205:PF16582:PF13378:PF12697,27,89,27,0,62,929,0.3,0.94,1.0,0.53,13,13,14,0,991,1.0,0.99,0.48,0.69
PF15378,PF15333:PF17078:PF05399:PF03379:PF15107,0,2,0,0,2,1016,0.0,1.0,0,0,0,0,0,0,1018,0,1.0,0,0
PF15926,PF07139:PF04139:PF10188:PF13864:PF08316,5,24,1,4,23,990,0.04,0.97,0.2,0.08,1,1,4,0,1013,1.0,1.0,0.2,0.45
PF10037,PF10167:PF05308:PF14857:PF05197:PF07406,3,16,0,3,16,999,0.0,0.98,0.0,-0.01,0,0,3,0,1015,0,1.0,0.0,0
PF02533,PF15171:PF04538:PF00489:PF10705:PF02024,2,4,0,2,4,1012,0.0,0.99,0.0,-0.0,0,0,2,0,1016,0,1.0,0.0,0
PF10491,PF10492:PF15999:PF00853:PF12751:PF15353,3,12,1,2,11,1004,0.08,0.99,0.33,0.16,0,0,3,0,1015,0,1.0,0.0,0
PF06558,PF14026:PF12084:PF07415:PF11730:PF02615,1,8,0,1,8,1009,0.0,0.99,0.0,-0.0,0,0,1,0,1017,0,1.0,0.0,0
PF00686,PF16387:PF00723:PF03009:PF09260:PF02446,36,42,24,12,18,964,0.57,0.97,0.67,0.6,1,1,35,0,982,1.0,0.97,0.03,0.16
PF12134,PF10596:PF08084:PF10597:PF08083:PF08082,17,18,17,0,1,1000,0.94,1.0,1.0,0.97,13,13,4,0,1001,1.0,1.0,0.76,0.87
PF03724,PF09149:PF15064:PF15302:PF02057:PF10284,0,6,0,0,6,1012,0.0,0.99,0,0,0,0,0,0,1018,0,1.0,0,0
PF03234,PF08564:PF08565:PF07334:PF08961:PF07292,7,13,7,0,6,1005,0.54,0.99,1.0,0.73,1,1,6,0,1011,1.0,0.99,0.14,0.38
PF10147,PF10244:PF14935:PF10161:PF15884:PF16089,3,12,0,3,12,1003,0.0,0.99,0.0,-0.01,1,0,3,1,1014,0.0,1.0,0.0,-0.0
PF13211,PF15155:PF08751:PF15333:PF08818:PF17053,0,8,0,0,8,1010,0.0,0.99,0,0,0,0,0,0,1018,0,1.0,0,0
PF01155,PF03831:PF01943:PF13247:PF05280:PF05513,2,4,0,2,4,1012,0.0,0.99,0.0,-0.0,0,0,2,0,1016,0,1.0,0.0,0
PF15395,PF11713:PF15491:PF09249:PF12381:PF04428,0,10,0,0,10,1008,0.0,0.99,0,0,0,0,0,0,1018,0,1.0,0,0
PF07855,PF06749:PF05915:PF05498:PF05910:PF03980,9,20,3,6,17,992,0.15,0.98,0.33,0.21,1,0,9,1,1008,0.0,0.99,0.0,-0.0
PF01619,PF14748:PF03807:PF16077:PF05460:PF13508,22,30,11,11,19,977,0.37,0.97,0.5,0.41,3,3,19,0,996,1.0,0.98,0.14,0.37
PF05294,PF08093:PF17112:PF16804:PF12194:PF02413,0,2,0,0,2,1016,0.0,1.0,0,0,0,0,0,0,1018,0,1.0,0,0
PF02607,PF02965:PF00809:PF02310:PF01642:PF02574,4,25,4,0,21,993,0.16,0.98,1.0,0.4,5,3,1,2,1012,0.6,1.0,0.75,0.67
PF00448,PF02978:PF02881:PF04086:PF14774:PF01179,37,57,35,2,22,959,0.61,0.98,0.95,0.75,11,11,26,0,981,1.0,0.97,0.3,0.54
PF04889,PF13954:PF08657:PF13953:PF08925:PF13204,12,13,2,10,11,995,0.15,0.98,0.17,0.15,0,0,12,0,1006,0,0.99,0.0,0
PF14797,PF09066:PF14796:PF06375:PF14807:PF14806,0,19,0,0,19,999,0.0,0.98,0,0,3,0,0,3,1015,0.0,1.0,0,0
PF06155,PF05141:PF10609:PF02668:PF15975:PF04431,10,61,9,1,52,956,0.15,0.95,0.9,0.35,3,2,8,1,1007,0.67,0.99,0.2,0.36
PF15795,PF00214:PF15910:PF09366:PF10276:PF09419,0,19,0,0,19,999,0.0,0.98,0,0,0,0,0,0,1018,0,1.0,0,0
PF05326,PF08404:PF05666:PF06890:PF02465:PF06403,0,1,0,0,1,1017,0.0,1.0,0,0,0,0,0,0,1018,0,1.0,0,0
PF15579,PF09726:PF01221:PF02659:PF06140:PF16901,0,31,0,0,31,987,0.0,0.97,0,0,0,0,0,0,1018,0,1.0,0,0
PF11321,PF09585:PF06876:PF15169:PF15672:PF10994,2,1,0,2,1,1015,0.0,1.0,0.0,-0.0,0,0,2,0,1016,0,1.0,0.0,0
PF08387,PF03478:PF08268:PF07734:PF07723:PF00646,23,106,18,5,88,907,0.17,0.91,0.78,0.34,13,7,16,6,989,0.54,0.98,0.3,0.39
PF10266,PF04922:PF05742:PF06728:PF15008:PF03932,3,37,2,1,35,980,0.05,0.96,0.67,0.18,3,0,3,3,1012,0.0,0.99,0.0,-0.0
PF16545,PF03823:PF17104:PF08649:PF05129:PF13564,7,19,2,5,17,994,0.11,0.98,0.29,0.16,2,1,6,1,1010,0.5,0.99,0.14,0.26
PF12707,PF12843:PF09951:PF05838:PF03743:PF15355,0,7,0,0,7,1011,0.0,0.99,0,0,0,0,0,0,1018,0,1.0,0,0
PF10474,PF07928:PF10475:PF12022:PF08303:PF17167,1,16,1,0,15,1002,0.06,0.99,1.0,0.25,2,1,0,1,1016,0.5,1.0,1.0,0.71
PF08095,PF03219:PF15072:PF15820:PF08192:PF04146,0,32,0,0,32,986,0.0,0.97,0,0,0,0,0,0,1018,0,1.0,0,0
PF15099,PF15725:PF15097:PF14512:PF05416:PF15763,0,3,0,0,3,1015,0.0,1.0,0,0,0,0,0,0,1018,0,1.0,0,0
PF07224,PF11017:PF01701:PF15319:PF02074:PF06592,3,3,0,3,3,1012,0.0,0.99,0.0,-0.0,0,0,3,0,1015,0,1.0,0.0,0
PF10195,PF15011:PF14989:PF04930:PF14832:PF03612,1,20,0,1,20,997,0.0,0.98,0.0,-0.0,1,0,1,1,1016,0.0,1.0,0.0,-0.0
PF05032,PF11093:PF08228:PF13933:PF15831:PF10310,9,5,0,9,5,1004,0.0,0.99,0.0,-0.01,0,0,9,0,1009,0,0.99,0.0,0
PF02729,PF00185:PF01808:PF00988:PF02142:PF02481,20,41,20,0,21,977,0.49,0.98,1.0,0.69,12,12,8,0,998,1.0,0.99,0.6,0.77
PF13823,PF16912:PF02302:PF12242:PF02082:PF00107,2,95,2,0,93,923,0.02,0.91,1.0,0.14,0,0,2,0,1016,0,1.0,0.0,0
PF16787,PF12550:PF08655:PF05508:PF14922:PF08634,18,15,9,9,6,994,0.6,0.99,0.5,0.54,0,0,18,0,1000,0,0.98,0.0,0
PF01948,PF03428:PF01312:PF01913:PF02211:PF02554,0,4,0,0,4,1014,0.0,1.0,0,0,0,0,0,0,1018,0,1.0,0,0
PF00091,PF03953:PF08609:PF05652:PF12579:PF04981,58,57,47,11,10,950,0.82,0.98,0.81,0.81,3,3,55,0,960,1.0,0.95,0.05,0.22
PF13096,PF06211:PF02083:PF05837:PF12709:PF15934,0,7,0,0,7,1011,0.0,0.99,0,0,0,0,0,0,1018,0,1.0,0,0
PF05160,PF10200:PF14753:PF03239:PF16044:PF07767,9,25,4,5,21,988,0.16,0.97,0.44,0.26,2,1,8,1,1008,0.5,0.99,0.11,0.23
PF00452,PF01146:PF01127:PF04089:PF03162:PF04410,10,43,4,6,39,969,0.09,0.96,0.4,0.18,1,1,9,0,1008,1.0,0.99,0.1,0.31
PF14159,PF03350:PF04759:PF14249:PF08137:PF07816,0,7,0,0,7,1011,0.0,0.99,0,0,0,0,0,0,1018,0,1.0,0,0
PF14532,PF08630:PF05496:PF13810:PF12927:PF05841,3,16,1,2,15,1000,0.06,0.98,0.33,0.14,0,0,3,0,1015,0,1.0,0.0,0
PF07195,PF08274:PF08345:PF02465:PF06995:PF13780,0,1,0,0,1,1017,0.0,1.0,0,0,0,0,0,0,1018,0,1.0,0,0
PF00109,PF02801:PF08242:PF14765:PF16073:PF08659,60,72,59,1,13,945,0.82,0.99,0.98,0.89,36,34,26,2,956,0.94,0.97,0.57,0.72
PF16784,PF04854:PF06588:PF00208:PF05751:PF14237,0,25,0,0,25,993,0.0,0.98,0,0,1,0,0,1,1017,0.0,1.0,0,0
PF17043,PF12640:PF02070:PF12153:PF12646:PF10063,0,5,0,0,5,1013,0.0,1.0,0,0,0,0,0,0,1018,0,1.0,0,0
PF15036,PF15125:PF14986:PF14866:PF15055:PF15333,1,3,0,1,3,1014,0.0,1.0,0.0,-0.0,0,0,1,0,1017,0,1.0,0.0,0
PF09848,PF07778:PF12470:PF06863:PF05076:PF06746,9,8,2,7,6,1003,0.25,0.99,0.22,0.23,2,1,8,1,1008,0.5,0.99,0.11,0.23
PF11179,PF03525:PF10138:PF15337:PF11223:PF07199,2,6,0,2,6,1010,0.0,0.99,0.0,-0.0,0,0,2,0,1016,0,1.0,0.0,0
PF07792,PF15912:PF09441:PF04357:PF05397:PF15309,2,16,0,2,16,1000,0.0,0.98,0.0,-0.01,0,0,2,0,1016,0,1.0,0.0,0
PF02479,PF07892:PF06252:PF09707:PF04356:PF05892,0,1,0,0,1,1017,0.0,1.0,0,0,0,0,0,0,1018,0,1.0,0,0
PF07833,PF05939:PF06798:PF05202:PF11775:PF13995,6,0,0,6,0,1012,0,0.99,0.0,0,0,0,6,0,1012,0,0.99,0.0,0
PF13809,PF10076:PF06745:PF04285:PF11612:PF01514,0,2,0,0,2,1016,0.0,1.0,0,0,0,0,0,0,1018,0,1.0,0,0
PF14740,PF04194:PF07929:PF01753:PF03353:PF14737,3,77,3,0,74,941,0.04,0.93,1.0,0.19,2,1,2,1,1014,0.5,1.0,0.33,0.41
PF10528,PF00624:PF07977:PF12371:PF06977:PF05345,2,17,2,0,15,1001,0.12,0.99,1.0,0.34,0,0,2,0,1016,0,1.0,0.0,0
PF02188,PF02145:PF06372:PF03542:PF11864:PF15867,11,18,6,5,12,995,0.33,0.98,0.55,0.42,5,2,9,3,1004,0.4,0.99,0.18,0.26
PF12724,PF15555:PF05418:PF03379:PF15212:PF17010,0,3,0,0,3,1015,0.0,1.0,0,0,0,0,0,0,1018,0,1.0,0,0
PF15165,PF15302:PF09367:PF03437:PF05238:PF15265,0,2,0,0,2,1016,0.0,1.0,0,0,0,0,0,0,1018,0,1.0,0,0
PF13304,PF12399:PF13732:PF08352:PF01032:PF12857,5,15,3,2,12,1001,0.2,0.99,0.6,0.34,2,2,3,0,1013,1.0,1.0,0.4,0.63
PF05910,PF04720:PF06376:PF06749:PF04520:PF00321,10,14,7,3,7,1001,0.5,0.99,0.7,0.59,1,1,9,0,1008,1.0,0.99,0.1,0.31
PF00258,PF00667:PF00175:PF02898:PF01855:PF00067,38,195,37,1,158,822,0.19,0.84,0.97,0.39,31,28,10,3,977,0.9,0.99,0.74,0.81
PF08646,PF16900:PF02721:PF04057:PF01336:PF09170,22,58,18,4,40,956,0.31,0.96,0.82,0.49,9,9,13,0,996,1.0,0.99,0.41,0.64
PF03864,PF02924:PF11767:PF02748:PF09967:PF02472,1,12,0,1,12,1005,0.0,0.99,0.0,-0.0,0,0,1,0,1017,0,1.0,0.0,0
PF03703,PF16060:PF02620:PF05991:PF14279:PF02576,1,15,1,0,14,1003,0.07,0.99,1.0,0.26,0,0,1,0,1017,0,1.0,0.0,0
PF03254,PF02309:PF04674:PF14476:PF07712:PF09353,6,18,1,5,17,995,0.06,0.98,0.17,0.09,1,0,6,1,1011,0.0,0.99,0.0,-0.0
PF14977,PF10198:PF10307:PF15280:PF15813:PF03546,6,11,3,3,8,1004,0.27,0.99,0.5,0.36,0,0,6,0,1012,0,0.99,0.0,0
PF10079,PF07495:PF14328:PF11863:PF01110:PF14508,0,2,0,0,2,1016,0.0,1.0,0,0,0,0,0,0,1018,0,1.0,0,0
PF04835,PF04848:PF01913:PF03238:PF17206:PF15485,0,5,0,0,5,1013,0.0,1.0,0,0,0,0,0,0,1018,0,1.0,0,0
PF16553,PF15898:PF09372:PF09310:PF11904:PF15808,1,14,1,0,13,1004,0.07,0.99,1.0,0.27,0,0,1,0,1017,0,1.0,0.0,0
PF09764,PF03727:PF00349:PF08714:PF16714:PF16346,6,26,6,0,20,992,0.23,0.98,1.0,0.48,3,2,4,1,1011,0.67,1.0,0.33,0.47
PF16870,PF16078:PF02779:PF00456:PF00676:PF13292,14,57,14,0,43,961,0.25,0.96,1.0,0.48,7,6,8,1,1003,0.86,0.99,0.43,0.6
PF13296,PF01580:PF03428:PF06798:PF12080:PF01752,1,7,0,1,7,1010,0.0,0.99,0.0,-0.0,0,0,1,0,1017,0,1.0,0.0,0
PF00751,PF08828:PF03474:PF15791:PF12374:PF11928,6,3,3,3,0,1012,1.0,1.0,0.5,0.71,1,1,5,0,1012,1.0,1.0,0.17,0.41
PF11029,PF15071:PF15884:PF04736:PF10161:PF14653,2,5,1,1,4,1012,0.2,1.0,0.5,0.31,0,0,2,0,1016,0,1.0,0.0,0
PF17100,PF15512:PF11816:PF13925:PF13271:PF17107,20,43,12,8,31,967,0.28,0.96,0.6,0.39,3,2,18,1,997,0.67,0.98,0.1,0.25
PF05542,PF02470:PF01980:PF04921:PF07899:PF05859,3,19,1,2,18,997,0.05,0.98,0.33,0.13,1,0,3,1,1014,0.0,1.0,0.0,-0.0
PF04825,PF15917:PF04118:PF04571:PF04821:PF09743,17,21,5,12,16,985,0.24,0.97,0.29,0.25,1,1,16,0,1001,1.0,0.98,0.06,0.24
PF02075,PF02773:PF10785:PF14767:PF02772:PF14911,3,8,3,0,5,1010,0.38,1.0,1.0,0.61,1,1,2,0,1015,1.0,1.0,0.33,0.58
PF11405,PF01552:PF14564:PF01312:PF10856:PF07409,0,13,0,0,13,1005,0.0,0.99,0,0,0,0,0,0,1018,0,1.0,0,0
PF13721,PF03428:PF11863:PF05509:PF16325:PF02355,3,6,3,0,3,1012,0.5,1.0,1.0,0.71,0,0,3,0,1015,0,1.0,0.0,0
PF02191,PF02354:PF12308:PF02140:PF06482:PF12287,13,35,6,7,29,976,0.17,0.96,0.46,0.27,0,0,13,0,1005,0,0.99,0.0,0
PF05091,PF00244:PF05129:PF05512:PF09751:PF03386,19,34,8,11,26,973,0.24,0.96,0.42,0.3,2,2,17,0,999,1.0,0.98,0.11,0.32
PF01673,PF04355:PF10109:PF10566:PF03050:PF12019,0,1,0,0,1,1017,0.0,1.0,0,0,0,0,0,0,1018,0,1.0,0,0
PF10206,PF02950:PF09232:PF17124:PF00451:PF02827,4,2,0,4,2,1012,0.0,0.99,0.0,-0.0,0,0,4,0,1014,0,1.0,0.0,0
PF14786,PF08917:PF06760:PF11629:PF12202:PF14593,2,13,2,0,11,1005,0.15,0.99,1.0,0.39,3,2,0,1,1015,0.67,1.0,1.0,0.82
PF10332,PF07545:PF13002:PF10104:PF04090:PF08588,0,16,0,0,16,1002,0.0,0.98,0,0,0,0,0,0,1018,0,1.0,0,0
PF12814,PF10650:PF16574:PF15456:PF11500:PF03344,9,8,2,7,6,1003,0.25,0.99,0.22,0.23,1,1,8,0,1009,1.0,0.99,0.11,0.33
PF06160,PF01446:PF15144:PF14478:PF08822:PF16921,0,6,0,0,6,1012,0.0,0.99,0,0,0,0,0,0,1018,0,1.0,0,0
PF15321,PF06403:PF14690:PF06082:PF05797:PF03888,0,1,0,0,1,1017,0.0,1.0,0,0,0,0,0,0,1018,0,1.0,0,0
PF08766,PF02229:PF03126:PF02201:PF09192:PF14671,32,40,21,11,19,967,0.53,0.97,0.66,0.57,7,6,26,1,985,0.86,0.97,0.19,0.39
PF05071,PF03501:PF00831:PF00159:PF06645:PF04667,15,24,6,9,18,985,0.25,0.97,0.4,0.3,1,1,14,0,1003,1.0,0.99,0.07,0.26
PF03735,PF05641:PF05266:PF16135:PF16921:PF09371,7,23,6,1,17,994,0.26,0.98,0.86,0.47,2,2,5,0,1011,1.0,1.0,0.29,0.53
PF00837,PF02106:PF05238:PF15302:PF01114:PF02057,3,2,0,3,2,1013,0.0,1.0,0.0,-0.0,0,0,3,0,1015,0,1.0,0.0,0
PF09635,PF13603:PF10458:PF09334:PF11551:PF06827,3,44,3,0,41,974,0.07,0.96,1.0,0.26,3,3,0,0,1015,1.0,1.0,1.0,1.0
PF14362,PF01752:PF03831:PF00669:PF03241:PF05513,0,4,0,0,4,1014,0.0,1.0,0,0,0,0,0,0,1018,0,1.0,0,0
PF10564,PF11476:PF11244:PF11235:PF11035:PF11232,1,7,0,1,7,1010,0.0,0.99,0.0,-0.0,0,0,1,0,1017,0,1.0,0.0,0
PF06202,PF14701:PF14699:PF14702:PF05285:PF12530,3,18,3,0,15,1000,0.17,0.99,1.0,0.41,1,0,3,1,1014,0.0,1.0,0.0,-0.0
PF16411,PF09498:PF13753:PF05167:PF05840:PF11019,1,1,0,1,1,1016,0.0,1.0,0.0,-0.0,0,0,1,0,1017,0,1.0,0.0,0
PF03241,PF11794:PF06798:PF02277:PF03090:PF13722,0,3,0,0,3,1015,0.0,1.0,0,0,0,0,0,0,1018,0,1.0,0,0
PF13628,PF05707:PF16804:PF15555:PF01752:PF09980,0,3,0,0,3,1015,0.0,1.0,0,0,0,0,0,0,1018,0,1.0,0,0
PF03851,PF10361:PF12527:PF08528:PF13810:PF10332,14,6,2,12,4,1000,0.33,0.98,0.14,0.21,0,0,14,0,1004,0,0.99,0.0,0
PF05267,PF16089:PF01097:PF15013:PF15884:PF06127,0,11,0,0,11,1007,0.0,0.99,0,0,0,0,0,0,1018,0,1.0,0,0
PF07765,PF11577:PF16830:PF10377:PF09762:PF17045,8,10,3,5,7,1003,0.3,0.99,0.38,0.33,0,0,8,0,1010,0,0.99,0.0,0
PF06808,PF00950:PF03150:PF05936:PF03459:PF12911,8,13,6,2,7,1003,0.46,0.99,0.75,0.58,2,2,6,0,1010,1.0,0.99,0.25,0.5
PF14291,PF05699:PF14372:PF12017:PF04937:PF02892,26,91,18,8,73,919,0.2,0.92,0.69,0.34,19,13,13,6,986,0.68,0.98,0.5,0.58
PF11408,PF09382:PF14493:PF16202:PF00570:PF08072,3,32,3,0,29,986,0.09,0.97,1.0,0.3,8,3,0,5,1010,0.38,1.0,1.0,0.61
PF16185,PF08352:PF12399:PF14396:PF09821:PF13304,7,14,3,4,11,1000,0.21,0.99,0.43,0.3,2,2,5,0,1011,1.0,1.0,0.29,0.53
PF15815,PF08941:PF06803:PF00642:PF04553:PF15451,1,76,1,0,75,942,0.01,0.93,1.0,0.11,5,1,0,4,1013,0.2,1.0,1.0,0.45
PF16886,PF07497:PF11421:PF00401:PF07498:PF02789,16,26,4,12,22,980,0.15,0.97,0.25,0.18,2,1,15,1,1001,0.5,0.98,0.06,0.17
PF05557,PF03285:PF04440:PF15301:PF04144:PF16516,5,18,1,4,17,996,0.06,0.98,0.2,0.1,1,0,5,1,1012,0.0,0.99,0.0,-0.0
PF11569,PF04731:PF10525:PF04617:PF12413:PF12407,1,5,1,0,4,1013,0.2,1.0,1.0,0.45,1,1,0,0,1017,1.0,1.0,1.0,1.0
PF01741,PF17032:PF00489:PF09232:PF08738:PF00451,2,2,0,2,2,1014,0.0,1.0,0.0,-0.0,0,0,2,0,1016,0,1.0,0.0,0
PF03946,PF02747:PF03989:PF09326:PF10559:PF00705,22,34,6,16,28,968,0.18,0.96,0.27,0.2,5,2,20,3,993,0.4,0.98,0.09,0.18
PF07063,PF12900:PF06108:PF07333:PF06912:PF11264,6,15,1,5,14,998,0.07,0.98,0.17,0.1,0,0,6,0,1012,0,0.99,0.0,0
PF16900,PF08646:PF02721:PF04057:PF09170:PF01336,15,62,15,0,47,956,0.24,0.95,1.0,0.48,9,9,6,0,1003,1.0,0.99,0.6,0.77
PF06983,PF09459:PF03379:PF08847:PF12006:PF09990,2,8,0,2,8,1008,0.0,0.99,0.0,-0.0,0,0,2,0,1016,0,1.0,0.0,0
PF13054,PF03748:PF07411:PF04671:PF14376:PF03241,0,4,0,0,4,1014,0.0,1.0,0,0,0,0,0,0,1018,0,1.0,0,0
PF03713,PF07209:PF14539:PF10951:PF05962:PF11341,0,4,0,0,4,1014,0.0,1.0,0,0,0,0,0,0,1018,0,1.0,0,0
PF06813,PF05978:PF10022:PF03209:PF07690:PF03600,6,241,5,1,236,776,0.02,0.77,0.83,0.11,4,1,5,3,1009,0.25,0.99,0.17,0.2
PF09811,PF07816:PF13225:PF01632:PF07889:PF08641,6,22,1,5,21,991,0.05,0.97,0.17,0.08,0,0,6,0,1012,0,0.99,0.0,0
PF08732,PF07464:PF09057:PF09690:PF09232:PF00451,3,2,0,3,2,1013,0.0,1.0,0.0,-0.0,0,0,3,0,1015,0,1.0,0.0,0
PF06637,PF16043:PF10506:PF07557:PF15619:PF11559,0,24,0,0,24,994,0.0,0.98,0,0,0,0,0,0,1018,0,1.0,0,0
PF03032,PF10583:PF00879:PF01387:PF00184:PF04643,3,4,0,3,4,1011,0.0,0.99,0.0,-0.0,0,0,3,0,1015,0,1.0,0.0,0
PF16203,PF13625:PF04313:PF09111:PF09416:PF16739,15,30,11,4,19,984,0.37,0.98,0.73,0.51,6,5,10,1,1002,0.83,0.99,0.33,0.52
PF11804,PF04338:PF07914:PF02873:PF16088:PF06280,0,16,0,0,16,1002,0.0,0.98,0,0,0,0,0,0,1018,0,1.0,0,0
PF07148,PF09996:PF01609:PF06559:PF02371:PF06056,0,6,0,0,6,1012,0.0,0.99,0,0,0,0,0,0,1018,0,1.0,0,0
PF11502,PF15735:PF15888:PF15082:PF04417:PF09038,1,10,0,1,10,1007,0.0,0.99,0.0,-0.0,0,0,1,0,1017,0,1.0,0.0,0
PF02067,PF15175:PF17015:PF17062:PF05836:PF05234,1,1,0,1,1,1016,0.0,1.0,0.0,-0.0,0,0,1,0,1017,0,1.0,0.0,0
PF15677,PF15119:PF15085:PF15224:PF14349:PF08398,0,6,0,0,6,1012,0.0,0.99,0,0,0,0,0,0,1018,0,1.0,0,0
PF10154,PF05529:PF01981:PF09288:PF07933:PF04758,4,34,2,2,32,982,0.06,0.97,0.5,0.16,3,1,3,2,1012,0.33,1.0,0.25,0.29
PF14231,PF00345:PF14232:PF09367:PF00577:PF17085,0,5,0,0,5,1013,0.0,1.0,0,0,0,0,0,0,1018,0,1.0,0,0
PF00166,PF03330:PF00967:PF01113:PF00957:PF00081,16,68,10,6,58,944,0.15,0.94,0.62,0.28,5,3,13,2,1000,0.6,0.99,0.19,0.33
PF06677,PF10234:PF09789:PF05346:PF05301:PF11708,3,30,2,1,28,987,0.07,0.97,0.67,0.2,1,1,2,0,1015,1.0,1.0,0.33,0.58
PF16757,PF01120:PF08526:PF08527:PF02971:PF04961,6,23,6,0,17,995,0.26,0.98,1.0,0.51,4,1,5,3,1009,0.25,0.99,0.17,0.2
PF03648,PF07477:PF07488:PF02065:PF02278:PF16875,3,11,3,0,8,1007,0.27,0.99,1.0,0.52,0,0,3,0,1015,0,1.0,0.0,0
PF09817,PF05823:PF10266:PF00821:PF00762:PF07165,3,23,1,2,22,993,0.04,0.98,0.33,0.11,0,0,3,0,1015,0,1.0,0.0,0
PF08305,PF16403:PF03815:PF08709:PF12633:PF03527,4,29,2,2,27,987,0.07,0.97,0.5,0.18,1,1,3,0,1014,1.0,1.0,0.25,0.5
PF12496,PF00616:PF02589:PF09304:PF16523:PF11878,9,29,2,7,27,982,0.07,0.97,0.22,0.11,1,0,9,1,1008,0.0,0.99,0.0,-0.0
PF02813,PF14216:PF12898:PF04988:PF07199:PF11179,3,8,1,2,7,1008,0.12,0.99,0.33,0.2,0,0,3,0,1015,0,1.0,0.0,0
PF07086,PF09347:PF15384:PF06937:PF15551:PF15139,0,6,0,0,6,1012,0.0,0.99,0,0,0,0,0,0,1018,0,1.0,0,0
PF03738,PF11965:PF00799:PF08343:PF00768:PF09051,0,11,0,0,11,1007,0.0,0.99,0,0,1,0,0,1,1017,0.0,1.0,0,0
PF09724,PF10282:PF09494:PF07350:PF01185:PF04106,13,35,7,6,28,977,0.2,0.97,0.54,0.31,3,2,11,1,1004,0.67,0.99,0.15,0.32
PF02909,PF05043:PF12200:PF15163:PF02302:PF07367,3,11,3,0,8,1007,0.27,0.99,1.0,0.52,0,0,3,0,1015,0,1.0,0.0,0
PF03722,PF03723:PF00372:PF16126:PF06746:PF14703,7,28,7,0,21,990,0.25,0.98,1.0,0.49,1,1,6,0,1011,1.0,0.99,0.14,0.38
PF09294,PF07140:PF01108:PF01733:PF06736:PF14161,2,19,1,1,18,998,0.05,0.98,0.5,0.16,1,1,1,0,1016,1.0,1.0,0.5,0.71
PF15033,PF10514:PF08026:PF15085:PF15333:PF11402,2,2,0,2,2,1014,0.0,1.0,0.0,-0.0,0,0,2,0,1016,0,1.0,0.0,0
PF02941,PF06393:PF08092:PF05151:PF00770:PF15036,1,5,0,1,5,1012,0.0,0.99,0.0,-0.0,0,0,1,0,1017,0,1.0,0.0,0
PF08658,PF13892:PF12054:PF09110:PF11648:PF07443,10,32,5,5,27,981,0.16,0.97,0.5,0.27,5,4,6,1,1007,0.8,0.99,0.4,0.56
PF00232,PF14498:PF05577:PF06964:PF07819:PF01799,36,53,16,20,37,945,0.3,0.94,0.44,0.34,6,5,31,1,981,0.83,0.97,0.14,0.33
PF16672,PF14645:PF10340:PF15360:PF06028:PF16966,6,7,1,5,6,1006,0.14,0.99,0.17,0.15,0,0,6,0,1012,0,0.99,0.0,0
PF00543,PF11264:PF07544:PF06232:PF06351:PF11947,4,12,1,3,11,1003,0.08,0.99,0.25,0.14,0,0,4,0,1014,0,1.0,0.0,0
PF04566,PF04565:PF06883:PF04561:PF00562:PF06159,13,24,13,0,11,994,0.54,0.99,1.0,0.73,7,3,10,4,1001,0.43,0.99,0.23,0.31
PF06584,PF13824:PF07222:PF01285:PF09736:PF14441,5,16,1,4,15,998,0.06,0.98,0.2,0.1,1,1,4,0,1013,1.0,1.0,0.2,0.45
PF01413,PF06339:PF08553:PF11693:PF14232:PF09339,10,20,0,10,20,988,0.0,0.97,0.0,-0.01,0,0,10,0,1008,0,0.99,0.0,0
PF01678,PF17187:PF09328:PF08622:PF09164:PF05023,5,11,0,5,11,1002,0.0,0.98,0.0,-0.01,0,0,5,0,1013,0,1.0,0.0,0
PF02810,PF13373:PF10302:PF14023:PF16843:PF07916,6,9,2,4,7,1005,0.22,0.99,0.33,0.27,0,0,6,0,1012,0,0.99,0.0,0
PF13564,PF15003:PF03760:PF03823:PF08649:PF10203,9,10,3,6,7,1002,0.3,0.99,0.33,0.31,0,0,9,0,1009,0,0.99,0.0,0
PF08633,PF14534:PF02972:PF15770:PF08189:PF11317,4,0,0,4,0,1014,0,1.0,0.0,0,0,0,4,0,1014,0,1.0,0.0,0
PF13662,PF00772:PF03796:PF02132:PF08275:PF07364,7,18,7,0,11,1000,0.39,0.99,1.0,0.62,2,2,5,0,1011,1.0,1.0,0.29,0.53
PF14917,PF10375:PF11291:PF15453:PF10490:PF15934,1,5,0,1,5,1012,0.0,0.99,0.0,-0.0,0,0,1,0,1017,0,1.0,0.0,0
PF09924,PF03741:PF11690:PF08653:PF08692:PF11460,5,8,3,2,5,1008,0.38,0.99,0.6,0.47,0,0,5,0,1013,0,1.0,0.0,0
PF04091,PF12036:PF12460:PF07035:PF08427:PF12612,13,32,6,7,26,979,0.19,0.97,0.46,0.28,2,1,12,1,1004,0.5,0.99,0.08,0.19
PF03124,PF00939:PF03105:PF02656:PF03600:PF03009,8,68,6,2,62,948,0.09,0.94,0.75,0.24,11,2,6,9,1001,0.18,0.99,0.25,0.21
PF01902,PF01042:PF01497:PF01593:PF02027:PF02353,7,84,6,1,78,933,0.07,0.92,0.86,0.23,7,4,3,3,1008,0.57,0.99,0.57,0.57
PF05743,PF09454:PF02866:PF03800:PF07292:PF15066,11,33,11,0,22,985,0.33,0.98,1.0,0.57,0,0,11,0,1007,0,0.99,0.0,0
PF05164,PF02108:PF16872:PF11291:PF10375:PF05065,0,2,0,0,2,1016,0.0,1.0,0,0,0,0,0,0,1018,0,1.0,0,0
PF03040,PF02392:PF08840:PF05023:PF12470:PF17187,6,23,6,0,17,995,0.26,0.98,1.0,0.51,1,0,6,1,1011,0.0,0.99,0.0,-0.0
PF14955,PF14935:PF14799:PF15013:PF00708:PF06658,5,15,0,5,15,998,0.0,0.98,0.0,-0.01,1,0,5,1,1012,0.0,0.99,0.0,-0.0
PF11941,PF09154:PF16657:PF16028:PF10438:PF09087,1,3,1,0,2,1015,0.33,1.0,1.0,0.58,1,1,0,0,1017,1.0,1.0,1.0,1.0
PF03930,PF15518:PF04865:PF00915:PF15150:PF02277,0,5,0,0,5,1013,0.0,1.0,0,0,0,0,0,0,1018,0,1.0,0,0
PF12853,PF03769:PF10785:PF08140:PF00502:PF04248,5,10,3,2,7,1006,0.3,0.99,0.6,0.42,0,0,5,0,1013,0,1.0,0.0,0
PF03969,PF04144:PF03619:PF10275:PF04921:PF00484,15,51,8,7,43,960,0.16,0.95,0.53,0.27,8,3,12,5,998,0.38,0.98,0.2,0.27
PF08361,PF00813:PF07494:PF01136:PF13421:PF02951,1,6,1,0,5,1012,0.17,1.0,1.0,0.41,0,0,1,0,1017,0,1.0,0.0,0
PF13698,PF15047:PF08792:PF12658:PF01913:PF11272,0,2,0,0,2,1016,0.0,1.0,0,0,0,0,0,0,1018,0,1.0,0,0
PF02852,PF14691:PF14962:PF01645:PF14721:PF04898,29,15,6,23,9,980,0.4,0.97,0.21,0.27,5,2,27,3,986,0.4,0.97,0.07,0.16
PF15160,PF05418:PF09428:PF02025:PF15204:PF05962,0,5,0,0,5,1013,0.0,1.0,0,0,0,0,0,0,1018,0,1.0,0,0
PF03589,PF03831:PF11751:PF05513:PF10995:PF01752,1,3,1,0,2,1015,0.33,1.0,1.0,0.58,0,0,1,0,1017,0,1.0,0.0,0
PF06069,PF05164:PF12240:PF11291:PF02108:PF05791,0,1,0,0,1,1017,0.0,1.0,0,0,0,0,0,0,1018,0,1.0,0,0
PF15923,PF15997:PF02200:PF14465:PF12478:PF08624,1,10,0,1,10,1007,0.0,0.99,0.0,-0.0,1,0,1,1,1016,0.0,1.0,0.0,-0.0
PF08194,PF11630:PF15972:PF14672:PF12046:PF15129,0,1,0,0,1,1017,0.0,1.0,0,0,0,0,0,0,1018,0,1.0,0,0
PF02059,PF10343:PF10626:PF03082:PF04301:PF08260,2,15,0,2,15,1001,0.0,0.98,0.0,-0.01,0,0,2,0,1016,0,1.0,0.0,0
PF01510,PF15955:PF09412:PF04241:PF00811:PF03006,7,42,2,5,40,971,0.05,0.96,0.29,0.1,5,2,5,3,1008,0.4,0.99,0.29,0.33
PF14684,PF11818:PF15153:PF12571:PF01314:PF01355,2,6,2,0,4,1012,0.33,1.0,1.0,0.58,0,0,2,0,1016,0,1.0,0.0,0
PF09461,PF11124:PF08453:PF15776:PF17049:PF00669,0,6,0,0,6,1012,0.0,0.99,0,0,0,0,0,0,1018,0,1.0,0,0
PF04828,PF02515:PF01738:PF03328:PF00756:PF11807,23,59,13,10,46,949,0.22,0.94,0.57,0.33,11,10,13,1,994,0.91,0.99,0.43,0.62
PF15113,PF02888:PF03530:PF03520:PF11539:PF08650,2,21,1,1,20,996,0.05,0.98,0.5,0.15,2,0,2,2,1014,0.0,1.0,0.0,-0.0
PF05172,PF07051:PF04367:PF07809:PF02576:PF10180,10,13,2,8,11,997,0.15,0.98,0.2,0.17,0,0,10,0,1008,0,0.99,0.0,0
PF15242,PF04714:PF07052:PF15991:PF07051:PF16007,1,16,0,1,16,1001,0.0,0.98,0.0,-0.0,0,0,1,0,1017,0,1.0,0.0,0
PF03189,PF01285:PF10401:PF14687:PF00605:PF04043,7,33,4,3,29,982,0.12,0.97,0.57,0.25,3,0,7,3,1008,0.0,0.99,0.0,-0.0
PF03155,PF04493:PF01722:PF14031:PF00842:PF05994,18,32,9,9,23,977,0.28,0.97,0.5,0.36,2,2,16,0,1000,1.0,0.98,0.11,0.33
PF02213,PF14738:PF14722:PF10377:PF14662:PF09429,16,23,4,12,19,983,0.17,0.97,0.25,0.19,1,1,15,0,1002,1.0,0.99,0.06,0.25
PF03024,PF07995:PF15387:PF08626:PF12371:PF09238,9,25,7,2,18,991,0.28,0.98,0.78,0.46,1,1,8,0,1009,1.0,0.99,0.11,0.33
PF15174,PF09677:PF16325:PF12388:PF04451:PF05778,0,3,0,0,3,1015,0.0,1.0,0,0,0,0,0,0,1018,0,1.0,0,0
PF12734,PF06127:PF06376:PF03980:PF01987:PF04520,2,15,1,1,14,1002,0.07,0.99,0.5,0.18,0,0,2,0,1016,0,1.0,0.0,0
PF00382,PF08271:PF07741:PF02002:PF10211:PF05424,20,29,17,3,12,986,0.59,0.99,0.85,0.7,3,2,18,1,997,0.67,0.98,0.1,0.25
PF10510,PF05719:PF06783:PF08661:PF03932:PF07096,13,35,6,7,29,976,0.17,0.96,0.46,0.27,1,1,12,0,1005,1.0,0.99,0.08,0.28
PF11696,PF15463:PF12118:PF10979:PF02016:PF11517,5,8,2,3,6,1007,0.25,0.99,0.4,0.31,0,0,5,0,1013,0,1.0,0.0,0
PF09400,PF04917:PF17030:PF03589:PF02399:PF01913,0,4,0,0,4,1014,0.0,1.0,0,0,0,0,0,0,1018,0,1.0,0,0
PF15719,PF11029:PF04736:PF09056:PF15071:PF15884,3,9,2,1,7,1008,0.22,0.99,0.67,0.38,0,0,3,0,1015,0,1.0,0.0,0
PF17147,PF01558:PF01855:PF10371:PF02898:PF12838,8,35,8,0,27,983,0.23,0.97,1.0,0.47,5,5,3,0,1010,1.0,1.0,0.62,0.79
PF05378,PF02538:PF01968:PF06032:PF00745:PF05201,28,35,28,0,7,983,0.8,0.99,1.0,0.89,7,7,21,0,990,1.0,0.98,0.25,0.49
PF08514,PF04048:PF14649:PF11028:PF12422:PF14959,13,19,5,8,14,991,0.26,0.98,0.38,0.31,0,0,13,0,1005,0,0.99,0.0,0
PF07047,PF10280:PF01730:PF14997:PF10203:PF01279,10,18,3,7,15,993,0.17,0.98,0.3,0.21,0,0,10,0,1008,0,0.99,0.0,0
PF01940,PF07110:PF12680:PF12311:PF07350:PF04199,9,33,7,2,26,983,0.21,0.97,0.78,0.4,5,2,7,3,1006,0.4,0.99,0.22,0.29
PF12066,PF08729:PF15778:PF11261:PF10264:PF09469,16,17,7,9,10,992,0.41,0.98,0.44,0.41,1,1,15,0,1002,1.0,0.99,0.06,0.25
PF13329,PF16910:PF12624:PF16908:PF14665:PF09333,10,36,10,0,26,982,0.28,0.97,1.0,0.52,14,3,7,11,997,0.21,0.98,0.3,0.24
PF14372,PF10683:PF04937:PF02892:PF14291:PF05699,21,88,19,2,69,928,0.22,0.93,0.9,0.42,17,10,11,7,990,0.59,0.98,0.48,0.52
PF11902,PF06251:PF03241:PF03090:PF15150:PF07411,0,0,0,0,0,1018,0,1.0,0,0,0,0,0,0,1018,0,1.0,0,0
PF15098,PF13466:PF04627:PF08367:PF16187:PF14136,1,36,1,0,35,982,0.03,0.97,1.0,0.16,0,0,1,0,1017,0,1.0,0.0,0
PF15382,PF15033:PF15748:PF10412:PF11402:PF06724,2,2,2,0,0,1016,1.0,1.0,1.0,1.0,0,0,2,0,1016,0,1.0,0.0,0
PF08367,PF16187:PF04627:PF05193:PF00675:PF15098,7,69,7,0,62,949,0.1,0.94,1.0,0.31,22,2,5,20,991,0.09,0.98,0.29,0.15
PF09423,PF16655:PF08689:PF03085:PF05257:PF04935,14,17,6,8,11,993,0.35,0.98,0.43,0.38,0,0,14,0,1004,0,0.99,0.0,0
PF09170,PF08784:PF02938:PF14579:PF10451:PF16900,2,38,1,1,37,979,0.03,0.96,0.5,0.11,3,1,1,2,1014,0.33,1.0,0.5,0.41
PF12026,PF08824:PF03983:PF08397:PF07815:PF16523,4,19,2,2,17,997,0.11,0.98,0.5,0.22,1,1,3,0,1014,1.0,1.0,0.25,0.5
PF04797,PF00780:PF10367:PF07305:PF10366:PF02196,0,51,0,0,51,967,0.0,0.95,0,0,10,0,0,10,1008,0.0,0.99,0,0
PF13439,PF15924:PF12038:PF13579:PF04413:PF00862,23,18,6,17,12,983,0.33,0.97,0.26,0.28,1,1,22,0,995,1.0,0.98,0.04,0.21
PF03185,PF09051:PF09049:PF09050:PF09303:PF01114,7,3,2,5,1,1010,0.67,0.99,0.29,0.43,0,0,7,0,1011,0,0.99,0.0,0
PF10265,PF15008:PF03253:PF10246:PF05825:PF10185,2,16,1,1,15,1001,0.06,0.98,0.5,0.17,1,1,1,0,1016,1.0,1.0,0.5,0.71
PF06115,PF07270:PF09855:PF07413:PF11832:PF11075,0,0,0,0,0,1018,0,1.0,0,0,0,0,0,0,1018,0,1.0,0,0
PF00808,PF08517:PF08347:PF15245:PF07797:PF04844,47,16,7,40,9,962,0.44,0.95,0.15,0.24,0,0,47,0,971,0,0.95,0.0,0
PF15859,PF12313:PF05247:PF04219:PF00651:PF12179,0,139,0,0,139,879,0.0,0.86,0,0,2,0,0,2,1016,0.0,1.0,0,0
PF00493,PF17207:PF14551:PF12619:PF00474:PF02800,49,90,48,1,42,927,0.53,0.96,0.98,0.71,24,24,25,0,969,1.0,0.98,0.49,0.69
PF04367,PF07939:PF00301:PF02576:PF08559:PF07809,2,6,1,1,5,1011,0.17,0.99,0.5,0.29,0,0,2,0,1016,0,1.0,0.0,0
PF09805,PF07939:PF09340:PF10248:PF10276:PF04852,9,13,3,6,10,999,0.23,0.98,0.33,0.27,1,1,8,0,1009,1.0,0.99,0.11,0.33
PF14528,PF07453:PF04232:PF04277:PF06286:PF06670,1,8,1,0,7,1010,0.12,0.99,1.0,0.35,0,0,1,0,1017,0,1.0,0.0,0
PF07473,PF05939:PF12615:PF04451:PF15976:PF02465,0,1,0,0,1,1017,0.0,1.0,0,0,0,0,0,0,1018,0,1.0,0,0
PF10846,PF15211:PF10992:PF15047:PF07400:PF13698,8,2,0,8,2,1008,0.0,0.99,0.0,-0.0,0,0,8,0,1010,0,0.99,0.0,0
PF14643,PF14644:PF15246:PF16529:PF14738:PF15253,5,12,3,2,9,1004,0.25,0.99,0.6,0.38,1,0,5,1,1012,0.0,0.99,0.0,-0.0
PF04325,PF00524:PF11300:PF11291:PF14107:PF13362,3,4,1,2,3,1012,0.25,1.0,0.33,0.29,0,0,3,0,1015,0,1.0,0.0,0
PF09793,PF00159:PF14774:PF01279:PF10780:PF10775,7,8,3,4,5,1006,0.38,0.99,0.43,0.4,0,0,7,0,1011,0,0.99,0.0,0
PF01385,PF17030:PF02741:PF11975:PF01136:PF02399,0,12,0,0,12,1006,0.0,0.99,0,0,0,0,0,0,1018,0,1.0,0,0
PF07354,PF15053:PF15293:PF01415:PF06679:PF16218,2,5,0,2,5,1011,0.0,0.99,0.0,-0.0,0,0,2,0,1016,0,1.0,0.0,0
PF11837,PF08244:PF16352:PF00251:PF16346:PF02018,2,22,2,0,20,996,0.09,0.98,1.0,0.3,0,0,2,0,1016,0,1.0,0.0,0
PF02500,PF13505:PF15856:PF11751:PF06505:PF17164,0,1,0,0,1,1017,0.0,1.0,0,0,0,0,0,0,1018,0,1.0,0,0
PF05922,PF06280:PF09286:PF12583:PF12580:PF00082,25,64,23,2,41,952,0.36,0.96,0.92,0.56,2,1,24,1,992,0.5,0.98,0.04,0.14
PF09374,PF13722:PF05947:PF05974:PF05591:PF11245,0,0,0,0,0,1018,0,1.0,0,0,0,0,0,0,1018,0,1.0,0,0
PF03484,PF03483:PF01409:PF03147:PF00766:PF00984,14,43,14,0,29,975,0.33,0.97,1.0,0.56,10,8,6,2,1002,0.8,0.99,0.57,0.67
PF00332,PF07983:PF03198:PF00154:PF04535:PF04674,26,42,17,9,25,967,0.4,0.97,0.65,0.5,5,5,21,0,992,1.0,0.98,0.19,0.43
PF04375,PF05513:PF05509:PF15518:PF16325:PF05034,2,3,0,2,3,1013,0.0,1.0,0.0,-0.0,0,0,2,0,1016,0,1.0,0.0,0
PF13435,PF10567:PF14508:PF03729:PF14028:PF04984,0,1,0,0,1,1017,0.0,1.0,0,0,0,0,0,0,1018,0,1.0,0,0
PF17121,PF14824:PF13241:PF14823:PF10414:PF06391,4,16,4,0,12,1002,0.25,0.99,1.0,0.5,8,0,4,8,1006,0.0,0.99,0.0,-0.01
PF07897,PF16136:PF16135:PF05266:PF06752:PF12269,1,20,1,0,19,998,0.05,0.98,1.0,0.22,1,1,0,0,1017,1.0,1.0,1.0,1.0
PF09232,PF07448:PF17124:PF00451:PF02950:PF14886,0,5,0,0,5,1013,0.0,1.0,0,0,0,0,0,0,1018,0,1.0,0,0
PF11849,PF05736:PF16822:PF02119:PF03743:PF08497,0,9,0,0,9,1009,0.0,0.99,0,0,0,0,0,0,1018,0,1.0,0,0
PF09741,PF01513:PF14953:PF10419:PF05859:PF04847,6,23,2,4,21,991,0.09,0.98,0.33,0.16,4,0,6,4,1008,0.0,0.99,0.0,-0.0
PF07645,PF07679:PF12662:PF07593:PF00008:PF07474,60,135,50,10,85,873,0.37,0.91,0.83,0.52,18,18,42,0,958,1.0,0.96,0.3,0.54
PF06739,PF15817:PF04632:PF07484:PF03135:PF05488,3,6,1,2,5,1010,0.17,0.99,0.33,0.23,0,0,3,0,1015,0,1.0,0.0,0
PF03449,PF01272:PF03958:PF12659:PF07963:PF06429,12,13,10,2,3,1003,0.77,1.0,0.83,0.8,1,1,11,0,1006,1.0,0.99,0.08,0.29
PF15622,PF11699:PF15620:PF06566:PF15059:PF06567,0,9,0,0,9,1009,0.0,0.99,0,0,0,0,0,0,1018,0,1.0,0,0
PF01652,PF08534:PF05047:PF04176:PF01261:PF04667,27,52,16,11,36,955,0.31,0.95,0.59,0.41,4,3,24,1,990,0.75,0.98,0.11,0.28
PF08953,PF09453:PF13925:PF12341:PF15512:PF07304,9,26,2,7,24,985,0.08,0.97,0.22,0.12,2,1,8,1,1008,0.5,0.99,0.11,0.23
PF08655,PF09463:PF05508:PF10446:PF10198:PF10307,5,6,0,5,6,1007,0.0,0.99,0.0,-0.01,0,0,5,0,1013,0,1.0,0.0,0
PF06422,PF08370:PF14510:PF14396:PF13304:PF00496,15,32,14,1,18,985,0.44,0.98,0.93,0.63,4,4,11,0,1003,1.0,0.99,0.27,0.51
PF13732,PF12399:PF08352:PF08402:PF01032:PF09383,5,15,3,2,12,1001,0.2,0.99,0.6,0.34,3,2,3,1,1012,0.67,1.0,0.4,0.51
PF16274,PF16544:PF16568:PF08067:PF16551:PF10470,2,7,1,1,6,1010,0.14,0.99,0.5,0.26,1,1,1,0,1016,1.0,1.0,0.5,0.71
PF03258,PF17154:PF03538:PF12264:PF03865:PF06114,1,8,0,1,8,1009,0.0,0.99,0.0,-0.0,0,0,1,0,1017,0,1.0,0.0,0
PF06835,PF03968:PF17088:PF15079:PF03319:PF06773,1,1,1,0,0,1017,1.0,1.0,1.0,1.0,0,0,1,0,1017,0,1.0,0.0,0
PF15974,PF08374:PF16492:PF07953:PF00028:PF02115,2,54,2,0,52,964,0.04,0.95,1.0,0.19,2,2,0,0,1016,1.0,1.0,1.0,1.0
PF09169,PF09103:PF09121:PF09104:PF00634:PF15994,5,8,5,0,3,1010,0.62,1.0,1.0,0.79,1,1,4,0,1013,1.0,1.0,0.2,0.45
PF11138,PF03963:PF05100:PF03090:PF10279:PF04954,0,1,0,0,1,1017,0.0,1.0,0,0,0,0,0,0,1018,0,1.0,0,0
PF03034,PF04831:PF10246:PF14895:PF03878:PF04588,8,33,3,5,30,980,0.09,0.97,0.38,0.17,1,0,8,1,1009,0.0,0.99,0.0,-0.0
PF08916,PF08174:PF16018:PF02174:PF08947:PF08574,3,23,2,1,21,994,0.09,0.98,0.67,0.24,1,1,2,0,1015,1.0,1.0,0.33,0.58
PF09792,PF12351:PF07961:PF07444:PF06912:PF12328,2,9,1,1,8,1008,0.11,0.99,0.5,0.23,0,0,2,0,1016,0,1.0,0.0,0
PF12314,PF12402:PF15999:PF04087:PF07175:PF04988,0,8,0,0,8,1010,0.0,0.99,0,0,0,0,0,0,1018,0,1.0,0,0
PF10203,PF10310:PF13564:PF08649:PF15003:PF02044,5,11,1,4,10,1003,0.09,0.99,0.2,0.13,0,0,5,0,1013,0,1.0,0.0,0
PF00810,PF02284:PF05995:PF05047:PF01625:PF04520,13,35,7,6,28,977,0.2,0.97,0.54,0.31,2,1,12,1,1004,0.5,0.99,0.08,0.19
PF03366,PF08123:PF03941:PF16529:PF14722:PF00439,11,90,7,4,83,924,0.08,0.91,0.64,0.2,6,4,7,2,1005,0.67,0.99,0.36,0.49
PF16122,PF00318:PF04161:PF08207:PF09285:PF16039,14,35,9,5,26,978,0.26,0.97,0.64,0.39,5,2,12,3,1001,0.4,0.99,0.14,0.23
PF09804,PF03085:PF14831:PF16019:PF11885:PF05971,3,20,2,1,18,997,0.1,0.98,0.67,0.25,0,0,3,0,1015,0,1.0,0.0,0
PF16472,PF00058:PF00057:PF00683:PF07593:PF12662,5,86,5,0,81,932,0.06,0.92,1.0,0.23,10,5,0,5,1008,0.5,1.0,1.0,0.71
PF09369,PF03880:PF03461:PF02559:PF16783:PF11648,7,15,4,3,11,1000,0.27,0.99,0.57,0.38,2,2,5,0,1011,1.0,1.0,0.29,0.53
PF13648,PF14865:PF06952:PF06393:PF11057:PF15192,0,2,0,0,2,1016,0.0,1.0,0,0,0,0,0,0,1018,0,1.0,0,0
PF04223,PF01289:PF11751:PF04764:PF07411:PF13767,1,1,0,1,1,1016,0.0,1.0,0.0,-0.0,0,0,1,0,1017,0,1.0,0.0,0
PF07364,PF07171:PF06863:PF06742:PF05683:PF14421,3,11,3,0,8,1007,0.27,0.99,1.0,0.52,0,0,3,0,1015,0,1.0,0.0,0
PF16056,PF11618:PF15625:PF09457:PF08151:PF02318,3,24,2,1,22,993,0.08,0.98,0.67,0.23,2,1,2,1,1014,0.5,1.0,0.33,0.41
PF08492,PF13174:PF05279:PF09976:PF16669:PF17004,8,27,6,2,21,989,0.22,0.98,0.75,0.4,3,3,5,0,1010,1.0,1.0,0.38,0.61
PF05282,PF05197:PF03073:PF05871:PF03928:PF13741,12,24,4,8,20,986,0.17,0.97,0.33,0.22,0,0,12,0,1006,0,0.99,0.0,0
PF01796,PF12106:PF03814:PF02399:PF00841:PF11387,1,5,0,1,5,1012,0.0,0.99,0.0,-0.0,0,0,1,0,1017,0,1.0,0.0,0
PF06134,PF08117:PF06412:PF07373:PF11658:PF06544,2,14,0,2,14,1002,0.0,0.98,0.0,-0.01,0,0,2,0,1016,0,1.0,0.0,0
PF04515,PF01757:PF06237:PF10155:PF01755:PF01285,15,50,8,7,42,961,0.16,0.95,0.53,0.27,1,1,14,0,1003,1.0,0.99,0.07,0.26
PF02889,PF14308:PF14237:PF11875:PF02852:PF03880,36,41,13,23,28,954,0.32,0.95,0.36,0.31,2,2,34,0,982,1.0,0.97,0.06,0.23
PF10430,PF02019:PF08917:PF06760:PF14786:PF07974,4,36,4,0,32,982,0.11,0.97,1.0,0.33,2,2,2,0,1014,1.0,1.0,0.5,0.71
PF08525,PF16824:PF07937:PF03525:PF05707:PF03743,0,7,0,0,7,1011,0.0,0.99,0,0,0,0,0,0,1018,0,1.0,0,0
PF10100,PF01108:PF14603:PF09794:PF08205:PF05185,0,52,0,0,52,966,0.0,0.95,0,0,2,0,0,2,1016,0.0,1.0,0,0
PF13593,PF05254:PF03386:PF05512:PF05197:PF04729,5,21,2,3,19,994,0.1,0.98,0.4,0.19,0,0,5,0,1013,0,1.0,0.0,0
PF14633,PF14878:PF09371:PF14641:PF14635:PF14632,13,15,13,0,2,1003,0.87,1.0,1.0,0.93,13,13,0,0,1005,1.0,1.0,1.0,1.0
PF08701,PF05128:PF01018:PF08153:PF15086:PF06780,3,15,1,2,14,1001,0.07,0.98,0.33,0.14,1,1,2,0,1015,1.0,1.0,0.33,0.58
PF04068,PF00037:PF12704:PF06472:PF14510:PF16326,20,41,14,6,27,971,0.34,0.97,0.7,0.48,3,3,17,0,998,1.0,0.98,0.15,0.38
PF02363,PF02736:PF14432:PF06957:PF07823:PF16748,6,63,4,2,59,953,0.06,0.94,0.67,0.19,3,0,6,3,1009,0.0,0.99,0.0,-0.0
PF15775,PF14251:PF11124:PF17164:PF00669:PF15856,0,4,0,0,4,1014,0.0,1.0,0,0,0,0,0,0,1018,0,1.0,0,0
PF03828,PF01909:PF14111:PF01107:PF10421:PF03467,26,75,20,6,55,937,0.27,0.94,0.77,0.43,6,5,21,1,991,0.83,0.98,0.19,0.39
PF07957,PF02277:PF01051:PF05974:PF04625:PF03845,0,13,0,0,13,1005,0.0,0.99,0,0,0,0,0,0,1018,0,1.0,0,0
PF03260,PF17206:PF03592:PF16011:PF10106:PF04932,0,4,0,0,4,1014,0.0,1.0,0,0,0,0,0,0,1018,0,1.0,0,0
PF17189,PF02055:PF08934:PF16757:PF01857:PF11934,13,25,13,0,12,993,0.52,0.99,1.0,0.72,0,0,13,0,1005,0,0.99,0.0,0
PF07530,PF16012:PF12259:PF16297:PF05869:PF12384,6,16,4,2,12,1000,0.25,0.99,0.67,0.4,2,1,5,1,1011,0.5,0.99,0.17,0.29
PF13012,PF12134:PF08084:PF01398:PF10596:PF03465,24,56,23,1,33,961,0.41,0.97,0.96,0.62,14,4,20,10,984,0.29,0.97,0.17,0.2
PF11979,PF11409:PF16696:PF11464:PF09311:PF04366,5,25,2,3,23,990,0.08,0.97,0.4,0.17,2,1,4,1,1012,0.5,1.0,0.2,0.31
PF07422,PF13307:PF13968:PF00305:PF06733:PF17132,0,49,0,0,49,969,0.0,0.95,0,0,11,0,0,11,1007,0.0,0.99,0,0
PF12721,PF09034:PF08917:PF06760:PF02295:PF11957,7,16,6,1,10,1001,0.38,0.99,0.86,0.56,2,2,5,0,1011,1.0,1.0,0.29,0.53
PF16690,PF15390:PF14822:PF05512:PF12304:PF09784,3,5,0,3,5,1010,0.0,0.99,0.0,-0.0,0,0,3,0,1015,0,1.0,0.0,0
PF17004,PF13174:PF05279:PF08492:PF09295:PF12770,7,26,6,1,20,991,0.23,0.98,0.86,0.44,3,3,4,0,1011,1.0,1.0,0.43,0.65
PF04160,PF13471:PF04225:PF14685:PF05568:PF12883,0,10,0,0,10,1008,0.0,0.99,0,0,1,0,0,1,1017,0.0,1.0,0,0
PF05772,PF05925:PF02311:PF05694:PF01022:PF03528,0,21,0,0,21,997,0.0,0.98,0,0,0,0,0,0,1018,0,1.0,0,0
PF08373,PF08368:PF06743:PF15074:PF15149:PF09511,16,21,9,7,12,990,0.43,0.98,0.56,0.48,2,2,14,0,1002,1.0,0.99,0.12,0.35
PF01588,PF16714:PF00579:PF06644:PF00458:PF09635,28,55,16,12,39,951,0.29,0.95,0.57,0.38,5,5,23,0,990,1.0,0.98,0.18,0.42
PF01206,PF07945:PF09902:PF01239:PF00948:PF07042,1,29,0,1,29,988,0.0,0.97,0.0,-0.01,0,0,1,0,1017,0,1.0,0.0,0
PF14768,PF14766:PF14767:PF01386:PF14577:PF14576,0,6,0,0,6,1012,0.0,0.99,0,0,0,0,0,0,1018,0,1.0,0,0
PF06817,PF13655:PF08388:PF12009:PF08284:PF05869,5,33,3,2,30,983,0.09,0.97,0.6,0.23,3,1,4,2,1011,0.33,0.99,0.2,0.26
PF13402,PF02368:PF15627:PF12036:PF15027:PF07035,3,14,0,3,14,1001,0.0,0.98,0.0,-0.01,0,0,3,0,1015,0,1.0,0.0,0
PF00669,PF01752:PF08453:PF13722:PF01514:PF11751,1,2,0,1,2,1015,0.0,1.0,0.0,-0.0,0,0,1,0,1017,0,1.0,0.0,0
PF07510,PF03745:PF08611:PF08058:PF05448:PF12646,1,7,0,1,7,1010,0.0,0.99,0.0,-0.0,0,0,1,0,1017,0,1.0,0.0,0
PF13960,PF13963:PF13952:PF02992:PF03004:PF03017,5,29,5,0,24,989,0.17,0.98,1.0,0.41,5,2,3,3,1010,0.4,0.99,0.4,0.4
PF11746,PF08518:PF12205:PF08321:PF00410:PF17029,0,28,0,0,28,990,0.0,0.97,0,0,2,0,0,2,1016,0.0,1.0,0,0
PF15870,PF13423:PF00929:PF16764:PF03467:PF08604,8,58,7,1,51,959,0.12,0.95,0.88,0.31,4,4,4,0,1010,1.0,1.0,0.5,0.71
PF04145,PF12406:PF01299:PF03248:PF02953:PF04535,24,46,15,9,31,963,0.33,0.96,0.62,0.43,4,4,20,0,994,1.0,0.98,0.17,0.4
PF12829,PF05685:PF12351:PF05824:PF15339:PF15091,1,6,0,1,6,1011,0.0,0.99,0.0,-0.0,0,0,1,0,1017,0,1.0,0.0,0
PF16657,PF09154:PF11941:PF16028:PF09260:PF07821,1,12,1,0,11,1006,0.08,0.99,1.0,0.29,1,1,0,0,1017,1.0,1.0,1.0,1.0
PF13749,PF11614:PF09093:PF02501:PF17084:PF04612,5,7,1,4,6,1007,0.14,0.99,0.2,0.16,0,0,5,0,1013,0,1.0,0.0,0
PF11775,PF03090:PF06798:PF03241:PF02465:PF16325,0,1,0,0,1,1017,0.0,1.0,0,0,0,0,0,0,1018,0,1.0,0,0
PF07385,PF05536:PF05777:PF03107:PF06183:PF02254,0,24,0,0,24,994,0.0,0.98,0,0,0,0,0,0,1018,0,1.0,0,0
PF10356,PF10303:PF12243:PF00165:PF07950:PF05390,2,15,1,1,14,1002,0.07,0.99,0.5,0.18,0,0,2,0,1016,0,1.0,0.0,0
PF00346,PF01731:PF00243:PF13391:PF01359:PF07258,12,68,7,5,61,945,0.1,0.94,0.58,0.23,2,2,10,0,1006,1.0,0.99,0.17,0.41
PF09756,PF04367:PF07809:PF15991:PF07939:PF01705,6,11,2,4,9,1003,0.18,0.99,0.33,0.24,0,0,6,0,1012,0,0.99,0.0,0
PF16363,PF04321:PF11803:PF01370:PF00908:PF14524,38,79,27,11,52,928,0.34,0.94,0.71,0.47,5,4,34,1,979,0.8,0.97,0.11,0.28
PF02133,PF13023:PF05241:PF13577:PF03595:PF05208,23,43,10,13,33,962,0.23,0.95,0.43,0.3,2,2,21,0,995,1.0,0.98,0.09,0.29
PF07562,PF01547:PF02608:PF00003:PF00497:PF12036,14,61,14,0,47,957,0.23,0.95,1.0,0.47,6,5,9,1,1003,0.83,0.99,0.36,0.54
PF17009,PF11068:PF05130:PF05125:PF07210:PF14085,0,1,0,0,1,1017,0.0,1.0,0,0,0,0,0,0,1018,0,1.0,0,0
PF04505,PF06083:PF07896:PF02915:PF03045:PF05915,15,15,3,12,12,991,0.2,0.98,0.2,0.19,2,1,14,1,1002,0.5,0.99,0.07,0.18
PF10994,PF15555:PF17010:PF15162:PF15825:PF15041,0,2,0,0,2,1016,0.0,1.0,0,0,0,0,0,0,1018,0,1.0,0,0
PF00585,PF00290:PF14821:PF01418:PF04739:PF01832,4,21,1,3,20,994,0.05,0.98,0.25,0.1,0,0,4,0,1014,0,1.0,0.0,0
PF06068,PF04979:PF02536:PF02990:PF06522:PF03501,11,66,8,3,58,949,0.12,0.94,0.73,0.28,8,4,7,4,1003,0.5,0.99,0.36,0.42
PF05470,PF08375:PF10602:PF09440:PF01894:PF06399,16,34,7,9,27,975,0.21,0.96,0.44,0.28,1,1,15,0,1002,1.0,0.99,0.06,0.25
PF00159,PF00446:PF01279:PF10780:PF09793:PF01097,2,14,2,0,12,1004,0.14,0.99,1.0,0.38,0,0,2,0,1016,0,1.0,0.0,0
PF03662,PF07542:PF03088:PF01758:PF00953:PF04884,9,49,2,7,47,962,0.04,0.95,0.22,0.08,7,2,7,5,1004,0.29,0.99,0.22,0.25
PF02142,PF00185:PF02729:PF01979:PF00988:PF13382,23,62,16,7,46,949,0.26,0.95,0.7,0.4,14,12,11,2,993,0.86,0.99,0.52,0.66
PF13916,PF12509:PF08729:PF14444:PF13914:PF09405,4,21,4,0,17,997,0.19,0.98,1.0,0.43,2,1,3,1,1013,0.5,1.0,0.25,0.35
PF04157,PF16988:PF11605:PF12767:PF06258:PF00148,10,13,7,3,6,1002,0.54,0.99,0.7,0.61,0,0,10,0,1008,0,0.99,0.0,0
PF08641,PF09631:PF09597:PF10780:PF15370:PF15359,4,15,3,1,12,1002,0.2,0.99,0.75,0.38,0,0,4,0,1014,0,1.0,0.0,0
PF15897,PF07996:PF08889:PF15716:PF11154:PF14982,0,4,0,0,4,1014,0.0,1.0,0,0,0,0,0,0,1018,0,1.0,0,0
PF06942,PF15434:PF11873:PF03244:PF15667:PF04170,0,1,0,0,1,1017,0.0,1.0,0,0,0,0,0,0,1018,0,1.0,0,0
PF15858,PF02931:PF08662:PF01823:PF08117:PF06911,0,104,0,0,104,914,0.0,0.9,0,0,6,0,0,6,1012,0.0,0.99,0,0
PF01382,PF06679:PF15745:PF04041:PF02267:PF11703,3,8,1,2,7,1008,0.12,0.99,0.33,0.2,0,0,3,0,1015,0,1.0,0.0,0
PF09060,PF09007:PF10608:PF10571:PF15764:PF15552,1,2,1,0,1,1016,0.5,1.0,1.0,0.71,1,1,0,0,1017,1.0,1.0,1.0,1.0
PF02494,PF07699:PF00084:PF01120:PF13778:PF00754,20,80,19,1,61,937,0.24,0.94,0.95,0.46,17,14,6,3,995,0.82,0.99,0.7,0.75
PF06179,PF01150:PF13462:PF00048:PF04061:PF07418,10,39,7,3,32,976,0.18,0.97,0.7,0.34,3,3,7,0,1008,1.0,0.99,0.3,0.55
PF05291,PF03491:PF02234:PF00301:PF00209:PF04367,9,46,5,4,41,968,0.11,0.96,0.56,0.23,1,1,8,0,1009,1.0,0.99,0.11,0.33
PF12615,PF05939:PF06890:PF10412:PF02465:PF01913,0,1,0,0,1,1017,0.0,1.0,0,0,0,0,0,0,1018,0,1.0,0,0
PF01873,PF05508:PF08655:PF10307:PF16944:PF15279,13,9,1,12,8,997,0.11,0.98,0.08,0.08,0,0,13,0,1005,0,0.99,0.0,0
PF12726,PF10407:PF15407:PF09462:PF05762:PF05715,4,8,1,3,7,1007,0.12,0.99,0.25,0.17,0,0,4,0,1014,0,1.0,0.0,0
PF04366,PF11464:PF16696:PF12210:PF11409:PF09431,11,22,3,8,19,988,0.14,0.97,0.27,0.18,1,1,10,0,1007,1.0,0.99,0.09,0.3
PF16912,PF13823:PF12242:PF02302:PF02082:PF02678,0,19,0,0,19,999,0.0,0.98,0,0,0,0,0,0,1018,0,1.0,0,0
PF09257,PF15443:PF15482:PF05547:PF15379:PF11652,1,3,0,1,3,1014,0.0,1.0,0.0,-0.0,0,0,1,0,1017,0,1.0,0.0,0
PF03195,PF05678:PF02325:PF01245:PF08536:PF10248,8,21,5,3,16,994,0.24,0.98,0.62,0.38,2,1,7,1,1009,0.5,0.99,0.12,0.25
PF00878,PF00040:PF00039:PF15149:PF01268:PF15181,4,32,4,0,28,986,0.12,0.97,1.0,0.35,1,1,3,0,1014,1.0,1.0,0.25,0.5
PF10486,PF04747:PF15710:PF11244:PF11232:PF15718,1,5,0,1,5,1012,0.0,0.99,0.0,-0.0,0,0,1,0,1017,0,1.0,0.0,0
PF03981,PF13225:PF01786:PF05678:PF01871:PF01245,7,29,3,4,26,985,0.1,0.97,0.43,0.2,3,2,5,1,1010,0.67,0.99,0.29,0.43
PF12336,PF13775:PF12067:PF08517:PF14887:PF09667,3,14,2,1,12,1003,0.14,0.99,0.67,0.3,0,0,3,0,1015,0,1.0,0.0,0
PF13178,PF10580:PF06614:PF15157:PF02179:PF02197,6,35,6,0,29,983,0.17,0.97,1.0,0.41,1,1,5,0,1012,1.0,1.0,0.17,0.41
PF00660,PF15478:PF14866:PF07448:PF09232:PF15681,1,4,0,1,4,1013,0.0,1.0,0.0,-0.0,0,0,1,0,1017,0,1.0,0.0,0
PF03416,PF04831:PF04729:PF07798:PF03095:PF05871,21,31,5,16,26,971,0.16,0.96,0.24,0.18,4,2,19,2,995,0.5,0.98,0.1,0.21
PF03886,PF04288:PF15285:PF12659:PF09170:PF08946,1,4,0,1,4,1013,0.0,1.0,0.0,-0.0,0,0,1,0,1017,0,1.0,0.0,0
PF08486,PF10279:PF11751:PF13995:PF15168:PF04954,0,3,0,0,3,1015,0.0,1.0,0,0,0,0,0,0,1018,0,1.0,0,0
PF14615,PF03713:PF03907:PF08857:PF11341:PF08642,7,3,0,7,3,1008,0.0,0.99,0.0,-0.0,0,0,7,0,1011,0,0.99,0.0,0
PF08238,PF07720:PF13374:PF01152:PF07225:PF07929,42,63,17,25,46,930,0.27,0.93,0.4,0.3,5,5,37,0,976,1.0,0.96,0.12,0.34
PF01387,PF15252:PF01415:PF14931:PF10166:PF15551,0,5,0,0,5,1013,0.0,1.0,0,0,0,0,0,0,1018,0,1.0,0,0
PF11697,PF17206:PF10106:PF09498:PF01316:PF13753,0,4,0,0,4,1014,0.0,1.0,0,0,0,0,0,0,1018,0,1.0,0,0
PF10271,PF15867:PF09295:PF06372:PF06585:PF05279,4,17,1,3,16,998,0.06,0.98,0.25,0.11,1,1,3,0,1014,1.0,1.0,0.25,0.5
PF08271,PF00382:PF07741:PF11521:PF02002:PF00438,12,29,12,0,17,989,0.41,0.98,1.0,0.64,4,3,9,1,1005,0.75,0.99,0.25,0.43
PF11788,PF15916:PF14803:PF00828:PF04573:PF09297,17,37,7,10,30,971,0.19,0.96,0.41,0.26,4,3,14,1,1000,0.75,0.99,0.18,0.36
PF09342,PF15494:PF16915:PF07502:PF16977:PF02983,3,16,2,1,14,1001,0.12,0.99,0.67,0.28,1,1,2,0,1015,1.0,1.0,0.33,0.58
PF13705,PF06547:PF13441:PF15419:PF13436:PF05495,6,12,4,2,8,1004,0.33,0.99,0.67,0.47,2,2,4,0,1012,1.0,1.0,0.33,0.58
PF14545,PF04182:PF10264:PF15678:PF13945:PF07001,2,16,1,1,15,1001,0.06,0.98,0.5,0.17,0,0,2,0,1016,0,1.0,0.0,0
PF00779,PF00616:PF00017:PF08916:PF11878:PF08947,7,84,7,0,77,934,0.08,0.92,1.0,0.28,3,2,5,1,1010,0.67,0.99,0.29,0.43
PF07888,PF04388:PF04108:PF17045:PF15905:PF10212,2,10,1,1,9,1007,0.1,0.99,0.5,0.22,1,1,1,0,1016,1.0,1.0,0.5,0.71
PF16717,PF08558:PF07988:PF14379:PF00684:PF16772,10,14,2,8,12,996,0.14,0.98,0.2,0.16,0,0,10,0,1008,0,0.99,0.0,0
PF06764,PF00737:PF15109:PF14986:PF15172:PF02943,0,3,0,0,3,1015,0.0,1.0,0,0,0,0,0,0,1018,0,1.0,0,0
PF05773,PF08572:PF12745:PF09186:PF01485:PF01205,32,69,20,12,49,937,0.29,0.94,0.62,0.4,4,4,28,0,986,1.0,0.97,0.12,0.35
PF02237,PF09825:PF10437:PF10210:PF03413:PF05201,3,18,1,2,17,998,0.06,0.98,0.33,0.13,2,1,2,1,1014,0.5,1.0,0.33,0.41
PF08728,PF00649:PF12516:PF15678:PF07792:PF13945,5,11,2,3,9,1004,0.18,0.99,0.4,0.26,0,0,5,0,1013,0,1.0,0.0,0
PF06283,PF03883:PF15314:PF10664:PF09784:PF08945,3,3,0,3,3,1012,0.0,0.99,0.0,-0.0,0,0,3,0,1015,0,1.0,0.0,0
PF06374,PF16752:PF13735:PF09287:PF09073:PF12659,2,8,0,2,8,1008,0.0,0.99,0.0,-0.0,0,0,2,0,1016,0,1.0,0.0,0
PF00365,PF12036:PF00854:PF12460:PF02727:PF04442,16,49,9,7,40,962,0.18,0.95,0.56,0.3,3,1,15,2,1000,0.33,0.98,0.06,0.14
PF03080,PF14365:PF04127:PF03951:PF00208:PF05652,10,38,6,4,32,976,0.16,0.96,0.6,0.3,5,2,8,3,1005,0.4,0.99,0.2,0.28
PF08345,PF03428:PF08274:PF14841:PF01706:PF03050,1,1,1,0,0,1017,1.0,1.0,1.0,1.0,0,0,1,0,1017,0,1.0,0.0,0
PF07561,PF08508:PF15730:PF04592:PF04681:PF06013,1,8,1,0,7,1010,0.12,0.99,1.0,0.35,0,0,1,0,1017,0,1.0,0.0,0
PF12592,PF07726:PF03626:PF06044:PF08385:PF05762,3,31,3,0,28,987,0.1,0.97,1.0,0.31,2,2,1,0,1015,1.0,1.0,0.67,0.82
PF03850,PF01015:PF01813:PF01199:PF00244:PF12271,10,39,5,5,34,974,0.13,0.96,0.5,0.24,7,2,8,5,1003,0.29,0.99,0.2,0.23
PF01219,PF06277:PF05999:PF05445:PF03400:PF01802,1,5,0,1,5,1012,0.0,0.99,0.0,-0.0,0,0,1,0,1017,0,1.0,0.0,0
PF03144,PF08938:PF08100:PF04760:PF00561:PF06414,59,95,28,31,67,892,0.29,0.9,0.47,0.33,4,4,55,0,959,1.0,0.95,0.07,0.25
PF15728,PF12843:PF12392:PF08453:PF06493:PF02554,1,3,0,1,3,1014,0.0,1.0,0.0,-0.0,0,0,1,0,1017,0,1.0,0.0,0
PF15282,PF15090:PF06485:PF08632:PF15327:PF05874,5,12,1,4,11,1002,0.08,0.99,0.2,0.12,0,0,5,0,1013,0,1.0,0.0,0
PF02704,PF05498:PF01097:PF16541:PF06697:PF01987,6,17,2,4,15,997,0.12,0.98,0.33,0.19,1,1,5,0,1012,1.0,1.0,0.17,0.41
PF09322,PF15082:PF15407:PF15914:PF08183:PF10407,0,6,0,0,6,1012,0.0,0.99,0,0,0,0,0,0,1018,0,1.0,0,0
PF08400,PF15068:PF13542:PF05591:PF01312:PF15623,0,1,0,0,1,1017,0.0,1.0,0,0,0,0,0,0,1018,0,1.0,0,0
PF11739,PF11736:PF14376:PF03428:PF05736:PF15727,1,7,1,0,6,1011,0.14,0.99,1.0,0.38,0,0,1,0,1017,0,1.0,0.0,0
PF00246,PF02244:PF09759:PF07810:PF01534:PF13640,47,57,29,18,28,943,0.51,0.95,0.62,0.54,8,8,39,0,971,1.0,0.96,0.17,0.4
PF09345,PF07718:PF14806:PF12436:PF17144:PF06481,0,32,0,0,32,986,0.0,0.97,0,0,3,0,0,3,1015,0.0,1.0,0,0
PF09682,PF13906:PF04952:PF00523:PF07276:PF10285,0,21,0,0,21,997,0.0,0.98,0,0,0,0,0,0,1018,0,1.0,0,0
PF00512,PF08446:PF08448:PF00672:PF00072:PF00158,45,73,41,4,32,941,0.56,0.96,0.91,0.7,12,10,35,2,971,0.83,0.96,0.22,0.42
PF04917,PF11751:PF08805:PF10554:PF07523:PF12256,1,1,1,0,0,1017,1.0,1.0,1.0,1.0,0,0,1,0,1017,0,1.0,0.0,0
PF15756,PF15049:PF06805:PF10109:PF10618:PF00669,1,1,0,1,1,1016,0.0,1.0,0.0,-0.0,0,0,1,0,1017,0,1.0,0.0,0
PF09351,PF11595:PF15546:PF15092:PF10706:PF09648,10,6,3,7,3,1005,0.5,0.99,0.3,0.38,0,0,10,0,1008,0,0.99,0.0,0
PF16540,PF13931:PF14739:PF16796:PF11995:PF00225,8,104,8,0,96,914,0.08,0.91,1.0,0.26,5,3,5,2,1008,0.6,0.99,0.38,0.47
PF03039,PF15556:PF02977:PF17050:PF08040:PF14290,2,2,0,2,2,1014,0.0,1.0,0.0,-0.0,0,0,2,0,1016,0,1.0,0.0,0
PF04357,PF15912:PF15309:PF05397:PF07001:PF12231,0,23,0,0,23,995,0.0,0.98,0,0,0,0,0,0,1018,0,1.0,0,0
PF09784,PF15744:PF15829:PF02202:PF15576:PF05387,0,2,0,0,2,1016,0.0,1.0,0,0,0,0,0,0,1018,0,1.0,0,0
PF09203,PF01301:PF15636:PF05593:PF12248:PF17205,1,48,0,1,48,969,0.0,0.95,0.0,-0.01,1,0,1,1,1016,0.0,1.0,0.0,-0.0
PF00488,PF05192:PF05188:PF05190:PF01624:PF11979,43,41,37,6,4,971,0.9,0.99,0.86,0.88,27,24,19,3,972,0.89,0.98,0.56,0.69
PF10435,PF13363:PF13364:PF01301:PF02449:PF02140,5,51,5,0,46,967,0.1,0.95,1.0,0.31,8,5,0,3,1010,0.62,1.0,1.0,0.79
PF06079,PF02290:PF02127:PF03803:PF02401:PF01218,10,37,7,3,30,978,0.19,0.97,0.7,0.35,2,1,9,1,1007,0.5,0.99,0.1,0.22
PF14686,PF06045:PF14683:PF09284:PF16711:PF16712,15,18,15,0,3,1000,0.83,1.0,1.0,0.91,0,0,15,0,1003,0,0.99,0.0,0
PF09797,PF10022:PF06662:PF14764:PF02219:PF16401,10,22,4,6,18,990,0.18,0.98,0.4,0.26,0,0,10,0,1008,0,0.99,0.0,0
PF12220,PF08081:PF15519:PF12196:PF11627:PF12353,5,27,4,1,23,990,0.15,0.98,0.8,0.34,1,1,4,0,1013,1.0,1.0,0.2,0.45
PF02632,PF01668:PF08497:PF15555:PF04754:PF17010,6,4,1,5,3,1009,0.25,0.99,0.17,0.2,0,0,6,0,1012,0,0.99,0.0,0
PF00697,PF00218:PF00977:PF06418:PF04715:PF00958,5,51,2,3,49,964,0.04,0.95,0.4,0.11,7,0,5,7,1006,0.0,0.99,0.0,-0.01
PF08158,PF05285:PF12530:PF09511:PF06165:PF11229,7,27,6,1,21,990,0.22,0.98,0.86,0.43,1,0,7,1,1010,0.0,0.99,0.0,-0.0
PF10234,PF09755:PF11708:PF09282:PF09728:PF01092,3,28,1,2,27,988,0.04,0.97,0.33,0.1,3,0,3,3,1012,0.0,0.99,0.0,-0.0
PF04790,PF05007:PF00590:PF10246:PF05497:PF10261,5,36,4,1,32,981,0.11,0.97,0.8,0.29,2,1,4,1,1012,0.5,1.0,0.2,0.31
PF02781,PF00479:PF01182:PF02812:PF01925:PF03721,14,37,14,0,23,981,0.38,0.98,1.0,0.61,4,3,11,1,1003,0.75,0.99,0.21,0.4
PF09109,PF12856:PF08453:PF09108:PF05939:PF02955,0,7,0,0,7,1011,0.0,0.99,0,0,0,0,0,0,1018,0,1.0,0,0
PF14657,PF16055:PF01514:PF07660:PF08453:PF04754,1,4,1,0,3,1014,0.25,1.0,1.0,0.5,0,0,1,0,1017,0,1.0,0.0,0
PF09253,PF07327:PF15085:PF14519:PF13094:PF09252,0,4,0,0,4,1014,0.0,1.0,0,0,0,0,0,0,1018,0,1.0,0,0
PF02531,PF02427:PF12046:PF08576:PF11909:PF08092,2,5,1,1,4,1012,0.2,1.0,0.5,0.31,0,0,2,0,1016,0,1.0,0.0,0
PF00122,PF12409:PF00690:PF00689:PF16212:PF08282,106,98,83,23,15,897,0.85,0.96,0.78,0.79,30,30,76,0,912,1.0,0.93,0.28,0.51
PF08039,PF05488:PF01638:PF13753:PF15023:PF15334,1,1,0,1,1,1016,0.0,1.0,0.0,-0.0,0,0,1,0,1017,0,1.0,0.0,0
PF03715,PF04139:PF15369:PF04000:PF09755:PF09816,13,27,7,6,20,985,0.26,0.97,0.54,0.36,3,2,11,1,1004,0.67,0.99,0.15,0.32
PF02197,PF13178:PF13545:PF10137:PF06614:PF10580,21,8,3,18,5,992,0.38,0.98,0.14,0.22,1,1,20,0,997,1.0,0.98,0.05,0.22
PF02027,PF07207:PF11739:PF15160:PF16259:PF10145,1,3,1,0,2,1015,0.33,1.0,1.0,0.58,0,0,1,0,1017,0,1.0,0.0,0
PF11750,PF12996:PF12938:PF03092:PF10427:PF16608,0,16,0,0,16,1002,0.0,0.98,0,0,1,0,0,1,1017,0.0,1.0,0,0
PF06701,PF11515:PF07738:PF03256:PF09387:PF16553,16,40,11,5,29,973,0.28,0.97,0.69,0.42,5,4,12,1,1001,0.8,0.99,0.25,0.44
PF10181,PF01632:PF08561:PF04716:PF09769:PF03980,3,24,0,3,24,991,0.0,0.97,0.0,-0.01,1,0,3,1,1014,0.0,1.0,0.0,-0.0
PF02148,PF06337:PF07576:PF00443:PF13441:PF01223,39,126,36,3,90,889,0.29,0.91,0.92,0.48,9,9,30,0,979,1.0,0.97,0.23,0.47
PF01956,PF02996:PF01912:PF00213:PF09749:PF00334,11,60,5,6,55,952,0.08,0.94,0.45,0.18,7,1,10,6,1001,0.14,0.98,0.09,0.11
PF08228,PF01878:PF15158:PF15673:PF11805:PF12926,3,11,1,2,10,1005,0.09,0.99,0.33,0.17,0,0,3,0,1015,0,1.0,0.0,0
PF12569,PF04049:PF17109:PF07719:PF05279:PF07721,17,49,6,11,43,958,0.12,0.95,0.35,0.19,2,2,15,0,1001,1.0,0.99,0.12,0.34
PF02944,PF10545:PF12596:PF04937:PF13613:PF04508,14,58,14,0,44,960,0.24,0.96,1.0,0.48,5,4,10,1,1003,0.8,0.99,0.29,0.47
PF10562,PF10565:PF04069:PF08636:PF03823:PF02155,5,19,5,0,14,999,0.26,0.99,1.0,0.51,0,0,5,0,1013,0,1.0,0.0,0
PF07400,PF15211:PF15138:PF16649:PF08792:PF10992,0,3,0,0,3,1015,0.0,1.0,0,0,0,0,0,0,1018,0,1.0,0,0
PF02421,PF08155:PF13878:PF11958:PF06858:PF08622,3,29,1,2,28,987,0.03,0.97,0.33,0.1,3,0,3,3,1012,0.0,0.99,0.0,-0.0
PF03089,PF13341:PF09778:PF03409:PF05612:PF09592,2,5,1,1,4,1012,0.2,1.0,0.5,0.31,0,0,2,0,1016,0,1.0,0.0,0
PF13427,PF01934:PF08485:PF00516:PF04552:PF13780,1,3,1,0,2,1015,0.33,1.0,1.0,0.58,0,0,1,0,1017,0,1.0,0.0,0
PF12662,PF07474:PF12661:PF07645:PF08584:PF07699,24,79,23,1,56,938,0.29,0.94,0.96,0.51,14,10,14,4,990,0.71,0.98,0.42,0.54
PF14061,PF16737:PF14051:PF12269:PF03172:PF12165,6,16,3,3,13,999,0.19,0.98,0.5,0.3,1,1,5,0,1012,1.0,1.0,0.17,0.41
PF05461,PF12605:PF08332:PF03822:PF04548:PF11886,15,29,8,7,21,982,0.28,0.97,0.53,0.37,2,2,13,0,1003,1.0,0.99,0.13,0.36
PF02762,PF02761:PF02262:PF08295:PF04571:PF13888,4,30,3,1,27,987,0.1,0.97,0.75,0.27,4,1,3,3,1011,0.25,0.99,0.25,0.25
PF03330,PF01357:PF00166:PF07258:PF00957:PF01731,20,62,15,5,47,951,0.24,0.95,0.75,0.41,5,4,16,1,997,0.8,0.98,0.2,0.4
PF02901,PF01228:PF10105:PF07963:PF15231:PF13404,7,8,2,5,6,1005,0.25,0.99,0.29,0.26,2,2,5,0,1011,1.0,1.0,0.29,0.53
PF06183,PF07385:PF05325:PF13471:PF13783:PF00005,0,168,0,0,168,850,0.0,0.83,0,0,0,0,0,0,1018,0,1.0,0,0
PF02519,PF04535:PF06749:PF05617:PF02298:PF04690,12,27,5,7,22,984,0.19,0.97,0.42,0.27,3,2,10,1,1005,0.67,0.99,0.17,0.33
PF03704,PF13464:PF14280:PF02388:PF01346:PF16463,2,6,1,1,5,1011,0.17,0.99,0.5,0.29,1,1,1,0,1016,1.0,1.0,0.5,0.71
PF07828,PF16829:PF16576:PF00799:PF07963:PF16416,1,4,0,1,4,1013,0.0,1.0,0.0,-0.0,0,0,1,0,1017,0,1.0,0.0,0
PF00367,PF10410:PF06773:PF14564:PF11736:PF15830,8,9,2,6,7,1003,0.22,0.99,0.25,0.23,0,0,8,0,1010,0,0.99,0.0,0
PF12785,PF16704:PF07202:PF17213:PF15908:PF12340,0,20,0,0,20,998,0.0,0.98,0,0,1,0,0,1,1017,0.0,1.0,0,0
PF03841,PF13382:PF01475:PF12390:PF09498:PF04466,1,6,1,0,5,1012,0.17,1.0,1.0,0.41,0,0,1,0,1017,0,1.0,0.0,0
PF00566,PF00581:PF12068:PF15733:PF02893:PF02759,84,94,46,38,48,886,0.49,0.92,0.55,0.47,6,6,78,0,934,1.0,0.92,0.07,0.26
PF05832,PF04667:PF00115:PF00499:PF00159:PF09769,10,25,3,7,22,986,0.12,0.97,0.3,0.18,0,0,10,0,1008,0,0.99,0.0,0
PF04186,PF15713:PF03203:PF14862:PF17017:PF17015,0,2,0,0,2,1016,0.0,1.0,0,0,0,0,0,0,1018,0,1.0,0,0
PF12927,PF05841:PF08634:PF08630:PF13810:PF11727,3,6,0,3,6,1009,0.0,0.99,0.0,-0.0,0,0,3,0,1015,0,1.0,0.0,0
PF11409,PF11979:PF16696:PF11464:PF12210:PF09311,1,22,1,0,21,996,0.05,0.98,1.0,0.21,1,1,0,0,1017,1.0,1.0,1.0,1.0
PF01613,PF09791:PF02898:PF06999:PF00753:PF08608,15,94,10,5,84,919,0.11,0.91,0.67,0.24,8,5,10,3,1000,0.62,0.99,0.33,0.45
PF03788,PF16967:PF07434:PF03534:PF15976:PF12255,2,0,0,2,0,1016,0,1.0,0.0,0,0,0,2,0,1016,0,1.0,0.0,0
PF15710,PF16829:PF10630:PF15398:PF15872:PF15015,0,1,0,0,1,1017,0.0,1.0,0,0,0,0,0,0,1018,0,1.0,0,0
PF01769,PF03448:PF12260:PF06312:PF08652:PF03367,6,27,6,0,21,991,0.22,0.98,1.0,0.47,0,0,6,0,1012,0,0.99,0.0,0
PF03428,PF08345:PF05939:PF04740:PF06890:PF05943,0,1,0,0,1,1017,0.0,1.0,0,0,0,0,0,0,1018,0,1.0,0,0
PF04811,PF08033:PF04815:PF04810:PF13254:PF00626,26,54,26,0,28,964,0.48,0.97,1.0,0.68,23,23,3,0,992,1.0,1.0,0.88,0.94
PF10961,PF07449:PF15928:PF15378:PF06936:PF06201,6,23,0,6,23,989,0.0,0.97,0.0,-0.01,0,0,6,0,1012,0,0.99,0.0,0
PF08634,PF16944:PF05508:PF12927:PF12253:PF08630,2,10,0,2,10,1006,0.0,0.99,0.0,-0.0,1,0,2,1,1015,0.0,1.0,0.0,-0.0
PF14875,PF14382:PF14921:PF12260:PF00874:PF08327,2,35,2,0,33,983,0.06,0.97,1.0,0.24,1,1,1,0,1016,1.0,1.0,0.5,0.71
PF06812,PF15050:PF17062:PF10664:PF15175:PF11371,0,3,0,0,3,1015,0.0,1.0,0,0,0,0,0,0,1018,0,1.0,0,0
PF12929,PF10252:PF10067:PF06500:PF13092:PF02683,11,10,0,11,10,997,0.0,0.98,0.0,-0.01,1,0,11,1,1006,0.0,0.99,0.0,-0.0
PF07691,PF10162:PF13402:PF08239:PF00526:PF00624,15,16,4,11,12,991,0.25,0.98,0.27,0.25,0,0,15,0,1003,0,0.99,0.0,0
PF13635,PF13390:PF01407:PF03814:PF09829:PF08535,0,2,0,0,2,1016,0.0,1.0,0,0,0,0,0,0,1018,0,1.0,0,0
PF12234,PF09453:PF14538:PF07304:PF12657:PF15787,7,41,4,3,37,974,0.1,0.96,0.57,0.22,2,1,6,1,1010,0.5,0.99,0.14,0.26
PF11580,PF12101:PF06651:PF03090:PF13689:PF11593,0,2,0,0,2,1016,0.0,1.0,0,0,0,0,0,0,1018,0,1.0,0,0
PF12547,PF15923:PF10198:PF09038:PF09463:PF10446,2,6,1,1,5,1011,0.17,0.99,0.5,0.29,0,0,2,0,1016,0,1.0,0.0,0
PF05418,PF15662:PF08497:PF12724:PF15085:PF14862,1,2,0,1,2,1015,0.0,1.0,0.0,-0.0,0,0,1,0,1017,0,1.0,0.0,0
PF04286,PF07434:PF06745:PF04349:PF03944:PF15976,2,2,0,2,2,1014,0.0,1.0,0.0,-0.0,0,0,2,0,1016,0,1.0,0.0,0
PF01824,PF01329:PF04520:PF00499:PF07114:PF02284,3,24,1,2,23,992,0.04,0.98,0.33,0.11,0,0,3,0,1015,0,1.0,0.0,0
PF09106,PF09107:PF16658:PF09173:PF14492:PF11987,3,55,3,0,52,963,0.05,0.95,1.0,0.23,3,2,1,1,1014,0.67,1.0,0.67,0.67
PF16066,PF07227:PF12453:PF09240:PF09067:PF12567,1,7,1,0,6,1011,0.14,0.99,1.0,0.38,1,1,0,0,1017,1.0,1.0,1.0,1.0
PF16889,PF10566:PF17164:PF03831:PF06745:PF01580,1,5,0,1,5,1012,0.0,0.99,0.0,-0.0,0,0,1,0,1017,0,1.0,0.0,0
PF04617,PF10525:PF13293:PF03867:PF12407:PF12413,1,4,1,0,3,1014,0.25,1.0,1.0,0.5,1,1,0,0,1017,1.0,1.0,1.0,1.0
PF01066,PF08652:PF13813:PF02517:PF04859:PF10156,35,29,12,23,17,966,0.41,0.96,0.34,0.36,3,3,32,0,983,1.0,0.97,0.09,0.29
PF00885,PF03488:PF10868:PF11264:PF02605:PF07333,10,3,0,10,3,1005,0.0,0.99,0.0,-0.01,0,0,10,0,1008,0,0.99,0.0,0
PF00594,PF12032:PF09272:PF16030:PF09396:PF00054,8,30,4,4,26,984,0.13,0.97,0.5,0.25,1,1,7,0,1010,1.0,0.99,0.12,0.35
PF07841,PF01758:PF07542:PF03022:PF03062:PF06814,4,61,1,3,60,954,0.02,0.94,0.25,0.05,3,0,4,3,1011,0.0,0.99,0.0,-0.0
PF02437,PF15223:PF08782:PF14444:PF00853:PF16566,11,22,10,1,12,995,0.45,0.99,0.91,0.64,1,1,10,0,1007,1.0,0.99,0.09,0.3
PF10548,PF17007:PF16991:PF15476:PF03272:PF06450,0,1,0,0,1,1017,0.0,1.0,0,0,0,0,0,0,1018,0,1.0,0,0
PF15928,PF07449:PF10961:PF05903:PF06201:PF07912,1,41,1,0,40,977,0.02,0.96,1.0,0.15,0,0,1,0,1017,0,1.0,0.0,0
PF04084,PF15929:PF10681:PF03085:PF07745:PF14475,8,9,1,7,8,1002,0.11,0.99,0.12,0.11,0,0,8,0,1010,0,0.99,0.0,0
PF03882,PF17192:PF04350:PF04288:PF03831:PF12477,0,0,0,0,0,1018,0,1.0,0,0,0,0,0,0,1018,0,1.0,0,0
PF02152,PF01288:PF00809:PF02607:PF02965:PF02574,11,27,10,1,17,990,0.37,0.98,0.91,0.57,6,3,8,3,1004,0.5,0.99,0.27,0.36
PF08622,PF17187:PF08309:PF02537:PF12470:PF05076,2,13,2,0,11,1005,0.15,0.99,1.0,0.39,1,1,1,0,1016,1.0,1.0,0.5,0.71
PF13449,PF05014:PF06581:PF03576:PF08738:PF10340,4,3,1,3,2,1012,0.33,1.0,0.25,0.29,0,0,4,0,1014,0,1.0,0.0,0
PF12402,PF08014:PF15257:PF05841:PF12927:PF07175,0,4,0,0,4,1014,0.0,1.0,0,0,1,0,0,1,1017,0.0,1.0,0,0
PF15435,PF05869:PF10917:PF03539:PF00606:PF02160,0,9,0,0,9,1009,0.0,0.99,0,0,0,0,0,0,1018,0,1.0,0,0
PF01222,PF09465:PF10477:PF10846:PF10581:PF05428,23,14,5,18,9,986,0.36,0.97,0.22,0.27,0,0,23,0,995,0,0.98,0.0,0
PF16134,PF11732:PF11262:PF03993:PF00073:PF00680,7,20,6,1,14,997,0.3,0.99,0.86,0.5,0,0,7,0,1011,0,0.99,0.0,0
PF15943,PF00967:PF04237:PF03345:PF00573:PF03690,0,33,0,0,33,985,0.0,0.97,0,0,3,0,0,3,1015,0.0,1.0,0,0
PF06083,PF01632:PF08561:PF10218:PF04716:PF12020,3,21,1,2,20,995,0.05,0.98,0.33,0.12,0,0,3,0,1015,0,1.0,0.0,0
PF11860,PF13421:PF08298:PF15272:PF14842:PF14841,0,1,0,0,1,1017,0.0,1.0,0,0,0,0,0,0,1018,0,1.0,0,0
PF07894,PF08313:PF15778:PF09429:PF08729:PF09469,5,26,1,4,25,988,0.04,0.97,0.2,0.08,1,1,4,0,1013,1.0,1.0,0.2,0.45
PF05425,PF13753:PF17206:PF07209:PF12843:PF09498,0,2,0,0,2,1016,0.0,1.0,0,0,0,0,0,0,1018,0,1.0,0,0
PF10595,PF09728:PF11250:PF15264:PF10058:PF07052,4,27,3,1,24,990,0.11,0.98,0.75,0.28,1,0,4,1,1013,0.0,1.0,0.0,-0.0
PF14934,PF10195:PF15011:PF02453:PF14989:PF00908,2,22,2,0,20,996,0.09,0.98,1.0,0.3,1,0,2,1,1015,0.0,1.0,0.0,-0.0
PF15653,PF15143:PF15367:PF13753:PF14841:PF11202,0,3,0,0,3,1015,0.0,1.0,0,0,0,0,0,0,1018,0,1.0,0,0
PF11464,PF16696:PF12210:PF04366:PF11409:PF13713,11,18,1,10,17,990,0.06,0.97,0.09,0.06,2,1,10,1,1006,0.5,0.99,0.09,0.21
PF12070,PF01147:PF00272:PF15260:PF05300:PF06951,1,15,0,1,15,1002,0.0,0.98,0.0,-0.0,0,0,1,0,1017,0,1.0,0.0,0
PF09074,PF01706:PF05939:PF11435:PF06070:PF13247,0,3,0,0,3,1015,0.0,1.0,0,0,0,0,0,0,1018,0,1.0,0,0
PF05192,PF05190:PF00488:PF05188:PF01624:PF01541,38,56,38,0,18,962,0.68,0.98,1.0,0.82,25,25,13,0,980,1.0,0.99,0.66,0.81
PF05020,PF05021:PF11543:PF00833:PF03880:PF12029,9,29,9,0,20,989,0.31,0.98,1.0,0.55,3,3,6,0,1009,1.0,0.99,0.33,0.58
PF03792,PF00157:PF13293:PF12413:PF04617:PF10525,4,8,4,0,4,1010,0.5,1.0,1.0,0.71,1,1,3,0,1014,1.0,1.0,0.25,0.5
PF12451,PF17122:PF12816:PF00637:PF05131:PF10367,8,37,8,0,29,981,0.22,0.97,1.0,0.46,6,6,2,0,1010,1.0,1.0,0.75,0.87
PF11820,PF01959:PF15252:PF14967:PF10630:PF01415,3,7,1,2,6,1009,0.14,0.99,0.33,0.21,0,0,3,0,1015,0,1.0,0.0,0
PF00887,PF00651:PF16553:PF00378:PF07646:PF09310,46,161,31,15,130,842,0.19,0.86,0.67,0.31,8,7,39,1,971,0.88,0.96,0.15,0.36
PF11038,PF12385:PF10924:PF15212:PF10106:PF07022,0,2,0,0,2,1016,0.0,1.0,0,0,0,0,0,0,1018,0,1.0,0,0
PF03626,PF07726:PF12592:PF05762:PF06044:PF03135,2,11,2,0,9,1007,0.18,0.99,1.0,0.42,2,2,0,0,1016,1.0,1.0,1.0,1.0
PF16930,PF05679:PF14518:PF04336:PF00514:PF05225,0,80,0,0,80,938,0.0,0.92,0,0,7,0,0,7,1011,0.0,0.99,0,0
PF00526,PF17210:PF05914:PF00746:PF01383:PF15718,1,10,0,1,10,1007,0.0,0.99,0.0,-0.0,0,0,1,0,1017,0,1.0,0.0,0
PF15828,PF03745:PF08040:PF06681:PF15185:PF03050,2,3,0,2,3,1013,0.0,1.0,0.0,-0.0,0,0,2,0,1016,0,1.0,0.0,0
PF11870,PF02589:PF10554:PF07523:PF13808:PF08345,0,9,0,0,9,1009,0.0,0.99,0,0,0,0,0,0,1018,0,1.0,0,0
PF00996,PF08295:PF02671:PF16879:PF08728:PF08620,26,35,10,16,25,967,0.29,0.96,0.38,0.31,15,7,19,8,984,0.47,0.97,0.27,0.34
PF08774,PF13892:PF08797:PF15790:PF09416:PF04842,6,36,4,2,32,980,0.11,0.97,0.67,0.26,5,2,4,3,1009,0.4,0.99,0.33,0.36
PF15708,PF06890:PF07499:PF11019:PF02277:PF04625,0,6,0,0,6,1012,0.0,0.99,0,0,0,0,0,0,1018,0,1.0,0,0
PF07541,PF09371:PF08206:PF00575:PF16921:PF08529,6,35,6,0,29,983,0.17,0.97,1.0,0.41,2,1,5,1,1011,0.5,0.99,0.17,0.29
PF01568,PF04879:PF09326:PF00384:PF10588:PF14710,5,26,5,0,21,992,0.19,0.98,1.0,0.43,15,2,3,13,1000,0.13,0.98,0.4,0.22
PF08310,PF04122:PF12753:PF10139:PF07520:PF11614,1,5,0,1,5,1012,0.0,0.99,0.0,-0.0,0,0,1,0,1017,0,1.0,0.0,0
PF02190,PF12037:PF06480:PF03226:PF05362:PF00004,27,163,25,2,138,853,0.15,0.86,0.93,0.34,12,10,17,2,989,0.83,0.98,0.37,0.55
PF14318,PF00946:PF03929:PF08762:PF16014:PF08579,4,12,4,0,8,1006,0.33,0.99,1.0,0.58,0,0,4,0,1014,0,1.0,0.0,0
PF03214,PF06219:PF09044:PF05238:PF15165:PF01114,3,5,0,3,5,1010,0.0,0.99,0.0,-0.0,0,0,3,0,1015,0,1.0,0.0,0
PF15125,PF15036:PF05558:PF17062:PF11371:PF14986,3,2,0,3,2,1013,0.0,1.0,0.0,-0.0,0,0,3,0,1015,0,1.0,0.0,0
PF08542,PF14629:PF08740:PF14363:PF05652:PF16725,18,33,8,10,25,975,0.24,0.97,0.44,0.31,4,4,14,0,1000,1.0,0.99,0.22,0.47
PF05643,PF13006:PF06286:PF07201:PF15726:PF11924,0,4,0,0,4,1014,0.0,1.0,0,0,0,0,0,0,1018,0,1.0,0,0
PF08423,PF04005:PF03162:PF13088:PF07847:PF07896,32,28,8,24,20,966,0.29,0.96,0.25,0.25,2,2,30,0,986,1.0,0.97,0.06,0.25
PF08726,PF13499:PF00036:PF13833:PF13405:PF14513,10,149,7,3,142,866,0.05,0.86,0.7,0.16,29,4,6,25,983,0.14,0.97,0.4,0.22
PF07733,PF14579:PF13477:PF10111:PF02938:PF12659,13,19,13,0,6,999,0.68,0.99,1.0,0.82,0,0,13,0,1005,0,0.99,0.0,0
PF10084,PF12608:PF00779:PF05541:PF10467:PF01862,0,9,0,0,9,1009,0.0,0.99,0,0,0,0,0,0,1018,0,1.0,0,0
PF12110,PF04096:PF13634:PF14636:PF14638:PF13329,15,31,13,2,18,985,0.42,0.98,0.87,0.6,4,2,13,2,1001,0.5,0.99,0.13,0.25
PF17198,PF09367:PF08432:PF11385:PF00879:PF05436,0,1,0,0,1,1017,0.0,1.0,0,0,0,0,0,0,1018,0,1.0,0,0
PF15661,PF08275:PF00308:PF04865:PF16833:PF02501,2,9,1,1,8,1008,0.11,0.99,0.5,0.23,0,0,2,0,1016,0,1.0,0.0,0
PF14342,PF05547:PF15578:PF08508:PF08642:PF03544,4,7,0,4,7,1007,0.0,0.99,0.0,-0.01,0,0,4,0,1014,0,1.0,0.0,0
PF08941,PF06803:PF15815:PF16207:PF16673:PF05495,8,23,5,3,18,992,0.22,0.98,0.62,0.36,4,3,5,1,1009,0.75,0.99,0.38,0.53
PF09340,PF10248:PF09805:PF04852:PF10276:PF15245,6,15,3,3,12,1000,0.2,0.99,0.5,0.31,0,0,6,0,1012,0,0.99,0.0,0
PF06151,PF08395:PF08925:PF14713:PF04598:PF06477,2,35,2,0,33,983,0.06,0.97,1.0,0.24,0,0,2,0,1016,0,1.0,0.0,0
PF15724,PF06875:PF06954:PF12046:PF09117:PF14653,0,1,0,0,1,1017,0.0,1.0,0,0,0,0,0,0,1018,0,1.0,0,0
PF03634,PF09335:PF02915:PF05678:PF04505:PF01789,6,44,4,2,40,972,0.09,0.96,0.67,0.24,4,1,5,3,1009,0.25,0.99,0.17,0.2
PF12042,PF11260:PF16763:PF11466:PF03382:PF08023,0,3,0,0,3,1015,0.0,1.0,0,0,0,0,0,0,1018,0,1.0,0,0
PF15840,PF00025:PF06357:PF05326:PF12482:PF06259,1,67,1,0,66,951,0.01,0.94,1.0,0.12,0,0,1,0,1017,0,1.0,0.0,0
PF00926,PF12471:PF07958:PF00925:PF16858:PF16869,9,18,6,3,12,997,0.33,0.99,0.67,0.47,0,0,9,0,1009,0,0.99,0.0,0
PF05587,PF05586:PF16754:PF06668:PF13757:PF12034,6,5,4,2,1,1011,0.8,1.0,0.67,0.73,0,0,6,0,1012,0,0.99,0.0,0
PF06200,PF09425:PF11891:PF04765:PF05349:PF03479,12,24,11,1,13,993,0.46,0.99,0.92,0.64,1,1,11,0,1006,1.0,0.99,0.08,0.29
PF16686,PF02765:PF03315:PF07171:PF16853:PF07923,3,21,3,0,18,997,0.14,0.98,1.0,0.37,1,0,3,1,1014,0.0,1.0,0.0,-0.0
PF12419,PF10532:PF03108:PF04434:PF10551:PF03101,2,69,2,0,67,949,0.03,0.93,1.0,0.16,17,2,0,15,1001,0.12,0.99,1.0,0.34
PF03030,PF01559:PF07712:PF03331:PF00407:PF07168,12,11,4,8,7,999,0.36,0.99,0.33,0.34,0,0,12,0,1006,0,0.99,0.0,0
PF10174,PF09457:PF08172:PF10195:PF05811:PF15011,10,19,2,8,17,991,0.11,0.98,0.2,0.13,1,1,9,0,1008,1.0,0.99,0.1,0.31
PF08082,PF10598:PF10597:PF10596:PF08083:PF12134,13,18,13,0,5,1000,0.72,1.0,1.0,0.85,15,13,0,2,1003,0.87,1.0,1.0,0.93
PF10454,PF06695:PF15062:PF02427:PF02393:PF09690,0,0,0,0,0,1018,0,1.0,0,0,0,0,0,0,1018,0,1.0,0,0
PF15142,PF03819:PF15809:PF15036:PF00770:PF05355,2,6,1,1,5,1011,0.17,0.99,0.5,0.29,0,0,2,0,1016,0,1.0,0.0,0
PF00467,PF11942:PF03439:PF16121:PF17136:PF08071,13,32,8,5,24,981,0.25,0.97,0.62,0.38,6,4,9,2,1003,0.67,0.99,0.31,0.45
PF07321,PF02863:PF03090:PF15662:PF01312:PF02413,0,2,0,0,2,1016,0.0,1.0,0,0,0,0,0,0,1018,0,1.0,0,0
PF01884,PF04488:PF00355:PF00940:PF04840:PF00185,1,82,0,1,82,935,0.0,0.92,0.0,-0.01,8,0,1,8,1009,0.0,0.99,0.0,-0.0
PF12911,PF02951:PF12299:PF15319:PF04999:PF14983,4,7,1,3,6,1008,0.14,0.99,0.25,0.18,0,0,4,0,1014,0,1.0,0.0,0
PF11822,PF12516:PF15326:PF02200:PF15678:PF14545,7,4,1,6,3,1008,0.25,0.99,0.14,0.18,0,0,7,0,1011,0,0.99,0.0,0
PF04384,PF02072:PF17053:PF15097:PF14512:PF01303,0,1,0,0,1,1017,0.0,1.0,0,0,0,0,0,0,1018,0,1.0,0,0
PF03088,PF13506:PF01758:PF03662:PF04884:PF07542,14,46,7,7,39,965,0.15,0.95,0.5,0.26,3,2,12,1,1003,0.67,0.99,0.14,0.3
PF05760,PF10488:PF10472:PF15374:PF14047:PF14049,0,1,0,0,1,1017,0.0,1.0,0,0,0,0,0,0,1018,0,1.0,0,0
PF01666,PF04562:PF12628:PF04370:PF16008:PF15032,0,0,0,0,0,1018,0,1.0,0,0,0,0,0,0,1018,0,1.0,0,0
PF14225,PF14222:PF14228:PF16206:PF11919:PF16507,6,23,6,0,17,995,0.26,0.98,1.0,0.51,1,1,5,0,1012,1.0,1.0,0.17,0.41
PF03653,PF00986:PF00204:PF12155:PF06467:PF07887,0,29,0,0,29,989,0.0,0.97,0,0,4,0,0,4,1014,0.0,1.0,0,0
PF04305,PF08802:PF00848:PF01180:PF14721:PF08417,9,40,7,2,33,976,0.17,0.97,0.78,0.36,3,3,6,0,1009,1.0,0.99,0.33,0.58
PF07522,PF13691:PF04516:PF15996:PF00568:PF08243,21,45,9,12,36,961,0.2,0.95,0.43,0.27,5,3,18,2,995,0.6,0.98,0.14,0.29
PF07786,PF16401:PF01458:PF06237:PF09949:PF16692,5,16,3,2,13,1000,0.19,0.99,0.6,0.33,0,0,5,0,1013,0,1.0,0.0,0
PF06206,PF07172:PF06373:PF02681:PF06697:PF10681,1,10,1,0,9,1008,0.1,0.99,1.0,0.31,0,0,1,0,1017,0,1.0,0.0,0
PF12313,PF11900:PF09494:PF13606:PF00651:PF16553,4,153,4,0,149,865,0.03,0.85,1.0,0.15,7,3,1,4,1010,0.43,1.0,0.75,0.56
PF01230,PF01177:PF01491:PF00795:PF01198:PF02416,28,67,15,13,52,938,0.22,0.94,0.54,0.32,5,4,24,1,989,0.8,0.98,0.14,0.33
PF03423,PF16338:PF16863:PF17137:PF13802:PF00088,3,37,3,0,34,981,0.08,0.97,1.0,0.28,8,2,1,6,1009,0.25,0.99,0.67,0.41
PF09163,PF13247:PF14842:PF03406:PF16325:PF14841,0,2,0,0,2,1016,0.0,1.0,0,0,0,0,0,0,1018,0,1.0,0,0
PF04895,PF00626:PF08024:PF11392:PF03107:PF00862,0,57,0,0,57,961,0.0,0.94,0,0,3,0,0,3,1015,0.0,1.0,0,0
PF12351,PF09056:PF03576:PF12716:PF11029:PF08738,3,6,0,3,6,1009,0.0,0.99,0.0,-0.0,0,0,3,0,1015,0,1.0,0.0,0
PF13186,PF13597:PF12345:PF06969:PF08608:PF06968,13,19,4,9,15,990,0.21,0.98,0.31,0.24,2,2,11,0,1005,1.0,0.99,0.15,0.39
PF15184,PF15776:PF11210:PF04911:PF15207:PF02565,1,5,0,1,5,1012,0.0,0.99,0.0,-0.0,0,0,1,0,1017,0,1.0,0.0,0
PF15916,PF09297:PF14803:PF09296:PF05026:PF10169,4,21,4,0,17,997,0.19,0.98,1.0,0.43,3,1,3,2,1012,0.33,1.0,0.25,0.29
PF15066,PF10506:PF11496:PF17045:PF15368:PF11559,0,20,0,0,20,998,0.0,0.98,0,0,0,0,0,0,1018,0,1.0,0,0
PF11022,PF03401:PF11697:PF08497:PF01514:PF01668,0,3,0,0,3,1015,0.0,1.0,0,0,0,0,0,0,1018,0,1.0,0,0
PF00567,PF13871:PF12872:PF00565:PF17182:PF16093,33,31,12,21,19,966,0.39,0.96,0.36,0.35,3,3,30,0,985,1.0,0.97,0.09,0.3
PF06028,PF06718:PF17076:PF16966:PF10106:PF15424,3,1,0,3,1,1014,0.0,1.0,0.0,-0.0,0,0,3,0,1015,0,1.0,0.0,0
PF11751,PF03090:PF07157:PF13742:PF07409:PF13722,0,2,0,0,2,1016,0.0,1.0,0,0,0,0,0,0,1018,0,1.0,0,0
PF08536,PF07011:PF09366:PF10775:PF01922:PF10310,4,14,2,2,12,1002,0.14,0.99,0.5,0.26,0,0,4,0,1014,0,1.0,0.0,0
PF10534,PF06663:PF09246:PF00536:PF14847:PF04629,2,65,2,0,63,953,0.03,0.94,1.0,0.17,4,1,1,3,1013,0.25,1.0,0.5,0.35
PF00013,PF16274:PF16544:PF08067:PF16568:PF12072,72,8,8,64,0,946,1.0,0.94,0.11,0.32,1,1,71,0,946,1.0,0.93,0.01,0.11
PF02784,PF00278:PF01536:PF00481:PF04406:PF00856,19,156,17,2,139,860,0.11,0.86,0.89,0.28,18,8,11,10,989,0.44,0.98,0.42,0.42
PF06831,PF09292:PF17219:PF01149:PF16764:PF15250,16,11,9,7,2,1000,0.82,0.99,0.56,0.67,1,1,15,0,1002,1.0,0.99,0.06,0.25
PF15070,PF10226:PF15921:PF15301:PF10998:PF11831,1,20,0,1,20,997,0.0,0.98,0.0,-0.0,0,0,1,0,1017,0,1.0,0.0,0
PF14344,PF07505:PF04671:PF05939:PF06505:PF04740,0,1,0,0,1,1017,0.0,1.0,0,0,0,0,0,0,1018,0,1.0,0,0
PF00579,PF16714:PF01588:PF00849:PF04757:PF00458,41,74,21,20,53,924,0.28,0.93,0.51,0.35,14,10,31,4,973,0.71,0.97,0.24,0.4
PF07039,PF01980:PF04706:PF09282:PF02470:PF14769,9,15,3,6,12,997,0.2,0.98,0.33,0.25,0,0,9,0,1009,0,0.99,0.0,0
PF03590,PF15216:PF14985:PF02087:PF01809:PF05355,4,8,0,4,8,1006,0.0,0.99,0.0,-0.01,0,0,4,0,1014,0,1.0,0.0,0
PF08520,PF07382:PF10563:PF03588:PF07448:PF15333,1,5,0,1,5,1012,0.0,0.99,0.0,-0.0,0,0,1,0,1017,0,1.0,0.0,0
PF13202,PF13833:PF13405:PF00036:PF13499:PF16166,68,149,56,12,93,857,0.38,0.9,0.82,0.51,29,26,42,3,947,0.9,0.96,0.38,0.57
PF12837,PF00950:PF11953:PF16590:PF07338:PF02056,0,15,0,0,15,1003,0.0,0.99,0,0,0,0,0,0,1018,0,1.0,0,0
PF16282,PF14958:PF07572:PF06239:PF04280:PF10253,7,19,4,3,15,996,0.21,0.98,0.57,0.34,0,0,7,0,1011,0,0.99,0.0,0
PF05663,PF07757:PF10360:PF10394:PF04981:PF12627,0,31,0,0,31,987,0.0,0.97,0,0,3,0,0,3,1015,0.0,1.0,0,0
PF16114,PF00549:PF08442:PF02629:PF06971:PF07850,5,40,5,0,35,978,0.12,0.97,1.0,0.35,7,5,0,2,1011,0.71,1.0,1.0,0.84
PF13581,PF02329:PF11386:PF02420:PF02392:PF07276,0,9,0,0,9,1009,0.0,0.99,0,0,0,0,0,0,1018,0,1.0,0,0
PF01504,PF00118:PF10247:PF09794:PF01363:PF00610,40,121,25,15,96,882,0.21,0.89,0.62,0.32,17,12,28,5,973,0.71,0.97,0.3,0.45
PF04096,PF12110:PF13634:PF14636:PF14638:PF09743,11,29,11,0,18,989,0.38,0.98,1.0,0.61,3,1,10,2,1005,0.33,0.99,0.09,0.17
PF13967,PF02714:PF14703:PF12621:PF08064:PF15149,22,28,22,0,6,990,0.79,0.99,1.0,0.88,10,10,12,0,996,1.0,0.99,0.45,0.67
PF13965,PF08445:PF07801:PF08652:PF06237:PF14521,4,24,3,1,21,993,0.12,0.98,0.75,0.3,0,0,4,0,1014,0,1.0,0.0,0
PF04706,PF01980:PF09496:PF03908:PF05837:PF02083,7,17,5,2,12,999,0.29,0.99,0.71,0.45,1,1,6,0,1011,1.0,0.99,0.14,0.38
PF13443,PF03238:PF14258:PF08258:PF09074:PF01514,1,0,0,1,0,1017,0,1.0,0.0,0,0,0,1,0,1017,0,1.0,0.0,0
PF16059,PF07001:PF16501:PF15557:PF05715:PF16529,5,11,1,4,10,1003,0.09,0.99,0.2,0.13,1,0,5,1,1012,0.0,0.99,0.0,-0.0
PF09402,PF08198:PF12949:PF04153:PF11560:PF09729,13,26,11,2,15,990,0.42,0.98,0.85,0.59,3,3,10,0,1005,1.0,0.99,0.23,0.48
PF07777,PF12498:PF02173:PF03957:PF11786:PF08601,2,11,2,0,9,1007,0.18,0.99,1.0,0.42,2,2,0,0,1016,1.0,1.0,1.0,1.0
PF17061,PF03745:PF06592:PF15185:PF02951:PF16590,0,8,0,0,8,1010,0.0,0.99,0,0,0,0,0,0,1018,0,1.0,0,0
PF15252,PF01415:PF01387:PF15551:PF01959:PF15741,0,6,0,0,6,1012,0.0,0.99,0,0,0,0,0,0,1018,0,1.0,0,0
PF00280,PF06404:PF14941:PF05216:PF05562:PF07712,11,10,1,10,9,998,0.1,0.98,0.09,0.09,0,0,11,0,1007,0,0.99,0.0,0
PF12590,PF01643:PF14767:PF08523:PF03766:PF02751,1,20,1,0,19,998,0.05,0.98,1.0,0.22,0,0,1,0,1017,0,1.0,0.0,0
PF03285,PF14802:PF15301:PF09496:PF06384:PF00836,0,21,0,0,21,997,0.0,0.98,0,0,0,0,0,0,1018,0,1.0,0,0
PF08669,PF01571:PF10170:PF16350:PF01266:PF16901,25,77,23,2,54,939,0.3,0.94,0.92,0.51,12,11,14,1,992,0.92,0.99,0.44,0.63
PF00363,PF07139:PF07800:PF02186:PF07260:PF15806,1,23,0,1,23,994,0.0,0.98,0.0,-0.0,0,0,1,0,1017,0,1.0,0.0,0
PF01216,PF02267:PF05283:PF12301:PF02422:PF07062,5,11,2,3,9,1004,0.18,0.99,0.4,0.26,0,0,5,0,1013,0,1.0,0.0,0
PF10058,PF10217:PF11282:PF07052:PF10595:PF11250,7,17,1,6,16,995,0.06,0.98,0.14,0.08,0,0,7,0,1011,0,0.99,0.0,0
PF02675,PF08411:PF17060:PF14251:PF07476:PF02501,3,6,0,3,6,1009,0.0,0.99,0.0,-0.0,0,0,3,0,1015,0,1.0,0.0,0
PF01156,PF00797:PF05212:PF00793:PF02736:PF01496,21,53,13,8,40,957,0.25,0.95,0.62,0.37,7,5,16,2,995,0.71,0.98,0.24,0.41
PF00389,PF01842:PF02826:PF10369:PF00351:PF01817,49,64,26,23,38,931,0.41,0.94,0.53,0.43,5,4,45,1,968,0.8,0.95,0.08,0.25
PF07217,PF16019:PF15279:PF16944:PF06058:PF10033,6,10,2,4,8,1004,0.2,0.99,0.33,0.25,0,0,6,0,1012,0,0.99,0.0,0
PF03913,PF13629:PF03739:PF09493:PF06131:PF15080,0,8,0,0,8,1010,0.0,0.99,0,0,0,0,0,0,1018,0,1.0,0,0
PF08818,PF02369:PF15155:PF13211:PF17053:PF15750,0,5,0,0,5,1013,0.0,1.0,0,0,0,0,0,0,1018,0,1.0,0,0
PF01531,PF04901:PF09631:PF10218:PF01632:PF10224,4,19,0,4,19,995,0.0,0.98,0.0,-0.01,0,0,4,0,1014,0,1.0,0.0,0
PF05849,PF04451:PF09826:PF04355:PF05202:PF07157,0,3,0,0,3,1015,0.0,1.0,0,0,0,0,0,0,1018,0,1.0,0,0
PF01776,PF12020:PF00272:PF09777:PF11779:PF02372,6,9,1,5,8,1004,0.11,0.99,0.17,0.13,0,0,6,0,1012,0,0.99,0.0,0
PF12657,PF09453:PF15787:PF12234:PF13271:PF15512,8,28,2,6,26,984,0.07,0.97,0.25,0.12,1,1,7,0,1010,1.0,0.99,0.12,0.35
PF07130,PF05488:PF13675:PF16670:PF13482:PF03976,0,3,0,0,3,1015,0.0,1.0,0,0,0,0,0,0,1018,0,1.0,0,0
PF08278,PF13612:PF03065:PF04472:PF07769:PF09614,4,4,1,3,3,1011,0.25,0.99,0.25,0.25,0,0,4,0,1014,0,1.0,0.0,0
PF06609,PF11700:PF00296:PF04479:PF11807:PF03211,12,44,9,3,35,971,0.2,0.96,0.75,0.38,7,5,7,2,1004,0.71,0.99,0.42,0.54
PF02199,PF03489:PF05184:PF03227:PF14863:PF14864,2,24,1,1,23,993,0.04,0.98,0.5,0.14,4,0,2,4,1012,0.0,0.99,0.0,-0.0
PF10536,PF03108:PF04434:PF10551:PF09331:PF03101,22,69,15,7,54,942,0.22,0.94,0.68,0.36,17,8,14,9,987,0.47,0.98,0.36,0.4
PF11347,PF15085:PF15333:PF15212:PF11057:PF05151,1,2,0,1,2,1015,0.0,1.0,0.0,-0.0,0,0,1,0,1017,0,1.0,0.0,0
PF15233,PF11291:PF05685:PF08651:PF10375:PF09447,4,4,0,4,4,1010,0.0,0.99,0.0,-0.0,0,0,4,0,1014,0,1.0,0.0,0
PF08244,PF00251:PF11837:PF16346:PF16352:PF02018,13,22,13,0,9,996,0.59,0.99,1.0,0.77,0,0,13,0,1005,0,0.99,0.0,0
PF16980,PF05944:PF04849:PF15270:PF12448:PF13600,0,7,0,0,7,1011,0.0,0.99,0,0,0,0,0,0,1018,0,1.0,0,0
PF03520,PF16799:PF11956:PF08412:PF03521:PF03493,8,20,5,3,15,995,0.25,0.98,0.62,0.39,1,1,7,0,1010,1.0,0.99,0.12,0.35
PF09107,PF09106:PF16658:PF09173:PF14492:PF08364,3,38,3,0,35,980,0.08,0.97,1.0,0.28,2,2,1,0,1015,1.0,1.0,0.67,0.82
PF09931,PF09444:PF09967:PF10407:PF03389:PF01430,1,4,0,1,4,1013,0.0,1.0,0.0,-0.0,0,0,1,0,1017,0,1.0,0.0,0
PF13239,PF13811:PF00055:PF01672:PF02545:PF06009,0,38,0,0,38,980,0.0,0.96,0,0,0,0,0,0,1018,0,1.0,0,0
PF11034,PF04355:PF06798:PF11751:PF07157:PF04954,4,0,0,4,0,1014,0,1.0,0.0,0,0,0,4,0,1014,0,1.0,0.0,0
PF06870,PF05995:PF04176:PF02284:PF02098:PF05719,9,25,3,6,22,987,0.12,0.97,0.33,0.19,2,0,9,2,1007,0.0,0.99,0.0,-0.0
PF09030,PF08214:PF02135:PF06001:PF12744:PF02172,11,26,9,2,17,990,0.35,0.98,0.82,0.53,12,8,3,4,1003,0.67,0.99,0.73,0.69
PF07303,PF01284:PF10390:PF12886:PF12884:PF11560,10,34,10,0,24,984,0.29,0.98,1.0,0.54,2,2,8,0,1008,1.0,0.99,0.2,0.45
PF02899,PF13356:PF09003:PF13276:PF02022:PF07245,6,17,2,4,15,997,0.12,0.98,0.33,0.19,1,1,5,0,1012,1.0,1.0,0.17,0.41
PF07678,PF07703:PF01835:PF10569:PF07677:PF00207,15,21,15,0,6,997,0.71,0.99,1.0,0.84,12,12,3,0,1003,1.0,1.0,0.8,0.89
PF16684,PF16457:PF01661:PF10923:PF01365:PF17058,0,42,0,0,42,976,0.0,0.96,0,0,4,0,0,4,1014,0.0,1.0,0,0
PF13778,PF05572:PF08433:PF13914:PF05781:PF15501,1,30,1,0,29,988,0.03,0.97,1.0,0.18,1,0,1,1,1016,0.0,1.0,0.0,-0.0
PF16714,PF01588:PF00579:PF14732:PF00458:PF04615,5,70,5,0,65,948,0.07,0.94,1.0,0.26,9,3,2,6,1007,0.33,0.99,0.6,0.44
PF10868,PF17032:PF15699:PF10716:PF16851:PF02427,0,1,0,0,1,1017,0.0,1.0,0,0,0,0,0,0,1018,0,1.0,0,0
PF07970,PF06201:PF01359:PF11025:PF14811:PF15928,15,57,8,7,49,954,0.14,0.94,0.53,0.25,1,1,14,0,1003,1.0,0.99,0.07,0.26
PF07277,PF07367:PF05633:PF10508:PF13648:PF09446,0,19,0,0,19,999,0.0,0.98,0,0,0,0,0,0,1018,0,1.0,0,0
PF03972,PF14027:PF05995:PF06172:PF10455:PF02284,7,27,3,4,24,987,0.11,0.97,0.43,0.21,2,1,6,1,1010,0.5,0.99,0.14,0.26
PF06873,PF04820:PF07645:PF08119:PF03931:PF07679,0,126,0,0,126,892,0.0,0.88,0,0,13,0,0,13,1005,0.0,0.99,0,0
PF12431,PF01339:PF12532:PF02645:PF05231:PF09904,0,8,0,0,8,1010,0.0,0.99,0,0,0,0,0,0,1018,0,1.0,0,0
PF14626,PF07199:PF05337:PF15696:PF13810:PF15759,1,3,0,1,3,1014,0.0,1.0,0.0,-0.0,0,0,1,0,1017,0,1.0,0.0,0
PF17106,PF12200:PF17046:PF17111:PF10423:PF07367,3,23,3,0,20,995,0.13,0.98,1.0,0.36,0,0,3,0,1015,0,1.0,0.0,0
PF10260,PF01599:PF10213:PF15810:PF08643:PF14610,2,21,1,1,20,996,0.05,0.98,0.5,0.15,1,0,2,1,1015,0.0,1.0,0.0,-0.0
PF12764,PF13876:PF07494:PF13721:PF12461:PF07391,5,5,0,5,5,1008,0.0,0.99,0.0,-0.0,0,0,5,0,1013,0,1.0,0.0,0
PF05869,PF02160:PF15435:PF03539:PF10917:PF13326,3,3,0,3,3,1012,0.0,0.99,0.0,-0.0,0,0,3,0,1015,0,1.0,0.0,0
PF02755,PF04589:PF06333:PF09750:PF09815:PF10744,8,38,4,4,34,976,0.11,0.96,0.5,0.22,2,1,7,1,1009,0.5,0.99,0.12,0.25
PF08250,PF10322:PF05181:PF01865:PF05835:PF05694,0,17,0,0,17,1001,0.0,0.98,0,0,0,0,0,0,1018,0,1.0,0,0
PF06758,PF05911:PF00836:PF03470:PF03253:PF06470,3,28,1,2,27,988,0.04,0.97,0.33,0.1,1,0,3,1,1014,0.0,1.0,0.0,-0.0
PF01450,PF07991:PF08622:PF17187:PF02744:PF06807,11,27,8,3,19,988,0.3,0.98,0.73,0.46,1,0,11,1,1006,0.0,0.99,0.0,-0.0
PF04924,PF01540:PF01504:PF14399:PF13198:PF10796,0,45,0,0,45,973,0.0,0.96,0,0,0,0,0,0,1018,0,1.0,0,0
PF16978,PF05422:PF16979:PF10348:PF12448:PF16070,13,28,10,3,18,987,0.36,0.98,0.77,0.52,2,1,12,1,1004,0.5,0.99,0.08,0.19
PF10490,PF13005:PF16588:PF10375:PF11291:PF15453,4,3,0,4,3,1011,0.0,0.99,0.0,-0.0,0,0,4,0,1014,0,1.0,0.0,0
PF03177,PF08801:PF05593:PF03511:PF15979:PF12742,15,30,14,1,16,987,0.47,0.98,0.93,0.65,0,0,15,0,1003,0,0.99,0.0,0
PF03657,PF01097:PF08641:PF03911:PF15359:PF03980,8,17,3,5,14,996,0.18,0.98,0.38,0.25,1,1,7,0,1010,1.0,0.99,0.12,0.35
PF05092,PF05787:PF09798:PF04349:PF04285:PF16449,0,0,0,0,0,1018,0,1.0,0,0,0,0,0,0,1018,0,1.0,0,0
PF00019,PF00688:PF10156:PF09771:PF01755:PF15280,20,28,16,4,12,986,0.57,0.98,0.8,0.67,0,0,20,0,998,0,0.98,0.0,0
PF02690,PF04261:PF07837:PF01858:PF04961:PF14700,8,28,6,2,22,988,0.21,0.98,0.75,0.39,2,1,7,1,1009,0.5,0.99,0.12,0.25
PF03315,PF03313:PF07171:PF05683:PF06742:PF02278,4,15,4,0,11,1003,0.27,0.99,1.0,0.51,0,0,4,0,1014,0,1.0,0.0,0
PF16070,PF15705:PF15706:PF16978:PF12448:PF00963,11,23,9,2,14,993,0.39,0.98,0.82,0.56,0,0,11,0,1007,0,0.99,0.0,0
PF14416,PF13839:PF13824:PF16401:PF09949:PF14441,16,33,16,0,17,985,0.48,0.98,1.0,0.69,1,1,15,0,1002,1.0,0.99,0.06,0.25
PF05170,PF13502:PF02604:PF10116:PF17010:PF05673,1,1,0,1,1,1016,0.0,1.0,0.0,-0.0,0,0,1,0,1017,0,1.0,0.0,0
PF06902,PF03428:PF11245:PF01514:PF05232:PF15186,0,1,0,0,1,1017,0.0,1.0,0,0,0,0,0,0,1018,0,1.0,0,0
PF05586,PF16754:PF05587:PF02743:PF06668:PF14624,2,26,2,0,24,992,0.08,0.98,1.0,0.27,1,0,2,1,1015,0.0,1.0,0.0,-0.0
PF06567,PF06566:PF10630:PF15467:PF05111:PF15064,1,4,1,0,3,1014,0.25,1.0,1.0,0.5,0,0,1,0,1017,0,1.0,0.0,0
PF13383,PF05405:PF00210:PF06083:PF07722:PF05609,7,21,1,6,20,991,0.05,0.97,0.14,0.07,2,1,6,1,1010,0.5,0.99,0.14,0.26
PF10540,PF06292:PF08150:PF08165:PF16165:PF16056,9,22,6,3,16,993,0.27,0.98,0.67,0.42,3,3,6,0,1009,1.0,0.99,0.33,0.58
PF01807,PF08275:PF09327:PF08411:PF15518:PF08479,6,6,4,2,2,1010,0.67,1.0,0.67,0.66,0,0,6,0,1012,0,0.99,0.0,0
PF13906,PF13520:PF00154:PF02727:PF12036:PF02728,18,88,17,1,71,929,0.19,0.93,0.94,0.41,11,5,13,6,994,0.45,0.98,0.28,0.35
PF02724,PF16901:PF16350:PF01266:PF01221:PF00435,8,104,7,1,97,913,0.07,0.9,0.88,0.23,13,4,4,9,1001,0.31,0.99,0.5,0.39
PF03345,PF04756:PF04527:PF02284:PF01264:PF05995,13,23,6,7,17,988,0.26,0.98,0.46,0.34,3,3,10,0,1005,1.0,0.99,0.23,0.48
PF00349,PF03727:PF09764:PF06880:PF04833:PF05023,20,33,20,0,13,985,0.61,0.99,1.0,0.77,1,1,19,0,998,1.0,0.98,0.05,0.22
PF02756,PF02757:PF00353:PF10937:PF10685:PF17054,0,11,0,0,11,1007,0.0,0.99,0,0,0,0,0,0,1018,0,1.0,0,0
PF06005,PF11658:PF02137:PF13305:PF00035:PF16984,0,58,0,0,58,960,0.0,0.94,0,0,1,0,0,1,1017,0.0,1.0,0,0
PF01025,PF01871:PF03637:PF04759:PF01786:PF00829,15,38,7,8,31,972,0.18,0.96,0.47,0.28,4,1,14,3,1000,0.25,0.98,0.07,0.12
PF04053,PF06957:PF15512:PF04192:PF07569:PF12657,24,31,14,10,17,977,0.45,0.97,0.58,0.5,4,4,20,0,994,1.0,0.98,0.17,0.4
PF15238,PF15374:PF15302:PF16829:PF09303:PF03306,1,8,0,1,8,1009,0.0,0.99,0.0,-0.0,0,0,1,0,1017,0,1.0,0.0,0
PF05140,PF09425:PF00925:PF04111:PF08692:PF15285,3,25,2,1,23,992,0.08,0.98,0.67,0.23,2,0,3,2,1013,0.0,1.0,0.0,-0.0
PF12166,PF15917:PF16399:PF11935:PF12842:PF16415,9,31,7,2,24,985,0.23,0.97,0.78,0.41,2,2,7,0,1009,1.0,0.99,0.22,0.47
PF16054,PF11032:PF06907:PF13933:PF15831:PF15063,4,5,2,2,3,1011,0.4,1.0,0.5,0.44,0,0,4,0,1014,0,1.0,0.0,0
PF16201,PF11707:PF08696:PF15277:PF11915:PF08427,3,37,2,1,35,980,0.05,0.96,0.67,0.18,2,1,2,1,1014,0.5,1.0,0.33,0.41
PF10261,PF02560:PF00590:PF04790:PF09807:PF14823,3,28,1,2,27,988,0.04,0.97,0.33,0.1,2,0,3,2,1013,0.0,1.0,0.0,-0.0
PF10471,PF02044:PF10310:PF04852:PF08649:PF10775,6,6,2,4,4,1008,0.33,0.99,0.33,0.33,0,0,6,0,1012,0,0.99,0.0,0
PF08014,PF05841:PF15696:PF15257:PF15774:PF04988,1,6,1,0,5,1012,0.17,1.0,1.0,0.41,0,0,1,0,1017,0,1.0,0.0,0
PF07909,PF05295:PF10630:PF15722:PF10285:PF15015,0,0,0,0,0,1018,0,1.0,0,0,0,0,0,0,1018,0,1.0,0,0
PF11960,PF08557:PF00173:PF10559:PF01070:PF13875,2,103,0,2,103,913,0.0,0.9,0.0,-0.01,6,0,2,6,1010,0.0,0.99,0.0,-0.0
PF09669,PF01312:PF15727:PF02413:PF04466:PF03244,1,0,0,1,0,1017,0,1.0,0.0,0,0,0,1,0,1017,0,1.0,0.0,0
PF16286,PF11764:PF10691:PF07023:PF08236:PF14452,0,19,0,0,19,999,0.0,0.98,0,0,0,0,0,0,1018,0,1.0,0,0
PF04727,PF11841:PF16457:PF07763:PF00388:PF02513,16,30,10,6,20,982,0.33,0.97,0.62,0.44,4,4,12,0,1002,1.0,0.99,0.25,0.5
PF00358,PF06780:PF10662:PF05128:PF03123:PF15086,9,6,4,5,2,1007,0.67,0.99,0.44,0.54,1,1,8,0,1009,1.0,0.99,0.11,0.33
PF05782,PF08444:PF08426:PF12904:PF15302:PF15718,2,4,0,2,4,1012,0.0,0.99,0.0,-0.0,0,0,2,0,1016,0,1.0,0.0,0
PF13729,PF09394:PF17026:PF06224:PF05317:PF04986,0,2,0,0,2,1016,0.0,1.0,0,0,0,0,0,0,1018,0,1.0,0,0
PF05690,PF02589:PF11870:PF02901:PF13404:PF02604,6,15,3,3,12,1000,0.2,0.99,0.5,0.31,1,1,5,0,1012,1.0,1.0,0.17,0.41
PF10834,PF13844:PF14821:PF01566:PF17016:PF03711,0,41,0,0,41,977,0.0,0.96,0,0,0,0,0,0,1018,0,1.0,0,0
PF02344,PF01056:PF11851:PF09427:PF01586:PF12232,5,15,4,1,11,1002,0.27,0.99,0.8,0.46,1,1,4,0,1013,1.0,1.0,0.2,0.45
PF08189,PF00451:PF09252:PF12201:PF02087:PF16647,0,4,0,0,4,1014,0.0,1.0,0,0,0,0,0,0,1018,0,1.0,0,0
PF08391,PF03954:PF09006:PF06023:PF09064:PF16754,1,3,1,0,2,1015,0.33,1.0,1.0,0.58,0,0,1,0,1017,0,1.0,0.0,0
PF03601,PF05874:PF08642:PF15553:PF03749:PF03544,0,7,0,0,7,1011,0.0,0.99,0,0,0,0,0,0,1018,0,1.0,0,0
PF16829,PF15872:PF15398:PF17085:PF04232:PF15234,0,4,0,0,4,1014,0.0,1.0,0,0,0,0,0,0,1018,0,1.0,0,0
PF00505,PF09011:PF13017:PF08347:PF13775:PF16090,61,21,19,42,2,955,0.9,0.96,0.31,0.52,0,0,61,0,957,0,0.94,0.0,0
PF11046,PF06923:PF01802:PF15034:PF03473:PF05973,0,17,0,0,17,1001,0.0,0.98,0,0,0,0,0,0,1018,0,1.0,0,0
PF04880,PF11831:PF13870:PF15934:PF14922:PF10226,3,18,2,1,16,999,0.11,0.98,0.67,0.27,1,0,3,1,1014,0.0,1.0,0.0,-0.0
PF04134,PF06232:PF06127:PF12734:PF09754:PF12023,9,15,3,6,12,997,0.2,0.98,0.33,0.25,1,1,8,0,1009,1.0,0.99,0.11,0.33
PF12040,PF12679:PF12256:PF04917:PF04355:PF07494,0,2,0,0,2,1016,0.0,1.0,0,0,0,0,0,0,1018,0,1.0,0,0
PF11567,PF03934:PF14849:PF05134:PF13557:PF02501,0,8,0,0,8,1010,0.0,0.99,0,0,1,0,0,1,1017,0.0,1.0,0,0
PF01159,PF03868:PF01733:PF01281:PF14693:PF06736,19,34,11,8,23,976,0.32,0.97,0.58,0.42,3,3,16,0,999,1.0,0.98,0.16,0.39
PF11855,PF10467:PF07905:PF09827:PF16784:PF06178,2,1,0,2,1,1015,0.0,1.0,0.0,-0.0,0,0,2,0,1016,0,1.0,0.0,0
PF03193,PF05991:PF12049:PF15342:PF07223:PF02576,5,8,1,4,7,1006,0.12,0.99,0.2,0.15,0,0,5,0,1013,0,1.0,0.0,0
PF07271,PF15400:PF06122:PF09684:PF08505:PF11363,0,2,0,0,2,1016,0.0,1.0,0,0,0,0,0,0,1018,0,1.0,0,0
PF17203,PF09239:PF08918:PF07730:PF02767:PF00015,5,24,1,4,23,990,0.04,0.97,0.2,0.08,1,0,5,1,1012,0.0,0.99,0.0,-0.0
PF05234,PF03974:PF17015:PF03816:PF08497:PF05939,1,3,0,1,3,1014,0.0,1.0,0.0,-0.0,0,0,1,0,1017,0,1.0,0.0,0
PF13269,PF15518:PF04552:PF08479:PF03241:PF03090,0,2,0,0,2,1016,0.0,1.0,0,0,0,0,0,0,1018,0,1.0,0,0
PF12209,PF07243:PF03831:PF04993:PF04284:PF09611,0,0,0,0,0,1018,0,1.0,0,0,0,0,0,0,1018,0,1.0,0,0
PF10246,PF15013:PF14935:PF06388:PF04201:PF02046,9,10,1,8,9,1000,0.1,0.98,0.11,0.1,0,0,9,0,1009,0,0.99,0.0,0
PF09088,PF09090:PF02854:PF02847:PF10573:PF04050,11,39,11,0,28,979,0.28,0.97,1.0,0.52,8,6,5,2,1005,0.75,0.99,0.55,0.64
PF09967,PF11672:PF06586:PF09444:PF01430:PF05100,2,4,2,0,2,1014,0.5,1.0,1.0,0.71,0,0,2,0,1016,0,1.0,0.0,0
PF04179,PF17184:PF08369:PF09363:PF16335:PF02326,3,12,3,0,9,1006,0.25,0.99,1.0,0.5,1,1,2,0,1015,1.0,1.0,0.33,0.58
PF07002,PF16056:PF08151:PF16165:PF08372:PF15625,24,21,7,17,14,980,0.33,0.97,0.29,0.3,1,1,23,0,994,1.0,0.98,0.04,0.2
PF00123,PF16680:PF02189:PF11628:PF05608:PF03868,7,21,2,5,19,992,0.1,0.98,0.29,0.16,2,0,7,2,1009,0.0,0.99,0.0,-0.0
PF10815,PF06751:PF09951:PF16325:PF12843:PF03428,0,2,0,0,2,1016,0.0,1.0,0,0,0,0,0,0,1018,0,1.0,0,0
PF07177,PF12610:PF00186:PF00723:PF07525:PF07998,10,46,7,3,39,969,0.15,0.96,0.7,0.31,3,2,8,1,1007,0.67,0.99,0.2,0.36
PF12483,PF01980:PF13225:PF04706:PF03908:PF11789,3,17,1,2,16,999,0.06,0.98,0.33,0.13,4,0,3,4,1011,0.0,0.99,0.0,-0.0
PF12464,PF14602:PF06426:PF13720:PF04613:PF01050,14,42,10,4,32,972,0.24,0.96,0.71,0.4,2,2,12,0,1004,1.0,0.99,0.14,0.38
PF01235,PF02741:PF05707:PF01752:PF05401:PF07218,4,4,0,4,4,1010,0.0,0.99,0.0,-0.0,0,0,4,0,1014,0,1.0,0.0,0
PF14052,PF10995:PF11272:PF06834:PF01913:PF04963,0,2,0,0,2,1016,0.0,1.0,0,0,0,0,0,0,1018,0,1.0,0,0
PF08334,PF01514:PF08479:PF08411:PF03428:PF14841,1,2,0,1,2,1015,0.0,1.0,0.0,-0.0,0,0,1,0,1017,0,1.0,0.0,0
PF02320,PF05915:PF03980:PF07114:PF09631:PF00321,13,14,3,10,11,994,0.21,0.98,0.23,0.21,1,1,12,0,1005,1.0,0.99,0.08,0.28
PF10598,PF08082:PF10597:PF10596:PF08083:PF12134,13,18,13,0,5,1000,0.72,1.0,1.0,0.85,15,13,0,2,1003,0.87,1.0,1.0,0.93
PF00547,PF00699:PF00449:PF13382:PF01979:PF03841,6,49,6,0,43,969,0.12,0.96,1.0,0.34,7,6,0,1,1011,0.86,1.0,1.0,0.93
PF05973,PF00695:PF05427:PF00047:PF15913:PF03523,0,42,0,0,42,976,0.0,0.96,0,0,1,0,0,1,1017,0.0,1.0,0,0
PF13368,PF01751:PF01131:PF00986:PF16898:PF01396,6,38,6,0,32,980,0.16,0.97,1.0,0.39,8,3,3,5,1007,0.38,0.99,0.5,0.43
PF10554,PF11751:PF13722:PF15518:PF11304:PF06826,0,2,0,0,2,1016,0.0,1.0,0,0,0,0,0,0,1018,0,1.0,0,0
PF00173,PF01070:PF11960:PF08557:PF03404:PF04172,87,56,38,49,18,913,0.68,0.93,0.44,0.51,3,3,84,0,931,1.0,0.92,0.03,0.18
PF14902,PF05762:PF06586:PF11542:PF10407:PF09967,1,7,1,0,6,1011,0.14,0.99,1.0,0.38,0,0,1,0,1017,0,1.0,0.0,0
PF14111,PF14392:PF03828:PF01107:PF03732:PF13966,57,135,48,9,87,874,0.36,0.91,0.84,0.51,20,16,41,4,957,0.8,0.96,0.28,0.46
PF01290,PF03466:PF11937:PF10261:PF02268:PF00184,4,25,1,3,24,990,0.04,0.97,0.25,0.09,1,0,4,1,1013,0.0,1.0,0.0,-0.0
PF14543,PF14541:PF00722:PF04406:PF06414:PF02536,27,93,24,3,69,922,0.26,0.93,0.89,0.46,11,8,19,3,988,0.73,0.98,0.3,0.46
PF11526,PF15912:PF07001:PF04357:PF13945:PF15914,7,10,3,4,7,1004,0.3,0.99,0.43,0.35,0,0,7,0,1011,0,0.99,0.0,0
PF10541,PF17213:PF10650:PF12297:PF07926:PF12510,5,15,1,4,14,999,0.07,0.98,0.2,0.11,0,0,5,0,1013,0,1.0,0.0,0
PF08718,PF01791:PF04178:PF06093:PF02284:PF04106,15,36,5,10,31,972,0.14,0.96,0.33,0.2,3,1,14,2,1001,0.33,0.98,0.07,0.14
PF06412,PF06134:PF11237:PF01659:PF10401:PF14106,0,11,0,0,11,1007,0.0,0.99,0,0,0,0,0,0,1018,0,1.0,0,0
PF04437,PF08318:PF16061:PF11571:PF10496:PF01928,13,34,10,3,24,981,0.29,0.97,0.77,0.47,2,1,12,1,1004,0.5,0.99,0.08,0.19
PF10607,PF13765:PF13019:PF16906:PF08513:PF03226,23,51,15,8,36,959,0.29,0.96,0.65,0.42,8,6,17,2,993,0.75,0.98,0.26,0.44
PF13600,PF09727:PF07926:PF09762:PF16471:PF17045,2,15,0,2,15,1001,0.0,0.98,0.0,-0.01,1,0,2,1,1015,0.0,1.0,0.0,-0.0
PF09469,PF12516:PF15778:PF08729:PF11822:PF15309,2,14,0,2,14,1002,0.0,0.98,0.0,-0.01,1,0,2,1,1015,0.0,1.0,0.0,-0.0
PF13971,PF15556:PF15843:PF15119:PF15623:PF15068,0,2,0,0,2,1016,0.0,1.0,0,0,0,0,0,0,1018,0,1.0,0,0
PF17220,PF03914:PF03098:PF16891:PF13423:PF05579,0,56,0,0,56,962,0.0,0.94,0,0,6,0,0,6,1012,0.0,0.99,0,0
PF04818,PF01805:PF16566:PF09750:PF08782:PF08312,29,57,20,9,37,952,0.35,0.95,0.69,0.47,9,9,20,0,989,1.0,0.98,0.31,0.55
PF01133,PF04253:PF09112:PF04481:PF07261:PF09747,3,24,2,1,22,993,0.08,0.98,0.67,0.23,0,0,3,0,1015,0,1.0,0.0,0
PF02547,PF03401:PF13333:PF07520:PF02056:PF12302,8,9,1,7,8,1002,0.11,0.99,0.12,0.11,0,0,8,0,1010,0,0.99,0.0,0
PF09290,PF08275:PF01807:PF10410:PF02132:PF16216,3,7,0,3,7,1008,0.0,0.99,0.0,-0.0,4,0,3,4,1011,0.0,0.99,0.0,-0.0
PF03860,PF07177:PF02932:PF11086:PF12853:PF07857,0,77,0,0,77,941,0.0,0.92,0,0,4,0,0,4,1014,0.0,1.0,0,0
PF13918,PF13091:PF12357:PF00614:PF08768:PF13453,6,37,5,1,32,980,0.14,0.97,0.83,0.33,5,2,4,3,1009,0.4,0.99,0.33,0.36
PF07866,PF04024:PF12738:PF12207:PF11750:PF07260,0,25,0,0,25,993,0.0,0.98,0,0,0,0,0,0,1018,0,1.0,0,0
PF02140,PF01301:PF10102:PF10435:PF02354:PF02191,31,40,16,15,24,963,0.4,0.96,0.52,0.43,2,2,29,0,987,1.0,0.97,0.06,0.25
PF03796,PF02132:PF06683:PF07364:PF07058:PF08275,12,11,5,7,6,1000,0.45,0.99,0.42,0.43,0,0,12,0,1006,0,0.99,0.0,0
PF10613,PF00497:PF00060:PF10565:PF10562:PF01321,33,69,31,2,38,947,0.45,0.96,0.94,0.63,7,6,27,1,984,0.86,0.97,0.18,0.39
PF13737,PF17188:PF01312:PF14362:PF03050:PF15212,0,0,0,0,0,1018,0,1.0,0,0,0,0,0,0,1018,0,1.0,0,0
PF02535,PF04592:PF07561:PF01184:PF03981:PF02485,57,38,17,40,21,940,0.45,0.94,0.3,0.34,2,2,55,0,961,1.0,0.95,0.04,0.18
PF04812,PF04814:PF04813:PF12360:PF03867:PF12045,3,6,3,0,3,1012,0.5,1.0,1.0,0.71,1,1,2,0,1015,1.0,1.0,0.33,0.58
PF05337,PF07199:PF14626:PF04988:PF10446:PF15918,2,7,0,2,7,1009,0.0,0.99,0.0,-0.0,0,0,2,0,1016,0,1.0,0.0,0
PF00838,PF04628:PF12680:PF14388:PF09749:PF04930,14,38,8,6,30,974,0.21,0.96,0.57,0.33,4,3,11,1,1003,0.75,0.99,0.21,0.4
PF01518,PF03422:PF16881:PF06463:PF02541:PF10288,2,36,0,2,36,980,0.0,0.96,0.0,-0.01,3,0,2,3,1013,0.0,1.0,0.0,-0.0
PF04893,PF03208:PF07896:PF00499:PF04667:PF08583,14,30,7,7,23,981,0.23,0.97,0.5,0.33,0,0,14,0,1004,0,0.99,0.0,0
PF05114,PF17010:PF06681:PF11124:PF17006:PF16011,0,2,0,0,2,1016,0.0,1.0,0,0,0,0,0,0,1018,0,1.0,0,0
PF11789,PF05191:PF12483:PF00830:PF14997:PF08698,6,28,3,3,25,987,0.11,0.97,0.5,0.22,3,2,4,1,1011,0.67,1.0,0.33,0.47
PF12470,PF05076:PF16173:PF17187:PF06746:PF02799,4,18,4,0,14,1000,0.22,0.99,1.0,0.47,1,1,3,0,1014,1.0,1.0,0.25,0.5
PF10592,PF08103:PF16566:PF12067:PF14327:PF16421,0,27,0,0,27,991,0.0,0.97,0,0,1,0,0,1,1017,0.0,1.0,0,0
PF14807,PF06375:PF14796:PF14797:PF09066:PF07718,0,15,0,0,15,1003,0.0,0.99,0,0,3,0,0,3,1015,0.0,1.0,0,0
PF17016,PF12355:PF14521:PF09240:PF06214:PF03118,0,17,0,0,17,1001,0.0,0.98,0,0,1,0,0,1,1017,0.0,1.0,0,0
PF14603,PF15442:PF15257:PF15670:PF15275:PF04988,5,12,1,4,11,1002,0.08,0.99,0.2,0.12,1,1,4,0,1013,1.0,1.0,0.2,0.45
PF06366,PF08997:PF12578:PF06440:PF00613:PF12068,0,48,0,0,48,970,0.0,0.95,0,0,1,0,0,1,1017,0.0,1.0,0,0
PF01866,PF03981:PF02636:PF03416:PF04724:PF13911,14,44,5,9,39,965,0.11,0.95,0.36,0.18,3,1,13,2,1002,0.33,0.99,0.07,0.15
PF01513,PF01758:PF03062:PF09335:PF01040:PF03556,13,84,7,6,77,928,0.08,0.92,0.54,0.19,10,6,7,4,1001,0.6,0.99,0.46,0.52
PF00583,PF13673:PF05153:PF13380:PF13508:PF04072,86,43,25,61,18,914,0.58,0.92,0.29,0.38,6,6,80,0,932,1.0,0.92,0.07,0.25
PF05925,PF06711:PF08192:PF11339:PF15307:PF13491,2,5,0,2,5,1011,0.0,0.99,0.0,-0.0,0,0,2,0,1016,0,1.0,0.0,0
PF10017,PF12867:PF03781:PF03074:PF07778:PF12735,8,21,4,4,17,993,0.19,0.98,0.5,0.3,1,1,7,0,1010,1.0,0.99,0.12,0.35
PF15119,PF14866:PF05355:PF06729:PF15212:PF15085,1,5,1,0,4,1013,0.2,1.0,1.0,0.45,0,0,1,0,1017,0,1.0,0.0,0
PF00331,PF02018:PF03664:PF16010:PF00251:PF00457,12,32,7,5,25,981,0.22,0.97,0.58,0.35,5,2,10,3,1003,0.4,0.99,0.17,0.25
PF05902,PF04382:PF11819:PF09141:PF08913:PF08736,5,26,5,0,21,992,0.19,0.98,1.0,0.43,1,1,4,0,1013,1.0,1.0,0.2,0.45
PF01730,PF08286:PF00835:PF14997:PF05267:PF09496,2,9,0,2,9,1007,0.0,0.99,0.0,-0.0,0,0,2,0,1016,0,1.0,0.0,0
PF06469,PF14844:PF15787:PF02138:PF12660:PF12657,3,42,3,0,39,976,0.07,0.96,1.0,0.26,9,1,2,8,1007,0.11,0.99,0.33,0.19
PF03613,PF14328:PF04954:PF07495:PF01943:PF08021,0,1,0,0,1,1017,0.0,1.0,0,0,0,0,0,0,1018,0,1.0,0,0
PF06842,PF09495:PF14542:PF05047:PF00213:PF06388,9,24,5,4,19,990,0.21,0.98,0.56,0.33,1,1,8,0,1009,1.0,0.99,0.11,0.33
PF00108,PF02803:PF02036:PF05768:PF02737:PF02812,43,68,38,5,30,945,0.56,0.97,0.88,0.69,9,9,34,0,975,1.0,0.97,0.21,0.45
PF03572,PF13180:PF12812:PF08144:PF03097:PF01529,17,94,13,4,81,920,0.14,0.92,0.76,0.3,7,4,13,3,998,0.57,0.98,0.24,0.36
PF11693,PF06276:PF08657:PF06449:PF14232:PF08369,2,8,0,2,8,1008,0.0,0.99,0.0,-0.0,0,0,2,0,1016,0,1.0,0.0,0
PF06972,PF07001:PF13945:PF15624:PF10482:PF05397,2,21,0,2,21,995,0.0,0.98,0.0,-0.01,0,0,2,0,1016,0,1.0,0.0,0
PF03671,PF14825:PF04691:PF13326:PF05535:PF05564,8,10,2,6,8,1002,0.2,0.99,0.25,0.22,0,0,8,0,1010,0,0.99,0.0,0
PF09441,PF15624:PF05397:PF13945:PF15407:PF15914,1,17,0,1,17,1000,0.0,0.98,0.0,-0.0,0,0,1,0,1017,0,1.0,0.0,0
PF09248,PF02727:PF02728:PF01179:PF05392:PF16353,3,33,3,0,30,985,0.09,0.97,1.0,0.3,14,3,0,11,1004,0.21,0.99,1.0,0.46
PF00530,PF01186:PF00100:PF01744:PF00051:PF00088,39,80,25,14,55,924,0.31,0.93,0.64,0.42,11,10,29,1,978,0.91,0.97,0.26,0.47
PF01846,PF16512:PF09445:PF12237:PF00639:PF06220,20,53,16,4,37,961,0.3,0.96,0.8,0.48,2,2,18,0,998,1.0,0.98,0.1,0.31
PF04831,PF09756:PF07809:PF02291:PF15298:PF01705,4,17,2,2,15,999,0.12,0.98,0.5,0.24,0,0,4,0,1014,0,1.0,0.0,0
PF01409,PF03147:PF10354:PF03484:PF02912:PF03483,21,33,19,2,14,983,0.58,0.98,0.9,0.71,11,9,12,2,995,0.82,0.99,0.43,0.59
PF07938,PF12118:PF06339:PF11720:PF08681:PF11259,4,8,0,4,8,1006,0.0,0.99,0.0,-0.01,0,0,4,0,1014,0,1.0,0.0,0
PF15390,PF14822:PF15388:PF14798:PF05308:PF14753,0,11,0,0,11,1007,0.0,0.99,0,0,1,0,0,1,1017,0.0,1.0,0,0
PF14761,PF14763:PF14762:PF00073:PF00680:PF14679,2,13,0,2,13,1003,0.0,0.99,0.0,-0.01,0,0,2,0,1016,0,1.0,0.0,0
PF01244,PF15868:PF05719:PF06870:PF14954:PF09749,14,28,6,8,22,982,0.21,0.97,0.43,0.29,0,0,14,0,1004,0,0.99,0.0,0
PF11901,PF12248:PF09458:PF01229:PF13436:PF03318,15,27,8,7,19,984,0.3,0.97,0.53,0.39,2,2,13,0,1003,1.0,0.99,0.13,0.36
PF05033,PF11764:PF10440:PF15811:PF09273:PF03353,25,32,11,14,21,972,0.34,0.97,0.44,0.37,2,2,23,0,993,1.0,0.98,0.08,0.28
PF10685,PF16871:PF02768:PF11958:PF14232:PF07963,1,13,0,1,13,1004,0.0,0.99,0.0,-0.0,0,0,1,0,1017,0,1.0,0.0,0
PF03775,PF06890:PF05666:PF05840:PF07476:PF15143,0,0,0,0,0,1018,0,1.0,0,0,0,0,0,0,1018,0,1.0,0,0
PF11919,PF16507:PF16547:PF13001:PF10347:PF11916,8,27,8,0,19,991,0.3,0.98,1.0,0.54,2,2,6,0,1010,1.0,0.99,0.25,0.5
PF09707,PF08188:PF02377:PF12316:PF07472:PF06073,0,8,0,0,8,1010,0.0,0.99,0,0,0,0,0,0,1018,0,1.0,0,0
PF10182,PF04740:PF13750:PF15856:PF10618:PF05513,3,2,0,3,2,1013,0.0,1.0,0.0,-0.0,0,0,3,0,1015,0,1.0,0.0,0
PF05676,PF01279:PF10775:PF13741:PF10280:PF00159,7,10,2,5,8,1003,0.2,0.99,0.29,0.23,0,0,7,0,1011,0,0.99,0.0,0
PF15250,PF15803:PF15805:PF07260:PF16027:PF14049,1,1,0,1,1,1016,0.0,1.0,0.0,-0.0,0,0,1,0,1017,0,1.0,0.0,0
PF14820,PF15119:PF15556:PF06952:PF02977:PF05355,0,3,0,0,3,1015,0.0,1.0,0,0,0,0,0,0,1018,0,1.0,0,0
PF07262,PF05838:PF15556:PF15199:PF07434:PF09951,0,0,0,0,0,1018,0,1.0,0,0,0,0,0,0,1018,0,1.0,0,0
PF02599,PF15826:PF16824:PF09493:PF15117:PF09614,1,0,0,1,0,1017,0,1.0,0.0,0,0,0,1,0,1017,0,1.0,0.0,0
PF12548,PF12411:PF16347:PF08019:PF00884:PF04437,3,53,3,0,50,965,0.06,0.95,1.0,0.23,4,1,2,3,1012,0.25,1.0,0.33,0.29
PF07589,PF09722:PF02217:PF08291:PF17164:PF08867,0,3,0,0,3,1015,0.0,1.0,0,0,0,0,0,0,1018,0,1.0,0,0
PF11985,PF02050:PF07916:PF09432:PF03848:PF12729,0,1,0,0,1,1017,0.0,1.0,0,0,0,0,0,0,1018,0,1.0,0,0
PF08263,PF00560:PF12819:PF11721:PF01453:PF13947,52,86,41,11,45,921,0.48,0.94,0.79,0.59,15,14,38,1,965,0.93,0.96,0.27,0.49
PF10319,PF10326:PF10318:PF10325:PF10327:PF10317,1,36,0,1,36,981,0.0,0.96,0.0,-0.01,1,0,1,1,1016,0.0,1.0,0.0,-0.0
PF05548,PF15045:PF05604:PF10104:PF15797:PF04988,2,14,1,1,13,1003,0.07,0.99,0.5,0.19,1,1,1,0,1016,1.0,1.0,0.5,0.71
PF00460,PF06429:PF02107:PF03963:PF07559:PF08461,2,2,1,1,1,1015,0.5,1.0,0.5,0.5,1,1,1,0,1016,1.0,1.0,0.5,0.71
PF09328,PF05023:PF02670:PF08125:PF17187:PF01232,2,27,2,0,25,991,0.07,0.98,1.0,0.27,1,0,2,1,1015,0.0,1.0,0.0,-0.0
PF13036,PF13946:PF05943:PF11794:PF05857:PF07157,0,1,0,0,1,1017,0.0,1.0,0,0,0,0,0,0,1018,0,1.0,0,0
PF14886,PF09232:PF15085:PF02950:PF07448:PF13013,4,4,1,3,3,1011,0.25,0.99,0.25,0.25,0,0,4,0,1014,0,1.0,0.0,0
PF04579,PF15750:PF17085:PF15703:PF16829:PF16576,3,2,0,3,2,1013,0.0,1.0,0.0,-0.0,0,0,3,0,1015,0,1.0,0.0,0
PF05309,PF06586:PF07178:PF05509:PF05513:PF01752,1,3,1,0,2,1015,0.33,1.0,1.0,0.58,1,1,0,0,1017,1.0,1.0,1.0,1.0
PF01263,PF05042:PF00197:PF04520:PF04535:PF14476,21,10,4,17,6,991,0.4,0.98,0.19,0.27,0,0,21,0,997,0,0.98,0.0,0
PF11938,PF02221:PF05669:PF12513:PF15028:PF11598,15,33,7,8,26,977,0.21,0.97,0.47,0.3,2,2,13,0,1003,1.0,0.99,0.13,0.36
PF00107,PF08240:PF16912:PF08242:PF00106:PF13823,95,229,86,9,143,780,0.38,0.85,0.91,0.52,27,26,69,1,922,0.96,0.93,0.27,0.49
PF08564,PF03234:PF08565:PF07334:PF08961:PF09775,9,13,9,0,4,1005,0.69,1.0,1.0,0.83,0,0,9,0,1009,0,0.99,0.0,0
PF10067,PF08058:PF02683:PF15346:PF09428:PF11016,1,6,1,0,5,1012,0.17,1.0,1.0,0.41,0,0,1,0,1017,0,1.0,0.0,0
PF10420,PF01731:PF01160:PF00243:PF17043:PF07258,1,23,1,0,22,995,0.04,0.98,1.0,0.21,0,0,1,0,1017,0,1.0,0.0,0
PF11838,PF01433:PF11940:PF12612:PF09127:PF12036,37,59,35,2,24,957,0.59,0.97,0.95,0.74,6,3,34,3,978,0.5,0.96,0.08,0.19
PF07466,PF04107:PF05096:PF14159:PF10693:PF01269,3,21,2,1,19,996,0.1,0.98,0.67,0.25,0,0,3,0,1015,0,1.0,0.0,0
PF09470,PF10856:PF02951:PF15367:PF05857:PF06890,0,6,0,0,6,1012,0.0,0.99,0,0,0,0,0,0,1018,0,1.0,0,0
PF11947,PF07011:PF15699:PF00537:PF15910:PF16594,3,2,1,2,1,1014,0.5,1.0,0.33,0.41,0,0,3,0,1015,0,1.0,0.0,0
PF04194,PF07929:PF13392:PF08788:PF14737:PF14740,10,26,3,7,23,985,0.12,0.97,0.3,0.17,1,1,9,0,1008,1.0,0.99,0.1,0.31
PF00561,PF12146:PF12697:PF01636:PF13419:PF03982,82,139,59,23,80,856,0.42,0.9,0.72,0.5,28,26,56,2,934,0.93,0.94,0.32,0.52
PF00871,PF01515:PF07279:PF14232:PF14231:PF00577,5,14,4,1,10,1003,0.29,0.99,0.8,0.47,0,0,5,0,1013,0,1.0,0.0,0
PF01374,PF04085:PF09979:PF13005:PF07119:PF16976,1,1,0,1,1,1016,0.0,1.0,0.0,-0.0,0,0,1,0,1017,0,1.0,0.0,0
PF09141,PF08913:PF01608:PF16511:PF05902:PF04382,10,33,10,0,23,985,0.3,0.98,1.0,0.54,5,4,6,1,1007,0.8,0.99,0.4,0.56
PF00915,PF15518:PF15976:PF13722:PF08479:PF11492,1,2,1,0,1,1016,0.5,1.0,1.0,0.71,0,0,1,0,1017,0,1.0,0.0,0
PF02413,PF06798:PF07157:PF06890:PF02277:PF02211,0,6,0,0,6,1012,0.0,0.99,0,0,0,0,0,0,1018,0,1.0,0,0
PF07851,PF07767:PF16969:PF09751:PF06140:PF05254,8,34,6,2,28,982,0.18,0.97,0.75,0.35,3,2,6,1,1009,0.67,0.99,0.25,0.41
PF10180,PF02116:PF10104:PF07904:PF15045:PF12855,10,12,1,9,11,997,0.08,0.98,0.1,0.08,1,0,10,1,1007,0.0,0.99,0.0,-0.0
PF16906,PF00159:PF07106:PF09809:PF10256:PF04667,13,32,6,7,26,979,0.19,0.97,0.46,0.28,1,1,12,0,1005,1.0,0.99,0.08,0.28
PF07973,PF01411:PF02272:PF03129:PF04424:PF00587,26,80,26,0,54,938,0.33,0.95,1.0,0.55,18,15,11,3,989,0.83,0.99,0.58,0.69
PF08765,PF11421:PF07497:PF07498:PF10511:PF05001,0,20,0,0,20,998,0.0,0.98,0,0,1,0,0,1,1017,0.0,1.0,0,0
PF02477,PF07434:PF16967:PF15976:PF14987:PF05167,0,4,0,0,4,1014,0.0,1.0,0,0,0,0,0,0,1018,0,1.0,0,0
PF03070,PF08543:PF02581:PF02152:PF01288:PF14683,13,42,11,2,31,974,0.26,0.97,0.85,0.46,5,3,10,2,1003,0.6,0.99,0.23,0.37
PF05236,PF08788:PF04589:PF12886:PF12031:PF15016,10,18,1,9,17,991,0.06,0.97,0.1,0.06,0,0,10,0,1008,0,0.99,0.0,0
PF10317,PF10319:PF02118:PF10318:PF10326:PF03125,9,36,5,4,31,978,0.14,0.97,0.56,0.27,0,0,9,0,1009,0,0.99,0.0,0
PF12625,PF12897:PF12242:PF12852:PF12488:PF03882,3,6,3,0,3,1012,0.5,1.0,1.0,0.71,0,0,3,0,1015,0,1.0,0.0,0
PF00464,PF02284:PF09439:PF01625:PF00197:PF10455,25,33,11,14,22,971,0.33,0.96,0.44,0.37,0,0,25,0,993,0,0.98,0.0,0
PF00982,PF02358:PF14372:PF07821:PF00723:PF09286,22,61,22,0,39,957,0.36,0.96,1.0,0.59,8,7,15,1,995,0.88,0.98,0.32,0.52
PF10946,PF16108:PF06476:PF02718:PF13567:PF05242,0,5,0,0,5,1013,0.0,1.0,0,0,0,0,0,0,1018,0,1.0,0,0
PF12297,PF10481:PF16830:PF07926:PF05104:PF17213,0,16,0,0,16,1002,0.0,0.98,0,0,0,0,0,0,1018,0,1.0,0,0
PF14773,PF09463:PF10446:PF05030:PF16944:PF11517,8,8,0,8,8,1002,0.0,0.98,0.0,-0.01,0,0,8,0,1010,0,0.99,0.0,0
PF13861,PF07157:PF07409:PF13722:PF10908:PF11751,0,0,0,0,0,1018,0,1.0,0,0,0,0,0,0,1018,0,1.0,0,0
PF09719,PF00112:PF03520:PF08246:PF08127:PF00079,0,82,0,0,82,936,0.0,0.92,0,0,13,0,0,13,1005,0.0,0.99,0,0
PF15550,PF06875:PF14866:PF08576:PF15173:PF05355,0,6,0,0,6,1012,0.0,0.99,0,0,0,0,0,0,1018,0,1.0,0,0
PF07960,PF05962:PF06681:PF07209:PF08291:PF15355,2,2,0,2,2,1014,0.0,1.0,0.0,-0.0,0,0,2,0,1016,0,1.0,0.0,0
PF03827,PF08983:PF09193:PF10413:PF12109:PF12369,2,4,1,1,3,1013,0.25,1.0,0.5,0.35,1,1,1,0,1016,1.0,1.0,0.5,0.71
PF08487,PF13768:PF06668:PF13757:PF15057:PF08473,11,25,11,0,14,993,0.44,0.99,1.0,0.66,2,2,9,0,1007,1.0,0.99,0.18,0.42
PF04239,PF02413:PF15089:PF08453:PF02741:PF07409,3,3,1,2,2,1013,0.33,1.0,0.33,0.33,0,0,3,0,1015,0,1.0,0.0,0
PF08504,PF15827:PF10846:PF10492:PF16176:PF16675,2,12,2,0,10,1006,0.17,0.99,1.0,0.41,1,1,1,0,1016,1.0,1.0,0.5,0.71
PF01988,PF01386:PF10342:PF00677:PF03417:PF14378,18,28,6,12,22,978,0.21,0.97,0.33,0.25,1,1,17,0,1000,1.0,0.98,0.06,0.23
PF01693,PF00075:PF03020:PF09337:PF08198:PF08284,23,65,16,7,49,946,0.25,0.94,0.7,0.39,6,4,19,2,993,0.67,0.98,0.17,0.33
PF15588,PF05448:PF15334:PF15817:PF14862:PF04754,0,4,0,0,4,1014,0.0,1.0,0,0,0,0,0,0,1018,0,1.0,0,0
PF07555,PF02838:PF15912:PF14952:PF09743:PF15917,3,18,1,2,17,998,0.06,0.98,0.33,0.13,0,0,3,0,1015,0,1.0,0.0,0
PF05647,PF14654:PF14920:PF14919:PF14918:PF07014,0,0,0,0,0,1018,0,1.0,0,0,0,0,0,0,1018,0,1.0,0,0
PF07939,PF04367:PF09805:PF10276:PF09419:PF15910,2,20,1,1,19,997,0.05,0.98,0.5,0.15,0,0,2,0,1016,0,1.0,0.0,0
PF00017,PF00779:PF00130:PF00387:PF00018:PF00620,74,166,53,21,113,831,0.32,0.87,0.72,0.42,28,24,50,4,940,0.86,0.95,0.32,0.51
PF05705,PF14388:PF05096:PF12680:PF02127:PF01195,15,31,5,10,26,977,0.16,0.96,0.33,0.22,1,1,14,0,1003,1.0,0.99,0.07,0.26
PF05830,PF02654:PF05962:PF11245:PF05939:PF06681,1,4,0,1,4,1013,0.0,1.0,0.0,-0.0,0,0,1,0,1017,0,1.0,0.0,0
PF08392,PF08545:PF08541:PF00351:PF01842:PF00195,8,59,8,0,51,959,0.14,0.95,1.0,0.36,5,3,5,2,1008,0.6,0.99,0.38,0.47
PF13361,PF00580:PF12014:PF16866:PF10442:PF05048,19,23,16,3,7,992,0.7,0.99,0.84,0.76,2,2,17,0,999,1.0,0.98,0.11,0.32
PF00105,PF00104:PF11825:PF12743:PF02166:PF02159,46,46,40,6,6,966,0.87,0.99,0.87,0.86,6,6,40,0,972,1.0,0.96,0.13,0.35
PF14782,PF14781:PF14783:PF10267:PF14944:PF09303,8,18,6,2,12,998,0.33,0.99,0.75,0.49,2,2,6,0,1010,1.0,0.99,0.25,0.5
PF13271,PF05386:PF11816:PF15512:PF09453:PF04192,7,30,5,2,25,986,0.17,0.97,0.71,0.34,2,2,5,0,1011,1.0,1.0,0.29,0.53
PF04034,PF12800:PF11953:PF02405:PF09383:PF12837,13,3,1,12,2,1003,0.33,0.99,0.08,0.16,2,1,12,1,1004,0.5,0.99,0.08,0.19
PF05029,PF12166:PF04821:PF04824:PF12366:PF16876,7,24,5,2,19,992,0.21,0.98,0.71,0.38,1,0,7,1,1010,0.0,0.99,0.0,-0.0
PF00145,PF12047:PF02008:PF01426:PF00855:PF11467,28,72,20,8,52,938,0.28,0.94,0.71,0.42,11,9,19,2,988,0.82,0.98,0.32,0.51
PF09830,PF07931:PF04981:PF05334:PF08539:PF10496,10,22,5,5,17,991,0.23,0.98,0.5,0.33,1,0,10,1,1007,0.0,0.99,0.0,-0.0
PF00603,PF06890:PF10080:PF15504:PF02955:PF15367,2,7,0,2,7,1009,0.0,0.99,0.0,-0.0,0,0,2,0,1016,0,1.0,0.0,0
PF10369,PF00351:PF01842:PF10637:PF12549:PF00742,10,45,4,6,41,967,0.09,0.95,0.4,0.17,3,1,9,2,1006,0.33,0.99,0.1,0.18
PF04994,PF05229:PF06505:PF11751:PF07157:PF01289,0,1,0,0,1,1017,0.0,1.0,0,0,0,0,0,0,1018,0,1.0,0,0
PF07799,PF15856:PF15775:PF17188:PF11124:PF01752,0,3,0,0,3,1015,0.0,1.0,0,0,0,0,0,0,1018,0,1.0,0,0
PF15827,PF08504:PF13866:PF04432:PF08164:PF01149,1,21,1,0,20,997,0.05,0.98,1.0,0.22,0,0,1,0,1017,0,1.0,0.0,0
PF15388,PF03298:PF05308:PF15390:PF14798:PF14822,2,9,1,1,8,1008,0.11,0.99,0.5,0.23,0,0,2,0,1016,0,1.0,0.0,0
PF05821,PF00717:PF01060:PF01400:PF10853:PF15454,6,84,6,0,78,934,0.07,0.92,1.0,0.26,8,2,4,6,1006,0.25,0.99,0.33,0.28
PF14994,PF15023:PF09673:PF15334:PF10994:PF17010,1,0,0,1,0,1017,0,1.0,0.0,0,0,0,1,0,1017,0,1.0,0.0,0
PF10102,PF06588:PF02676:PF02140:PF15881:PF09118,3,41,2,1,39,976,0.05,0.96,0.67,0.17,2,1,2,1,1014,0.5,1.0,0.33,0.41
PF04734,PF17048:PF02268:PF02751:PF02929:PF14222,8,25,8,0,17,993,0.32,0.98,1.0,0.56,4,1,7,3,1007,0.25,0.99,0.12,0.17
PF14136,PF11245:PF04932:PF06678:PF06403:PF10793,0,1,0,0,1,1017,0.0,1.0,0,0,0,0,0,0,1018,0,1.0,0,0
PF12242,PF12241:PF15529:PF04350:PF13568:PF07805,1,2,1,0,1,1016,0.5,1.0,1.0,0.71,0,0,1,0,1017,0,1.0,0.0,0
PF11811,PF08482:PF03923:PF08658:PF04018:PF03461,0,12,0,0,12,1006,0.0,0.99,0,0,2,0,0,2,1016,0.0,1.0,0,0
PF02468,PF15172:PF15115:PF15036:PF02448:PF07448,0,2,0,0,2,1016,0.0,1.0,0,0,0,0,0,0,1018,0,1.0,0,0
PF00190,PF04859:PF04702:PF07762:PF09713:PF01144,17,41,8,9,33,968,0.2,0.96,0.47,0.29,2,2,15,0,1001,1.0,0.99,0.12,0.34
PF13241,PF14823:PF14824:PF00590:PF10414:PF10785,10,26,10,0,16,992,0.38,0.98,1.0,0.62,4,4,6,0,1008,1.0,0.99,0.4,0.63
PF12226,PF15222:PF16859:PF03630:PF12495:PF00695,0,14,0,0,14,1004,0.0,0.99,0,0,0,0,0,0,1018,0,1.0,0,0
PF16050,PF05179:PF03269:PF14642:PF14654:PF08309,8,7,5,3,2,1008,0.71,1.0,0.62,0.67,0,0,8,0,1010,0,0.99,0.0,0
PF01967,PF06969:PF00919:PF13597:PF01938:PF08608,9,32,6,3,26,983,0.19,0.97,0.67,0.34,5,3,6,2,1007,0.6,0.99,0.33,0.44
PF16205,PF14853:PF14852:PF01381:PF02607:PF10660,12,19,4,8,15,991,0.21,0.98,0.33,0.25,1,1,11,0,1006,1.0,0.99,0.08,0.29
PF00042,PF00175:PF09791:PF00499:PF00177:PF00124,23,79,15,8,64,931,0.19,0.93,0.65,0.33,2,2,21,0,995,1.0,0.98,0.09,0.29
PF10138,PF11179:PF12628:PF15460:PF08642:PF14216,2,4,0,2,4,1012,0.0,0.99,0.0,-0.0,0,0,2,0,1016,0,1.0,0.0,0
PF09812,PF01784:PF04716:PF04667:PF15013:PF07114,2,23,1,1,22,994,0.04,0.98,0.5,0.14,0,0,2,0,1016,0,1.0,0.0,0
PF02727,PF02728:PF01179:PF09248:PF02887:PF16863,17,54,17,0,37,964,0.31,0.96,1.0,0.55,14,11,6,3,998,0.79,0.99,0.65,0.71
PF14517,PF08535:PF07010:PF02305:PF14322:PF11642,1,2,0,1,2,1015,0.0,1.0,0.0,-0.0,0,0,1,0,1017,0,1.0,0.0,0
PF15666,PF11317:PF05564:PF02448:PF02427:PF15699,0,1,0,0,1,1017,0.0,1.0,0,0,0,0,0,0,1018,0,1.0,0,0
PF09962,PF09428:PF17078:PF05448:PF03745:PF03238,1,4,0,1,4,1013,0.0,1.0,0.0,-0.0,0,0,1,0,1017,0,1.0,0.0,0
PF12129,PF07001:PF10482:PF05397:PF14665:PF15557,4,17,1,3,16,998,0.06,0.98,0.25,0.11,0,0,4,0,1014,0,1.0,0.0,0
PF03451,PF09453:PF04192:PF11540:PF13925:PF13271,12,26,5,7,21,985,0.19,0.97,0.42,0.27,3,2,10,1,1005,0.67,0.99,0.17,0.33
PF06296,PF15763:PF04892:PF02511:PF01316:PF03243,0,7,0,0,7,1011,0.0,0.99,0,0,0,0,0,0,1018,0,1.0,0,0
PF12221,PF09611:PF15529:PF05401:PF02554:PF12392,0,2,0,0,2,1016,0.0,1.0,0,0,0,0,0,0,1018,0,1.0,0,0
PF15121,PF15762:PF15312:PF02070:PF08642:PF05874,1,1,0,1,1,1016,0.0,1.0,0.0,-0.0,0,0,1,0,1017,0,1.0,0.0,0
PF05659,PF12061:PF07725:PF00619:PF01439:PF11835,5,35,4,1,31,982,0.11,0.97,0.8,0.3,3,2,3,1,1012,0.67,1.0,0.4,0.51
PF04898,PF01645:PF00310:PF14691:PF01493:PF14721,7,19,7,0,12,999,0.37,0.99,1.0,0.6,6,6,1,0,1011,1.0,1.0,0.86,0.93
PF13599,PF00805:PF11601:PF05336:PF11700:PF11471,6,22,2,4,20,992,0.09,0.98,0.33,0.17,0,0,6,0,1012,0,0.99,0.0,0
PF13961,PF13976:PF03732:PF14244:PF08284:PF09337,18,109,12,6,97,903,0.11,0.9,0.67,0.24,18,8,10,10,990,0.44,0.98,0.44,0.43
PF11700,PF06609:PF00296:PF06884:PF04479:PF16672,3,41,0,3,41,974,0.0,0.96,0.0,-0.01,7,0,3,7,1008,0.0,0.99,0.0,-0.0
PF12798,PF12837:PF11953:PF07338:PF04860:PF08964,0,6,0,0,6,1012,0.0,0.99,0,0,0,0,0,0,1018,0,1.0,0,0
PF08926,PF14593:PF12063:PF11629:PF12202:PF12605,10,18,6,4,12,996,0.33,0.98,0.6,0.44,4,4,6,0,1008,1.0,0.99,0.4,0.63
PF16654,PF11697:PF13101:PF10091:PF01668:PF17206,0,3,0,0,3,1015,0.0,1.0,0,0,0,0,0,0,1018,0,1.0,0,0
PF07114,PF10244:PF03980:PF05915:PF06766:PF10224,3,15,3,0,12,1003,0.2,0.99,1.0,0.44,1,0,3,1,1014,0.0,1.0,0.0,-0.0
PF13266,PF06683:PF10950:PF07279:PF15710:PF01114,1,2,0,1,2,1015,0.0,1.0,0.0,-0.0,0,0,1,0,1017,0,1.0,0.0,0
PF15192,PF15680:PF15119:PF07327:PF15772:PF06868,0,2,0,0,2,1016,0.0,1.0,0,0,0,0,0,0,1018,0,1.0,0,0
PF09336,PF01434:PF16565:PF16193:PF08519:PF16725,15,55,10,5,45,958,0.18,0.95,0.67,0.33,5,3,12,2,1001,0.6,0.99,0.2,0.34
PF00298,PF14853:PF00283:PF01381:PF14852:PF13869,22,22,6,16,16,980,0.27,0.97,0.27,0.26,3,2,20,1,995,0.67,0.98,0.09,0.24
PF03663,PF03595:PF04570:PF11927:PF07798:PF11327,16,41,8,8,33,969,0.2,0.96,0.5,0.3,1,0,16,1,1001,0.0,0.98,0.0,-0.0
PF14882,PF12241:PF08299:PF03428:PF07805:PF03406,0,4,0,0,4,1014,0.0,1.0,0,0,0,0,0,0,1018,0,1.0,0,0
PF00339,PF02752:PF05404:PF02269:PF12579:PF08652,33,39,29,4,10,975,0.74,0.99,0.88,0.8,1,1,32,0,985,1.0,0.97,0.03,0.17
PF11019,PF05840:PF02277:PF03090:PF06890:PF11304,0,3,0,0,3,1015,0.0,1.0,0,0,0,0,0,0,1018,0,1.0,0,0
PF14679,PF14676:PF14680:PF14677:PF14675:PF14674,1,1,1,0,0,1017,1.0,1.0,1.0,1.0,1,1,0,0,1017,1.0,1.0,1.0,1.0
PF00731,PF02222:PF01259:PF04248:PF01014:PF01729,11,26,7,4,19,988,0.27,0.98,0.64,0.4,2,2,9,0,1007,1.0,0.99,0.18,0.42
PF15681,PF15119:PF14866:PF15809:PF15555:PF03050,3,2,0,3,2,1013,0.0,1.0,0.0,-0.0,0,0,3,0,1015,0,1.0,0.0,0
PF05221,PF00670:PF01144:PF03071:PF02812:PF02782,10,64,7,3,57,951,0.11,0.94,0.7,0.26,9,3,7,6,1002,0.33,0.99,0.3,0.31
PF08850,PF08096:PF09485:PF08803:PF08846:PF05940,0,1,0,0,1,1017,0.0,1.0,0,0,0,0,0,0,1018,0,1.0,0,0
PF16319,PF09856:PF10134:PF06290:PF14607:PF12679,1,0,0,1,0,1017,0,1.0,0.0,0,0,0,1,0,1017,0,1.0,0.0,0
PF02485,PF09362:PF12529:PF11790:PF01822:PF00685,17,77,12,5,65,936,0.16,0.93,0.71,0.31,5,2,15,3,998,0.4,0.98,0.12,0.21
PF06892,PF09095:PF02066:PF01118:PF14330:PF10070,0,15,0,0,15,1003,0.0,0.99,0,0,1,0,0,1,1017,0.0,1.0,0,0
PF16352,PF16346:PF11837:PF03788:PF08244:PF11880,0,17,0,0,17,1001,0.0,0.98,0,0,0,0,0,0,1018,0,1.0,0,0
PF10034,PF08925:PF12150:PF07324:PF14654:PF11277,13,15,6,7,9,996,0.4,0.98,0.46,0.42,0,0,13,0,1005,0,0.99,0.0,0
PF08265,PF12319:PF11669:PF07939:PF02116:PF10276,11,8,1,10,7,1000,0.12,0.98,0.09,0.1,0,0,11,0,1007,0,0.99,0.0,0
PF10101,PF07442:PF12207:PF13701:PF10694:PF13116,0,12,0,0,12,1006,0.0,0.99,0,0,0,0,0,0,1018,0,1.0,0,0
PF09229,PF08327:PF13339:PF11710:PF10312:PF03851,18,50,17,1,33,967,0.34,0.97,0.94,0.56,5,4,14,1,999,0.8,0.99,0.22,0.42
PF10244,PF14935:PF15071:PF12020:PF07114:PF10780,8,5,2,6,3,1007,0.4,0.99,0.25,0.31,0,0,8,0,1010,0,0.99,0.0,0
PF13011,PF05418:PF15141:PF15097:PF15085:PF05778,0,5,0,0,5,1013,0.0,1.0,0,0,0,0,0,0,1018,0,1.0,0,0
PF06512,PF11933:PF11404:PF16905:PF08763:PF16519,5,16,4,1,12,1001,0.25,0.99,0.8,0.44,3,2,3,1,1012,0.67,1.0,0.4,0.51
PF05930,PF15529:PF14841:PF14842:PF04222:PF01706,0,1,0,0,1,1017,0.0,1.0,0,0,0,0,0,0,1018,0,1.0,0,0
PF10377,PF15246:PF16501:PF07765:PF14846:PF12329,5,20,4,1,16,997,0.2,0.98,0.8,0.4,0,0,5,0,1013,0,1.0,0.0,0
PF14974,PF00467:PF01238:PF01929:PF14807:PF16121,10,40,8,2,32,976,0.2,0.97,0.8,0.39,6,4,6,2,1006,0.67,0.99,0.4,0.51
PF16667,PF05671:PF02604:PF15830:PF06251:PF10077,1,6,0,1,6,1011,0.0,0.99,0.0,-0.0,0,0,1,0,1017,0,1.0,0.0,0
PF10432,PF16265:PF05488:PF12805:PF05299:PF06403,2,1,0,2,1,1015,0.0,1.0,0.0,-0.0,0,0,2,0,1016,0,1.0,0.0,0
PF16653,PF04455:PF05222:PF02233:PF12769:PF01262,13,22,10,3,12,993,0.45,0.99,0.77,0.58,8,6,7,2,1003,0.75,0.99,0.46,0.58
PF15792,PF14049:PF14047:PF15803:PF15805:PF05716,1,4,0,1,4,1013,0.0,1.0,0.0,-0.0,0,0,1,0,1017,0,1.0,0.0,0
PF13618,PF08848:PF16265:PF12805:PF13482:PF06678,0,1,0,0,1,1017,0.0,1.0,0,0,0,0,0,0,1018,0,1.0,0,0
PF07962,PF16297:PF10175:PF02093:PF03716:PF00607,6,16,3,3,13,999,0.19,0.98,0.5,0.3,2,2,4,0,1012,1.0,1.0,0.33,0.58
PF11392,PF04895:PF09986:PF02458:PF07156:PF00583,0,103,0,0,103,915,0.0,0.9,0,0,6,0,0,6,1012,0.0,0.99,0,0
PF00551,PF02911:PF00586:PF01071:PF02843:PF00465,24,44,16,8,28,966,0.36,0.96,0.67,0.48,10,8,16,2,992,0.8,0.98,0.33,0.51
PF01698,PF03414:PF03242:PF02431:PF07189:PF05612,1,14,1,0,13,1004,0.07,0.99,1.0,0.27,0,0,1,0,1017,0,1.0,0.0,0
PF05770,PF10263:PF06179:PF04720:PF06320:PF03629,12,40,8,4,32,974,0.2,0.96,0.67,0.35,3,2,10,1,1005,0.67,0.99,0.17,0.33
PF00035,PF01207:PF14622:PF00636:PF02137:PF07528,54,68,37,17,31,933,0.54,0.95,0.69,0.59,11,11,43,0,964,1.0,0.96,0.2,0.44
PF17148,PF15082:PF10933:PF08291:PF15856:PF06222,0,4,0,0,4,1014,0.0,1.0,0,0,0,0,0,0,1018,0,1.0,0,0
PF02912,PF03147:PF08279:PF09012:PF13280:PF10354,5,31,4,1,27,986,0.13,0.97,0.8,0.31,4,3,2,1,1012,0.75,1.0,0.6,0.67
PF17187,PF08622:PF09164:PF12470:PF05076:PF09328,2,7,2,0,5,1011,0.29,1.0,1.0,0.53,1,1,1,0,1016,1.0,1.0,0.5,0.71
PF03778,PF10285:PF07276:PF06753:PF11054:PF10284,0,2,0,0,2,1016,0.0,1.0,0,0,0,0,0,0,1018,0,1.0,0,0
PF04519,PF02554:PF06798:PF09867:PF07833:PF00669,2,7,0,2,7,1009,0.0,0.99,0.0,-0.0,0,0,2,0,1016,0,1.0,0.0,0
PF07978,PF09766:PF01733:PF02222:PF03868:PF01159,17,45,12,5,33,968,0.27,0.96,0.71,0.42,5,5,12,0,1001,1.0,0.99,0.29,0.54
PF16893,PF16892:PF12258:PF09309:PF03119:PF16770,2,16,2,0,14,1002,0.12,0.99,1.0,0.35,0,0,2,0,1016,0,1.0,0.0,0
PF11025,PF02915:PF04769:PF13225:PF00830:PF13092,0,16,0,0,16,1002,0.0,0.98,0,0,0,0,0,0,1018,0,1.0,0,0
PF11331,PF14611:PF15862:PF00649:PF08578:PF05041,3,23,0,3,23,992,0.0,0.97,0.0,-0.01,0,0,3,0,1015,0,1.0,0.0,0
PF01801,PF12246:PF05145:PF12247:PF07472:PF00939,0,19,0,0,19,999,0.0,0.98,0,0,0,0,0,0,1018,0,1.0,0,0
PF07709,PF17085:PF14231:PF02740:PF05474:PF15710,1,1,0,1,1,1016,0.0,1.0,0.0,-0.0,0,0,1,0,1017,0,1.0,0.0,0
PF09631,PF08641:PF09597:PF15370:PF05039:PF15359,10,10,4,6,6,1002,0.4,0.99,0.4,0.39,0,0,10,0,1008,0,0.99,0.0,0
PF03639,PF02015:PF06910:PF05730:PF02575:PF00885,12,32,5,7,27,979,0.16,0.97,0.42,0.24,2,1,11,1,1005,0.5,0.99,0.08,0.2
PF11856,PF11019:PF14052:PF09611:PF00555:PF04471,0,5,0,0,5,1013,0.0,1.0,0,0,0,0,0,0,1018,0,1.0,0,0
PF08954,PF05386:PF10647:PF15512:PF14077:PF05731,1,11,1,0,10,1007,0.09,0.99,1.0,0.3,1,1,0,0,1017,1.0,1.0,1.0,1.0
PF07270,PF06115:PF04955:PF09779:PF08292:PF07866,0,6,0,0,6,1012,0.0,0.99,0,0,0,0,0,0,1018,0,1.0,0,0
PF15063,PF15831:PF06541:PF02044:PF06907:PF15109,0,2,0,0,2,1016,0.0,1.0,0,0,0,0,0,0,1018,0,1.0,0,0
PF07286,PF00220:PF04643:PF04644:PF06540:PF14336,3,5,0,3,5,1010,0.0,0.99,0.0,-0.0,1,0,3,1,1014,0.0,1.0,0.0,-0.0
PF12125,PF16856:PF10647:PF04300:PF12014:PF03048,6,8,2,4,6,1006,0.25,0.99,0.33,0.28,1,1,5,0,1012,1.0,1.0,0.17,0.41
PF13725,PF13718:PF05127:PF08351:PF08746:PF03298,12,22,12,0,10,996,0.55,0.99,1.0,0.73,13,12,0,1,1005,0.92,1.0,1.0,0.96
PF06393,PF02941:PF15107:PF15085:PF05836:PF05151,2,3,0,2,3,1013,0.0,1.0,0.0,-0.0,0,0,2,0,1016,0,1.0,0.0,0
PF01402,PF05939:PF07157:PF06798:PF11593:PF11638,1,4,0,1,4,1013,0.0,1.0,0.0,-0.0,0,0,1,0,1017,0,1.0,0.0,0
PF03462,PF00472:PF04095:PF02744:PF09296:PF03484,21,61,21,0,40,957,0.34,0.96,1.0,0.57,3,2,19,1,996,0.67,0.98,0.1,0.25
PF16760,PF08323:PF00862:PF04413:PF08472:PF13477,2,17,1,1,16,1000,0.06,0.98,0.5,0.17,0,0,2,0,1016,0,1.0,0.0,0
PF06527,PF10266:PF03311:PF06923:PF00206:PF04099,0,59,0,0,59,959,0.0,0.94,0,0,4,0,0,4,1014,0.0,1.0,0,0
PF00995,PF06783:PF15433:PF13932:PF01722:PF12850,31,45,14,17,31,956,0.31,0.95,0.45,0.35,2,2,29,0,987,1.0,0.97,0.06,0.25
PF08025,PF04111:PF06923:PF03116:PF00645:PF02126,0,34,0,0,34,984,0.0,0.97,0,0,1,0,0,1,1017,0.0,1.0,0,0
PF07964,PF08479:PF15518:PF08411:PF04552:PF16449,1,3,0,1,3,1014,0.0,1.0,0.0,-0.0,0,0,1,0,1017,0,1.0,0.0,0
PF00161,PF00652:PF00535:PF16499:PF01704:PF15048,13,91,10,3,81,924,0.11,0.92,0.77,0.27,17,5,8,12,993,0.29,0.98,0.38,0.33
PF11304,PF08479:PF10554:PF11019:PF02572:PF03562,0,3,0,0,3,1015,0.0,1.0,0,0,0,0,0,0,1018,0,1.0,0,0
PF07361,PF02614:PF06864:PF11614:PF09678:PF09397,6,12,4,2,8,1004,0.33,0.99,0.67,0.47,0,0,6,0,1012,0,0.99,0.0,0
PF15454,PF10224:PF10780:PF10244:PF06232:PF15013,4,14,2,2,12,1002,0.14,0.99,0.5,0.26,0,0,4,0,1014,0,1.0,0.0,0
PF13291,PF06780:PF10662:PF15086:PF16360:PF04963,2,8,0,2,8,1008,0.0,0.99,0.0,-0.0,1,0,2,1,1015,0.0,1.0,0.0,-0.0
PF02002,PF11521:PF08271:PF07741:PF16978:PF15058,11,30,7,4,23,984,0.23,0.97,0.64,0.38,1,1,10,0,1007,1.0,0.99,0.09,0.3
PF12877,PF16019:PF07535:PF15275:PF15670:PF08014,5,11,1,4,10,1003,0.09,0.99,0.2,0.13,1,1,4,0,1013,1.0,1.0,0.2,0.45
PF04378,PF09611:PF02621:PF01345:PF11593:PF09498,2,2,0,2,2,1014,0.0,1.0,0.0,-0.0,0,0,2,0,1016,0,1.0,0.0,0
PF00374,PF17188:PF15340:PF05294:PF15192:PF02413,1,2,0,1,2,1015,0.0,1.0,0.0,-0.0,0,0,1,0,1017,0,1.0,0.0,0
PF06384,PF13096:PF06211:PF02083:PF07739:PF05837,4,5,0,4,5,1009,0.0,0.99,0.0,-0.0,0,0,4,0,1014,0,1.0,0.0,0
PF14490,PF15128:PF15716:PF03816:PF15175:PF15976,0,2,0,0,2,1016,0.0,1.0,0,0,0,0,0,0,1018,0,1.0,0,0
PF10270,PF00831:PF03501:PF07106:PF08583:PF01126,7,35,2,5,33,978,0.06,0.96,0.29,0.11,3,1,6,2,1009,0.33,0.99,0.14,0.21
PF01169,PF01980:PF04921:PF07292:PF15070:PF02470,4,17,1,3,16,998,0.06,0.98,0.25,0.11,0,0,4,0,1014,0,1.0,0.0,0
PF12881,PF11265:PF03516:PF11235:PF05716:PF11244,1,11,1,0,10,1007,0.09,0.99,1.0,0.3,0,0,1,0,1017,0,1.0,0.0,0
PF02492,PF07683:PF08546:PF11989:PF02317:PF10342,19,39,11,8,28,971,0.28,0.96,0.58,0.39,3,2,17,1,998,0.67,0.98,0.11,0.26
PF02337,PF00607:PF02093:PF12384:PF01141:PF01140,5,13,5,0,8,1005,0.38,0.99,1.0,0.62,4,4,1,0,1013,1.0,1.0,0.8,0.89
PF08808,PF15281:PF04351:PF17206:PF09498:PF09677,0,4,0,0,4,1014,0.0,1.0,0,0,0,0,0,0,1018,0,1.0,0,0
PF03720,PF00984:PF03721:PF03483:PF01227:PF04064,6,27,6,0,21,991,0.22,0.98,1.0,0.47,3,2,4,1,1011,0.67,1.0,0.33,0.47
PF17051,PF15046:PF17062:PF03203:PF05853:PF15343,0,4,0,0,4,1014,0.0,1.0,0,0,0,0,0,0,1018,0,1.0,0,0
PF04174,PF06082:PF10566:PF01752:PF02601:PF13750,0,4,0,0,4,1014,0.0,1.0,0,0,0,0,0,0,1018,0,1.0,0,0
PF04289,PF13897:PF08438:PF11952:PF01018:PF13291,0,19,0,0,19,999,0.0,0.98,0,0,3,0,0,3,1015,0.0,1.0,0,0
PF02222,PF01259:PF00731:PF01729:PF04248:PF01731,8,31,6,2,25,985,0.19,0.97,0.75,0.37,1,0,8,1,1009,0.0,0.99,0.0,-0.0
PF07055,PF12241:PF15726:PF02561:PF05943:PF04764,1,1,1,0,0,1017,1.0,1.0,1.0,1.0,0,0,1,0,1017,0,1.0,0.0,0
PF08692,PF11016:PF03692:PF12855:PF06485:PF11460,0,7,0,0,7,1011,0.0,0.99,0,0,0,0,0,0,1018,0,1.0,0,0
PF00986,PF00204:PF16898:PF08070:PF00521:PF01751,13,33,11,2,22,983,0.33,0.98,0.85,0.52,15,7,6,8,997,0.47,0.99,0.54,0.49
PF15423,PF04500:PF06903:PF10532:PF01610:PF00872,0,25,0,0,25,993,0.0,0.98,0,0,2,0,0,2,1016,0.0,1.0,0,0
PF11162,PF02217:PF15337:PF15485:PF08744:PF03743,0,11,0,0,11,1007,0.0,0.99,0,0,0,0,0,0,1018,0,1.0,0,0
PF12315,PF15936:PF06297:PF04814:PF00412:PF03867,8,90,7,1,83,927,0.08,0.92,0.88,0.25,3,3,5,0,1010,1.0,1.0,0.38,0.61
PF07172,PF15129:PF06373:PF06206:PF00758:PF08194,1,4,0,1,4,1013,0.0,1.0,0.0,-0.0,0,0,1,0,1017,0,1.0,0.0,0
PF07944,PF07173:PF00150:PF13813:PF04616:PF07103,12,76,9,3,67,939,0.12,0.93,0.75,0.28,6,3,9,3,1003,0.5,0.99,0.25,0.35
PF02910,PF00890:PF02424:PF12831:PF07976:PF04205,17,56,16,1,40,961,0.29,0.96,0.94,0.51,6,3,14,3,998,0.5,0.98,0.18,0.29
PF01051,PF06403:PF00669:PF15775:PF11210:PF15680,1,1,0,1,1,1016,0.0,1.0,0.0,-0.0,0,0,1,0,1017,0,1.0,0.0,0
PF13720,PF06426:PF12464:PF04613:PF14602:PF01050,2,45,1,1,44,972,0.02,0.96,0.5,0.1,4,1,1,3,1013,0.25,1.0,0.5,0.35
PF02374,PF09738:PF07137:PF07047:PF00261:PF09775,11,19,4,7,15,992,0.21,0.98,0.36,0.27,1,0,11,1,1006,0.0,0.99,0.0,-0.0
PF05672,PF14738:PF11500:PF14722:PF08920:PF14662,5,22,1,4,21,992,0.05,0.98,0.2,0.09,1,0,5,1,1012,0.0,0.99,0.0,-0.0
PF08788,PF04194:PF07929:PF01342:PF13392:PF05236,7,30,2,5,28,983,0.07,0.97,0.29,0.13,3,1,6,2,1009,0.33,0.99,0.14,0.21
PF00696,PF00171:PF04768:PF13840:PF10000:PF00551,39,117,28,11,89,890,0.24,0.9,0.72,0.38,6,5,34,1,978,0.83,0.97,0.13,0.32
PF05876,PF07409:PF10279:PF07484:PF13722:PF12255,4,0,0,4,0,1014,0,1.0,0.0,0,0,0,4,0,1014,0,1.0,0.0,0
PF05788,PF09493:PF15214:PF15826:PF03739:PF11681,2,7,0,2,7,1009,0.0,0.99,0.0,-0.0,0,0,2,0,1016,0,1.0,0.0,0
PF02210,PF00054:PF00028:PF01049:PF06009:PF06008,40,55,30,10,25,953,0.55,0.97,0.75,0.62,4,4,36,0,978,1.0,0.96,0.1,0.31
PF02305,PF11751:PF07157:PF06890:PF03963:PF10279,1,1,0,1,1,1016,0.0,1.0,0.0,-0.0,0,0,1,0,1017,0,1.0,0.0,0
PF11555,PF07815:PF08397:PF09027:PF08824:PF12026,3,14,2,1,12,1003,0.14,0.99,0.67,0.3,2,1,2,1,1014,0.5,1.0,0.33,0.41
PF04137,PF00197:PF10604:PF05910:PF04520:PF04979,6,38,1,5,37,975,0.03,0.96,0.17,0.05,3,1,5,2,1010,0.33,0.99,0.17,0.23
PF12264,PF08762:PF01660:PF00915:PF12256:PF12255,4,8,4,0,4,1010,0.5,1.0,1.0,0.71,0,0,4,0,1014,0,1.0,0.0,0
PF07977,PF15888:PF04417:PF11502:PF12371:PF12478,15,8,1,14,7,996,0.12,0.98,0.07,0.08,0,0,15,0,1003,0,0.99,0.0,0
PF02173,PF12498:PF03957:PF08601:PF07777:PF14144,6,11,3,3,8,1004,0.27,0.99,0.5,0.36,2,2,4,0,1012,1.0,1.0,0.33,0.58
PF14076,PF04991:PF05154:PF07162:PF05758:PF07779,0,40,0,0,40,978,0.0,0.96,0,0,2,0,0,2,1016,0.0,1.0,0,0
PF05473,PF12453:PF06583:PF12355:PF16066:PF06328,4,5,1,3,4,1010,0.2,0.99,0.25,0.22,1,1,3,0,1014,1.0,1.0,0.25,0.5
PF13438,PF11798:PF11626:PF00817:PF04773:PF16727,1,34,1,0,33,984,0.03,0.97,1.0,0.17,3,1,0,2,1015,0.33,1.0,1.0,0.58
PF10272,PF10148:PF10444:PF15929:PF03085:PF10146,4,10,1,3,9,1005,0.1,0.99,0.25,0.15,0,0,4,0,1014,0,1.0,0.0,0
PF11730,PF09069:PF09068:PF12738:PF00302:PF00569,0,60,0,0,60,958,0.0,0.94,0,0,6,0,0,6,1012,0.0,0.99,0,0
PF08538,PF10705:PF14542:PF04402:PF08656:PF02605,5,7,1,4,6,1007,0.14,0.99,0.2,0.16,0,0,5,0,1013,0,1.0,0.0,0
PF05977,PF07523:PF01136:PF15518:PF06458:PF01364,7,4,0,7,4,1007,0.0,0.99,0.0,-0.01,0,0,7,0,1011,0,0.99,0.0,0
PF07934,PF10576:PF14815:PF00633:PF16174:PF09598,13,14,3,10,11,994,0.21,0.98,0.23,0.21,1,1,12,0,1005,1.0,0.99,0.08,0.28
PF07638,PF15870:PF13423:PF02037:PF13579:PF14863,0,73,0,0,73,945,0.0,0.93,0,0,3,0,0,3,1015,0.0,1.0,0,0
PF04973,PF01717:PF00130:PF02123:PF03662:PF00316,1,92,0,1,92,925,0.0,0.91,0.0,-0.01,5,0,1,5,1012,0.0,0.99,0.0,-0.0
PF03812,PF10523:PF03099:PF00452:PF11413:PF08447,1,48,0,1,48,969,0.0,0.95,0.0,-0.01,6,0,1,6,1011,0.0,0.99,0.0,-0.0
PF06481,PF02790:PF02433:PF06146:PF11729:PF02578,3,14,2,1,12,1003,0.14,0.99,0.67,0.3,0,0,3,0,1015,0,1.0,0.0,0
PF08355,PF08356:PF10149:PF16512:PF14513:PF16901,13,29,12,1,17,988,0.41,0.98,0.92,0.61,4,4,9,0,1005,1.0,0.99,0.31,0.55
PF07081,PF03576:PF08738:PF07444:PF00737:PF13095,4,3,0,4,3,1011,0.0,0.99,0.0,-0.0,0,0,4,0,1014,0,1.0,0.0,0
PF02186,PF12049:PF06420:PF07223:PF10330:PF03741,14,11,2,12,9,995,0.18,0.98,0.14,0.15,0,0,14,0,1004,0,0.99,0.0,0
PF12634,PF13362:PF13422:PF12196:PF07574:PF08922,2,17,0,2,17,999,0.0,0.98,0.0,-0.01,1,0,2,1,1015,0.0,1.0,0.0,-0.0
PF01295,PF03038:PF10084:PF11882:PF05390:PF15349,1,8,0,1,8,1009,0.0,0.99,0.0,-0.0,0,0,1,0,1017,0,1.0,0.0,0
PF11250,PF02234:PF15264:PF17098:PF04004:PF10180,2,29,2,0,27,989,0.07,0.97,1.0,0.26,0,0,2,0,1016,0,1.0,0.0,0
PF03344,PF09444:PF06513:PF15030:PF05762:PF12178,1,7,0,1,7,1010,0.0,0.99,0.0,-0.0,0,0,1,0,1017,0,1.0,0.0,0
PF10476,PF05177:PF15509:PF06752:PF13915:PF08166,0,15,0,0,15,1003,0.0,0.99,0,0,1,0,0,1,1017,0.0,1.0,0,0
PF14760,PF01706:PF16325:PF02465:PF04612:PF12615,1,2,0,1,2,1015,0.0,1.0,0.0,-0.0,0,0,1,0,1017,0,1.0,0.0,0
PF04002,PF08544:PF07959:PF10509:PF05038:PF02736,1,56,1,0,55,962,0.02,0.95,1.0,0.13,5,1,0,4,1013,0.2,1.0,1.0,0.45
PF07797,PF15245:PF11623:PF07904:PF08034:PF15247,4,10,0,4,10,1004,0.0,0.99,0.0,-0.01,0,0,4,0,1014,0,1.0,0.0,0
PF05386,PF05731:PF13271:PF15512:PF08954:PF09453,2,19,2,0,17,999,0.11,0.98,1.0,0.32,2,2,0,0,1016,1.0,1.0,1.0,1.0
PF00806,PF07990:PF03124:PF11030:PF07075:PF14985,21,12,5,16,7,990,0.42,0.98,0.24,0.3,1,1,20,0,997,1.0,0.98,0.05,0.22
PF02635,PF10279:PF05974:PF03090:PF11019:PF03963,0,1,0,0,1,1017,0.0,1.0,0,0,0,0,0,0,1018,0,1.0,0,0
PF01896,PF04588:PF04819:PF00830:PF13092:PF11789,8,23,3,5,20,990,0.13,0.98,0.38,0.21,3,3,5,0,1010,1.0,1.0,0.38,0.61
PF01221,PF10157:PF01023:PF16166:PF05996:PF13405,17,47,6,11,41,960,0.13,0.95,0.35,0.19,5,4,13,1,1000,0.8,0.99,0.24,0.43
PF08996,PF12254:PF14260:PF03104:PF00136:PF08490,12,38,12,0,26,980,0.32,0.97,1.0,0.55,29,11,1,18,988,0.38,0.98,0.92,0.58
PF14518,PF08297:PF08674:PF15280:PF15093:PF01057,3,7,1,2,6,1009,0.14,0.99,0.33,0.21,0,0,3,0,1015,0,1.0,0.0,0
PF01218,PF04107:PF14159:PF02186:PF10236:PF04719,7,26,2,5,24,987,0.08,0.97,0.29,0.14,4,1,6,3,1008,0.25,0.99,0.14,0.18
PF14420,PF15898:PF17109:PF07693:PF17111:PF16553,14,28,8,6,20,984,0.29,0.97,0.57,0.39,1,1,13,0,1004,1.0,0.99,0.07,0.27
PF11261,PF07001:PF15914:PF15912:PF10482:PF13945,6,11,1,5,10,1002,0.09,0.99,0.17,0.12,0,0,6,0,1012,0,0.99,0.0,0
PF14692,PF12782:PF15622:PF15362:PF10578:PF09132,0,1,0,0,1,1017,0.0,1.0,0,0,0,0,0,0,1018,0,1.0,0,0
PF13408,PF07508:PF00239:PF02501:PF03934:PF04612,2,5,2,0,3,1013,0.4,1.0,1.0,0.63,1,0,2,1,1015,0.0,1.0,0.0,-0.0
PF11831,PF15934:PF15821:PF13870:PF09787:PF08647,12,15,2,10,13,993,0.13,0.98,0.17,0.14,1,0,12,1,1005,0.0,0.99,0.0,-0.0
PF16551,PF16568:PF16274:PF16544:PF12235:PF10470,1,10,1,0,9,1008,0.1,0.99,1.0,0.31,1,1,0,0,1017,1.0,1.0,1.0,1.0
PF05997,PF05030:PF15619:PF09429:PF16944:PF16043,10,21,2,8,19,989,0.1,0.97,0.2,0.13,0,0,10,0,1008,0,0.99,0.0,0
PF01202,PF01761:PF01487:PF08501:PF00275:PF01488,11,34,11,0,23,984,0.32,0.98,1.0,0.56,12,11,0,1,1006,0.92,1.0,1.0,0.96
PF07759,PF00040:PF03669:PF10867:PF09420:PF02270,0,40,0,0,40,978,0.0,0.96,0,0,1,0,0,1,1017,0.0,1.0,0,0
PF16706,PF11244:PF14047:PF11235:PF11232:PF02740,1,7,0,1,7,1010,0.0,0.99,0.0,-0.0,0,0,1,0,1017,0,1.0,0.0,0
PF07107,PF11016:PF06695:PF00127:PF13270:PF12046,1,6,0,1,6,1011,0.0,0.99,0.0,-0.0,0,0,1,0,1017,0,1.0,0.0,0
PF11688,PF05757:PF06253:PF01593:PF00125:PF06079,0,85,0,0,85,933,0.0,0.92,0,0,5,0,0,5,1013,0.0,1.0,0,0
PF13091,PF00614:PF13918:PF12357:PF05664:PF00787,29,92,18,11,74,915,0.2,0.92,0.62,0.32,7,6,23,1,988,0.86,0.98,0.21,0.41
PF13905,PF03107:PF01436:PF13419:PF03712:PF05199,17,123,12,5,111,890,0.1,0.89,0.71,0.23,12,7,10,5,996,0.58,0.99,0.41,0.48
PF05666,PF14659:PF05939:PF01913:PF06798:PF15281,0,6,0,0,6,1012,0.0,0.99,0,0,0,0,0,0,1018,0,1.0,0,0
PF10267,PF13865:PF14782:PF08081:PF06495:PF12353,9,32,5,4,27,982,0.16,0.97,0.56,0.28,2,2,7,0,1009,1.0,0.99,0.22,0.47
PF16413,PF08676:PF17203:PF17065:PF01119:PF08778,15,46,14,1,32,971,0.3,0.97,0.93,0.52,4,4,11,0,1003,1.0,0.99,0.27,0.51
PF01549,PF08768:PF05507:PF04942:PF07210:PF05086,43,12,7,36,5,970,0.58,0.96,0.16,0.29,0,0,43,0,975,0,0.96,0.0,0
PF12240,PF15248:PF13870:PF15866:PF08286:PF11291,1,9,0,1,9,1008,0.0,0.99,0.0,-0.0,0,0,1,0,1017,0,1.0,0.0,0
PF01071,PF02843:PF02844:PF00586:PF02769:PF00551,16,37,13,3,24,978,0.35,0.97,0.81,0.52,9,8,8,1,1001,0.89,0.99,0.5,0.66
PF11542,PF06586:PF05309:PF07178:PF09967:PF05762,1,6,0,1,6,1011,0.0,0.99,0.0,-0.0,1,0,1,1,1016,0.0,1.0,0.0,-0.0
PF03550,PF10798:PF12143:PF12923:PF13085:PF17016,0,32,0,0,32,986,0.0,0.97,0,0,0,0,0,0,1018,0,1.0,0,0
PF10712,PF06723:PF10268:PF00012:PF14895:PF04450,6,73,6,0,67,945,0.08,0.93,1.0,0.28,3,2,4,1,1011,0.67,1.0,0.33,0.47
PF14948,PF11548:PF09414:PF00102:PF12453:PF12567,3,56,3,0,53,962,0.05,0.95,1.0,0.23,2,1,2,1,1014,0.5,1.0,0.33,0.41
PF07010,PF17049:PF15207:PF10009:PF10380:PF15169,0,3,0,0,3,1015,0.0,1.0,0,0,0,0,0,0,1018,0,1.0,0,0
PF03922,PF11736:PF01752:PF17206:PF01514:PF17188,0,7,0,0,7,1011,0.0,0.99,0,0,0,0,0,0,1018,0,1.0,0,0
PF09363,PF09364:PF03894:PF08369:PF08523:PF03185,2,14,2,0,12,1004,0.14,0.99,1.0,0.38,0,0,2,0,1016,0,1.0,0.0,0
PF00576,PF00711:PF00340:PF07771:PF02060:PF11937,6,8,2,4,6,1006,0.25,0.99,0.33,0.28,0,0,6,0,1012,0,0.99,0.0,0
PF06746,PF12470:PF08426:PF07943:PF11958:PF08762,0,17,0,0,17,1001,0.0,0.98,0,0,0,0,0,0,1018,0,1.0,0,0
PF04388,PF15905:PF07888:PF17045:PF16471:PF04108,8,3,0,8,3,1007,0.0,0.99,0.0,-0.0,1,0,8,1,1009,0.0,0.99,0.0,-0.0
PF04133,PF03071:PF16282:PF02245:PF06374:PF08714,5,23,2,3,21,992,0.09,0.98,0.4,0.18,1,0,5,1,1012,0.0,0.99,0.0,-0.0
PF13194,PF04370:PF14539:PF06451:PF05836:PF08291,0,0,0,0,0,1018,0,1.0,0,0,0,0,0,0,1018,0,1.0,0,0
PF00329,PF01058:PF00507:PF00499:PF00124:PF00902,17,27,9,8,18,983,0.33,0.97,0.53,0.41,2,2,15,0,1001,1.0,0.99,0.12,0.34
PF01096,PF02150:PF15694:PF15693:PF08711:PF07500,19,40,15,4,25,974,0.38,0.97,0.79,0.53,4,4,15,0,999,1.0,0.99,0.21,0.46
PF05703,PF08458:PF00591:PF07831:PF09284:PF16544,6,16,6,0,10,1002,0.38,0.99,1.0,0.61,2,1,5,1,1011,0.5,0.99,0.17,0.29
PF15021,PF15518:PF04196:PF08411:PF08479:PF15976,0,2,0,0,2,1016,0.0,1.0,0,0,0,0,0,0,1018,0,1.0,0,0
PF01323,PF06288:PF00274:PF06585:PF08881:PF16984,21,28,8,13,20,977,0.29,0.97,0.38,0.31,2,2,19,0,997,1.0,0.98,0.1,0.31
PF05264,PF11529:PF08223:PF06224:PF07199:PF09361,0,0,0,0,0,1018,0,1.0,0,0,0,0,0,0,1018,0,1.0,0,0
PF03450,PF00941:PF01315:PF02738:PF01799:PF00111,22,43,22,0,21,975,0.51,0.98,1.0,0.71,21,21,1,0,996,1.0,1.0,0.95,0.98
PF06542,PF06581:PF04402:PF02024:PF00727:PF00489,2,11,1,1,10,1006,0.09,0.99,0.5,0.21,0,0,2,0,1016,0,1.0,0.0,0
PF12924,PF02177:PF03494:PF12925:PF10515:PF10264,8,15,8,0,7,1003,0.53,0.99,1.0,0.73,8,8,0,0,1010,1.0,1.0,1.0,1.0
PF05456,PF15325:PF06876:PF06729:PF16001:PF14865,3,1,1,2,0,1015,1.0,1.0,0.33,0.58,0,0,3,0,1015,0,1.0,0.0,0
PF01725,PF09297:PF09296:PF03912:PF11788:PF14976,14,21,4,10,17,987,0.19,0.97,0.29,0.22,4,2,12,2,1002,0.5,0.99,0.14,0.26
PF01726,PF16965:PF00796:PF10974:PF12856:PF02277,1,5,0,1,5,1012,0.0,0.99,0.0,-0.0,0,0,1,0,1017,0,1.0,0.0,0
PF02086,PF11019:PF05939:PF06070:PF07484:PF03090,2,1,0,2,1,1015,0.0,1.0,0.0,-0.0,0,0,2,0,1016,0,1.0,0.0,0
PF08424,PF08514:PF14973:PF11374:PF14959:PF14649,13,34,6,7,28,977,0.18,0.97,0.46,0.27,1,1,12,0,1005,1.0,0.99,0.08,0.28
PF04840,PF04841:PF12215:PF04685:PF10487:PF14228,14,25,9,5,16,988,0.36,0.98,0.64,0.47,3,2,12,1,1003,0.67,0.99,0.14,0.3
PF16850,PF10554:PF17010:PF13722:PF11304:PF02625,1,1,0,1,1,1016,0.0,1.0,0.0,-0.0,0,0,1,0,1017,0,1.0,0.0,0
PF13701,PF08813:PF01801:PF01798:PF10101:PF00829,0,32,0,0,32,986,0.0,0.97,0,0,0,0,0,0,1018,0,1.0,0,0
PF10326,PF10319:PF10318:PF10317:PF10323:PF02118,20,28,7,13,21,977,0.25,0.97,0.35,0.28,2,0,20,2,996,0.0,0.98,0.0,-0.01
PF04657,PF08497:PF15281:PF03888:PF03241:PF11874,4,3,0,4,3,1011,0.0,0.99,0.0,-0.0,0,0,4,0,1014,0,1.0,0.0,0
PF02323,PF03203:PF17015:PF04892:PF05981:PF11325,1,4,0,1,4,1013,0.0,1.0,0.0,-0.0,0,0,1,0,1017,0,1.0,0.0,0
PF07054,PF11265:PF04747:PF11244:PF11235:PF11765,2,6,0,2,6,1010,0.0,0.99,0.0,-0.0,0,0,2,0,1016,0,1.0,0.0,0
PF02847,PF02854:PF09090:PF09088:PF10573:PF02020,20,54,19,1,35,963,0.35,0.96,0.95,0.57,9,6,14,3,995,0.67,0.98,0.3,0.44
PF12879,PF12887:PF12878:PF15253:PF02213:PF10377,0,22,0,0,22,996,0.0,0.98,0,0,1,0,0,1,1017,0.0,1.0,0,0
PF12549,PF00351:PF01842:PF10369:PF00742:PF03447,3,55,3,0,52,963,0.05,0.95,1.0,0.23,7,0,3,7,1008,0.0,0.99,0.0,-0.0
PF10109,PF04355:PF07157:PF15976:PF01580:PF10618,0,5,0,0,5,1013,0.0,1.0,0,0,0,0,0,0,1018,0,1.0,0,0
PF07762,PF04859:PF06830:PF04833:PF08268:PF04646,18,18,4,14,14,986,0.22,0.97,0.22,0.21,1,0,18,1,999,0.0,0.98,0.0,-0.0
PF00117,PF00988:PF00958:PF06418:PF00218:PF00977,68,54,48,20,6,944,0.89,0.97,0.71,0.78,7,7,61,0,950,1.0,0.94,0.1,0.31
PF04350,PF11794:PF12241:PF04351:PF09826:PF14882,0,3,0,0,3,1015,0.0,1.0,0,0,0,0,0,0,1018,0,1.0,0,0
PF11654,PF03379:PF15055:PF17032:PF09990:PF15550,1,1,0,1,1,1016,0.0,1.0,0.0,-0.0,0,0,1,0,1017,0,1.0,0.0,0
PF03547,PF00610:PF12257:PF00686:PF06652:PF02377,16,70,10,6,60,942,0.14,0.94,0.62,0.28,2,1,15,1,1001,0.5,0.98,0.06,0.17
PF00628,PF12269:PF03172:PF16737:PF14061:PF00439,97,85,54,43,31,890,0.64,0.93,0.56,0.56,2,2,95,0,921,1.0,0.91,0.02,0.14
PF00158,PF02954:PF04397:PF00990:PF06580:PF00563,11,21,7,4,14,993,0.33,0.98,0.64,0.45,6,4,7,2,1005,0.67,0.99,0.36,0.49
PF08206,PF08529:PF13184:PF09876:PF09371:PF14878,1,17,1,0,16,1001,0.06,0.98,1.0,0.24,1,1,0,0,1017,1.0,1.0,1.0,1.0
PF11327,PF14610:PF15245:PF04852:PF07172:PF08194,4,9,2,2,7,1007,0.22,0.99,0.5,0.33,0,0,4,0,1014,0,1.0,0.0,0
PF07702,PF00392:PF04288:PF04247:PF10797:PF07729,4,20,4,0,16,998,0.2,0.98,1.0,0.44,0,0,4,0,1014,0,1.0,0.0,0
PF14816,PF05604:PF04988:PF05841:PF13810:PF16171,6,6,1,5,5,1007,0.17,0.99,0.17,0.16,0,0,6,0,1012,0,0.99,0.0,0
PF03528,PF09311:PF11409:PF16696:PF11464:PF12210,5,20,5,0,15,998,0.25,0.99,1.0,0.5,1,1,4,0,1013,1.0,1.0,0.2,0.45
PF05546,PF12049:PF15342:PF07223:PF03193:PF09282,8,11,3,5,8,1002,0.27,0.99,0.38,0.31,0,0,8,0,1010,0,0.99,0.0,0
PF17213,PF12297:PF16830:PF10481:PF07926:PF11577,3,16,0,3,16,999,0.0,0.98,0.0,-0.01,0,0,3,0,1015,0,1.0,0.0,0
PF08602,PF17062:PF03275:PF15175:PF05202:PF09074,0,1,0,0,1,1017,0.0,1.0,0,0,0,0,0,0,1018,0,1.0,0,0
PF10217,PF07052:PF10173:PF14769:PF15991:PF05615,1,22,0,1,22,995,0.0,0.98,0.0,-0.0,1,0,1,1,1016,0.0,1.0,0.0,-0.0
PF01636,PF13419:PF00561:PF00441:PF03109:PF02770,55,154,43,12,111,852,0.28,0.88,0.78,0.42,40,26,29,14,949,0.65,0.96,0.47,0.53
PF00880,PF15149:PF16748:PF00305:PF00361:PF04841,10,45,7,3,38,970,0.16,0.96,0.7,0.32,1,1,9,0,1008,1.0,0.99,0.1,0.31
PF03982,PF12146:PF00561:PF04083:PF13350:PF12697,19,129,14,5,115,884,0.11,0.88,0.74,0.25,33,12,7,21,978,0.36,0.97,0.63,0.47
PF04592,PF07561:PF02535:PF05508:PF08655:PF08634,1,62,1,0,61,956,0.02,0.94,1.0,0.12,0,0,1,0,1017,0,1.0,0.0,0
PF15350,PF14022:PF14421:PF02350:PF04704:PF12600,0,6,0,0,6,1012,0.0,0.99,0,0,0,0,0,0,1018,0,1.0,0,0
PF13160,PF10734:PF08277:PF15508:PF02885:PF01858,0,19,0,0,19,999,0.0,0.98,0,0,0,0,0,0,1018,0,1.0,0,0
PF07218,PF03729:PF05974:PF06798:PF07520:PF11863,0,0,0,0,0,1018,0,1.0,0,0,0,0,0,0,1018,0,1.0,0,0
PF13006,PF05671:PF01254:PF11924:PF14564:PF05598,3,7,2,1,5,1010,0.29,0.99,0.67,0.43,0,0,3,0,1015,0,1.0,0.0,0
PF02022,PF13276:PF00552:PF01141:PF01623:PF09337,5,20,5,0,15,998,0.25,0.99,1.0,0.5,4,4,1,0,1013,1.0,1.0,0.8,0.89
PF04092,PF16321:PF10806:PF17172:PF02482:PF02578,0,12,0,0,12,1006,0.0,0.99,0,0,1,0,0,1,1017,0.0,1.0,0,0
PF11018,PF15955:PF15868:PF14935:PF11779:PF02285,1,16,0,1,16,1001,0.0,0.98,0.0,-0.0,0,0,1,0,1017,0,1.0,0.0,0
PF07534,PF12068:PF00566:PF15733:PF08593:PF11830,18,85,12,6,73,927,0.14,0.92,0.67,0.28,2,1,17,1,999,0.5,0.98,0.06,0.16
PF01383,PF00502:PF01228:PF15130:PF03063:PF15444,1,4,1,0,3,1014,0.25,1.0,1.0,0.5,0,0,1,0,1017,0,1.0,0.0,0
PF06747,PF10276:PF01922:PF06645:PF05676:PF00831,10,27,6,4,21,987,0.22,0.98,0.6,0.36,2,1,9,1,1007,0.5,0.99,0.1,0.22
PF03865,PF13722:PF10554:PF06826:PF04865:PF03428,0,1,0,0,1,1017,0.0,1.0,0,0,0,0,0,0,1018,0,1.0,0,0
PF07505,PF03428:PF01913:PF17206:PF01752:PF06070,0,5,0,0,5,1013,0.0,1.0,0,0,0,0,0,0,1018,0,1.0,0,0
PF09416,PF13625:PF16203:PF04313:PF12851:PF14665,11,19,6,5,13,994,0.32,0.98,0.55,0.41,3,3,8,0,1007,1.0,0.99,0.27,0.52
PF12247,PF12246:PF00867:PF00752:PF05700:PF00136,2,62,2,0,60,956,0.03,0.94,1.0,0.17,13,1,1,12,1004,0.08,0.99,0.5,0.19
PF12743,PF12577:PF02159:PF02161:PF02155:PF11825,6,13,6,0,7,1005,0.46,0.99,1.0,0.68,5,5,1,0,1012,1.0,1.0,0.83,0.91
PF05687,PF01373:PF03181:PF06964:PF08314:PF07250,6,31,5,1,26,986,0.16,0.97,0.83,0.36,3,2,4,1,1011,0.67,1.0,0.33,0.47
PF16276,PF14186:PF08365:PF06540:PF12121:PF08023,2,6,0,2,6,1010,0.0,0.99,0.0,-0.0,0,0,2,0,1016,0,1.0,0.0,0
PF09224,PF09361:PF06505:PF09611:PF00555:PF16967,0,2,0,0,2,1016,0.0,1.0,0,0,0,0,0,0,1018,0,1.0,0,0
PF08101,PF09441:PF09047:PF15407:PF05397:PF04357,1,13,1,0,12,1005,0.08,0.99,1.0,0.28,0,0,1,0,1017,0,1.0,0.0,0
PF03652,PF00537:PF06232:PF07011:PF07333:PF12638,5,10,2,3,8,1005,0.2,0.99,0.4,0.28,0,0,5,0,1013,0,1.0,0.0,0
PF08351,PF13725:PF13718:PF05127:PF00049:PF08746,12,27,12,0,15,991,0.44,0.99,1.0,0.66,12,12,0,0,1006,1.0,1.0,1.0,1.0
PF15367,PF05857:PF11751:PF06890:PF07409:PF05109,2,0,0,2,0,1016,0,1.0,0.0,0,0,0,2,0,1016,0,1.0,0.0,0
PF05831,PF12764:PF08699:PF07963:PF16829:PF11642,2,43,2,0,41,975,0.05,0.96,1.0,0.21,0,0,2,0,1016,0,1.0,0.0,0
PF11703,PF15703:PF15551:PF15814:PF07326:PF00419,0,1,0,0,1,1017,0.0,1.0,0,0,0,0,0,0,1018,0,1.0,0,0
PF12659,PF12461:PF03934:PF15518:PF04612:PF13954,0,6,0,0,6,1012,0.0,0.99,0,0,0,0,0,0,1018,0,1.0,0,0
PF04983,PF00623:PF04992:PF04997:PF11523:PF04998,31,39,30,1,9,978,0.77,0.99,0.97,0.86,29,29,2,0,987,1.0,1.0,0.94,0.97
PF10347,PF10293:PF10351:PF10344:PF10305:PF10359,5,8,5,0,3,1010,0.62,1.0,1.0,0.79,4,4,1,0,1013,1.0,1.0,0.8,0.89
PF08729,PF12480:PF15778:PF10264:PF09469:PF12090,4,15,2,2,13,1001,0.13,0.99,0.5,0.25,0,0,4,0,1014,0,1.0,0.0,0
PF04955,PF06119:PF07519:PF07019:PF07270:PF01979,0,73,0,0,73,945,0.0,0.93,0,0,8,0,0,8,1010,0.0,0.99,0,0
PF10091,PF06745:PF17164:PF13505:PF02211:PF11751,0,3,0,0,3,1015,0.0,1.0,0,0,0,0,0,0,1018,0,1.0,0,0
PF03309,PF02654:PF14258:PF04559:PF08291:PF05939,1,3,0,1,3,1014,0.0,1.0,0.0,-0.0,0,0,1,0,1017,0,1.0,0.0,0
PF08693,PF17056:PF15972:PF03749:PF10563:PF05808,1,4,0,1,4,1013,0.0,1.0,0.0,-0.0,0,0,1,0,1017,0,1.0,0.0,0
PF14082,PF09826:PF16888:PF07523:PF07409:PF11751,0,2,0,0,2,1016,0.0,1.0,0,0,0,0,0,0,1018,0,1.0,0,0
PF07940,PF04428:PF04632:PF01057:PF12600:PF16967,6,4,0,6,4,1008,0.0,0.99,0.0,-0.0,0,0,6,0,1012,0,0.99,0.0,0
PF06549,PF02605:PF11152:PF09057:PF01947:PF10868,1,2,1,0,1,1016,0.5,1.0,1.0,0.71,0,0,1,0,1017,0,1.0,0.0,0
PF10189,PF02213:PF12422:PF14738:PF16059:PF05715,8,22,2,6,20,990,0.09,0.97,0.25,0.14,1,1,7,0,1010,1.0,0.99,0.12,0.35
PF11204,PF02028:PF04749:PF02180:PF05097:PF05346,9,36,4,5,32,977,0.11,0.96,0.44,0.21,2,0,9,2,1007,0.0,0.99,0.0,-0.0
PF12067,PF13775:PF12336:PF09667:PF08517:PF08347,1,10,0,1,10,1007,0.0,0.99,0.0,-0.0,0,0,1,0,1017,0,1.0,0.0,0
PF04739,PF00478:PF00654:PF16561:PF00893:PF00585,6,59,6,0,53,959,0.1,0.95,1.0,0.31,5,2,4,3,1009,0.4,0.99,0.33,0.36
PF11262,PF16134:PF11732:PF16685:PF10491:PF00073,6,25,6,0,19,993,0.24,0.98,1.0,0.49,0,0,6,0,1012,0,0.99,0.0,0
PF01937,PF03630:PF06888:PF05742:PF02310:PF02607,17,22,8,9,14,987,0.36,0.98,0.47,0.4,3,0,17,3,998,0.0,0.98,0.0,-0.01
PF06999,PF11927:PF01977:PF09791:PF12597:PF00111,25,54,11,14,43,950,0.2,0.94,0.44,0.27,4,4,21,0,993,1.0,0.98,0.16,0.4
PF01500,PF05287:PF13885:PF00323:PF03185:PF14944,1,11,0,1,11,1006,0.0,0.99,0.0,-0.0,0,0,1,0,1017,0,1.0,0.0,0
PF16683,PF15314:PF04359:PF06485:PF05448:PF05991,3,8,0,3,8,1007,0.0,0.99,0.0,-0.0,0,0,3,0,1015,0,1.0,0.0,0
PF10591,PF09289:PF00050:PF09307:PF00219:PF01469,9,29,6,3,23,986,0.21,0.97,0.67,0.36,1,1,8,0,1009,1.0,0.99,0.11,0.33
PF08674,PF00135:PF11095:PF03154:PF06884:PF14518,0,90,0,0,90,928,0.0,0.91,0,0,2,0,0,2,1016,0.0,1.0,0,0
PF07572,PF02631:PF11267:PF15379:PF05459:PF15553,8,3,1,7,2,1008,0.33,0.99,0.12,0.2,0,0,8,0,1010,0,0.99,0.0,0
PF10309,PF12516:PF05182:PF14722:PF15249:PF16043,10,28,5,5,23,985,0.18,0.97,0.5,0.29,0,0,10,0,1008,0,0.99,0.0,0
PF05359,PF06681:PF02413:PF12615:PF06890:PF06407,0,0,0,0,0,1018,0,1.0,0,0,0,0,0,0,1018,0,1.0,0,0
PF04108,PF03468:PF15246:PF10377:PF01465:PF14846,1,24,1,0,23,994,0.04,0.98,1.0,0.2,1,1,0,0,1017,1.0,1.0,1.0,1.0
PF03768,PF03769:PF16048:PF17054:PF08018:PF12121,0,7,0,0,7,1011,0.0,0.99,0,0,0,0,0,0,1018,0,1.0,0,0
PF00431,PF01382:PF01400:PF01133:PF00008:PF00683,73,103,51,22,52,893,0.5,0.93,0.7,0.55,6,6,67,0,945,1.0,0.93,0.08,0.28
PF14541,PF14543:PF04833:PF06414:PF04406:PF04859,27,48,25,2,23,968,0.52,0.98,0.93,0.68,3,3,24,0,991,1.0,0.98,0.11,0.33
PF11988,PF08744:PF04001:PF04965:PF05947:PF08183,0,0,0,0,0,1018,0,1.0,0,0,0,0,0,0,1018,0,1.0,0,0
PF16776,PF16726:PF08952:PF09036:PF08333:PF07092,1,24,1,0,23,994,0.04,0.98,1.0,0.2,1,1,0,0,1017,1.0,1.0,1.0,1.0
PF15379,PF11652:PF15553:PF06485:PF15895:PF02425,0,5,0,0,5,1013,0.0,1.0,0,0,0,0,0,0,1018,0,1.0,0,0
PF12717,PF15246:PF12922:PF10377:PF02213:PF14738,24,34,18,6,16,978,0.53,0.98,0.75,0.62,1,1,23,0,994,1.0,0.98,0.04,0.2
PF11061,PF10690:PF07617:PF03426:PF13828:PF02066,0,0,0,0,0,1018,0,1.0,0,0,0,0,0,0,1018,0,1.0,0,0
PF13409,PF02798:PF13417:PF14497:PF13679:PF00953,16,105,12,4,93,909,0.11,0.9,0.75,0.27,19,6,10,13,989,0.32,0.98,0.38,0.33
PF00739,PF17014:PF06450:PF17007:PF05943:PF05947,1,1,0,1,1,1016,0.0,1.0,0.0,-0.0,0,0,1,0,1017,0,1.0,0.0,0
PF08734,PF15175:PF15208:PF05155:PF07419:PF02624,1,2,1,0,1,1016,0.5,1.0,1.0,0.71,0,0,1,0,1017,0,1.0,0.0,0
PF00165,PF04422:PF02805:PF12350:PF11690:PF08639,6,10,6,0,4,1008,0.6,1.0,1.0,0.77,0,0,6,0,1012,0,0.99,0.0,0
PF03927,PF09092:PF05069:PF16448:PF02311:PF08310,0,11,0,0,11,1007,0.0,0.99,0,0,0,0,0,0,1018,0,1.0,0,0
PF16265,PF13482:PF09374:PF12840:PF08093:PF05488,0,2,0,0,2,1016,0.0,1.0,0,0,0,0,0,0,1018,0,1.0,0,0
PF00144,PF03109:PF11954:PF07930:PF06176:PF01636,68,76,36,32,40,910,0.47,0.93,0.53,0.46,3,3,65,0,950,1.0,0.94,0.04,0.2
PF15407,PF15082:PF09322:PF10407:PF08183:PF09441,0,4,0,0,4,1014,0.0,1.0,0,0,0,0,0,0,1018,0,1.0,0,0
PF01928,PF00485:PF04437:PF11571:PF10496:PF14958,3,43,3,0,40,975,0.07,0.96,1.0,0.26,3,0,3,3,1012,0.0,0.99,0.0,-0.0
PF10323,PF02118:PF10326:PF10317:PF03125:PF10319,9,33,4,5,29,980,0.12,0.97,0.44,0.22,2,0,9,2,1007,0.0,0.99,0.0,-0.0
PF07504,PF02128:PF03413:PF05285:PF08302:PF12742,3,23,3,0,20,995,0.13,0.98,1.0,0.36,2,2,1,0,1015,1.0,1.0,0.67,0.82
PF09237,PF09494:PF12507:PF03131:PF11900:PF03000,3,32,2,1,30,985,0.06,0.97,0.67,0.2,5,1,2,4,1011,0.2,0.99,0.33,0.26
PF02529,PF05466:PF03613:PF14328:PF13750:PF01914,0,0,0,0,0,1018,0,1.0,0,0,0,0,0,0,1018,0,1.0,0,0
PF15217,PF15212:PF06724:PF05947:PF06403:PF08497,0,1,0,0,1,1017,0.0,1.0,0,0,0,0,0,0,1018,0,1.0,0,0
PF08038,PF15475:PF04736:PF11029:PF09057:PF15053,1,6,0,1,6,1011,0.0,0.99,0.0,-0.0,0,0,1,0,1017,0,1.0,0.0,0
PF15136,PF11435:PF14467:PF14251:PF04170:PF16411,2,4,0,2,4,1012,0.0,0.99,0.0,-0.0,0,0,2,0,1016,0,1.0,0.0,0
PF16531,PF07989:PF05104:PF03801:PF09762:PF12297,3,21,1,2,20,995,0.05,0.98,0.33,0.12,0,0,3,0,1015,0,1.0,0.0,0
PF02645,PF09904:PF08805:PF15355:PF01752:PF00974,1,3,0,1,3,1014,0.0,1.0,0.0,-0.0,0,0,1,0,1017,0,1.0,0.0,0
PF15810,PF14610:PF11282:PF12855:PF01878:PF12926,1,16,1,0,15,1002,0.06,0.99,1.0,0.25,0,0,1,0,1017,0,1.0,0.0,0
PF08806,PF01667:PF01783:PF03942:PF08583:PF01907,12,41,8,4,33,973,0.2,0.96,0.67,0.35,6,4,8,2,1004,0.67,0.99,0.33,0.47
PF01797,PF08571:PF00681:PF04356:PF01231:PF02153,2,38,1,1,37,979,0.03,0.96,0.5,0.11,2,0,2,2,1014,0.0,1.0,0.0,-0.0
PF08070,PF16898:PF00521:PF00986:PF00204:PF01751,4,35,4,0,31,983,0.11,0.97,1.0,0.33,19,4,0,15,999,0.21,0.99,1.0,0.46
PF12686,PF04222:PF03831:PF10995:PF03050:PF06450,0,1,0,0,1,1017,0.0,1.0,0,0,0,0,0,0,1018,0,1.0,0,0
PF16099,PF08585:PF13888:PF14438:PF07217:PF06741,1,33,1,0,32,985,0.03,0.97,1.0,0.17,4,0,1,4,1013,0.0,1.0,0.0,-0.0
PF06140,PF05308:PF14822:PF15388:PF15390:PF08315,6,20,4,2,16,996,0.2,0.98,0.67,0.36,1,1,5,0,1012,1.0,1.0,0.17,0.41
PF06239,PF14784:PF12243:PF10444:PF16173:PF03993,4,11,1,3,10,1004,0.09,0.99,0.25,0.15,0,0,4,0,1014,0,1.0,0.0,0
PF13696,PF08783:PF17180:PF15017:PF05924:PF10453,10,19,10,0,9,999,0.53,0.99,1.0,0.72,2,2,8,0,1008,1.0,0.99,0.2,0.45
PF15022,PF09669:PF04738:PF04342:PF05144:PF03589,0,1,0,0,1,1017,0.0,1.0,0,0,0,0,0,0,1018,0,1.0,0,0
PF14399,PF09260:PF07393:PF11852:PF00090:PF00057,7,101,4,3,97,914,0.04,0.9,0.57,0.13,10,2,5,8,1003,0.2,0.99,0.29,0.23
PF13286,PF04225:PF04335:PF02583:PF12883:PF13471,6,15,4,2,11,1001,0.27,0.99,0.67,0.42,2,0,6,2,1010,0.0,0.99,0.0,-0.0
PF06697,PF00321:PF06206:PF07333:PF01099:PF05479,2,4,0,2,4,1012,0.0,0.99,0.0,-0.0,0,0,2,0,1016,0,1.0,0.0,0
PF06291,PF02297:PF07719:PF13640:PF01812:PF04577,0,81,0,0,81,937,0.0,0.92,0,0,13,0,0,13,1005,0.0,0.99,0,0
PF11863,PF03592:PF03428:PF05939:PF04466:PF06744,0,0,0,0,0,1018,0,1.0,0,0,0,0,0,0,1018,0,1.0,0,0
PF01032,PF09383:PF16326:PF09821:PF12857:PF12399,5,12,3,2,9,1004,0.25,0.99,0.6,0.38,2,2,3,0,1013,1.0,1.0,0.4,0.63
PF14033,PF07000:PF07065:PF07350:PF01680:PF10780,18,24,3,15,21,979,0.12,0.96,0.17,0.13,1,1,17,0,1000,1.0,0.98,0.06,0.23
PF00323,PF02740:PF15722:PF01114:PF04643:PF00879,0,3,0,0,3,1015,0.0,1.0,0,0,0,0,0,0,1018,0,1.0,0,0
PF07418,PF07333:PF15370:PF00321:PF06232:PF15071,0,8,0,0,8,1010,0.0,0.99,0,0,0,0,0,0,1018,0,1.0,0,0
PF00769,PF09766:PF16705:PF04382:PF10509:PF09379,10,53,9,1,44,964,0.17,0.96,0.9,0.38,3,3,7,0,1008,1.0,0.99,0.3,0.55
PF00647,PF02798:PF06441:PF16780:PF13417:PF04399,11,89,11,0,78,929,0.12,0.92,1.0,0.34,5,2,9,3,1004,0.4,0.99,0.18,0.26
PF16594,PF08656:PF15055:PF13933:PF04852:PF02202,1,5,1,0,4,1013,0.2,1.0,1.0,0.45,0,0,1,0,1017,0,1.0,0.0,0
PF04794,PF00796:PF07486:PF03379:PF07936:PF15212,3,4,0,3,4,1011,0.0,0.99,0.0,-0.0,0,0,3,0,1015,0,1.0,0.0,0
PF15334,PF15770:PF17022:PF01668:PF15760:PF15097,0,3,0,0,3,1015,0.0,1.0,0,0,0,0,0,0,1018,0,1.0,0,0
PF06868,PF03379:PF15085:PF07327:PF17124:PF02025,0,6,0,0,6,1012,0.0,0.99,0,0,0,0,0,0,1018,0,1.0,0,0
PF12165,PF12269:PF16737:PF03172:PF14061:PF12998,3,27,2,1,25,990,0.07,0.97,0.67,0.22,2,1,2,1,1014,0.5,1.0,0.33,0.41
PF05276,PF09808:PF04139:PF09302:PF09755:PF15369,5,19,3,2,16,997,0.16,0.98,0.6,0.3,2,1,4,1,1012,0.5,1.0,0.2,0.31
PF15991,PF06420:PF07052:PF07051:PF10217:PF06989,0,15,0,0,15,1003,0.0,0.99,0,0,0,0,0,0,1018,0,1.0,0,0
PF16510,PF12388:PF15207:PF17015:PF01752:PF11210,0,3,0,0,3,1015,0.0,1.0,0,0,0,0,0,0,1018,0,1.0,0,0
PF01034,PF06365:PF15369:PF15290:PF15342:PF15247,4,17,2,2,15,999,0.12,0.98,0.5,0.24,1,1,3,0,1014,1.0,1.0,0.25,0.5
PF15352,PF11035:PF15345:PF16829:PF15079:PF15254,0,4,0,0,4,1014,0.0,1.0,0,0,0,0,0,0,1018,0,1.0,0,0
PF03067,PF05335:PF13695:PF01551:PF09451:PF01341,19,33,10,9,23,976,0.3,0.97,0.53,0.38,1,1,18,0,999,1.0,0.98,0.05,0.23
PF00282,PF05637:PF00494:PF02517:PF01370:PF03006,46,110,29,17,81,891,0.26,0.9,0.63,0.37,11,9,37,2,970,0.82,0.96,0.2,0.39
PF16727,PF11626:PF08914:PF14377:PF13438:PF08605,2,21,2,0,19,997,0.1,0.98,1.0,0.31,1,0,2,1,1015,0.0,1.0,0.0,-0.0
PF14755,PF00063:PF08416:PF16735:PF06017:PF16521,2,80,2,0,78,938,0.03,0.92,1.0,0.15,6,2,0,4,1012,0.33,1.0,1.0,0.58
PF15172,PF14672:PF02448:PF15559:PF15173:PF10716,1,1,0,1,1,1016,0.0,1.0,0.0,-0.0,0,0,1,0,1017,0,1.0,0.0,0
PF15168,PF05947:PF10279:PF03729:PF04965:PF05939,3,0,0,3,0,1015,0,1.0,0.0,0,0,0,3,0,1015,0,1.0,0.0,0
PF17151,PF07004:PF00109:PF01266:PF08976:PF07575,0,108,0,0,108,910,0.0,0.89,0,0,10,0,0,10,1008,0.0,0.99,0,0
PF09174,PF01951:PF09786:PF01217:PF10574:PF00928,2,60,2,0,58,958,0.03,0.94,1.0,0.18,4,2,0,2,1014,0.5,1.0,1.0,0.71
PF07159,PF05994:PF01175:PF04704:PF09511:PF08302,7,20,7,0,13,998,0.35,0.99,1.0,0.59,2,2,5,0,1011,1.0,1.0,0.29,0.53
PF08050,PF12220:PF12353:PF08081:PF12196:PF08143,1,19,1,0,18,999,0.05,0.98,1.0,0.23,1,1,0,0,1017,1.0,1.0,1.0,1.0
PF16752,PF06374:PF08600:PF12043:PF09732:PF05086,4,19,0,4,19,995,0.0,0.98,0.0,-0.01,0,0,4,0,1014,0,1.0,0.0,0
PF03591,PF14903:PF09690:PF12602:PF14618:PF03244,0,0,0,0,0,1018,0,1.0,0,0,0,0,0,0,1018,0,1.0,0,0
PF03411,PF11245:PF09861:PF05913:PF00669:PF14552,1,3,0,1,3,1014,0.0,1.0,0.0,-0.0,0,0,1,0,1017,0,1.0,0.0,0
PF10976,PF03562:PF15089:PF10988:PF08795:PF02554,0,1,0,0,1,1017,0.0,1.0,0,0,0,0,0,0,1018,0,1.0,0,0
PF16207,PF08941:PF02172:PF03167:PF08316:PF03366,11,44,7,4,37,970,0.16,0.96,0.64,0.3,5,3,8,2,1005,0.6,0.99,0.27,0.4
PF01926,PF01018:PF09994:PF13167:PF04870:PF03109,71,58,30,41,28,919,0.52,0.93,0.42,0.43,8,8,63,0,947,1.0,0.94,0.11,0.33
PF03009,PF03105:PF00686:PF00723:PF16387:PF03124,33,63,22,11,41,944,0.35,0.95,0.67,0.46,7,6,27,1,984,0.86,0.97,0.18,0.39
PF02922,PF02806:PF07821:PF16028:PF09260:PF11852,16,26,14,2,12,990,0.54,0.99,0.88,0.68,2,2,14,0,1002,1.0,0.99,0.12,0.35
PF11066,PF12513:PF02475:PF11938:PF02221:PF07152,0,52,0,0,52,966,0.0,0.95,0,0,3,0,0,3,1015,0.0,1.0,0,0
PF16860,PF10558:PF05300:PF03073:PF02569:PF06825,4,24,1,3,23,991,0.04,0.97,0.25,0.09,0,0,4,0,1014,0,1.0,0.0,0
PF08441,PF01839:PF00882:PF01788:PF00357:PF08473,17,20,17,0,3,998,0.85,1.0,1.0,0.92,2,2,15,0,1001,1.0,0.99,0.12,0.34
PF13400,PF06305:PF12034:PF03713:PF15682:PF05969,0,4,0,0,4,1014,0.0,1.0,0,0,0,0,0,0,1018,0,1.0,0,0
PF01850,PF12604:PF05474:PF06719:PF02311:PF00950,0,12,0,0,12,1006,0.0,0.99,0,0,0,0,0,0,1018,0,1.0,0,0
PF08349,PF04671:PF09826:PF12040:PF01385:PF06864,2,4,0,2,4,1012,0.0,0.99,0.0,-0.0,0,0,2,0,1016,0,1.0,0.0,0
PF04932,PF03050:PF08497:PF08345:PF06798:PF14987,0,3,0,0,3,1015,0.0,1.0,0,0,0,0,0,0,1018,0,1.0,0,0
PF04161,PF06172:PF05995:PF00210:PF04110:PF16122,13,32,7,6,25,980,0.22,0.97,0.54,0.33,3,3,10,0,1005,1.0,0.99,0.23,0.48
PF06784,PF10320:PF05719:PF06825:PF03073:PF05197,5,20,1,4,19,994,0.05,0.98,0.2,0.09,1,0,5,1,1012,0.0,0.99,0.0,-0.0
PF06581,PF06875:PF14653:PF02427:PF12046:PF15109,0,0,0,0,0,1018,0,1.0,0,0,0,0,0,0,1018,0,1.0,0,0
PF08247,PF10673:PF01778:PF01798:PF10065:PF01011,0,42,0,0,42,976,0.0,0.96,0,0,3,0,0,3,1015,0.0,1.0,0,0
PF08383,PF00473:PF15010:PF01705:PF11945:PF04004,4,25,2,2,23,991,0.08,0.98,0.5,0.19,2,1,3,1,1013,0.5,1.0,0.25,0.35
PF06441,PF06237:PF10288:PF04083:PF10022:PF05827,14,45,5,9,40,964,0.11,0.95,0.36,0.18,1,0,14,1,1003,0.0,0.99,0.0,-0.0
PF12407,PF10525:PF04617:PF03867:PF04731:PF12413,1,5,1,0,4,1013,0.2,1.0,1.0,0.45,1,1,0,0,1017,1.0,1.0,1.0,1.0
PF10434,PF05466:PF06724:PF10906:PF06681:PF15775,0,2,0,0,2,1016,0.0,1.0,0,0,0,0,0,0,1018,0,1.0,0,0
PF11627,PF08143:PF12220:PF12196:PF08080:PF08081,2,5,1,1,4,1012,0.2,1.0,0.5,0.31,1,1,1,0,1016,1.0,1.0,0.5,0.71
PF17078,PF06485:PF03907:PF09962:PF15460:PF15553,1,7,0,1,7,1010,0.0,0.99,0.0,-0.0,0,0,1,0,1017,0,1.0,0.0,0
PF03856,PF00473:PF02576:PF14279:PF10330:PF03193,8,11,2,6,9,1001,0.18,0.99,0.25,0.21,0,0,8,0,1010,0,0.99,0.0,0
PF09234,PF03268:PF16851:PF15556:PF06876:PF16590,2,1,0,2,1,1015,0.0,1.0,0.0,-0.0,0,0,2,0,1016,0,1.0,0.0,0
PF10276,PF07939:PF09805:PF15910:PF09340:PF07816,1,15,0,1,15,1002,0.0,0.98,0.0,-0.0,1,0,1,1,1016,0.0,1.0,0.0,-0.0
PF15002,PF06951:PF06679:PF05335:PF04856:PF00726,12,14,3,9,11,995,0.21,0.98,0.25,0.22,0,0,12,0,1006,0,0.99,0.0,0
PF14364,PF13724:PF10533:PF06830:PF10496:PF12214,1,22,0,1,22,995,0.0,0.98,0.0,-0.0,0,0,1,0,1017,0,1.0,0.0,0
PF10734,PF03735:PF16135:PF08512:PF15299:PF09588,0,42,0,0,42,976,0.0,0.96,0,0,7,0,0,7,1011,0.0,0.99,0,0
PF10626,PF02059:PF00123:PF13195:PF10547:PF05224,0,22,0,0,22,996,0.0,0.98,0,0,0,0,0,0,1018,0,1.0,0,0
PF13684,PF14052:PF13657:PF04196:PF06834:PF15023,1,5,0,1,5,1012,0.0,0.99,0.0,-0.0,0,0,1,0,1017,0,1.0,0.0,0
PF08638,PF04048:PF14649:PF12372:PF09743:PF14952,9,23,2,7,21,988,0.09,0.97,0.22,0.13,1,1,8,0,1009,1.0,0.99,0.11,0.33
PF08906,PF00713:PF02583:PF08846:PF02718:PF02348,0,10,0,0,10,1008,0.0,0.99,0,0,0,0,0,0,1018,0,1.0,0,0
PF04965,PF05939:PF05974:PF08744:PF02601:PF09108,0,2,0,0,2,1016,0.0,1.0,0,0,0,0,0,0,1018,0,1.0,0,0
PF05915,PF04716:PF08561:PF06376:PF00321:PF07114,2,19,1,1,18,998,0.05,0.98,0.5,0.16,0,0,2,0,1016,0,1.0,0.0,0
PF09191,PF12104:PF05790:PF11465:PF02189:PF07204,0,8,0,0,8,1010,0.0,0.99,0,0,1,0,0,1,1017,0.0,1.0,0,0
PF01737,PF03819:PF05135:PF15207:PF11057:PF15119,0,3,0,0,3,1015,0.0,1.0,0,0,0,0,0,0,1018,0,1.0,0,0
PF11052,PF15622:PF16448:PF14607:PF13749:PF03272,1,6,0,1,6,1011,0.0,0.99,0.0,-0.0,0,0,1,0,1017,0,1.0,0.0,0
PF11742,PF08651:PF12236:PF05138:PF06122:PF00602,0,2,0,0,2,1016,0.0,1.0,0,0,0,0,0,0,1018,0,1.0,0,0
PF01007,PF08466:PF14798:PF05308:PF04831:PF02038,14,13,4,10,9,995,0.31,0.98,0.29,0.29,1,1,13,0,1004,1.0,0.99,0.07,0.27
PF01849,PF01279:PF00159:PF07911:PF09793:PF10248,13,13,2,11,11,994,0.15,0.98,0.15,0.14,0,0,13,0,1005,0,0.99,0.0,0
PF04387,PF01370:PF05089:PF12972:PF12971:PF08338,19,77,8,11,69,930,0.1,0.92,0.42,0.18,8,4,15,4,995,0.5,0.98,0.21,0.32
PF08137,PF09419:PF11264:PF12023:PF11947:PF06232,0,18,0,0,18,1000,0.0,0.98,0,0,2,0,0,2,1016,0.0,1.0,0,0
PF16968,PF03739:PF07157:PF01330:PF09614:PF11794,0,6,0,0,6,1012,0.0,0.99,0,0,0,0,0,0,1018,0,1.0,0,0
PF05631,PF03847:PF00782:PF00999:PF14671:PF09192,14,106,10,4,96,908,0.09,0.9,0.71,0.24,9,5,9,4,1000,0.56,0.99,0.36,0.44
PF03747,PF03381:PF01667:PF08122:PF03645:PF01470,12,48,6,6,42,964,0.12,0.95,0.5,0.23,3,2,10,1,1005,0.67,0.99,0.17,0.33
PF01885,PF01126:PF06487:PF04119:PF06645:PF10310,13,23,4,9,19,986,0.17,0.97,0.31,0.22,1,1,12,0,1005,1.0,0.99,0.08,0.28
PF15194,PF05939:PF14494:PF10974:PF08453:PF06798,1,2,0,1,2,1015,0.0,1.0,0.0,-0.0,0,0,1,0,1017,0,1.0,0.0,0
PF10798,PF03550:PF05103:PF10335:PF09606:PF09704,0,10,0,0,10,1008,0.0,0.99,0,0,0,0,0,0,1018,0,1.0,0,0
PF04459,PF02217:PF17014:PF13753:PF03944:PF15485,0,5,0,0,5,1013,0.0,1.0,0,0,0,0,0,0,1018,0,1.0,0,0
PF16855,PF04101:PF01554:PF00156:PF02780:PF01095,0,95,0,0,95,923,0.0,0.91,0,0,13,0,0,13,1005,0.0,0.99,0,0
PF07197,PF16872:PF02108:PF13005:PF05065:PF11291,1,1,0,1,1,1016,0.0,1.0,0.0,-0.0,0,0,1,0,1017,0,1.0,0.0,0
PF09810,PF10303:PF04422:PF04432:PF00165:PF09775,4,7,1,3,6,1008,0.14,0.99,0.25,0.18,0,0,4,0,1014,0,1.0,0.0,0
PF15773,PF15744:PF05532:PF15849:PF08636:PF03823,1,5,0,1,5,1012,0.0,0.99,0.0,-0.0,0,0,1,0,1017,0,1.0,0.0,0
PF04648,PF05436:PF01114:PF00323:PF04643:PF15165,1,4,1,0,3,1014,0.25,1.0,1.0,0.5,0,0,1,0,1017,0,1.0,0.0,0
PF12619,PF14551:PF04558:PF16870:PF13882:PF08083,13,65,13,0,52,953,0.2,0.95,1.0,0.44,4,2,11,2,1003,0.5,0.99,0.15,0.27
PF11265,PF11232:PF11244:PF11235:PF12881:PF10522,4,11,3,1,8,1006,0.27,0.99,0.75,0.45,0,0,4,0,1014,0,1.0,0.0,0
PF08032,PF12105:PF00588:PF17191:PF12927:PF03851,4,33,4,0,29,985,0.12,0.97,1.0,0.34,6,2,2,4,1010,0.33,0.99,0.5,0.41
PF17171,PF11801:PF06814:PF17172:PF04104:PF00707,10,41,6,4,35,973,0.15,0.96,0.6,0.28,2,2,8,0,1008,1.0,0.99,0.2,0.45
PF01390,PF02983:PF09272:PF15494:PF16030:PF12032,30,27,7,23,20,968,0.26,0.96,0.23,0.22,1,1,29,0,988,1.0,0.97,0.03,0.18
PF07807,PF07808:PF05391:PF07504:PF12935:PF11816,5,24,5,0,19,994,0.21,0.98,1.0,0.45,1,1,4,0,1013,1.0,1.0,0.2,0.45
PF09073,PF15093:PF11510:PF15749:PF05990:PF13810,2,11,0,2,11,1005,0.0,0.99,0.0,-0.0,1,0,2,1,1015,0.0,1.0,0.0,-0.0
PF12638,PF00537:PF06232:PF12643:PF10839:PF06446,5,8,2,3,6,1007,0.25,0.99,0.4,0.31,0,0,5,0,1013,0,1.0,0.0,0
PF13805,PF03760:PF05532:PF04468:PF09716:PF08636,9,11,1,8,10,999,0.09,0.98,0.11,0.09,0,0,9,0,1009,0,0.99,0.0,0
PF01416,PF08524:PF04189:PF02701:PF14671:PF05334,21,26,8,13,18,979,0.31,0.97,0.38,0.33,1,1,20,0,997,1.0,0.98,0.05,0.22
PF10721,PF16178:PF02902:PF00145:PF04547:PF10734,0,90,0,0,90,928,0.0,0.91,0,0,8,0,0,8,1010,0.0,0.99,0,0
PF06452,PF08792:PF12658:PF15211:PF15047:PF15713,10,3,1,9,2,1006,0.33,0.99,0.1,0.18,0,0,10,0,1008,0,0.99,0.0,0
PF07584,PF01208:PF03962:PF01280:PF03639:PF14085,0,36,0,0,36,982,0.0,0.96,0,0,4,0,0,4,1014,0.0,1.0,0,0
PF14248,PF08093:PF15220:PF03743:PF07960:PF17017,0,9,0,0,9,1009,0.0,0.99,0,0,0,0,0,0,1018,0,1.0,0,0
PF10865,PF02591:PF15191:PF07023:PF09655:PF01389,0,0,0,0,0,1018,0,1.0,0,0,0,0,0,0,1018,0,1.0,0,0
PF04222,PF17206:PF15529:PF11751:PF01514:PF10411,0,1,0,0,1,1017,0.0,1.0,0,0,0,0,0,0,1018,0,1.0,0,0
PF11055,PF08093:PF09832:PF05611:PF09365:PF09826,0,5,0,0,5,1013,0.0,1.0,0,0,0,0,0,0,1018,0,1.0,0,0
PF15844,PF08116:PF00732:PF00106:PF02230:PF05721,0,220,0,0,220,798,0.0,0.78,0,0,23,0,0,23,995,0.0,0.98,0,0
PF09382,PF08072:PF16202:PF00570:PF16124:PF14493,17,42,17,0,25,976,0.4,0.98,1.0,0.63,8,8,9,0,1001,1.0,0.99,0.47,0.68
PF00513,PF08719:PF01872:PF06911:PF16608:PF08423,1,67,0,1,67,950,0.0,0.93,0.0,-0.01,5,0,1,5,1012,0.0,0.99,0.0,-0.0
PF15427,PF15709:PF15976:PF15504:PF06890:PF02074,1,2,0,1,2,1015,0.0,1.0,0.0,-0.0,0,0,1,0,1017,0,1.0,0.0,0
PF04216,PF14467:PF15150:PF14294:PF08299:PF16325,1,5,0,1,5,1012,0.0,0.99,0.0,-0.0,0,0,1,0,1017,0,1.0,0.0,0
PF13018,PF05658:PF05662:PF02951:PF16590:PF04624,0,7,0,0,7,1011,0.0,0.99,0,0,0,0,0,0,1018,0,1.0,0,0
PF01620,PF14984:PF15138:PF07400:PF15973:PF15129,0,2,0,0,2,1016,0.0,1.0,0,0,0,0,0,0,1018,0,1.0,0,0
PF08761,PF01668:PF01316:PF10994:PF02972:PF02632,1,10,0,1,10,1007,0.0,0.99,0.0,-0.0,0,0,1,0,1017,0,1.0,0.0,0
PF05010,PF12372:PF08638:PF15912:PF04048:PF11526,5,28,2,3,26,987,0.07,0.97,0.4,0.16,1,0,5,1,1012,0.0,0.99,0.0,-0.0
PF13928,PF15230:PF07977:PF07400:PF15138:PF15211,5,16,0,5,16,997,0.0,0.98,0.0,-0.01,0,0,5,0,1013,0,1.0,0.0,0
PF08316,PF04090:PF10330:PF06420:PF11001:PF11489,7,10,0,7,10,1001,0.0,0.98,0.0,-0.01,0,0,7,0,1011,0,0.99,0.0,0
PF03954,PF08391:PF09006:PF06023:PF09064:PF16754,1,3,1,0,2,1015,0.33,1.0,1.0,0.58,0,0,1,0,1017,0,1.0,0.0,0
PF17146,PF15017:PF14051:PF05508:PF08590:PF14061,7,23,4,3,19,992,0.17,0.98,0.57,0.31,1,1,6,0,1011,1.0,0.99,0.14,0.38
PF10477,PF09746:PF00853:PF07217:PF16159:PF12540,3,20,1,2,19,996,0.05,0.98,0.33,0.12,1,0,3,1,1014,0.0,1.0,0.0,-0.0
PF00630,PF12780:PF08393:PF07691:PF12777:PF10162,24,54,18,6,36,958,0.33,0.96,0.75,0.48,30,12,12,18,976,0.4,0.97,0.5,0.43
PF07919,PF12742:PF11817:PF12584:PF02128:PF08427,3,23,3,0,20,995,0.13,0.98,1.0,0.36,2,2,1,0,1015,1.0,1.0,0.67,0.82
PF14777,PF14886:PF09232:PF17124:PF08398:PF02950,4,6,3,1,3,1011,0.5,1.0,0.75,0.61,0,0,4,0,1014,0,1.0,0.0,0
PF03083,PF14811:PF04819:PF07985:PF04769:PF03947,15,30,7,8,23,980,0.23,0.97,0.47,0.32,1,1,14,0,1003,1.0,0.99,0.07,0.26
PF14920,PF14918:PF14919:PF14654:PF05647:PF02971,0,4,0,0,4,1014,0.0,1.0,0,0,0,0,0,0,1018,0,1.0,0,0
PF13230,PF02683:PF16091:PF15749:PF13095:PF14475,3,10,0,3,10,1005,0.0,0.99,0.0,-0.01,0,0,3,0,1015,0,1.0,0.0,0
PF13085,PF06159:PF07542:PF11735:PF03583:PF02915,20,21,3,17,18,980,0.14,0.97,0.15,0.13,0,0,20,0,998,0,0.98,0.0,0
PF07464,PF09057:PF15825:PF00451:PF15664:PF06369,1,2,0,1,2,1015,0.0,1.0,0.0,-0.0,0,0,1,0,1017,0,1.0,0.0,0
PF16834,PF05613:PF06054:PF05523:PF07415:PF05343,0,10,0,0,10,1008,0.0,0.99,0,0,0,0,0,0,1018,0,1.0,0,0
PF10470,PF09005:PF16568:PF16274:PF10469:PF16544,0,25,0,0,25,993,0.0,0.98,0,0,1,0,0,1,1017,0.0,1.0,0,0
PF08248,PF08110:PF07440:PF01372:PF08256:PF16048,0,1,0,0,1,1017,0.0,1.0,0,0,0,0,0,0,1018,0,1.0,0,0
PF15223,PF08782:PF02437:PF16566:PF12478:PF09469,0,24,0,0,24,994,0.0,0.98,0,0,4,0,0,4,1014,0.0,1.0,0,0
PF00227,PF10584:PF12465:PF03357:PF14953:PF04847,87,68,45,42,23,908,0.66,0.94,0.52,0.55,5,5,82,0,931,1.0,0.92,0.06,0.23
PF17164,PF17206:PF15775:PF01580:PF17188:PF08707,0,6,0,0,6,1012,0.0,0.99,0,0,0,0,0,0,1018,0,1.0,0,0
PF07327,PF17124:PF03379:PF15085:PF08847:PF09253,1,3,0,1,3,1014,0.0,1.0,0.0,-0.0,0,0,1,0,1017,0,1.0,0.0,0
PF09796,PF04229:PF05870:PF07080:PF00737:PF03576,6,11,2,4,9,1003,0.18,0.99,0.33,0.24,0,0,6,0,1012,0,0.99,0.0,0
PF10706,PF08497:PF05509:PF05513:PF04352:PF01514,1,1,0,1,1,1016,0.0,1.0,0.0,-0.0,0,0,1,0,1017,0,1.0,0.0,0
PF09826,PF07409:PF04717:PF04963:PF04865:PF08479,2,1,1,1,0,1016,1.0,1.0,0.5,0.71,0,0,2,0,1016,0,1.0,0.0,0
PF04762,PF16940:PF02219:PF07034:PF15871:PF15539,8,16,2,6,14,996,0.12,0.98,0.25,0.17,0,0,8,0,1010,0,0.99,0.0,0
PF03748,PF14882:PF03406:PF07411:PF10995:PF08708,0,0,0,0,0,1018,0,1.0,0,0,0,0,0,0,1018,0,1.0,0,0
PF09135,PF08649:PF08636:PF11093:PF04852:PF13933,0,8,0,0,8,1010,0.0,0.99,0,0,0,0,0,0,1018,0,1.0,0,0
PF07975,PF04056:PF14687:PF03648:PF15350:PF07837,4,24,4,0,20,994,0.17,0.98,1.0,0.4,1,0,4,1,1013,0.0,1.0,0.0,-0.0
PF02470,PF07039:PF11708:PF07800:PF12298:PF02186,4,34,2,2,32,982,0.06,0.97,0.5,0.16,3,0,4,3,1011,0.0,0.99,0.0,-0.0
PF07953,PF15394:PF08374:PF00028:PF12679:PF09839,4,49,3,1,46,968,0.06,0.95,0.75,0.21,1,1,3,0,1014,1.0,1.0,0.25,0.5
PF09991,PF15289:PF12646:PF02620:PF03703:PF07298,0,11,0,0,11,1007,0.0,0.99,0,0,0,0,0,0,1018,0,1.0,0,0
PF10484,PF14864:PF14863:PF11718:PF16123:PF00874,12,26,5,7,21,985,0.19,0.97,0.42,0.27,3,1,11,2,1004,0.33,0.99,0.08,0.16
PF08166,PF08167:PF11597:PF06333:PF12366:PF16415,3,23,3,0,20,995,0.13,0.98,1.0,0.36,2,1,2,1,1014,0.5,1.0,0.33,0.41
PF09247,PF15557:PF15624:PF07001:PF09441:PF15914,2,12,1,1,11,1005,0.08,0.99,0.5,0.2,0,0,2,0,1016,0,1.0,0.0,0
PF10412,PF12615:PF15281:PF06805:PF05939:PF02413,0,3,0,0,3,1015,0.0,1.0,0,0,0,0,0,0,1018,0,1.0,0,0
PF00501,PF00550:PF16177:PF13360:PF07993:PF13193,124,132,103,21,29,865,0.78,0.95,0.83,0.78,30,30,94,0,894,1.0,0.91,0.24,0.47
PF12518,PF08792:PF09967:PF05309:PF15505:PF00381,0,3,0,0,3,1015,0.0,1.0,0,0,0,0,0,0,1018,0,1.0,0,0
PF13041,PF12854:PF02363:PF10674:PF15960:PF12734,130,64,60,70,4,884,0.94,0.93,0.46,0.63,1,1,129,0,888,1.0,0.87,0.01,0.08
PF01722,PF04493:PF01652:PF01261:PF12311:PF02936,16,57,9,7,48,954,0.16,0.95,0.56,0.28,2,2,14,0,1002,1.0,0.99,0.12,0.35
PF13472,PF03659:PF04199:PF10503:PF00457:PF12296,39,40,20,19,20,959,0.5,0.96,0.51,0.49,6,6,33,0,979,1.0,0.97,0.15,0.39
PF01591,PF00300:PF10419:PF09741:PF04859:PF07815,19,76,18,1,58,941,0.24,0.94,0.95,0.46,2,2,17,0,999,1.0,0.98,0.11,0.32
PF15107,PF15085:PF15119:PF01316:PF15333:PF15680,0,5,0,0,5,1013,0.0,1.0,0,0,0,0,0,0,1018,0,1.0,0,0
PF13098,PF08497:PF13746:PF16822:PF06798:PF07195,5,4,0,5,4,1009,0.0,0.99,0.0,-0.0,0,0,5,0,1013,0,1.0,0.0,0
PF10568,PF17172:PF10806:PF09737:PF04092:PF08079,9,19,4,5,15,994,0.21,0.98,0.44,0.3,2,2,7,0,1009,1.0,0.99,0.22,0.47
PF07192,PF02557:PF04562:PF05418:PF06681:PF08093,0,4,0,0,4,1014,0.0,1.0,0,0,0,0,0,0,1018,0,1.0,0,0
PF17081,PF00770:PF12724:PF08843:PF15838:PF03243,0,4,0,0,4,1014,0.0,1.0,0,0,0,0,0,0,1018,0,1.0,0,0
PF03444,PF01580:PF10109:PF06798:PF09611:PF02554,1,5,1,0,4,1013,0.2,1.0,1.0,0.45,0,0,1,0,1017,0,1.0,0.0,0
PF01840,PF08964:PF00997:PF10856:PF06592:PF15685,0,1,0,0,1,1017,0.0,1.0,0,0,0,0,0,0,1018,0,1.0,0,0
PF02571,PF00999:PF09676:PF04100:PF10408:PF08395,1,79,0,1,79,938,0.0,0.92,0.0,-0.01,3,0,1,3,1014,0.0,1.0,0.0,-0.0
PF07248,PF10340:PF06581:PF14645:PF05014:PF14895,0,7,0,0,7,1011,0.0,0.99,0,0,0,0,0,0,1018,0,1.0,0,0
PF09112,PF09113:PF05787:PF16126:PF16477:PF15798,0,1,0,0,1,1017,0.0,1.0,0,0,0,0,0,0,1018,0,1.0,0,0
PF10273,PF07052:PF08034:PF16007:PF11623:PF08636,5,14,2,3,12,1001,0.14,0.99,0.4,0.23,0,0,5,0,1013,0,1.0,0.0,0
PF00462,PF06936:PF05903:PF06201:PF15928:PF04784,49,50,18,31,32,937,0.36,0.94,0.37,0.33,2,1,48,1,968,0.5,0.95,0.02,0.09
PF12248,PF11901:PF09458:PF07703:PF07678:PF00754,14,68,11,3,57,947,0.16,0.94,0.79,0.34,12,3,11,9,995,0.25,0.98,0.21,0.22
PF09992,PF02012:PF02333:PF09443:PF01457:PF01868,3,24,2,1,22,993,0.08,0.98,0.67,0.23,0,0,3,0,1015,0,1.0,0.0,0
PF01852,PF07059:PF16719:PF12045:PF00157:PF00046,30,98,22,8,76,912,0.22,0.92,0.73,0.38,4,3,27,1,987,0.75,0.97,0.1,0.27
PF11691,PF01846:PF08786:PF01862:PF16512:PF05769,0,25,0,0,25,993,0.0,0.98,0,0,2,0,0,2,1016,0.0,1.0,0,0
PF04352,PF01752:PF17206:PF15463:PF17188:PF04349,0,4,0,0,4,1014,0.0,1.0,0,0,0,0,0,0,1018,0,1.0,0,0
PF05932,PF05939:PF05547:PF06626:PF03428:PF02217,1,5,0,1,5,1012,0.0,0.99,0.0,-0.0,0,0,1,0,1017,0,1.0,0.0,0
PF05346,PF04139:PF15929:PF10188:PF04004:PF04939,14,24,6,8,18,986,0.25,0.97,0.43,0.32,1,1,13,0,1004,1.0,0.99,0.07,0.27
PF15949,PF10358:PF12130:PF12510:PF15147:PF02208,5,28,2,3,26,987,0.07,0.97,0.4,0.16,1,1,4,0,1013,1.0,1.0,0.2,0.45
PF08597,PF10166:PF14931:PF14713:PF01959:PF08038,8,8,2,6,6,1004,0.25,0.99,0.25,0.24,0,0,8,0,1010,0,0.99,0.0,0
PF00619,PF12061:PF05659:PF13553:PF07725:PF02758,28,23,12,16,11,979,0.52,0.97,0.43,0.46,4,3,25,1,989,0.75,0.97,0.11,0.28
PF11232,PF11235:PF11244:PF11265:PF10488:PF16706,4,8,3,1,5,1009,0.38,0.99,0.75,0.53,0,0,4,0,1014,0,1.0,0.0,0
PF03640,PF15709:PF15185:PF08964:PF03963:PF07149,0,3,0,0,3,1015,0.0,1.0,0,0,0,0,0,0,1018,0,1.0,0,0
PF10495,PF15456:PF16574:PF12726:PF04423:PF05104,5,10,1,4,9,1004,0.1,0.99,0.2,0.14,1,0,5,1,1012,0.0,0.99,0.0,-0.0
PF01536,PF08132:PF00272:PF08660:PF04603:PF08661,9,20,5,4,15,994,0.25,0.98,0.56,0.36,0,0,9,0,1009,0,0.99,0.0,0
PF08458,PF05703:PF07831:PF12235:PF07231:PF03979,6,17,6,0,11,1001,0.35,0.99,1.0,0.59,1,1,5,0,1012,1.0,1.0,0.17,0.41
PF07723,PF08268:PF07734:PF01167:PF14299:PF08387,10,46,7,3,39,969,0.15,0.96,0.7,0.31,5,4,6,1,1007,0.8,0.99,0.4,0.56
PF07596,PF07960:PF05453:PF04384:PF05299:PF04532,0,4,0,0,4,1014,0.0,1.0,0,0,0,0,0,0,1018,0,1.0,0,0
PF04748,PF10403:PF04224:PF08620:PF09655:PF08236,1,22,0,1,22,995,0.0,0.98,0.0,-0.0,1,0,1,1,1016,0.0,1.0,0.0,-0.0
PF08892,PF08411:PF07964:PF16449:PF08334:PF10974,1,3,0,1,3,1014,0.0,1.0,0.0,-0.0,0,0,1,0,1017,0,1.0,0.0,0
PF01654,PF07681:PF14962:PF00070:PF13098:PF06804,5,14,3,2,11,1002,0.21,0.99,0.6,0.35,1,1,4,0,1013,1.0,1.0,0.2,0.45
PF06724,PF08795:PF02557:PF05939:PF10698:PF06798,0,2,0,0,2,1016,0.0,1.0,0,0,0,0,0,0,1018,0,1.0,0,0
PF14064,PF03922:PF01673:PF17014:PF04355:PF17006,0,0,0,0,0,1018,0,1.0,0,0,0,0,0,0,1018,0,1.0,0,0
PF00266,PF03476:PF03473:PF01171:PF06094:PF06041,49,47,17,32,30,939,0.36,0.94,0.35,0.32,6,5,44,1,968,0.83,0.96,0.1,0.28
PF09177,PF11416:PF00804:PF02269:PF05739:PF01028,7,49,4,3,45,966,0.08,0.95,0.57,0.2,7,1,6,6,1005,0.14,0.99,0.14,0.14
PF12022,PF10474:PF08303:PF08302:PF09511:PF17167,5,13,3,2,10,1003,0.23,0.99,0.6,0.37,3,1,4,2,1011,0.33,0.99,0.2,0.26
PF04869,PF14932:PF09822:PF14779:PF14764:PF03800,14,16,5,9,11,993,0.31,0.98,0.36,0.32,1,1,13,0,1004,1.0,0.99,0.07,0.27
PF15479,PF06429:PF14421:PF02305:PF08256:PF03963,2,2,0,2,2,1014,0.0,1.0,0.0,-0.0,0,0,2,0,1016,0,1.0,0.0,0
PF10937,PF14495:PF11017:PF10994:PF02817:PF15053,2,17,0,2,17,999,0.0,0.98,0.0,-0.01,0,0,2,0,1016,0,1.0,0.0,0
PF12516,PF11822:PF10309:PF15249:PF15778:PF15292,0,23,0,0,23,995,0.0,0.98,0,0,1,0,0,1,1017,0.0,1.0,0,0
PF03592,PF06381:PF11863:PF17206:PF01580:PF08479,0,5,0,0,5,1013,0.0,1.0,0,0,0,0,0,0,1018,0,1.0,0,0
PF14289,PF05421:PF12897:PF00455:PF13746:PF04375,2,13,2,0,11,1005,0.15,0.99,1.0,0.39,0,0,2,0,1016,0,1.0,0.0,0
PF05962,PF14539:PF08291:PF08093:PF06681:PF15482,1,1,0,1,1,1016,0.0,1.0,0.0,-0.0,0,0,1,0,1017,0,1.0,0.0,0
PF06495,PF12196:PF12220:PF08081:PF08080:PF11627,3,6,2,1,4,1011,0.33,1.0,0.67,0.47,1,1,2,0,1015,1.0,1.0,0.33,0.58
PF00177,PF01058:PF00124:PF00507:PF00119:PF00115,26,30,7,19,23,969,0.23,0.96,0.27,0.23,6,1,25,5,987,0.17,0.97,0.04,0.07
PF06103,PF09986:PF09545:PF16330:PF04387:PF10003,0,20,0,0,20,998,0.0,0.98,0,0,0,0,0,0,1018,0,1.0,0,0
PF15199,PF00519:PF17049:PF08026:PF15772:PF08308,0,6,0,0,6,1012,0.0,0.99,0,0,0,0,0,0,1018,0,1.0,0,0
PF11435,PF13247:PF07805:PF05857:PF02336:PF14841,1,4,0,1,4,1013,0.0,1.0,0.0,-0.0,0,0,1,0,1017,0,1.0,0.0,0
PF04718,PF16158:PF08939:PF15454:PF12351:PF15884,9,21,7,2,14,995,0.33,0.98,0.78,0.5,0,0,9,0,1009,0,0.99,0.0,0
PF10487,PF12530:PF11229:PF08427:PF05285:PF08696,7,29,3,4,26,985,0.1,0.97,0.43,0.2,2,0,7,2,1009,0.0,0.99,0.0,-0.0
PF01147,PF00711:PF05497:PF00965:PF09778:PF14935,0,14,0,0,14,1004,0.0,0.99,0,0,0,0,0,0,1018,0,1.0,0,0
PF01759,PF07703:PF01821:PF07677:PF10569:PF07678,16,17,9,7,8,994,0.53,0.99,0.56,0.54,12,9,7,3,999,0.75,0.99,0.56,0.64
PF05609,PF15370:PF04736:PF10853:PF09597:PF12328,1,12,1,0,11,1006,0.08,0.99,1.0,0.29,0,0,1,0,1017,0,1.0,0.0,0
PF10013,PF10707:PF15727:PF13698:PF07022:PF15756,0,2,0,0,2,1016,0.0,1.0,0,0,0,0,0,0,1018,0,1.0,0,0
PF00874,PF03123:PF09648:PF00358:PF11870:PF02378,4,14,3,1,11,1003,0.21,0.99,0.75,0.4,2,2,2,0,1014,1.0,1.0,0.5,0.71
PF08651,PF08853:PF05138:PF15233:PF11742:PF06122,1,4,0,1,4,1013,0.0,1.0,0.0,-0.0,0,0,1,0,1017,0,1.0,0.0,0
PF01929,PF01777:PF17136:PF00900:PF02357:PF16065,17,36,6,11,30,971,0.17,0.96,0.35,0.22,4,2,15,2,999,0.5,0.98,0.12,0.24
PF15210,PF15683:PF15208:PF01478:PF15760:PF08808,0,2,0,0,2,1016,0.0,1.0,0,0,0,0,0,0,1018,0,1.0,0,0
PF06090,PF05757:PF04690:PF07911:PF00048:PF04720,12,23,6,6,17,989,0.26,0.98,0.5,0.35,0,0,12,0,1006,0,0.99,0.0,0
PF11761,PF02979:PF13389:PF15681:PF15384:PF03819,0,7,0,0,7,1011,0.0,0.99,0,0,0,0,0,0,1018,0,1.0,0,0
PF15848,PF03238:PF03745:PF12724:PF05418:PF06681,0,1,0,0,1,1017,0.0,1.0,0,0,0,0,0,0,1018,0,1.0,0,0
PF16368,PF16366:PF16367:PF04961:PF14919:PF02971,3,17,3,0,14,1001,0.18,0.99,1.0,0.42,1,0,3,1,1014,0.0,1.0,0.0,-0.0
PF09699,PF15834:PF15049:PF00841:PF16217:PF09109,0,1,0,0,1,1017,0.0,1.0,0,0,0,0,0,0,1018,0,1.0,0,0
PF04348,PF12437:PF04556:PF12867:PF11774:PF16952,1,11,0,1,11,1006,0.0,0.99,0.0,-0.0,0,0,1,0,1017,0,1.0,0.0,0
PF14094,PF09655:PF10474:PF08086:PF03007:PF04245,0,10,0,0,10,1008,0.0,0.99,0,0,0,0,0,0,1018,0,1.0,0,0
PF15106,PF15085:PF14866:PF15478:PF15088:PF15119,2,4,0,2,4,1012,0.0,0.99,0.0,-0.0,0,0,2,0,1016,0,1.0,0.0,0
PF03002,PF00127:PF10542:PF04839:PF11315:PF14279,7,9,1,6,8,1003,0.11,0.99,0.14,0.12,0,0,7,0,1011,0,0.99,0.0,0
PF12360,PF04812:PF03867:PF12045:PF04814:PF10525,3,6,1,2,5,1010,0.17,0.99,0.33,0.23,2,1,2,1,1014,0.5,1.0,0.33,0.41
PF06406,PF13876:PF17006:PF01913:PF07804:PF04963,0,4,0,0,4,1014,0.0,1.0,0,0,0,0,0,0,1018,0,1.0,0,0
PF14978,PF04307:PF00972:PF09498:PF00978:PF17010,8,7,2,6,5,1005,0.29,0.99,0.25,0.26,1,1,7,0,1010,1.0,0.99,0.12,0.35
PF11510,PF15337:PF07175:PF04642:PF15553:PF04988,6,8,3,3,5,1007,0.38,0.99,0.5,0.43,0,0,6,0,1012,0,0.99,0.0,0
PF16449,PF08411:PF15935:PF08724:PF09829:PF01514,0,1,0,0,1,1017,0.0,1.0,0,0,0,0,0,0,1018,0,1.0,0,0
PF14895,PF00964:PF09419:PF02245:PF00214:PF15364,3,16,1,2,15,1000,0.06,0.98,0.33,0.14,0,0,3,0,1015,0,1.0,0.0,0
PF00027,PF08412:PF13545:PF13426:PF10137:PF00618,83,64,27,56,37,898,0.42,0.91,0.33,0.32,4,4,79,0,935,1.0,0.92,0.05,0.21
PF16046,PF10311:PF10376:PF08140:PF07084:PF08535,1,10,1,0,9,1008,0.1,0.99,1.0,0.31,0,0,1,0,1017,0,1.0,0.0,0
PF14863,PF14864:PF00874:PF16123:PF10484:PF03772,4,28,4,0,24,990,0.14,0.98,1.0,0.37,1,1,3,0,1014,1.0,1.0,0.25,0.5
PF13866,PF15285:PF15689:PF15690:PF09598:PF02751,1,16,1,0,15,1002,0.06,0.99,1.0,0.25,0,0,1,0,1017,0,1.0,0.0,0
PF05327,PF04006:PF00462:PF05091:PF14778:PF16690,12,66,7,5,59,947,0.11,0.94,0.58,0.23,3,1,11,2,1004,0.33,0.99,0.08,0.16
PF15077,PF08601:PF12498:PF03957:PF11787:PF02173,3,11,3,0,8,1007,0.27,0.99,1.0,0.52,2,2,1,0,1015,1.0,1.0,0.67,0.82
PF07260,PF07223:PF00473:PF12049:PF15342:PF10187,1,17,0,1,17,1000,0.0,0.98,0.0,-0.0,0,0,1,0,1017,0,1.0,0.0,0
PF02302,PF12242:PF13568:PF13580:PF08220:PF04279,1,7,1,0,6,1011,0.14,0.99,1.0,0.38,0,0,1,0,1017,0,1.0,0.0,0
PF12104,PF09191:PF05790:PF10570:PF09291:PF11465,0,5,0,0,5,1013,0.0,1.0,0,0,0,0,0,0,1018,0,1.0,0,0
PF02189,PF16680:PF11628:PF09191:PF00049:PF12104,2,14,2,0,12,1004,0.14,0.99,1.0,0.38,0,0,2,0,1016,0,1.0,0.0,0
PF00081,PF02777:PF07258:PF16196:PF00993:PF01731,22,37,22,0,15,981,0.59,0.99,1.0,0.77,0,0,22,0,996,0,0.98,0.0,0
PF16202,PF09382:PF08072:PF16204:PF00570:PF11408,6,31,6,0,25,987,0.19,0.98,1.0,0.43,7,6,0,1,1011,0.86,1.0,1.0,0.93
PF12834,PF15762:PF15482:PF03544:PF03090:PF08708,0,4,0,0,4,1014,0.0,1.0,0,0,0,0,0,0,1018,0,1.0,0,0
PF11864,PF03542:PF02145:PF11881:PF12166:PF14638,5,25,5,0,20,993,0.2,0.98,1.0,0.44,3,2,3,1,1012,0.67,1.0,0.4,0.51
PF11800,PF08479:PF04865:PF04552:PF02572:PF09327,0,3,0,0,3,1015,0.0,1.0,0,0,0,0,0,0,1018,0,1.0,0,0
PF13103,PF03749:PF03739:PF12856:PF07321:PF15175,4,8,4,0,4,1010,0.5,1.0,1.0,0.71,0,0,4,0,1014,0,1.0,0.0,0
PF05970,PF14214:PF02689:PF13538:PF02721:PF04843,41,31,19,22,12,965,0.61,0.97,0.46,0.52,7,7,34,0,977,1.0,0.97,0.17,0.41
PF04046,PF12214:PF16297:PF14922:PF05334:PF04087,9,11,4,5,7,1002,0.36,0.99,0.44,0.4,1,1,8,0,1009,1.0,0.99,0.11,0.33
PF06316,PF00849:PF01747:PF12569:PF02978:PF05103,0,73,0,0,73,945,0.0,0.93,0,0,5,0,0,5,1013,0.0,1.0,0,0
PF03318,PF01117:PF07468:PF02594:PF01656:PF15006,1,24,1,0,23,994,0.04,0.98,1.0,0.2,0,0,1,0,1017,0,1.0,0.0,0
PF15732,PF04370:PF14297:PF15482:PF15355:PF05449,0,0,0,0,0,1018,0,1.0,0,0,0,0,0,0,1018,0,1.0,0,0
PF03821,PF03261:PF02988:PF11069:PF09292:PF02189,0,14,0,0,14,1004,0.0,0.99,0,0,0,0,0,0,1018,0,1.0,0,0
PF00288,PF08544:PF10509:PF07959:PF05038:PF00394,44,70,39,5,31,943,0.56,0.96,0.89,0.69,6,5,39,1,973,0.83,0.96,0.11,0.3
PF03637,PF01025:PF10190:PF00213:PF02582:PF16891,17,50,10,7,40,961,0.2,0.95,0.59,0.33,3,3,14,0,1001,1.0,0.99,0.18,0.42
PF04158,PF16699:PF08145:PF04494:PF08606:PF12265,7,30,4,3,26,985,0.13,0.97,0.57,0.27,3,1,6,2,1009,0.33,0.99,0.14,0.21
PF12412,PF05167:PF12834:PF03241:PF03090:PF05840,0,1,0,0,1,1017,0.0,1.0,0,0,0,0,0,0,1018,0,1.0,0,0
PF16916,PF10241:PF13566:PF01545:PF03957:PF12498,10,44,10,0,34,974,0.23,0.97,1.0,0.47,1,1,9,0,1008,1.0,0.99,0.1,0.31
PF02836,PF02837:PF02929:PF16353:PF00703:PF16355,18,30,17,1,13,987,0.57,0.99,0.94,0.73,7,7,11,0,1000,1.0,0.99,0.39,0.62
PF02388,PF13464:PF14280:PF12835:PF09543:PF09684,2,2,1,1,1,1015,0.5,1.0,0.5,0.5,1,1,1,0,1016,1.0,1.0,0.5,0.71
PF09795,PF02453:PF00717:PF04137:PF14252:PF14934,0,49,0,0,49,969,0.0,0.95,0,0,2,0,0,2,1016,0.0,1.0,0,0
PF15298,PF07809:PF02576:PF11255:PF14279:PF13270,0,3,0,0,3,1015,0.0,1.0,0,0,0,0,0,0,1018,0,1.0,0,0
PF05431,PF11975:PF09678:PF12753:PF11492:PF05977,0,16,0,0,16,1002,0.0,0.98,0,0,0,0,0,0,1018,0,1.0,0,0
PF01717,PF08267:PF14577:PF01808:PF14576:PF00502,14,17,4,10,13,991,0.24,0.98,0.29,0.25,0,0,14,0,1004,0,0.99,0.0,0
PF14022,PF15093:PF12600:PF07891:PF16692:PF16401,2,8,2,0,6,1010,0.25,0.99,1.0,0.5,0,0,2,0,1016,0,1.0,0.0,0
PF00752,PF12246:PF00867:PF12247:PF05700:PF01547,30,55,30,0,25,963,0.55,0.98,1.0,0.73,3,2,28,1,987,0.67,0.97,0.07,0.2
PF03767,PF06404:PF07712:PF00074:PF14476:PF06749,7,9,0,7,9,1002,0.0,0.98,0.0,-0.01,1,0,7,1,1010,0.0,0.99,0.0,-0.0
PF00090,PF15913:PF00007:PF07474:PF05986:PF06468,57,30,24,33,6,955,0.8,0.96,0.42,0.56,3,3,54,0,961,1.0,0.95,0.05,0.22
PF01907,PF01922:PF01176:PF05676:PF15879:PF10775,9,26,6,3,20,989,0.23,0.98,0.67,0.38,2,2,7,0,1009,1.0,0.99,0.22,0.47
PF06864,PF12421:PF16325:PF07523:PF04740:PF01913,1,2,0,1,2,1015,0.0,1.0,0.0,-0.0,0,0,1,0,1017,0,1.0,0.0,0
PF15078,PF04485:PF15079:PF04360:PF10664:PF06773,0,1,0,0,1,1017,0.0,1.0,0,0,0,0,0,0,1018,0,1.0,0,0
PF05805,PF05296:PF12301:PF14941:PF03414:PF06552,7,12,0,7,12,999,0.0,0.98,0.0,-0.01,0,0,7,0,1011,0,0.99,0.0,0
PF08506,PF08389:PF03378:PF12755:PF08167:PF02985,16,73,16,0,57,945,0.22,0.94,1.0,0.45,7,7,9,0,1002,1.0,0.99,0.44,0.66
PF00789,PF04000:PF00627:PF15275:PF08585:PF00924,23,76,12,11,64,931,0.16,0.93,0.52,0.26,5,3,20,2,993,0.6,0.98,0.13,0.27
PF15624,PF09441:PF05397:PF13945:PF07001:PF15557,4,18,1,3,17,997,0.06,0.98,0.25,0.11,0,0,4,0,1014,0,1.0,0.0,0
PF04391,PF03241:PF11751:PF14690:PF04717:PF13722,0,0,0,0,0,1018,0,1.0,0,0,0,0,0,0,1018,0,1.0,0,0
PF07987,PF09278:PF01455:PF00376:PF09488:PF12792,2,3,1,1,2,1014,0.33,1.0,0.5,0.41,2,1,1,1,1015,0.5,1.0,0.5,0.5
PF07741,PF08271:PF00382:PF11521:PF02002:PF16858,9,31,9,0,22,987,0.29,0.98,1.0,0.53,4,2,7,2,1007,0.5,0.99,0.22,0.33
PF05924,PF05923:PF05956:PF05937:PF05972:PF16689,9,8,7,2,1,1008,0.88,1.0,0.78,0.82,3,3,6,0,1009,1.0,0.99,0.33,0.58
PF12928,PF10307:PF13859:PF10198:PF10336:PF14977,9,11,0,9,11,998,0.0,0.98,0.0,-0.01,0,0,9,0,1009,0,0.99,0.0,0
PF13493,PF07730:PF06580:PF16359:PF09239:PF08448,0,21,0,0,21,997,0.0,0.98,0,0,2,0,0,2,1016,0.0,1.0,0,0
PF09420,PF16954:PF08925:PF03858:PF04710:PF16720,4,11,2,2,9,1005,0.18,0.99,0.5,0.3,0,0,4,0,1014,0,1.0,0.0,0
PF02343,PF10322:PF03436:PF15362:PF10583:PF12782,2,2,1,1,1,1015,0.5,1.0,0.5,0.5,0,0,2,0,1016,0,1.0,0.0,0
PF00400,PF14077:PF15512:PF04192:PF09384:PF13271,259,24,22,237,2,757,0.92,0.77,0.08,0.24,2,2,257,0,759,1.0,0.75,0.01,0.08
PF09139,PF14996:PF15938:PF15161:PF04421:PF06962,14,8,3,11,5,999,0.38,0.98,0.21,0.28,1,1,13,0,1004,1.0,0.99,0.07,0.27
PF14685,PF04225:PF12883:PF08437:PF10118:PF13471,1,15,0,1,15,1002,0.0,0.98,0.0,-0.0,1,0,1,1,1016,0.0,1.0,0.0,-0.0
PF10046,PF11264:PF06521:PF15719:PF07544:PF11029,12,11,3,9,8,998,0.27,0.98,0.25,0.25,0,0,12,0,1006,0,0.99,0.0,0
PF10108,PF08496:PF02951:PF15685:PF04865:PF02508,2,7,1,1,6,1010,0.14,0.99,0.5,0.26,1,0,2,1,1015,0.0,1.0,0.0,-0.0
PF06703,PF03298:PF01922:PF02969:PF10471:PF04668,7,22,4,3,18,993,0.18,0.98,0.57,0.31,1,1,6,0,1011,1.0,0.99,0.14,0.38
PF11992,PF11932:PF04515:PF03074:PF01458:PF00292,0,24,0,0,24,994,0.0,0.98,0,0,1,0,0,1,1017,0.0,1.0,0,0
PF01338,PF00706:PF15119:PF07327:PF09428:PF17049,0,4,0,0,4,1014,0.0,1.0,0,0,0,0,0,0,1018,0,1.0,0,0
PF15993,PF03784:PF03769:PF16720:PF15293:PF15031,1,8,0,1,8,1009,0.0,0.99,0.0,-0.0,0,0,1,0,1017,0,1.0,0.0,0
PF01843,PF16521:PF00063:PF16735:PF12075:PF05104,28,79,20,8,59,931,0.25,0.93,0.71,0.4,3,3,25,0,990,1.0,0.98,0.11,0.32
PF06632,PF03652:PF01279:PF00214:PF06232:PF02525,3,11,2,1,9,1006,0.18,0.99,0.67,0.34,0,0,3,0,1015,0,1.0,0.0,0
PF13331,PF11341:PF17049:PF05981:PF15312:PF11272,0,7,0,0,7,1011,0.0,0.99,0,0,0,0,0,0,1018,0,1.0,0,0
PF12552,PF14383:PF14309:PF08729:PF10264:PF12887,4,14,4,0,10,1004,0.29,0.99,1.0,0.53,3,0,4,3,1011,0.0,0.99,0.0,-0.0
PF08527,PF03068:PF08526:PF02971:PF04961:PF14951,4,13,4,0,9,1005,0.31,0.99,1.0,0.55,0,0,4,0,1014,0,1.0,0.0,0
PF05679,PF02434:PF06312:PF05652:PF08652:PF01432,13,48,11,2,37,968,0.23,0.96,0.85,0.43,7,2,11,5,1000,0.29,0.98,0.15,0.2
PF12276,PF08260:PF05929:PF12087:PF00587:PF01096,0,60,0,0,60,958,0.0,0.94,0,0,0,0,0,0,1018,0,1.0,0,0
PF13127,PF00892:PF12804:PF00356:PF02311:PF04230,1,48,1,0,47,970,0.02,0.95,1.0,0.14,8,0,1,8,1009,0.0,0.99,0.0,-0.0
PF11258,PF08026:PF06868:PF11593:PF05453:PF03065,0,4,0,0,4,1014,0.0,1.0,0,0,0,0,0,0,1018,0,1.0,0,0
PF14418,PF17182:PF01936:PF11608:PF12872:PF13871,1,23,1,0,22,995,0.04,0.98,1.0,0.21,3,0,1,3,1014,0.0,1.0,0.0,-0.0
PF10240,PF03455:PF03456:PF02141:PF00814:PF02893,14,79,8,6,71,933,0.1,0.92,0.57,0.22,17,2,12,15,989,0.12,0.97,0.14,0.12
PF09186,PF03843:PF08572:PF14348:PF05773:PF02618,0,35,0,0,35,983,0.0,0.97,0,0,0,0,0,0,1018,0,1.0,0,0
PF01070,PF00173:PF03404:PF00487:PF08557:PF00174,45,105,36,9,69,904,0.34,0.92,0.8,0.49,16,11,34,5,968,0.69,0.96,0.24,0.4
PF04011,PF06744:PF04552:PF03922:PF14882:PF07494,0,2,0,0,2,1016,0.0,1.0,0,0,0,0,0,0,1018,0,1.0,0,0
PF04001,PF11517:PF15082:PF08183:PF11988:PF07610,0,4,0,0,4,1014,0.0,1.0,0,0,0,0,0,0,1018,0,1.0,0,0
PF14444,PF08729:PF14443:PF12509:PF14075:PF09497,3,17,3,0,14,1001,0.18,0.99,1.0,0.42,1,1,2,0,1015,1.0,1.0,0.33,0.58
PF01264,PF01680:PF01997:PF06172:PF05176:PF01774,5,21,1,4,20,993,0.05,0.98,0.2,0.09,0,0,5,0,1013,0,1.0,0.0,0
PF13516,PF00560:PF14484:PF13855:PF02758:PF07834,89,154,64,25,90,839,0.42,0.89,0.72,0.49,9,9,80,0,929,1.0,0.92,0.1,0.31
PF08639,PF02116:PF10330:PF06485:PF11690:PF08316,4,15,2,2,13,1001,0.13,0.99,0.5,0.25,0,0,4,0,1014,0,1.0,0.0,0
PF07368,PF15055:PF02448:PF07961:PF15715:PF14986,0,0,0,0,0,1018,0,1.0,0,0,0,0,0,0,1018,0,1.0,0,0
PF16815,PF17003:PF14087:PF07347:PF11595:PF15171,6,16,5,1,11,1001,0.31,0.99,0.83,0.51,3,3,3,0,1012,1.0,1.0,0.5,0.71
PF01890,PF08982:PF12390:PF12080:PF03406:PF01364,1,5,0,1,5,1012,0.0,0.99,0.0,-0.0,0,0,1,0,1017,0,1.0,0.0,0
PF13530,PF08479:PF08411:PF11019:PF04865:PF06890,2,1,0,2,1,1015,0.0,1.0,0.0,-0.0,0,0,2,0,1016,0,1.0,0.0,0
PF00435,PF16901:PF10541:PF16350:PF08726:PF04810,42,52,22,20,30,946,0.42,0.95,0.52,0.45,2,2,40,0,976,1.0,0.96,0.05,0.21
PF01958,PF00742:PF03447:PF10000:PF01817:PF13840,11,33,11,0,22,985,0.33,0.98,1.0,0.57,3,2,9,1,1006,0.67,0.99,0.18,0.34
PF07662,PF07670:PF01773:PF07664:PF03068:PF08527,17,22,13,4,9,992,0.59,0.99,0.76,0.67,2,2,15,0,1001,1.0,0.99,0.12,0.34
PF16358,PF10554:PF03180:PF15150:PF14467:PF16888,0,3,0,0,3,1015,0.0,1.0,0,0,0,0,0,0,1018,0,1.0,0,0
PF10338,PF10471:PF11623:PF02044:PF11282:PF09340,1,12,0,1,12,1005,0.0,0.99,0.0,-0.0,0,0,1,0,1017,0,1.0,0.0,0
PF05258,PF15680:PF13011:PF09232:PF15097:PF08036,0,1,0,0,1,1017,0.0,1.0,0,0,0,0,0,0,1018,0,1.0,0,0
PF08549,PF09775:PF16485:PF11958:PF16871:PF08657,3,8,0,3,8,1007,0.0,0.99,0.0,-0.0,0,0,3,0,1015,0,1.0,0.0,0
PF16492,PF08374:PF15974:PF01282:PF06645:PF05071,2,27,2,0,25,991,0.07,0.98,1.0,0.27,1,0,2,1,1015,0.0,1.0,0.0,-0.0
PF14980,PF07661:PF05167:PF15482:PF15312:PF03238,0,3,0,0,3,1015,0.0,1.0,0,0,0,0,0,0,1018,0,1.0,0,0
PF05463,PF05111:PF10630:PF03842:PF02057:PF15302,1,2,0,1,2,1015,0.0,1.0,0.0,-0.0,0,0,1,0,1017,0,1.0,0.0,0
PF05118,PF05279:PF13174:PF13181:PF04049:PF16669,8,110,4,4,106,904,0.04,0.89,0.5,0.11,5,3,5,2,1008,0.6,0.99,0.38,0.47
PF12152,PF04050:PF15407:PF09462:PF15624:PF15557,3,11,3,0,8,1007,0.27,0.99,1.0,0.52,0,0,3,0,1015,0,1.0,0.0,0
PF03668,PF06070:PF13247:PF08299:PF01706:PF11638,5,3,1,4,2,1011,0.33,0.99,0.2,0.26,1,1,4,0,1013,1.0,1.0,0.2,0.45
PF08947,PF12162:PF08916:PF16454:PF14596:PF12188,1,11,1,0,10,1007,0.09,0.99,1.0,0.3,1,1,0,0,1017,1.0,1.0,1.0,1.0
PF14200,PF03762:PF08531:PF05592:PF09458:PF03815,5,37,3,2,34,979,0.08,0.96,0.6,0.21,2,1,4,1,1012,0.5,1.0,0.2,0.31
PF15115,PF14986:PF15332:PF15055:PF15559:PF15462,0,2,0,0,2,1016,0.0,1.0,0,0,0,0,0,0,1018,0,1.0,0,0
PF11023,PF02635:PF13530:PF10279:PF02646:PF05488,0,6,0,0,6,1012,0.0,0.99,0,0,0,0,0,0,1018,0,1.0,0,0
PF06650,PF16909:PF16910:PF12624:PF09333:PF16908,21,39,20,1,19,978,0.51,0.98,0.95,0.69,20,14,7,6,991,0.7,0.99,0.67,0.68
PF02212,PF00350:PF01031:PF11698:PF10155:PF04799,34,80,34,0,46,938,0.42,0.95,1.0,0.64,10,7,27,3,981,0.7,0.97,0.21,0.37
PF01868,PF10332:PF10188:PF07545:PF13002:PF08598,10,10,2,8,8,1000,0.2,0.98,0.2,0.19,0,0,10,0,1008,0,0.99,0.0,0
PF07373,PF07942:PF00621:PF14634:PF00640:PF03982,0,103,0,0,103,915,0.0,0.9,0,0,12,0,0,12,1006,0.0,0.99,0,0
PF10387,PF12066:PF01713:PF03915:PF16131:PF05879,0,39,0,0,39,979,0.0,0.96,0,0,6,0,0,6,1012,0.0,0.99,0,0
PF12309,PF04981:PF16061:PF10496:PF05334:PF15067,8,25,2,6,23,987,0.08,0.97,0.25,0.13,0,0,8,0,1010,0,0.99,0.0,0
PF12350,PF12243:PF00165:PF01386:PF14232:PF03768,3,10,2,1,8,1007,0.2,0.99,0.67,0.36,0,0,3,0,1015,0,1.0,0.0,0
PF03714,PF11852:PF09087:PF10438:PF16657:PF11941,2,3,2,0,1,1015,0.67,1.0,1.0,0.82,1,0,2,1,1015,0.0,1.0,0.0,-0.0
PF00777,PF03062:PF09335:PF01758:PF02517:PF07542,22,71,9,13,62,934,0.13,0.93,0.41,0.2,3,2,20,1,995,0.67,0.98,0.09,0.24
PF07219,PF16546:PF02388:PF13464:PF14280:PF09295,2,15,1,1,14,1002,0.07,0.99,0.5,0.18,1,1,1,0,1016,1.0,1.0,0.5,0.71
PF01789,PF07896:PF02915:PF07816:PF13225:PF01632,6,13,1,5,12,1000,0.08,0.98,0.17,0.11,0,0,6,0,1012,0,0.99,0.0,0
PF03457,PF08426:PF04546:PF03458:PF02514:PF14312,6,8,1,5,7,1005,0.12,0.99,0.17,0.14,0,0,6,0,1012,0,0.99,0.0,0
PF14492,PF16004:PF03764:PF00679:PF06421:PF16658,35,51,27,8,24,959,0.53,0.97,0.77,0.62,13,10,25,3,980,0.77,0.97,0.29,0.46
PF08661,PF05912:PF10504:PF15014:PF08092:PF15550,9,6,2,7,4,1005,0.33,0.99,0.22,0.27,0,0,9,0,1009,0,0.99,0.0,0
PF15014,PF08761:PF09057:PF15104:PF15187:PF15139,1,2,0,1,2,1015,0.0,1.0,0.0,-0.0,0,0,1,0,1017,0,1.0,0.0,0
PF04988,PF15696:PF15337:PF05841:PF15553:PF07199,5,3,1,4,2,1011,0.33,0.99,0.2,0.26,0,0,5,0,1013,0,1.0,0.0,0
PF09288,PF10520:PF07933:PF05529:PF05162:PF00179,0,106,0,0,106,912,0.0,0.9,0,0,5,0,0,5,1013,0.0,1.0,0,0
PF15162,PF10994:PF16590:PF15134:PF06056:PF15480,0,4,0,0,4,1014,0.0,1.0,0,0,0,0,0,0,1018,0,1.0,0,0
PF16078,PF16870:PF02779:PF00676:PF08064:PF08393,6,79,6,0,73,939,0.08,0.93,1.0,0.27,21,6,0,15,997,0.29,0.99,1.0,0.53
PF06741,PF14438:PF07145:PF10033:PF07742:PF09133,12,34,10,2,24,982,0.29,0.97,0.83,0.49,3,3,9,0,1006,1.0,0.99,0.25,0.5
PF02537,PF08622:PF17187:PF02421:PF03984:PF05076,7,7,0,7,7,1004,0.0,0.99,0.0,-0.01,1,0,7,1,1010,0.0,0.99,0.0,-0.0
PF02283,PF16586:PF11245:PF14489:PF07520:PF05299,2,1,0,2,1,1015,0.0,1.0,0.0,-0.0,0,0,2,0,1016,0,1.0,0.0,0
PF00458,PF09180:PF03950:PF03129:PF00749:PF04558,18,59,15,3,44,956,0.25,0.95,0.83,0.45,17,8,10,9,991,0.47,0.98,0.44,0.45
PF08099,PF01668:PF05754:PF17002:PF11111:PF01292,1,9,0,1,9,1008,0.0,0.99,0.0,-0.0,0,0,1,0,1017,0,1.0,0.0,0
PF09831,PF00854:PF02705:PF00535:PF11080:PF03169,0,103,0,0,103,915,0.0,0.9,0,0,11,0,0,11,1007,0.0,0.99,0,0
PF01370,PF13460:PF01073:PF16363:PF05368:PF04387,71,98,37,34,61,886,0.38,0.91,0.52,0.39,21,21,50,0,947,1.0,0.95,0.3,0.53
PF01832,PF14600:PF02863:PF12571:PF11902:PF14376,2,5,0,2,5,1011,0.0,0.99,0.0,-0.0,0,0,2,0,1016,0,1.0,0.0,0
PF00735,PF04548:PF03673:PF16066:PF11886:PF07227,32,23,10,22,13,973,0.43,0.97,0.31,0.35,1,1,31,0,986,1.0,0.97,0.03,0.17
PF05704,PF10329:PF04229:PF03631:PF01475:PF04986,5,15,0,5,15,998,0.0,0.98,0.0,-0.01,0,0,5,0,1013,0,1.0,0.0,0
PF07258,PF00243:PF01731:PF10420:PF00969:PF01359,15,51,7,8,44,959,0.14,0.95,0.47,0.23,2,2,13,0,1003,1.0,0.99,0.13,0.36
PF02097,PF05901:PF06725:PF06355:PF04350:PF09614,0,3,0,0,3,1015,0.0,1.0,0,0,0,0,0,0,1018,0,1.0,0,0
PF07119,PF10106:PF14328:PF08093:PF07353:PF15771,0,4,0,0,4,1014,0.0,1.0,0,0,0,0,0,0,1018,0,1.0,0,0
PF04118,PF09743:PF15917:PF11597:PF15903:PF12552,7,14,1,6,13,998,0.07,0.98,0.14,0.09,0,0,7,0,1011,0,0.99,0.0,0
PF11130,PF12477:PF09677:PF03241:PF17164:PF01752,0,2,0,0,2,1016,0.0,1.0,0,0,0,0,0,0,1018,0,1.0,0,0
PF03496,PF09372:PF09310:PF15487:PF15898:PF16553,3,5,1,2,4,1011,0.2,0.99,0.33,0.26,1,1,2,0,1015,1.0,1.0,0.33,0.58
PF00341,PF14554:PF15800:PF03128:PF04692:PF07602,7,4,2,5,2,1009,0.5,0.99,0.29,0.37,1,1,6,0,1011,1.0,0.99,0.14,0.38
PF00713,PF03812:PF08906:PF05145:PF10965:PF00004,1,158,1,0,157,860,0.01,0.85,1.0,0.07,0,0,1,0,1017,0,1.0,0.0,0
PF09335,PF01789:PF02915:PF13225:PF02517:PF03045,22,26,4,18,22,974,0.15,0.96,0.18,0.15,2,1,21,1,995,0.5,0.98,0.05,0.15
PF06448,PF09172:PF01347:PF09175:PF12491:PF00094,4,44,4,0,40,974,0.09,0.96,1.0,0.3,9,4,0,5,1009,0.44,1.0,1.0,0.67
PF12401,PF00791:PF12313:PF00093:PF00425:PF00531,0,69,0,0,69,949,0.0,0.93,0,0,8,0,0,8,1010,0.0,0.99,0,0
PF04704,PF15350:PF12733:PF04056:PF14764:PF06662,2,16,1,1,15,1001,0.06,0.98,0.5,0.17,1,0,2,1,1015,0.0,1.0,0.0,-0.0
PF13277,PF17176:PF02785:PF14577:PF04002:PF00289,1,35,0,1,35,982,0.0,0.96,0.0,-0.01,3,0,1,3,1014,0.0,1.0,0.0,-0.0
PF15984,PF14224:PF05962:PF03713:PF08848:PF14539,0,1,0,0,1,1017,0.0,1.0,0,0,0,0,0,0,1018,0,1.0,0,0
PF06602,PF02893:PF02141:PF12335:PF03456:PF16016,35,65,17,18,48,935,0.26,0.94,0.49,0.33,12,9,26,3,980,0.75,0.97,0.26,0.43
PF09190,PF01406:PF05622:PF09635:PF15539:PF04266,5,33,5,0,28,985,0.15,0.97,1.0,0.38,4,3,2,1,1012,0.75,1.0,0.6,0.67
PF14925,PF13995:PF02277:PF10109:PF15427:PF13946,2,5,0,2,5,1011,0.0,0.99,0.0,-0.0,0,0,2,0,1016,0,1.0,0.0,0
PF16967,PF07434:PF15976:PF09361:PF12477:PF03241,0,0,0,0,0,1018,0,1.0,0,0,0,0,0,0,1018,0,1.0,0,0
PF07748,PF09261:PF01074:PF03669:PF08541:PF01645,21,34,21,0,13,984,0.62,0.99,1.0,0.78,9,9,12,0,997,1.0,0.99,0.43,0.65
PF14668,PF14664:PF14663:PF14666:PF14665:PF15961,12,13,12,0,1,1005,0.92,1.0,1.0,0.96,10,10,2,0,1006,1.0,1.0,0.83,0.91
PF16563,PF13919:PF08313:PF05066:PF15778:PF05030,6,28,4,2,24,988,0.14,0.97,0.67,0.3,1,0,6,1,1011,0.0,0.99,0.0,-0.0
PF12237,PF09445:PF11547:PF10258:PF01846:PF16072,4,29,3,1,26,988,0.1,0.97,0.75,0.27,3,1,3,2,1012,0.33,1.0,0.25,0.29
PF04006,PF05693:PF14798:PF15390:PF04113:PF03096,10,19,3,7,16,992,0.16,0.98,0.3,0.21,1,1,9,0,1008,1.0,0.99,0.1,0.31
PF00051,PF01392:PF09396:PF16030:PF15494:PF02983,34,36,20,14,16,968,0.56,0.97,0.59,0.56,2,2,32,0,984,1.0,0.97,0.06,0.24
PF13097,PF00835:PF15313:PF07137:PF14988:PF08651,4,13,0,4,13,1001,0.0,0.98,0.0,-0.01,1,0,4,1,1013,0.0,1.0,0.0,-0.0
PF05242,PF06008:PF16094:PF07953:PF07168:PF11820,0,16,0,0,16,1002,0.0,0.98,0,0,1,0,0,1,1017,0.0,1.0,0,0
PF05145,PF04046:PF16837:PF09359:PF05178:PF01801,0,26,0,0,26,992,0.0,0.97,0,0,3,0,0,3,1015,0.0,1.0,0,0
PF02517,PF09335:PF11735:PF04769:PF08598:PF12579,13,34,2,11,32,973,0.06,0.96,0.15,0.08,1,1,12,0,1005,1.0,0.99,0.08,0.28
PF02060,PF15370:PF05039:PF15071:PF00236:PF05825,2,6,0,2,6,1010,0.0,0.99,0.0,-0.0,0,0,2,0,1016,0,1.0,0.0,0
PF04451,PF04355:PF11751:PF04076:PF00669:PF02413,1,1,1,0,0,1017,1.0,1.0,1.0,1.0,0,0,1,0,1017,0,1.0,0.0,0
PF00582,PF12202:PF13281:PF03822:PF00314:PF12605,31,31,11,20,20,967,0.35,0.96,0.35,0.33,3,3,28,0,987,1.0,0.97,0.1,0.31
PF03222,PF14159:PF15699:PF08137:PF05055:PF08536,1,7,0,1,7,1010,0.0,0.99,0.0,-0.0,0,0,1,0,1017,0,1.0,0.0,0
PF08704,PF05871:PF07798:PF03095:PF03416:PF04729,8,45,5,3,40,970,0.11,0.96,0.62,0.25,4,2,6,2,1008,0.5,0.99,0.25,0.35
PF06424,PF08163:PF12770:PF17109:PF12340:PF11640,2,32,1,1,31,985,0.03,0.97,0.5,0.12,3,1,1,2,1014,0.33,1.0,0.5,0.41
PF04997,PF04983:PF04992:PF00623:PF04998:PF04990,29,37,29,0,8,981,0.78,0.99,1.0,0.88,28,28,1,0,989,1.0,1.0,0.97,0.98
PF10057,PF03729:PF08708:PF12241:PF07195:PF07495,0,2,0,0,2,1016,0.0,1.0,0,0,0,0,0,0,1018,0,1.0,0,0
PF14378,PF08643:PF10483:PF03095:PF04729:PF00165,5,26,1,4,25,988,0.04,0.97,0.2,0.08,1,0,5,1,1012,0.0,0.99,0.0,-0.0
PF10767,PF17025:PF01120:PF07829:PF02782:PF08260,0,48,0,0,48,970,0.0,0.95,0,0,0,0,0,0,1018,0,1.0,0,0
PF08568,PF12463:PF03385:PF02449:PF06423:PF02219,5,34,2,3,32,981,0.06,0.97,0.4,0.14,0,0,5,0,1013,0,1.0,0.0,0
PF03993,PF00073:PF02868:PF00548:PF02226:PF09770,2,16,0,2,16,1000,0.0,0.98,0.0,-0.01,12,0,2,12,1004,0.0,0.99,0.0,-0.0
PF12225,PF15608:PF08485:PF08298:PF08479:PF15726,2,1,0,2,1,1015,0.0,1.0,0.0,-0.0,0,0,2,0,1016,0,1.0,0.0,0
PF12474,PF16797:PF13281:PF08587:PF02295:PF08311,10,29,5,5,24,984,0.17,0.97,0.5,0.28,2,2,8,0,1008,1.0,0.99,0.2,0.45
PF14196,PF10566:PF07157:PF04355:PF15775:PF01580,0,5,0,0,5,1013,0.0,1.0,0,0,0,0,0,0,1018,0,1.0,0,0
PF02309,PF06507:PF02362:PF03254:PF08041:PF01929,12,46,7,5,39,967,0.15,0.96,0.58,0.28,5,1,11,4,1002,0.2,0.99,0.08,0.12
PF06047,PF07222:PF06869:PF13824:PF10505:PF07839,8,15,3,5,12,998,0.2,0.98,0.38,0.27,0,0,8,0,1010,0,0.99,0.0,0
PF05048,PF02617:PF02207:PF12014:PF03048:PF16866,4,17,4,0,13,1001,0.24,0.99,1.0,0.48,2,2,2,0,1014,1.0,1.0,0.5,0.71
PF06428,PF15266:PF14922:PF10998:PF05334:PF15311,8,13,2,6,11,999,0.15,0.98,0.25,0.19,1,0,8,1,1009,0.0,0.99,0.0,-0.0
PF14474,PF04988:PF07199:PF14877:PF04468:PF01358,4,17,2,2,15,999,0.12,0.98,0.5,0.24,0,0,4,0,1014,0,1.0,0.0,0
PF04837,PF06355:PF02977:PF15556:PF12827:PF15809,0,2,0,0,2,1016,0.0,1.0,0,0,0,0,0,0,1018,0,1.0,0,0
PF14950,PF14951:PF07085:PF14911:PF02226:PF00073,0,19,0,0,19,999,0.0,0.98,0,0,1,0,0,1,1017,0.0,1.0,0,0
PF13554,PF14508:PF03729:PF02501:PF04612:PF06744,0,2,0,0,2,1016,0.0,1.0,0,0,0,0,0,0,1018,0,1.0,0,0
PF05089,PF12971:PF12972:PF03648:PF07488:PF07477,11,14,11,0,3,1004,0.79,1.0,1.0,0.89,3,1,10,2,1005,0.33,0.99,0.09,0.17
PF02954,PF00158:PF04397:PF01339:PF06580:PF00196,7,23,6,1,17,994,0.26,0.98,0.86,0.47,3,2,5,1,1010,0.67,0.99,0.29,0.43
PF05784,PF12896:PF12444:PF00734:PF05110:PF12341,0,55,0,0,55,963,0.0,0.95,0,0,3,0,0,3,1015,0.0,1.0,0,0
PF00916,PF01740:PF15098:PF01055:PF13466:PF02347,37,64,31,6,33,948,0.48,0.96,0.84,0.62,3,3,34,0,981,1.0,0.97,0.08,0.28
PF01607,PF15002:PF01522:PF09347:PF07686:PF04886,55,86,28,27,58,905,0.33,0.92,0.51,0.36,8,8,47,0,963,1.0,0.95,0.15,0.37
PF04313,PF12008:PF01863:PF06114:PF13625:PF13749,4,16,4,0,12,1002,0.25,0.99,1.0,0.5,4,4,0,0,1014,1.0,1.0,1.0,1.0
PF16573,PF06807:PF16575:PF08622:PF08635:PF02774,8,35,8,0,27,983,0.23,0.97,1.0,0.47,1,1,7,0,1010,1.0,0.99,0.12,0.35
PF06681,PF03238:PF03745:PF05962:PF17010:PF02070,0,1,0,0,1,1017,0.0,1.0,0,0,0,0,0,0,1018,0,1.0,0,0
PF05399,PF15333:PF15664:PF15550:PF15158:PF09252,0,0,0,0,0,1018,0,1.0,0,0,0,0,0,0,1018,0,1.0,0,0
PF02554,PF01580:PF13722:PF04610:PF11794:PF02572,0,7,0,0,7,1011,0.0,0.99,0,0,1,0,0,1,1017,0.0,1.0,0,0
PF16321,PF02482:PF07014:PF01228:PF07085:PF16829,4,10,4,0,6,1008,0.4,0.99,1.0,0.63,0,0,4,0,1014,0,1.0,0.0,0
PF02381,PF17060:PF04963:PF14841:PF12080:PF01706,2,3,0,2,3,1013,0.0,1.0,0.0,-0.0,0,0,2,0,1016,0,1.0,0.0,0
PF16862,PF06964:PF04842:PF12036:PF08216:PF11899,17,28,6,11,22,979,0.21,0.97,0.35,0.26,0,0,17,0,1001,0,0.98,0.0,0
PF02602,PF06172:PF04756:PF04520:PF05995:PF00321,16,18,7,9,11,991,0.39,0.98,0.44,0.4,0,0,16,0,1002,0,0.98,0.0,0
PF14661,PF15678:PF09429:PF13836:PF07001:PF00649,1,18,0,1,18,999,0.0,0.98,0.0,-0.0,0,0,1,0,1017,0,1.0,0.0,0
PF03275,PF05611:PF17062:PF14877:PF15046:PF11044,1,7,0,1,7,1010,0.0,0.99,0.0,-0.0,0,0,1,0,1017,0,1.0,0.0,0
PF10035,PF02588:PF04917:PF06505:PF13876:PF07523,2,4,2,0,2,1014,0.5,1.0,1.0,0.71,0,0,2,0,1016,0,1.0,0.0,0
PF05278,PF10226:PF15558:PF15742:PF07576:PF03384,2,15,2,0,13,1003,0.13,0.99,1.0,0.36,1,1,1,0,1016,1.0,1.0,0.5,0.71
PF15151,PF07055:PF11924:PF07881:PF12241:PF07167,3,5,0,3,5,1010,0.0,0.99,0.0,-0.0,0,0,3,0,1015,0,1.0,0.0,0
PF09457,PF11618:PF16056:PF15625:PF16562:PF10174,10,18,2,8,16,992,0.11,0.98,0.2,0.14,2,1,9,1,1007,0.5,0.99,0.1,0.22
PF12832,PF03647:PF04831:PF04729:PF01126:PF05197,13,31,4,9,27,978,0.13,0.96,0.31,0.18,3,2,11,1,1004,0.67,0.99,0.15,0.32
PF04094,PF04195:PF07430:PF03578:PF07276:PF03991,4,8,2,2,6,1008,0.25,0.99,0.5,0.35,0,0,4,0,1014,0,1.0,0.0,0
PF10782,PF11751:PF06890:PF01312:PF07157:PF01330,0,2,0,0,2,1016,0.0,1.0,0,0,0,0,0,0,1018,0,1.0,0,0
PF08771,PF11865:PF02260:PF02192:PF02259:PF00454,10,69,10,0,59,949,0.14,0.94,1.0,0.37,21,10,0,11,997,0.48,0.99,1.0,0.69
PF02065,PF16874:PF16875:PF16711:PF16709:PF02350,5,6,1,4,5,1008,0.17,0.99,0.2,0.18,0,0,5,0,1013,0,1.0,0.0,0
PF02661,PF02430:PF02517:PF10211:PF02991:PF05046,11,33,7,4,26,981,0.21,0.97,0.64,0.36,2,2,9,0,1007,1.0,0.99,0.18,0.42
PF12828,PF12825:PF09325:PF03700:PF13924:PF08944,4,25,4,0,21,993,0.16,0.98,1.0,0.4,3,2,2,1,1013,0.67,1.0,0.5,0.58
PF08612,PF03386:PF04418:PF05129:PF13564:PF10310,8,22,2,6,20,990,0.09,0.97,0.25,0.14,1,0,8,1,1009,0.0,0.99,0.0,-0.0
PF03310,PF13861:PF06744:PF00700:PF13742:PF09093,3,4,0,3,4,1011,0.0,0.99,0.0,-0.0,0,0,3,0,1015,0,1.0,0.0,0
PF16002,PF12213:PF15072:PF08418:PF16655:PF10492,4,17,3,1,14,1000,0.18,0.99,0.75,0.36,2,2,2,0,1014,1.0,1.0,0.5,0.71
PF13815,PF07926:PF07989:PF14846:PF16830:PF11577,6,24,1,5,23,989,0.04,0.97,0.17,0.07,1,0,6,1,1011,0.0,0.99,0.0,-0.0
PF05707,PF00669:PF17164:PF05299:PF16967:PF01752,0,3,0,0,3,1015,0.0,1.0,0,0,0,0,0,0,1018,0,1.0,0,0
PF02678,PF16912:PF05726:PF01729:PF13823:PF01087,17,26,11,6,15,986,0.42,0.98,0.65,0.51,0,0,17,0,1001,0,0.98,0.0,0
PF17223,PF01269:PF04422:PF14861:PF04452:PF15973,1,15,0,1,15,1002,0.0,0.98,0.0,-0.0,0,0,1,0,1017,0,1.0,0.0,0
PF07486,PF07805:PF03406:PF09951:PF03050:PF14841,2,2,0,2,2,1014,0.0,1.0,0.0,-0.0,0,0,2,0,1016,0,1.0,0.0,0
PF07915,PF05672:PF01873:PF02213:PF03909:PF04504,19,44,9,10,35,964,0.2,0.96,0.47,0.29,4,3,16,1,998,0.75,0.98,0.16,0.34
PF12449,PF12935:PF02916:PF11542:PF05762:PF11544,4,6,0,4,6,1008,0.0,0.99,0.0,-0.0,0,0,4,0,1014,0,1.0,0.0,0
PF01655,PF02928:PF02375:PF08429:PF07219:PF02388,18,23,3,15,20,980,0.13,0.97,0.17,0.13,9,3,15,6,994,0.33,0.98,0.17,0.23
PF14432,PF03178:PF06957:PF14498:PF02736:PF12036,41,57,22,19,35,942,0.39,0.95,0.54,0.43,4,4,37,0,977,1.0,0.96,0.1,0.31
PF14877,PF15050:PF17078:PF17015:PF15863:PF03203,4,3,0,4,3,1011,0.0,0.99,0.0,-0.0,0,0,4,0,1014,0,1.0,0.0,0
PF14331,PF07491:PF00262:PF10345:PF07047:PF08698,0,45,0,0,45,973,0.0,0.96,0,0,2,0,0,2,1016,0.0,1.0,0,0
PF09808,PF09816:PF07814:PF05182:PF15279:PF04910,5,31,3,2,28,985,0.1,0.97,0.6,0.23,3,1,4,2,1011,0.33,0.99,0.2,0.26
PF03723,PF03722:PF00372:PF16126:PF14307:PF16477,9,9,7,2,2,1007,0.78,1.0,0.78,0.78,0,0,9,0,1009,0,0.99,0.0,0
PF16726,PF16776:PF08952:PF09036:PF15151:PF07092,1,20,0,1,20,997,0.0,0.98,0.0,-0.0,1,0,1,1,1016,0.0,1.0,0.0,-0.0
PF10254,PF15499:PF14636:PF15999:PF09469:PF15273,4,14,0,4,14,1000,0.0,0.98,0.0,-0.01,0,0,4,0,1014,0,1.0,0.0,0
PF05625,PF04756:PF06090:PF14943:PF00213:PF06842,9,44,4,5,40,969,0.09,0.96,0.44,0.19,4,4,5,0,1009,1.0,1.0,0.44,0.67
PF03107,PF13905:PF11835:PF14299:PF00232:PF00408,15,63,13,2,50,953,0.21,0.95,0.87,0.41,7,6,9,1,1002,0.86,0.99,0.4,0.58
PF01623,PF16850:PF13276:PF09299:PF15153:PF01609,1,9,0,1,9,1008,0.0,0.99,0.0,-0.0,0,0,1,0,1017,0,1.0,0.0,0
PF03209,PF05336:PF06718:PF06028:PF06813:PF06711,0,11,0,0,11,1007,0.0,0.99,0,0,0,0,0,0,1018,0,1.0,0,0
PF13288,PF08436:PF02670:PF00674:PF09328:PF05076,5,14,5,0,9,1004,0.36,0.99,1.0,0.59,3,3,2,0,1013,1.0,1.0,0.6,0.77
PF13924,PF16117:PF12828:PF16697:PF13491:PF12825,8,13,5,3,8,1002,0.38,0.99,0.62,0.49,1,1,7,0,1010,1.0,0.99,0.12,0.35
PF00092,PF08473:PF06668:PF13768:PF05586:PF08487,55,24,16,39,8,955,0.67,0.95,0.29,0.42,4,4,51,0,963,1.0,0.95,0.07,0.26
PF09005,PF16568:PF10470:PF16544:PF16274:PF08067,10,8,3,7,5,1003,0.38,0.99,0.3,0.33,1,1,9,0,1008,1.0,0.99,0.1,0.31
PF14313,PF07661:PF01292:PF09556:PF10077:PF00700,0,13,0,0,13,1005,0.0,0.99,0,0,0,0,0,0,1018,0,1.0,0,0
PF06592,PF02951:PF17061:PF02277:PF10974:PF03244,1,7,0,1,7,1010,0.0,0.99,0.0,-0.0,0,0,1,0,1017,0,1.0,0.0,0
PF11971,PF08683:PF17095:PF16523:PF06395:PF09128,11,15,9,2,6,1001,0.6,0.99,0.82,0.7,4,4,7,0,1007,1.0,0.99,0.36,0.6
PF08975,PF12158:PF03050:PF03243:PF04986:PF14903,1,5,0,1,5,1012,0.0,0.99,0.0,-0.0,0,0,1,0,1017,0,1.0,0.0,0
PF00830,PF10218:PF01632:PF10252:PF09597:PF13092,3,12,1,2,11,1004,0.08,0.99,0.33,0.16,0,0,3,0,1015,0,1.0,0.0,0
PF10222,PF14308:PF00684:PF05207:PF14901:PF11926,8,24,3,5,21,989,0.12,0.97,0.38,0.21,1,1,7,0,1010,1.0,0.99,0.12,0.35
PF12844,PF03709:PF01355:PF09950:PF08343:PF07963,2,7,1,1,6,1010,0.14,0.99,0.5,0.26,0,0,2,0,1016,0,1.0,0.0,0
PF07199,PF15337:PF03525:PF15774:PF08744:PF04965,0,3,0,0,3,1015,0.0,1.0,0,0,0,0,0,0,1018,0,1.0,0,0
PF05613,PF16834:PF09580:PF09747:PF11354:PF05343,0,20,0,0,20,998,0.0,0.98,0,0,0,0,0,0,1018,0,1.0,0,0
PF01258,PF12465:PF10584:PF04225:PF05103:PF12833,6,55,4,2,51,961,0.07,0.95,0.67,0.21,1,0,6,1,1011,0.0,0.99,0.0,-0.0
PF08354,PF16073:PF01575:PF14765:PF00698:PF14498,10,68,10,0,58,950,0.15,0.94,1.0,0.37,24,10,0,14,994,0.42,0.99,1.0,0.64
PF12675,PF05001:PF04997:PF00180:PF08367:PF06682,0,65,0,0,65,953,0.0,0.94,0,0,7,0,0,7,1011,0.0,0.99,0,0
PF01316,PF01668:PF03379:PF10106:PF03238:PF17206,2,5,0,2,5,1011,0.0,0.99,0.0,-0.0,0,0,2,0,1016,0,1.0,0.0,0
PF04253,PF09747:PF01133:PF02225:PF04258:PF01229,15,59,14,1,45,958,0.24,0.95,0.93,0.46,8,3,12,5,998,0.38,0.98,0.2,0.27
PF06286,PF11642:PF15231:PF06670:PF01254:PF05671,0,3,0,0,3,1015,0.0,1.0,0,0,0,0,0,0,1018,0,1.0,0,0
PF15300,PF13519:PF14771:PF15057:PF13757:PF12034,2,42,2,0,40,976,0.05,0.96,1.0,0.21,2,0,2,2,1014,0.0,1.0,0.0,-0.0
PF00508,PF15052:PF02511:PF07881:PF15863:PF08017,2,13,1,1,12,1004,0.08,0.99,0.5,0.19,0,0,2,0,1016,0,1.0,0.0,0
PF11957,PF09034:PF01335:PF00531:PF10461:PF12721,5,43,4,1,39,974,0.09,0.96,0.8,0.26,4,3,2,1,1012,0.75,1.0,0.6,0.67
PF14936,PF08591:PF15462:PF03488:PF15683:PF15825,0,2,0,0,2,1016,0.0,1.0,0,0,0,0,0,0,1018,0,1.0,0,0
PF13919,PF05066:PF13922:PF16563:PF00320:PF12031,9,48,8,1,40,969,0.17,0.96,0.89,0.38,4,2,7,2,1007,0.5,0.99,0.22,0.33
PF05004,PF04836:PF02310:PF00344:PF02965:PF02607,6,26,6,0,20,992,0.23,0.98,1.0,0.48,5,1,5,4,1008,0.2,0.99,0.17,0.18
PF02625,PF01325:PF05232:PF08497:PF13269:PF14882,1,3,1,0,2,1015,0.33,1.0,1.0,0.58,0,0,1,0,1017,0,1.0,0.0,0
PF10063,PF06695:PF12646:PF15062:PF04359:PF11016,3,1,0,3,1,1014,0.0,1.0,0.0,-0.0,0,0,3,0,1015,0,1.0,0.0,0
PF00034,PF08752:PF16381:PF06375:PF14797:PF01775,17,13,6,11,7,994,0.46,0.98,0.35,0.39,2,1,16,1,1000,0.5,0.98,0.06,0.17
PF07331,PF08334:PF06745:PF08479:PF02572:PF14841,0,3,0,0,3,1015,0.0,1.0,0,0,0,0,0,0,1018,0,1.0,0,0
PF15612,PF02791:PF10537:PF15613:PF03172:PF16737,15,23,11,4,12,991,0.48,0.98,0.73,0.58,11,7,8,4,999,0.64,0.99,0.47,0.54
PF10601,PF07816:PF15795:PF01146:PF06799:PF00543,24,17,8,16,9,985,0.47,0.98,0.33,0.38,0,0,24,0,994,0,0.98,0.0,0
PF05859,PF12319:PF15346:PF08598:PF12766:PF14769,3,15,1,2,14,1001,0.07,0.98,0.33,0.14,0,0,3,0,1015,0,1.0,0.0,0
PF11374,PF08216:PF14649:PF15627:PF11028:PF04048,15,22,4,11,18,985,0.18,0.97,0.27,0.21,0,0,15,0,1003,0,0.99,0.0,0
PF09398,PF06541:PF07281:PF10839:PF12716:PF06581,6,4,0,6,4,1008,0.0,0.99,0.0,-0.0,0,0,6,0,1012,0,0.99,0.0,0
PF08461,PF08411:PF06890:PF04612:PF03592:PF09829,0,2,0,0,2,1016,0.0,1.0,0,0,0,0,0,0,1018,0,1.0,0,0
PF17011,PF01419:PF00764:PF09042:PF12534:PF08938,0,24,0,0,24,994,0.0,0.98,0,0,3,0,0,3,1015,0.0,1.0,0,0
PF04472,PF03065:PF09614:PF08795:PF15482:PF15337,0,4,0,0,4,1014,0.0,1.0,0,0,0,0,0,0,1018,0,1.0,0,0
PF06624,PF08229:PF07189:PF06884:PF13577:PF10455,5,22,1,4,21,992,0.05,0.98,0.2,0.09,1,0,5,1,1012,0.0,0.99,0.0,-0.0
PF08019,PF12411:PF06406:PF10035:PF07024:PF01364,4,5,1,3,4,1010,0.2,0.99,0.25,0.22,0,0,4,0,1014,0,1.0,0.0,0
PF13793,PF14572:PF00215:PF02812:PF03951:PF04833,23,52,15,8,37,958,0.29,0.96,0.65,0.42,4,4,19,0,995,1.0,0.98,0.17,0.41
PF02291,PF00473:PF05172:PF02234:PF09756:PF04759,5,31,3,2,28,985,0.1,0.97,0.6,0.23,0,0,5,0,1013,0,1.0,0.0,0
PF03631,PF17206:PF05797:PF08894:PF10106:PF15529,0,3,0,0,3,1015,0.0,1.0,0,0,0,0,0,0,1018,0,1.0,0,0
PF14021,PF08591:PF10664:PF15125:PF17062:PF11371,0,4,0,0,4,1014,0.0,1.0,0,0,0,0,0,0,1018,0,1.0,0,0
PF05791,PF05164:PF10375:PF11291:PF05685:PF13005,0,2,0,0,2,1016,0.0,1.0,0,0,0,0,0,0,1018,0,1.0,0,0
PF02200,PF15997:PF15923:PF14465:PF15914:PF11517,1,4,0,1,4,1013,0.0,1.0,0.0,-0.0,0,0,1,0,1017,0,1.0,0.0,0
PF04654,PF03386:PF03242:PF05512:PF06825:PF09748,5,19,1,4,18,995,0.05,0.98,0.2,0.09,0,0,5,0,1013,0,1.0,0.0,0
PF11754,PF09729:PF10348:PF04376:PF02423:PF10355,11,19,5,6,14,993,0.26,0.98,0.45,0.34,3,2,9,1,1006,0.67,0.99,0.18,0.34
PF15323,PF00379:PF01906:PF09348:PF12778:PF14998,2,36,1,1,35,981,0.03,0.96,0.5,0.11,0,0,2,0,1016,0,1.0,0.0,0
PF07528,PF16482:PF14622:PF00035:PF15396:PF13805,9,65,7,2,58,951,0.11,0.94,0.78,0.28,4,2,7,2,1007,0.5,0.99,0.22,0.33
PF00135,PF08674:PF06884:PF11095:PF03154:PF07519,82,32,20,62,12,924,0.62,0.93,0.24,0.36,2,2,80,0,936,1.0,0.92,0.02,0.15
PF14493,PF09382:PF00570:PF11408:PF16202:PF08072,5,31,4,1,27,986,0.13,0.97,0.8,0.31,7,3,2,4,1009,0.43,0.99,0.6,0.5
PF05162,PF16843:PF09055:PF04758:PF01020:PF12057,5,25,2,3,23,990,0.08,0.97,0.4,0.17,1,1,4,0,1013,1.0,1.0,0.2,0.45
PF12761,PF16880:PF12763:PF08226:PF05934:PF16652,7,48,5,2,43,968,0.1,0.96,0.71,0.26,6,2,5,4,1007,0.33,0.99,0.29,0.3
PF06565,PF00334:PF16901:PF13833:PF01266:PF00036,6,124,5,1,119,893,0.04,0.88,0.83,0.17,19,3,3,16,996,0.16,0.98,0.5,0.27
PF00743,PF13434:PF07247:PF07938:PF02515:PF07287,57,49,24,33,25,936,0.49,0.94,0.42,0.42,9,9,48,0,961,1.0,0.95,0.16,0.39
PF17095,PF08683:PF15246:PF10377:PF10358:PF14643,6,32,6,0,26,986,0.19,0.97,1.0,0.43,2,1,5,1,1011,0.5,0.99,0.17,0.29
PF05715,PF15914:PF14465:PF15030:PF15082:PF10407,3,7,1,2,6,1009,0.14,0.99,0.33,0.21,0,0,3,0,1015,0,1.0,0.0,0
PF11233,PF15046:PF03319:PF09256:PF04360:PF17015,0,3,0,0,3,1015,0.0,1.0,0,0,0,0,0,0,1018,0,1.0,0,0
PF04678,PF08265:PF10276:PF03045:PF02234:PF02100,16,27,5,11,22,980,0.19,0.97,0.31,0.22,2,0,16,2,1000,0.0,0.98,0.0,-0.01
PF15104,PF07327:PF03379:PF11493:PF05355:PF02087,0,7,0,0,7,1011,0.0,0.99,0,0,0,0,0,0,1018,0,1.0,0,0
PF12374,PF08828:PF15791:PF03474:PF00751:PF10330,1,8,1,0,7,1010,0.12,0.99,1.0,0.35,1,1,0,0,1017,1.0,1.0,1.0,1.0
PF07022,PF06934:PF05939:PF06805:PF01913:PF15355,1,1,0,1,1,1016,0.0,1.0,0.0,-0.0,0,0,1,0,1017,0,1.0,0.0,0
PF00195,PF02797:PF08545:PF03951:PF07632:PF03080,23,36,20,3,16,979,0.56,0.98,0.87,0.69,2,1,22,1,994,0.5,0.98,0.04,0.14
PF16095,PF08477:PF12799:PF06479:PF13676:PF15904,19,69,18,1,51,948,0.26,0.95,0.95,0.48,9,6,13,3,996,0.67,0.98,0.32,0.45
PF02772,PF02773:PF00438:PF01731:PF02578:PF08611,4,17,4,0,13,1001,0.24,0.99,1.0,0.48,0,0,4,0,1014,0,1.0,0.0,0
PF14846,PF12297:PF05104:PF11577:PF13815:PF17213,3,13,1,2,12,1003,0.08,0.99,0.33,0.16,0,0,3,0,1015,0,1.0,0.0,0
PF10632,PF09072:PF03442:PF16499:PF03422:PF14200,1,34,1,0,33,984,0.03,0.97,1.0,0.17,4,1,0,3,1014,0.25,1.0,1.0,0.5
PF11587,PF11466:PF01620:PF15973:PF00377:PF05642,0,4,0,0,4,1014,0.0,1.0,0,0,0,0,0,0,1018,0,1.0,0,0
PF04976,PF05018:PF04876:PF09606:PF03029:PF04204,0,32,0,0,32,986,0.0,0.97,0,0,2,0,0,2,1016,0.0,1.0,0,0
PF03108,PF04434:PF10551:PF10532:PF03101:PF10536,16,76,16,0,60,942,0.21,0.94,1.0,0.44,14,7,9,7,995,0.5,0.98,0.44,0.46
PF02799,PF01233:PF05076:PF12470:PF08622:PF14784,17,16,15,2,1,1000,0.94,1.0,0.88,0.91,3,3,14,0,1001,1.0,0.99,0.18,0.42
PF06073,PF16859:PF09937:PF09707:PF09912:PF13996,0,0,0,0,0,1018,0,1.0,0,0,0,0,0,0,1018,0,1.0,0,0
PF00925,PF00926:PF12471:PF08704:PF05140:PF00707,10,22,7,3,15,993,0.32,0.98,0.7,0.46,3,2,8,1,1007,0.67,0.99,0.2,0.36
PF11041,PF09397:PF07391:PF01136:PF07494:PF08886,2,7,0,2,7,1009,0.0,0.99,0.0,-0.0,0,0,2,0,1016,0,1.0,0.0,0
PF10951,PF05939:PF07805:PF14251:PF11863:PF17206,0,4,0,0,4,1014,0.0,1.0,0,0,0,0,0,0,1018,0,1.0,0,0
PF02263,PF02841:PF02176:PF04871:PF16013:PF16673,21,35,16,5,19,978,0.46,0.98,0.76,0.58,4,4,17,0,997,1.0,0.98,0.19,0.43
PF09839,PF14573:PF14885:PF03548:PF03749:PF01051,0,7,0,0,7,1011,0.0,0.99,0,0,0,0,0,0,1018,0,1.0,0,0
PF01715,PF01745:PF08648:PF12171:PF16835:PF16837,15,52,10,5,42,961,0.19,0.95,0.67,0.34,3,3,12,0,1003,1.0,0.99,0.2,0.44
PF00466,PF03647:PF04769:PF11735:PF09687:PF07814,19,30,10,9,20,979,0.33,0.97,0.53,0.41,2,2,17,0,999,1.0,0.98,0.11,0.32
PF10780,PF01097:PF00159:PF06127:PF08641:PF10244,0,18,0,0,18,1000,0.0,0.98,0,0,0,0,0,0,1018,0,1.0,0,0
PF01809,PF15550:PF07936:PF11317:PF09990:PF05754,0,1,0,0,1,1017,0.0,1.0,0,0,0,0,0,0,1018,0,1.0,0,0
PF12032,PF16030:PF09272:PF02983:PF15494:PF00089,8,127,8,0,119,891,0.06,0.88,1.0,0.24,3,1,7,2,1008,0.33,0.99,0.12,0.2
PF01419,PF12044:PF03018:PF14299:PF03945:PF12061,15,26,7,8,19,984,0.27,0.97,0.47,0.34,0,0,15,0,1003,0,0.99,0.0,0
PF15468,PF05840:PF08808:PF17076:PF17206:PF09669,3,1,0,3,1,1014,0.0,1.0,0.0,-0.0,0,0,3,0,1015,0,1.0,0.0,0
PF06161,PF15832:PF06070:PF02621:PF01316:PF16654,0,3,0,0,3,1015,0.0,1.0,0,0,0,0,0,0,1018,0,1.0,0,0
PF14714,PF15086:PF09269:PF05128:PF06780:PF08438,3,8,1,2,7,1008,0.12,0.99,0.33,0.2,1,1,2,0,1015,1.0,1.0,0.33,0.58
PF07491,PF13023:PF08315:PF00831:PF04667:PF01907,7,36,3,4,33,978,0.08,0.96,0.43,0.18,5,1,6,4,1007,0.2,0.99,0.14,0.16
PF06545,PF04247:PF01523:PF03063:PF03180:PF03406,8,16,5,3,11,999,0.31,0.99,0.62,0.44,0,0,8,0,1010,0,0.99,0.0,0
PF02949,PF07035:PF00141:PF00685:PF02958:PF12036,41,78,18,23,60,917,0.23,0.92,0.44,0.28,7,5,36,2,975,0.71,0.96,0.12,0.29
PF04177,PF15377:PF08038:PF00235:PF15239:PF01875,11,19,4,7,15,992,0.21,0.98,0.36,0.27,1,1,10,0,1007,1.0,0.99,0.09,0.3
PF07930,PF11954:PF01427:PF06176:PF07311:PF00144,1,69,1,0,68,949,0.01,0.93,1.0,0.12,0,0,1,0,1017,0,1.0,0.0,0
PF00003,PF00497:PF07562:PF01547:PF08216:PF08640,32,55,21,11,34,952,0.38,0.96,0.66,0.48,5,5,27,0,986,1.0,0.97,0.16,0.39
PF14040,PF10295:PF13094:PF13810:PF15478:PF15759,0,6,0,0,6,1012,0.0,0.99,0,0,0,0,0,0,1018,0,1.0,0,0
PF17154,PF10554:PF05016:PF01807:PF07556:PF03058,1,6,0,1,6,1011,0.0,0.99,0.0,-0.0,0,0,1,0,1017,0,1.0,0.0,0
PF08847,PF03379:PF07327:PF11317:PF15085:PF09252,0,4,0,0,4,1014,0.0,1.0,0,0,0,0,0,0,1018,0,1.0,0,0
PF10000,PF13840:PF00742:PF01958:PF03447:PF09290,3,29,2,1,27,988,0.07,0.97,0.67,0.21,3,1,2,2,1013,0.33,1.0,0.33,0.33
PF12001,PF05837:PF13096:PF15934:PF02083:PF06211,3,5,0,3,5,1010,0.0,0.99,0.0,-0.0,0,0,3,0,1015,0,1.0,0.0,0
PF06889,PF11751:PF13722:PF03589:PF02305:PF08707,0,3,0,0,3,1015,0.0,1.0,0,0,0,0,0,0,1018,0,1.0,0,0
PF05375,PF09206:PF13330:PF09175:PF02822:PF08742,7,41,5,2,36,975,0.12,0.96,0.71,0.29,5,2,5,3,1008,0.4,0.99,0.29,0.33
PF04425,PF04426:PF08124:PF02884:PF02278:PF16126,0,6,0,0,6,1012,0.0,0.99,0,0,1,0,0,1,1017,0.0,1.0,0,0
PF11900,PF12313:PF16553:PF09310:PF09372:PF11904,4,10,4,0,6,1008,0.4,0.99,1.0,0.63,1,1,3,0,1014,1.0,1.0,0.25,0.5
PF03016,PF09258:PF03407:PF01501:PF04130:PF02365,34,91,22,12,69,915,0.24,0.92,0.65,0.36,13,11,23,2,982,0.85,0.98,0.32,0.51
PF12295,PF11935:PF12166:PF08101:PF15917:PF08623,6,21,6,0,15,997,0.29,0.99,1.0,0.53,2,2,4,0,1012,1.0,1.0,0.33,0.58
PF01596,PF15011:PF04930:PF04061:PF05724:PF04979,15,39,9,6,30,973,0.23,0.96,0.6,0.36,3,3,12,0,1003,1.0,0.99,0.2,0.44
PF08768,PF01549:PF05507:PF07210:PF05086:PF13918,3,50,3,0,47,968,0.06,0.95,1.0,0.24,0,0,3,0,1015,0,1.0,0.0,0
PF12344,PF16783:PF03461:PF03880:PF08061:PF07652,5,14,4,1,10,1003,0.29,0.99,0.8,0.47,2,2,3,0,1013,1.0,1.0,0.4,0.63
PF04043,PF01095:PF00156:PF02449:PF00215:PF01397,16,76,13,3,63,939,0.17,0.94,0.81,0.35,10,5,11,5,997,0.5,0.98,0.31,0.39
PF07823,PF08189:PF15014:PF07080:PF07543:PF16851,5,10,0,5,10,1003,0.0,0.99,0.0,-0.01,0,0,5,0,1013,0,1.0,0.0,0
PF01523,PF03548:PF02614:PF13247:PF09677:PF13630,11,5,1,10,4,1003,0.2,0.99,0.09,0.13,0,0,11,0,1007,0,0.99,0.0,0
PF09240,PF07227:PF16066:PF09067:PF06328:PF12772,4,6,1,3,5,1009,0.17,0.99,0.25,0.2,1,1,3,0,1014,1.0,1.0,0.25,0.5
PF05502,PF10443:PF05383:PF03467:PF04073:PF00390,3,50,3,0,47,968,0.06,0.95,1.0,0.24,5,2,1,3,1012,0.4,1.0,0.67,0.51
PF06098,PF07802:PF08227:PF07406:PF10595:PF06907,3,13,1,2,12,1003,0.08,0.99,0.33,0.16,1,0,3,1,1014,0.0,1.0,0.0,-0.0
PF01643,PF12590:PF08523:PF02747:PF03763:PF00705,1,26,1,0,25,992,0.04,0.98,1.0,0.19,1,0,1,1,1016,0.0,1.0,0.0,-0.0
PF00403,PF00080:PF00122:PF06090:PF02583:PF12274,31,118,25,6,93,894,0.21,0.9,0.81,0.38,8,6,25,2,985,0.75,0.97,0.19,0.37
PF15178,PF05418:PF06681:PF15758:PF17193:PF14251,0,3,0,0,3,1015,0.0,1.0,0,0,0,0,0,0,1018,0,1.0,0,0
PF11593,PF01913:PF05939:PF03244:PF03428:PF04717,2,1,0,2,1,1015,0.0,1.0,0.0,-0.0,0,0,2,0,1016,0,1.0,0.0,0
PF05416,PF10106:PF02465:PF15366:PF16325:PF08404,2,2,0,2,2,1014,0.0,1.0,0.0,-0.0,0,0,2,0,1016,0,1.0,0.0,0
PF12951,PF12779:PF02107:PF16586:PF06429:PF07520,1,2,0,1,2,1015,0.0,1.0,0.0,-0.0,0,0,1,0,1017,0,1.0,0.0,0
PF03141,PF05097:PF04646:PF14547:PF02701:PF04504,20,27,9,11,18,980,0.33,0.97,0.45,0.37,1,1,19,0,998,1.0,0.98,0.05,0.22
PF00794,PF00792:PF00613:PF00454:PF14413:PF04446,23,66,21,2,45,950,0.32,0.95,0.91,0.52,24,21,2,3,992,0.88,1.0,0.91,0.89
PF13651,PF07373:PF00621:PF05437:PF04062:PF16796,0,87,0,0,87,931,0.0,0.91,0,0,2,0,0,2,1016,0.0,1.0,0,0
PF16794,PF12884:PF12509:PF13916:PF08729:PF12886,7,13,2,5,11,1000,0.15,0.98,0.29,0.2,0,0,7,0,1011,0,0.99,0.0,0
PF05757,PF00321:PF06232:PF04520:PF06376:PF04241,2,14,0,2,14,1002,0.0,0.98,0.0,-0.01,1,0,2,1,1015,0.0,1.0,0.0,-0.0
PF07750,PF01927:PF06882:PF08066:PF06506:PF01810,2,20,2,0,18,998,0.1,0.98,1.0,0.31,2,2,0,0,1016,1.0,1.0,1.0,1.0
PF06248,PF11989:PF14844:PF05731:PF06469:PF04129,9,37,5,4,32,977,0.14,0.96,0.56,0.26,1,1,8,0,1009,1.0,0.99,0.11,0.33
PF03920,PF08232:PF12931:PF07304:PF13925:PF14538,1,37,1,0,36,981,0.03,0.96,1.0,0.16,3,1,0,2,1015,0.33,1.0,1.0,0.58
PF04942,PF01549:PF05507:PF01683:PF08768:PF07210,2,56,1,1,55,961,0.02,0.94,0.5,0.09,3,0,2,3,1013,0.0,1.0,0.0,-0.0
PF16851,PF10868:PF06369:PF09057:PF17032:PF11493,0,1,0,0,1,1017,0.0,1.0,0,0,0,0,0,0,1018,0,1.0,0,0
PF02137,PF14622:PF00035:PF16482:PF01207:PF00636,22,81,20,2,61,935,0.25,0.94,0.91,0.46,17,7,15,10,986,0.41,0.98,0.32,0.35
PF05567,PF17164:PF13505:PF17006:PF13575:PF13101,0,0,0,0,0,1018,0,1.0,0,0,0,0,0,0,1018,0,1.0,0,0
PF11929,PF09372:PF16553:PF09310:PF15487:PF15898,3,5,1,2,4,1011,0.2,0.99,0.33,0.26,1,1,2,0,1015,1.0,1.0,0.33,0.58
PF07808,PF07807:PF05391:PF02128:PF08596:PF07504,9,13,7,2,6,1003,0.54,0.99,0.78,0.64,2,2,7,0,1009,1.0,0.99,0.22,0.47
PF14644,PF14643:PF15246:PF15452:PF15253:PF16529,3,15,3,0,12,1003,0.2,0.99,1.0,0.44,0,0,3,0,1015,0,1.0,0.0,0
PF05913,PF03831:PF07411:PF16888:PF11245:PF17188,1,0,0,1,0,1017,0,1.0,0.0,0,0,0,1,0,1017,0,1.0,0.0,0
PF15143,PF07805:PF07308:PF12241:PF14841:PF04717,0,3,0,0,3,1015,0.0,1.0,0,0,0,0,0,0,1018,0,1.0,0,0
PF16739,PF13625:PF11648:PF08148:PF16203:PF08061,10,26,8,2,18,990,0.31,0.98,0.8,0.49,6,6,4,0,1008,1.0,1.0,0.6,0.77
PF15185,PF05840:PF00419:PF06890:PF13722:PF14690,2,1,0,2,1,1015,0.0,1.0,0.0,-0.0,0,0,2,0,1016,0,1.0,0.0,0
PF11904,PF16553:PF15898:PF09310:PF00710:PF04960,9,22,3,6,19,990,0.14,0.98,0.33,0.2,1,1,8,0,1009,1.0,0.99,0.11,0.33
PF12080,PF07499:PF03090:PF11794:PF01706:PF06834,0,2,0,0,2,1016,0.0,1.0,0,0,0,0,0,0,1018,0,1.0,0,0
PF07787,PF10252:PF10218:PF13092:PF04839:PF00468,5,11,1,4,10,1003,0.09,0.99,0.2,0.13,1,0,5,1,1012,0.0,0.99,0.0,-0.0
PF08595,PF15400:PF06210:PF12628:PF05065:PF09510,7,1,0,7,1,1010,0.0,0.99,0.0,-0.0,0,0,7,0,1011,0,0.99,0.0,0
PF06684,PF03222:PF04183:PF05694:PF06552:PF04699,0,15,0,0,15,1003,0.0,0.99,0,0,1,0,0,1,1017,0.0,1.0,0,0
PF10337,PF10334:PF06165:PF17167:PF16761:PF10347,7,16,7,0,9,1002,0.44,0.99,1.0,0.66,4,1,6,3,1008,0.25,0.99,0.14,0.18
PF10440,PF03353:PF05964:PF05965:PF05033:PF11616,4,40,3,1,37,977,0.07,0.96,0.75,0.23,7,2,2,5,1009,0.29,0.99,0.5,0.37
PF14828,PF14799:PF14473:PF06446:PF10705:PF06541,4,6,1,3,5,1009,0.17,0.99,0.25,0.2,0,0,4,0,1014,0,1.0,0.0,0
PF02988,PF00021:PF02513:PF03821:PF10381:PF03986,1,15,1,0,14,1003,0.07,0.99,1.0,0.26,0,0,1,0,1017,0,1.0,0.0,0
PF06535,PF06534:PF05076:PF17187:PF12470:PF09164,0,5,0,0,5,1013,0.0,1.0,0,0,1,0,0,1,1017,0.0,1.0,0,0
PF14785,PF05591:PF05947:PF04966:PF00604:PF10076,0,3,0,0,3,1015,0.0,1.0,0,0,0,0,0,0,1018,0,1.0,0,0
PF00617,PF00618:PF00620:PF00611:PF09128:PF00610,46,114,44,2,70,902,0.39,0.93,0.96,0.58,16,16,30,0,972,1.0,0.97,0.35,0.58
PF16279,PF08832:PF08815:PF07469:PF08778:PF11413,6,11,6,0,5,1007,0.55,1.0,1.0,0.74,4,4,2,0,1012,1.0,1.0,0.67,0.82
PF06691,PF11130:PF05707:PF02572:PF17164:PF13722,1,2,0,1,2,1015,0.0,1.0,0.0,-0.0,0,0,1,0,1017,0,1.0,0.0,0
PF02260,PF11865:PF02259:PF08771:PF08064:PF02192,24,35,18,6,17,977,0.51,0.98,0.75,0.61,9,9,15,0,994,1.0,0.99,0.38,0.61
PF16486,PF08699:PF16488:PF02170:PF02171:PF16487,33,56,33,0,23,962,0.59,0.98,1.0,0.76,37,32,1,5,980,0.86,0.99,0.97,0.91
PF03022,PF03417:PF07542:PF04819:PF00953:PF10255,6,36,1,5,35,977,0.03,0.96,0.17,0.05,2,0,6,2,1010,0.0,0.99,0.0,-0.0
PF07648,PF00050:PF01469:PF03146:PF09289:PF00054,25,30,12,13,18,975,0.4,0.97,0.48,0.42,3,3,22,0,993,1.0,0.98,0.12,0.34
PF16346,PF16352:PF11837:PF08975:PF08317:PF16968,0,8,0,0,8,1010,0.0,0.99,0,0,0,0,0,0,1018,0,1.0,0,0
PF02545,PF16864:PF08100:PF04093:PF00891:PF02672,18,37,10,8,27,973,0.27,0.97,0.56,0.37,2,2,16,0,1000,1.0,0.98,0.11,0.33
PF07666,PF00621:PF00616:PF06920:PF02518:PF07460,1,141,0,1,141,876,0.0,0.86,0.0,-0.01,16,0,1,16,1001,0.0,0.98,0.0,-0.0
PF15120,PF15829:PF15576:PF07259:PF07458:PF15849,1,3,1,0,2,1015,0.33,1.0,1.0,0.58,0,0,1,0,1017,0,1.0,0.0,0
PF05437,PF05904:PF13960:PF15412:PF04094:PF08827,0,13,0,0,13,1005,0.0,0.99,0,0,1,0,0,1,1017,0.0,1.0,0,0
PF02536,PF01066:PF06068:PF04577:PF00854:PF08241,38,114,22,16,92,888,0.19,0.89,0.58,0.29,13,10,28,3,977,0.77,0.97,0.26,0.44
PF14334,PF04187:PF08321:PF05705:PF12588:PF04365,0,25,0,0,25,993,0.0,0.98,0,0,0,0,0,0,1018,0,1.0,0,0
PF05741,PF07939:PF15247:PF02234:PF04367:PF07412,8,19,4,4,15,995,0.21,0.98,0.5,0.32,1,1,7,0,1010,1.0,0.99,0.12,0.35
PF08598,PF15346:PF14279:PF12319:PF15247:PF13092,6,13,1,5,12,1000,0.08,0.98,0.17,0.11,1,1,5,0,1012,1.0,1.0,0.17,0.41
PF08815,PF16279:PF08832:PF07469:PF12114:PF08778,6,12,6,0,6,1006,0.5,0.99,1.0,0.71,4,4,2,0,1012,1.0,1.0,0.67,0.82
PF01313,PF00813:PF06995:PF02501:PF07494:PF10908,0,3,0,0,3,1015,0.0,1.0,0,0,0,0,0,0,1018,0,1.0,0,0
PF10275,PF11303:PF03162:PF08265:PF07798:PF09789,7,23,5,2,18,993,0.22,0.98,0.71,0.39,1,1,6,0,1011,1.0,0.99,0.14,0.38
PF07876,PF01988:PF01817:PF07950:PF04248:PF07687,26,35,11,15,24,968,0.31,0.96,0.42,0.35,3,2,24,1,991,0.67,0.98,0.08,0.22
PF10473,PF12795:PF08505:PF10979:PF02108:PF05164,4,5,0,4,5,1009,0.0,0.99,0.0,-0.0,0,0,4,0,1014,0,1.0,0.0,0
PF00801,PF02010:PF08016:PF07632:PF01477:PF00059,10,106,8,2,98,910,0.08,0.9,0.8,0.23,11,3,7,8,1000,0.27,0.99,0.3,0.28
PF14663,PF14664:PF14666:PF14668:PF15961:PF14837,11,15,11,0,4,1003,0.73,1.0,1.0,0.85,10,10,1,0,1007,1.0,1.0,0.91,0.95
PF03221,PF04218:PF03184:PF04236:PF05225:PF09607,55,71,44,11,27,936,0.62,0.96,0.8,0.69,9,9,46,0,963,1.0,0.95,0.16,0.4
PF16891,PF04152:PF05011:PF10360:PF03637:PF02872,14,43,7,7,36,968,0.16,0.96,0.5,0.27,4,3,11,1,1003,0.75,0.99,0.21,0.4
PF08657,PF14232:PF09051:PF14654:PF09050:PF09049,2,0,0,2,0,1016,0,1.0,0.0,0,0,0,2,0,1016,0,1.0,0.0,0
PF07879,PF05233:PF15546:PF17192:PF16968:PF03882,1,1,1,0,0,1017,1.0,1.0,1.0,1.0,0,0,1,0,1017,0,1.0,0.0,0
PF13511,PF13005:PF09979:PF04222:PF06007:PF12686,3,2,0,3,2,1013,0.0,1.0,0.0,-0.0,0,0,3,0,1015,0,1.0,0.0,0
PF07497,PF11421:PF16886:PF07498:PF02874:PF00401,3,50,3,0,47,968,0.06,0.95,1.0,0.24,3,1,2,2,1013,0.33,1.0,0.33,0.33
PF05995,PF02284:PF01774:PF01775:PF06172:PF05047,10,21,4,6,17,991,0.19,0.98,0.4,0.27,2,2,8,0,1008,1.0,0.99,0.2,0.45
PF00079,PF04045:PF16038:PF01182:PF07686:PF02949,29,94,16,13,78,911,0.17,0.91,0.55,0.27,10,3,26,7,982,0.3,0.97,0.1,0.16
PF05724,PF05995:PF06172:PF02284:PF01774:PF01775,8,23,5,3,18,992,0.22,0.98,0.62,0.36,3,1,7,2,1008,0.33,0.99,0.12,0.2
PF13870,PF06211:PF15934:PF12240:PF11831:PF13096,3,14,1,2,13,1002,0.07,0.99,0.33,0.15,0,0,3,0,1015,0,1.0,0.0,0
PF08207,PF09285:PF01132:PF13241:PF10785:PF14823,8,20,6,2,14,996,0.3,0.98,0.75,0.47,0,0,8,0,1010,0,0.99,0.0,0
PF15867,PF13877:PF05279:PF16546:PF04049:PF11998,5,29,4,1,25,988,0.14,0.97,0.8,0.33,2,1,4,1,1012,0.5,1.0,0.2,0.31
PF03595,PF01987:PF07106:PF04667:PF13664:PF00436,21,38,9,12,29,968,0.24,0.96,0.43,0.3,2,2,19,0,997,1.0,0.98,0.1,0.31
PF07326,PF00419:PF04624:PF07409:PF03775:PF15185,0,4,0,0,4,1014,0.0,1.0,0,0,0,0,0,0,1018,0,1.0,0,0
PF01509,PF01472:PF16198:PF08068:PF10343:PF09183,19,31,13,6,18,981,0.42,0.98,0.68,0.52,5,5,14,0,999,1.0,0.99,0.26,0.51
PF02569,PF09774:PF07080:PF05755:PF09781:PF02982,11,19,3,8,16,991,0.16,0.98,0.27,0.2,0,0,11,0,1007,0,0.99,0.0,0
PF05964,PF05965:PF10440:PF08429:PF12269:PF03353,18,36,17,1,19,981,0.47,0.98,0.94,0.66,3,3,15,0,1000,1.0,0.99,0.17,0.41
PF05509,PF05513:PF07178:PF05309:PF06586:PF01752,1,3,1,0,2,1015,0.33,1.0,1.0,0.58,1,1,0,0,1017,1.0,1.0,1.0,1.0
PF15539,PF09332:PF16944:PF11496:PF17020:PF05508,0,17,0,0,17,1001,0.0,0.98,0,0,0,0,0,0,1018,0,1.0,0,0
PF02126,PF14931:PF10251:PF15551:PF14933:PF15741,8,5,1,7,4,1006,0.2,0.99,0.12,0.15,1,1,7,0,1010,1.0,0.99,0.12,0.35
PF12878,PF12879:PF12887:PF05640:PF05177:PF15253,0,8,0,0,8,1010,0.0,0.99,0,0,1,0,0,1,1017,0.0,1.0,0,0
PF10505,PF09733:PF01594:PF15189:PF06047:PF07839,7,18,1,6,17,994,0.06,0.98,0.14,0.08,2,0,7,2,1009,0.0,0.99,0.0,-0.0
PF15463,PF17206:PF00669:PF11751:PF07434:PF01752,1,4,0,1,4,1013,0.0,1.0,0.0,-0.0,0,0,1,0,1017,0,1.0,0.0,0
PF14983,PF07195:PF13726:PF07149:PF16590:PF02951,2,5,0,2,5,1011,0.0,0.99,0.0,-0.0,0,0,2,0,1016,0,1.0,0.0,0
PF10416,PF11581:PF15749:PF07444:PF16091:PF06324,0,6,0,0,6,1012,0.0,0.99,0,0,0,0,0,0,1018,0,1.0,0,0
PF00025,PF15840:PF14634:PF12273:PF00643:PF05018,65,70,31,34,39,914,0.44,0.93,0.48,0.42,8,7,58,1,952,0.88,0.94,0.11,0.3
PF15791,PF08828:PF12374:PF03474:PF00751:PF10330,2,8,2,0,6,1010,0.25,0.99,1.0,0.5,1,1,1,0,1016,1.0,1.0,0.5,0.71
PF15322,PF08453:PF10279:PF05939:PF03888:PF15128,0,2,0,0,2,1016,0.0,1.0,0,0,0,0,0,0,1018,0,1.0,0,0
PF06012,PF06025:PF10427:PF12938:PF11597:PF11522,6,19,6,0,13,999,0.32,0.99,1.0,0.56,1,1,5,0,1012,1.0,1.0,0.17,0.41
PF09070,PF05903:PF08324:PF08614:PF04192:PF14077,8,34,6,2,28,982,0.18,0.97,0.75,0.35,2,2,6,0,1010,1.0,0.99,0.25,0.5
PF15927,PF12366:PF11597:PF14665:PF06333:PF15452,6,13,4,2,9,1003,0.31,0.99,0.67,0.45,2,1,5,1,1011,0.5,0.99,0.17,0.29
PF07547,PF15774:PF16756:PF15696:PF07199:PF12628,4,0,0,4,0,1014,0,1.0,0.0,0,0,0,4,0,1014,0,1.0,0.0,0
PF06766,PF15370:PF15359:PF06912:PF15071:PF06108,2,13,0,2,13,1003,0.0,0.99,0.0,-0.01,0,0,2,0,1016,0,1.0,0.0,0
PF08120,PF05284:PF04927:PF00333:PF14694:PF08765,2,22,0,2,22,994,0.0,0.98,0.0,-0.01,0,0,2,0,1016,0,1.0,0.0,0
PF00535,PF00652:PF04577:PF02709:PF00016:PF13679,64,84,42,22,42,912,0.5,0.94,0.66,0.54,12,12,52,0,954,1.0,0.95,0.19,0.42
PF01987,PF04667:PF10780:PF01097:PF00159:PF06127,6,13,1,5,12,1000,0.08,0.98,0.17,0.11,0,0,6,0,1012,0,0.99,0.0,0
PF05158,PF06219:PF03894:PF03214:PF08523:PF09363,7,12,1,6,11,1000,0.08,0.98,0.14,0.1,0,0,7,0,1011,0,0.99,0.0,0
PF02583,PF02348:PF15928:PF00403:PF02130:PF12515,4,40,4,0,36,978,0.1,0.96,1.0,0.31,3,0,4,3,1011,0.0,0.99,0.0,-0.0
PF01858,PF11934:PF01857:PF08934:PF14700:PF12859,2,15,1,1,14,1002,0.07,0.99,0.5,0.18,0,0,2,0,1016,0,1.0,0.0,0
PF15287,PF14049:PF14047:PF15779:PF05716:PF15324,4,11,1,3,10,1004,0.09,0.99,0.25,0.15,0,0,4,0,1014,0,1.0,0.0,0
PF13508,PF13673:PF04982:PF06500:PF13225:PF11833,10,31,5,5,26,982,0.16,0.97,0.5,0.27,2,1,9,1,1007,0.5,0.99,0.1,0.22
PF05532,PF03823:PF08636:PF15576:PF08649:PF15839,1,8,1,0,7,1010,0.12,0.99,1.0,0.35,0,0,1,0,1017,0,1.0,0.0,0
PF15173,PF06875:PF02427:PF14653:PF15559:PF09252,0,0,0,0,0,1018,0,1.0,0,0,0,0,0,0,1018,0,1.0,0,0
PF08740,PF14629:PF08542:PF14363:PF16725:PF09079,14,34,6,8,28,976,0.18,0.96,0.43,0.26,3,3,11,0,1004,1.0,0.99,0.21,0.46
PF07699,PF01404:PF02494:PF14575:PF12662:PF04775,20,38,13,7,25,973,0.34,0.97,0.65,0.46,5,5,15,0,998,1.0,0.99,0.25,0.5
PF04082,PF11951:PF16846:PF08493:PF13434:PF01544,154,97,65,89,32,832,0.67,0.88,0.42,0.47,12,12,142,0,864,1.0,0.86,0.08,0.26
PF00893,PF11363:PF07321:PF14615:PF11794:PF02863,1,9,0,1,9,1008,0.0,0.99,0.0,-0.0,0,0,1,0,1017,0,1.0,0.0,0
PF07543,PF14087:PF08189:PF09252:PF09459:PF07544,6,14,4,2,10,1002,0.29,0.99,0.67,0.43,0,0,6,0,1012,0,0.99,0.0,0
PF14613,PF13320:PF15491:PF08579:PF13020:PF15232,0,6,0,0,6,1012,0.0,0.99,0,0,0,0,0,0,1018,0,1.0,0,0
PF05045,PF04196:PF15518:PF06458:PF06506:PF06826,0,6,0,0,6,1012,0.0,0.99,0,0,0,0,0,0,1018,0,1.0,0,0
PF09427,PF12533:PF01586:PF11851:PF02344:PF06621,3,9,1,2,8,1007,0.11,0.99,0.33,0.19,1,1,2,0,1015,1.0,1.0,0.33,0.58
PF03705,PF08411:PF03241:PF11751:PF02277:PF16861,0,7,0,0,7,1011,0.0,0.99,0,0,0,0,0,0,1018,0,1.0,0,0
PF05365,PF09802:PF07802:PF08107:PF15773:PF17064,6,12,3,3,9,1003,0.25,0.99,0.5,0.35,0,0,6,0,1012,0,0.99,0.0,0
PF08466,PF01007:PF09463:PF10446:PF08655:PF02078,1,23,1,0,22,995,0.04,0.98,1.0,0.21,0,0,1,0,1017,0,1.0,0.0,0
PF12144,PF15778:PF12478:PF09596:PF15249:PF15232,5,17,1,4,16,997,0.06,0.98,0.2,0.1,0,0,5,0,1013,0,1.0,0.0,0
PF16954,PF15008:PF01147:PF05300:PF05497:PF03858,2,9,0,2,9,1007,0.0,0.99,0.0,-0.0,0,0,2,0,1016,0,1.0,0.0,0
PF05279,PF13174:PF05118:PF09295:PF07721:PF15867,1,27,1,0,26,991,0.04,0.97,1.0,0.19,2,1,0,1,1016,0.5,1.0,1.0,0.71
PF11136,PF11876:PF07495:PF03613:PF10079:PF05223,0,2,0,0,2,1016,0.0,1.0,0,0,0,0,0,0,1018,0,1.0,0,0
PF04170,PF05939:PF01706:PF03589:PF03090:PF09951,0,2,0,0,2,1016,0.0,1.0,0,0,0,0,0,0,1018,0,1.0,0,0
PF16768,PF16769:PF16766:PF05104:PF11577:PF10481,2,9,1,1,8,1008,0.11,0.99,0.5,0.23,0,0,2,0,1016,0,1.0,0.0,0
PF15765,PF15856:PF17049:PF06681:PF13750:PF14539,0,2,0,0,2,1016,0.0,1.0,0,0,0,0,0,0,1018,0,1.0,0,0
PF06052,PF07883:PF06249:PF02560:PF05899:PF01259,3,38,3,0,35,980,0.08,0.97,1.0,0.28,2,0,3,2,1013,0.0,1.0,0.0,-0.0
PF00621,PF08174:PF08916:PF00617:PF00616:PF00620,78,110,43,35,67,873,0.39,0.9,0.55,0.41,8,7,71,1,939,0.88,0.93,0.09,0.27
PF01650,PF05191:PF07722:PF07542:PF01765:PF04140,18,42,7,11,35,965,0.17,0.95,0.39,0.23,4,3,15,1,999,0.75,0.98,0.17,0.35
PF00473,PF15342:PF03856:PF02576:PF12049:PF10571,5,12,1,4,11,1002,0.08,0.99,0.2,0.12,0,0,5,0,1013,0,1.0,0.0,0
PF09256,PF10567:PF01752:PF08708:PF15046:PF03729,0,6,0,0,6,1012,0.0,0.99,0,0,0,0,0,0,1018,0,1.0,0,0
PF02174,PF08174:PF16018:PF08916:PF16528:PF12480,16,26,6,10,20,982,0.23,0.97,0.38,0.28,1,1,15,0,1002,1.0,0.99,0.06,0.25
PF12681,PF11124:PF15828:PF15224:PF10863:PF11037,0,2,0,0,2,1016,0.0,1.0,0,0,0,0,0,0,1018,0,1.0,0,0
PF09507,PF14621:PF06824:PF00454:PF05162:PF06609,8,70,4,4,66,944,0.06,0.93,0.5,0.15,2,0,8,2,1008,0.0,0.99,0.0,-0.0
PF00213,PF00210:PF02284:PF01625:PF10183:PF02167,16,40,6,10,34,968,0.15,0.96,0.38,0.22,4,3,13,1,1001,0.75,0.99,0.19,0.37
PF10209,PF17053:PF17050:PF14290:PF15091:PF15325,1,2,1,0,1,1016,0.5,1.0,1.0,0.71,0,0,1,0,1017,0,1.0,0.0,0
PF15804,PF16766:PF11767:PF06429:PF15751:PF02748,1,12,0,1,12,1005,0.0,0.99,0.0,-0.0,0,0,1,0,1017,0,1.0,0.0,0
PF00446,PF00159:PF01279:PF02488:PF16541:PF01099,3,5,1,2,4,1011,0.2,0.99,0.33,0.26,0,0,3,0,1015,0,1.0,0.0,0
PF04774,PF13339:PF02750:PF03479:PF16174:PF09598,7,20,6,1,14,997,0.3,0.99,0.86,0.5,0,0,7,0,1011,0,0.99,0.0,0
PF16332,PF12062:PF12372:PF14906:PF14726:PF14649,2,19,1,1,18,998,0.05,0.98,0.5,0.16,2,0,2,2,1014,0.0,1.0,0.0,-0.0
PF11805,PF08228:PF17032:PF05419:PF02427:PF15158,0,3,0,0,3,1015,0.0,1.0,0,0,0,0,0,0,1018,0,1.0,0,0
PF00933,PF01915:PF14310:PF14498:PF06964:PF08427,35,47,32,3,15,968,0.68,0.98,0.91,0.78,14,13,22,1,982,0.93,0.98,0.37,0.58
PF00185,PF02729:PF02142:PF00988:PF01808:PF02481,21,40,20,1,20,977,0.5,0.98,0.95,0.68,12,12,9,0,997,1.0,0.99,0.57,0.75
PF00525,PF10660:PF00011:PF14803:PF16922:PF07702,3,39,3,0,36,979,0.08,0.96,1.0,0.27,2,0,3,2,1013,0.0,1.0,0.0,-0.0
PF04939,PF08316:PF11489:PF15991:PF04004:PF06420,9,19,2,7,17,992,0.11,0.98,0.22,0.14,0,0,9,0,1009,0,0.99,0.0,0
PF14690,PF02211:PF03831:PF13722:PF03428:PF07409,0,3,0,0,3,1015,0.0,1.0,0,0,0,0,0,0,1018,0,1.0,0,0
PF16797,PF12063:PF11629:PF08311:PF14593:PF12202,3,22,2,1,20,995,0.09,0.98,0.67,0.24,4,2,1,2,1013,0.5,1.0,0.67,0.58
PF04361,PF09731:PF09248:PF01074:PF11421:PF06978,0,36,0,0,36,982,0.0,0.96,0,0,2,0,0,2,1016,0.0,1.0,0,0
PF05664,PF01735:PF10540:PF15625:PF16056:PF13091,15,50,8,7,42,961,0.16,0.95,0.53,0.27,2,1,14,1,1002,0.5,0.99,0.07,0.18
PF11161,PF04559:PF05489:PF02086:PF10554:PF11751,0,2,0,0,2,1016,0.0,1.0,0,0,0,0,0,0,1018,0,1.0,0,0
PF08426,PF12904:PF05782:PF15302:PF05111:PF06746,0,3,0,0,3,1015,0.0,1.0,0,0,0,0,0,0,1018,0,1.0,0,0
PF05224,PF13887:PF13888:PF13884:PF05508:PF08839,16,13,8,8,5,997,0.62,0.99,0.5,0.55,6,6,10,0,1002,1.0,0.99,0.38,0.61
PF08640,PF08216:PF10392:PF15296:PF08161:PF11781,10,21,4,6,17,991,0.19,0.98,0.4,0.27,2,2,8,0,1008,1.0,0.99,0.2,0.45
PF16501,PF11500:PF05715:PF10377:PF09247:PF15030,0,10,0,0,10,1008,0.0,0.99,0,0,1,0,0,1,1017,0.0,1.0,0,0
PF01497,PF01902:PF02027:PF01042:PF14240:PF08192,10,31,5,5,26,982,0.16,0.97,0.5,0.27,0,0,10,0,1008,0,0.99,0.0,0
PF10816,PF00932:PF06748:PF14372:PF13949:PF00662,0,42,0,0,42,976,0.0,0.96,0,0,4,0,0,4,1014,0.0,1.0,0,0
PF05790,PF09191:PF12104:PF11465:PF07204:PF12355,2,6,1,1,5,1011,0.17,0.99,0.5,0.29,1,1,1,0,1016,1.0,1.0,0.5,0.71
PF01400,PF05821:PF08768:PF00431:PF01549:PF05507,46,94,33,13,61,911,0.35,0.93,0.72,0.47,6,4,42,2,970,0.67,0.96,0.09,0.23
PF01215,PF10183:PF04667:PF08561:PF04716:PF12734,10,29,3,7,26,982,0.1,0.97,0.3,0.16,2,1,9,1,1007,0.5,0.99,0.1,0.22
PF05458,PF15872:PF15069:PF15741:PF15133:PF03842,5,2,0,5,2,1011,0.0,0.99,0.0,-0.0,0,0,5,0,1013,0,1.0,0.0,0
PF07941,PF11404:PF16799:PF08763:PF16885:PF03521,3,12,2,1,10,1005,0.17,0.99,0.67,0.33,1,1,2,0,1015,1.0,1.0,0.33,0.58
PF02597,PF02391:PF06249:PF02502:PF13577:PF07096,13,28,6,7,22,983,0.21,0.97,0.46,0.3,0,0,13,0,1005,0,0.99,0.0,0
PF13874,PF05064:PF13634:PF12314:PF16026:PF10177,15,25,7,8,18,985,0.28,0.97,0.47,0.35,1,1,14,0,1003,1.0,0.99,0.07,0.26
PF14024,PF17017:PF03739:PF11402:PF06403:PF03553,0,7,0,0,7,1011,0.0,0.99,0,0,0,0,0,0,1018,0,1.0,0,0
PF07729,PF00392:PF03958:PF01228:PF02901:PF07702,14,25,13,1,12,992,0.52,0.99,0.93,0.69,3,2,12,1,1003,0.67,0.99,0.14,0.3
PF13101,PF17164:PF04610:PF03994:PF13505:PF04632,0,4,0,0,4,1014,0.0,1.0,0,0,0,0,0,0,1018,0,1.0,0,0
PF16159,PF09354:PF08430:PF16675:PF16676:PF00250,4,45,4,0,41,973,0.09,0.96,1.0,0.29,5,2,2,3,1011,0.4,1.0,0.5,0.44
PF09430,PF08315:PF04418:PF10280:PF01279:PF02044,7,27,2,5,25,986,0.07,0.97,0.29,0.13,0,0,7,0,1011,0,0.99,0.0,0
PF07976,PF06314:PF12831:PF01494:PF00890:PF08491,18,111,18,0,93,907,0.16,0.91,1.0,0.38,11,6,12,5,995,0.55,0.98,0.33,0.42
PF16958,PF11931:PF12108:PF01745:PF09290:PF02614,0,14,0,0,14,1004,0.0,0.99,0,0,0,0,0,0,1018,0,1.0,0,0
PF07856,PF12824:PF06026:PF01470:PF01592:PF01084,7,36,6,1,30,981,0.17,0.97,0.86,0.37,1,1,6,0,1011,1.0,0.99,0.14,0.38
PF00359,PF07565:PF00955:PF00874:PF07733:PF01695,2,39,1,1,38,978,0.03,0.96,0.5,0.11,2,0,2,2,1014,0.0,1.0,0.0,-0.0
PF14664,PF14663:PF14666:PF14668:PF15961:PF06165,11,15,11,0,4,1003,0.73,1.0,1.0,0.85,10,10,1,0,1007,1.0,1.0,0.91,0.95
PF07992,PF01180:PF00355:PF01645:PF08417:PF14721,89,60,38,51,22,907,0.63,0.93,0.43,0.48,3,3,86,0,929,1.0,0.92,0.03,0.18
PF04422,PF15805:PF15803:PF04432:PF04111:PF14047,0,12,0,0,12,1006,0.0,0.99,0,0,0,0,0,0,1018,0,1.0,0,0
PF03051,PF07096:PF05351:PF08661:PF12596:PF10510,10,32,7,3,25,983,0.22,0.97,0.7,0.38,1,1,9,0,1008,1.0,0.99,0.1,0.31
PF02083,PF13096:PF05837:PF06211:PF12709:PF12001,3,7,0,3,7,1008,0.0,0.99,0.0,-0.0,0,0,3,0,1015,0,1.0,0.0,0
PF11658,PF05001:PF11523:PF05316:PF15451:PF13243,0,25,0,0,25,993,0.0,0.98,0,0,2,0,0,2,1016,0.0,1.0,0,0
PF10631,PF04363:PF02561:PF15153:PF05309:PF11542,0,3,0,0,3,1015,0.0,1.0,0,0,0,0,0,0,1018,0,1.0,0,0
PF13404,PF03406:PF13007:PF01136:PF15750:PF01706,6,3,0,6,3,1009,0.0,0.99,0.0,-0.0,0,0,6,0,1012,0,0.99,0.0,0
PF02480,PF06305:PF07010:PF02124:PF05838:PF17049,4,4,3,1,1,1013,0.75,1.0,0.75,0.75,0,0,4,0,1014,0,1.0,0.0,0
PF06507,PF02362:PF02309:PF07496:PF00847:PF14733,11,56,9,2,47,960,0.16,0.95,0.82,0.35,8,4,7,4,1003,0.5,0.99,0.36,0.42
PF07462,PF12946:PF01723:PF14956:PF15377:PF02175,0,5,0,0,5,1013,0.0,1.0,0,0,0,0,0,0,1018,0,1.0,0,0
PF10638,PF17084:PF11369:PF02501:PF04984:PF01364,0,4,0,0,4,1014,0.0,1.0,0,0,0,0,0,0,1018,0,1.0,0,0
PF01251,PF16739:PF16203:PF13625:PF00636:PF11648,21,35,11,10,24,973,0.31,0.97,0.52,0.39,8,7,14,1,996,0.88,0.99,0.33,0.53
PF08311,PF12202:PF14593:PF12063:PF16797:PF11629,8,18,3,5,15,995,0.17,0.98,0.38,0.24,4,3,5,1,1009,0.75,0.99,0.38,0.53
PF05316,PF09950:PF04453:PF06832:PF02399:PF10035,1,5,0,1,5,1012,0.0,0.99,0.0,-0.0,0,0,1,0,1017,0,1.0,0.0,0
PF13842,PF13843:PF01710:PF12760:PF03539:PF00508,2,49,2,0,47,969,0.04,0.95,1.0,0.2,0,0,2,0,1016,0,1.0,0.0,0
PF04956,PF06744:PF04391:PF04466:PF10566:PF11863,3,0,0,3,0,1015,0,1.0,0.0,0,0,0,3,0,1015,0,1.0,0.0,0
PF11476,PF15751:PF07149:PF15830:PF07523:PF00915,0,2,0,0,2,1016,0.0,1.0,0,0,0,0,0,0,1018,0,1.0,0,0
PF14706,PF16968:PF05513:PF02557:PF06798:PF13677,2,3,1,1,2,1014,0.33,1.0,0.5,0.41,0,0,2,0,1016,0,1.0,0.0,0
PF00649,PF15678:PF14611:PF09429:PF02040:PF11331,8,24,3,5,21,989,0.12,0.97,0.38,0.21,0,0,8,0,1010,0,0.99,0.0,0
PF00140,PF08281:PF04545:PF04539:PF03979:PF04546,7,25,6,1,19,992,0.24,0.98,0.86,0.45,5,5,2,0,1011,1.0,1.0,0.71,0.84
PF04452,PF09991:PF06954:PF15289:PF11909:PF05428,2,3,0,2,3,1013,0.0,1.0,0.0,-0.0,0,0,2,0,1016,0,1.0,0.0,0
PF00120,PF03951:PF04909:PF00891:PF00903:PF02800,21,93,18,3,75,922,0.19,0.92,0.86,0.39,13,7,14,6,991,0.54,0.98,0.33,0.41
PF00184,PF02740:PF09050:PF09051:PF09049:PF00323,2,1,0,2,1,1015,0.0,1.0,0.0,-0.0,0,0,2,0,1016,0,1.0,0.0,0
PF11539,PF01312:PF00796:PF06573:PF06681:PF04445,0,4,0,0,4,1014,0.0,1.0,0,0,0,0,0,0,1018,0,1.0,0,0
PF11732,PF16134:PF11262:PF03993:PF00073:PF11958,6,25,6,0,19,993,0.24,0.98,1.0,0.49,0,0,6,0,1012,0,0.99,0.0,0
PF05598,PF04865:PF03428:PF06890:PF11751:PF08479,3,0,0,3,0,1015,0,1.0,0.0,0,0,0,3,0,1015,0,1.0,0.0,0
PF10390,PF07303:PF08417:PF09463:PF05508:PF04305,13,20,9,4,11,994,0.45,0.99,0.69,0.55,3,3,10,0,1005,1.0,0.99,0.23,0.48
PF05270,PF09206:PF08742:PF09175:PF13330:PF09172,7,44,6,1,38,973,0.14,0.96,0.86,0.33,2,1,6,1,1010,0.5,0.99,0.14,0.26
PF04340,PF15130:PF01254:PF15685:PF01311:PF15234,1,2,0,1,2,1015,0.0,1.0,0.0,-0.0,0,0,1,0,1017,0,1.0,0.0,0
PF05361,PF15359:PF05039:PF15370:PF04901:PF05281,4,8,1,3,7,1007,0.12,0.99,0.25,0.17,0,0,4,0,1014,0,1.0,0.0,0
PF07156,PF08911:PF00638:PF00343:PF04819:PF10255,14,51,8,6,43,961,0.16,0.95,0.57,0.28,4,3,11,1,1003,0.75,0.99,0.21,0.4
PF06861,PF06821:PF15577:PF08183:PF15763:PF15082,1,7,0,1,7,1010,0.0,0.99,0.0,-0.0,0,0,1,0,1017,0,1.0,0.0,0
PF03401,PF13247:PF08404:PF01514:PF08479:PF07804,1,1,0,1,1,1016,0.0,1.0,0.0,-0.0,0,0,1,0,1017,0,1.0,0.0,0
PF07632,PF00305:PF01477:PF02010:PF08016:PF02797,1,67,0,1,67,950,0.0,0.93,0.0,-0.01,14,0,1,14,1003,0.0,0.99,0.0,-0.0
PF09794,PF02732:PF07810:PF12877:PF01594:PF00012,9,82,5,4,77,932,0.06,0.92,0.56,0.16,10,4,5,6,1003,0.4,0.99,0.44,0.42
PF01443,PF00978:PF14307:PF12381:PF01660:PF08762,7,8,6,1,2,1009,0.75,1.0,0.86,0.8,2,2,5,0,1011,1.0,1.0,0.29,0.53
PF01699,PF03733:PF16494:PF01553:PF13833:PF13499,41,165,29,12,136,841,0.18,0.85,0.71,0.3,22,13,28,9,968,0.59,0.96,0.32,0.42
PF10448,PF15716:PF15763:PF11402:PF08026:PF12412,0,0,0,0,0,1018,0,1.0,0,0,0,0,0,0,1018,0,1.0,0,0
PF01739,PF00770:PF02087:PF15091:PF06876:PF14534,4,3,0,4,3,1011,0.0,0.99,0.0,-0.0,0,0,4,0,1014,0,1.0,0.0,0
PF02078,PF10581:PF02750:PF14161:PF02805:PF15783,4,8,1,3,7,1007,0.12,0.99,0.25,0.17,0,0,4,0,1014,0,1.0,0.0,0
PF07484,PF01913:PF05939:PF05167:PF02086:PF02277,0,7,0,0,7,1011,0.0,0.99,0,0,0,0,0,0,1018,0,1.0,0,0
PF10110,PF03925:PF05913:PF03831:PF13780:PF04351,1,2,0,1,2,1015,0.0,1.0,0.0,-0.0,0,0,1,0,1017,0,1.0,0.0,0
PF06105,PF11815:PF01249:PF15816:PF00325:PF12223,10,23,6,4,17,991,0.26,0.98,0.6,0.39,2,1,9,1,1007,0.5,0.99,0.1,0.22
PF01817,PF01958:PF00742:PF03447:PF10000:PF10369,7,25,1,6,24,987,0.04,0.97,0.14,0.06,7,1,6,6,1005,0.14,0.99,0.14,0.14
PF00689,PF08282:PF12409:PF16212:PF00690:PF12515,62,95,59,3,36,920,0.62,0.96,0.95,0.75,11,10,52,1,955,0.91,0.95,0.16,0.37
PF12456,PF07092:PF08952:PF02383:PF16726:PF04802,10,42,9,1,33,975,0.21,0.97,0.9,0.43,3,2,8,1,1007,0.67,0.99,0.2,0.36
PF05494,PF16216:PF02056:PF05662:PF15272:PF08345,1,10,0,1,10,1007,0.0,0.99,0.0,-0.0,0,0,1,0,1017,0,1.0,0.0,0
PF08551,PF14279:PF08598:PF15346:PF04367:PF11016,5,8,2,3,6,1007,0.25,0.99,0.4,0.31,1,1,4,0,1013,1.0,1.0,0.2,0.45
PF04881,PF11593:PF10459:PF01882:PF15155:PF17017,1,8,0,1,8,1009,0.0,0.99,0.0,-0.0,0,0,1,0,1017,0,1.0,0.0,0
PF04687,PF04285:PF02742:PF02277:PF08479:PF05513,1,6,0,1,6,1011,0.0,0.99,0.0,-0.0,0,0,1,0,1017,0,1.0,0.0,0
PF13639,PF12678:PF17123:PF00097:PF13445:PF13436,122,109,53,69,56,840,0.49,0.88,0.43,0.39,13,13,109,0,896,1.0,0.89,0.11,0.31
PF02087,PF09252:PF05355:PF15119:PF14986:PF00770,2,4,0,2,4,1012,0.0,0.99,0.0,-0.0,0,0,2,0,1016,0,1.0,0.0,0
PF11713,PF14113:PF04196:PF03534:PF06890:PF10279,1,1,0,1,1,1016,0.0,1.0,0.0,-0.0,0,0,1,0,1017,0,1.0,0.0,0
PF05134,PF03934:PF02501:PF11612:PF08461:PF04612,1,2,1,0,1,1016,0.5,1.0,1.0,0.71,2,1,0,1,1016,0.5,1.0,1.0,0.71
PF15875,PF03033:PF10964:PF12394:PF11416:PF10509,0,35,0,0,35,983,0.0,0.97,0,0,0,0,0,0,1018,0,1.0,0,0
PF04190,PF01294:PF13741:PF09777:PF05676:PF03073,10,13,1,9,12,996,0.08,0.98,0.1,0.08,1,0,10,1,1007,0.0,0.99,0.0,-0.0
PF11075,PF07305:PF11546:PF16338:PF00088:PF10087,0,16,0,0,16,1002,0.0,0.98,0,0,0,0,0,0,1018,0,1.0,0,0
PF02313,PF07755:PF10418:PF05541:PF10297:PF05613,0,6,0,0,6,1012,0.0,0.99,0,0,0,0,0,0,1018,0,1.0,0,0
PF02686,PF10181:PF15370:PF09597:PF09769:PF10853,7,13,1,6,12,999,0.08,0.98,0.14,0.1,0,0,7,0,1011,0,0.99,0.0,0
PF03165,PF00859:PF10524:PF03166:PF16070:PF02198,10,36,10,0,26,982,0.28,0.97,1.0,0.52,2,2,8,0,1008,1.0,0.99,0.2,0.45
PF05424,PF03011:PF15445:PF12377:PF15447:PF12361,1,1,1,0,0,1017,1.0,1.0,1.0,1.0,1,1,0,0,1017,1.0,1.0,1.0,1.0
PF10793,PF15623:PF16590:PF13588:PF06639:PF07520,0,3,0,0,3,1015,0.0,1.0,0,0,0,0,0,0,1018,0,1.0,0,0
PF01851,PF12859:PF06662:PF11882:PF01858:PF07555,13,16,3,10,13,992,0.19,0.98,0.23,0.2,0,0,13,0,1005,0,0.99,0.0,0
PF02192,PF00792:PF02260:PF08771:PF00613:PF00794,10,53,10,0,43,965,0.19,0.96,1.0,0.43,21,10,0,11,997,0.48,0.99,1.0,0.69
PF13603,PF10458:PF09635:PF06827:PF08264:PF04390,13,47,10,3,37,968,0.21,0.96,0.77,0.39,3,3,10,0,1005,1.0,0.99,0.23,0.48
PF07085,PF01515:PF15398:PF03306:PF17085:PF00345,6,17,5,1,12,1000,0.29,0.99,0.83,0.49,0,0,6,0,1012,0,0.99,0.0,0
PF11027,PF14865:PF15480:PF10974:PF06681:PF15681,2,4,0,2,4,1012,0.0,0.99,0.0,-0.0,0,0,2,0,1016,0,1.0,0.0,0
PF01386,PF14693:PF04549:PF14766:PF14768:PF14767,2,6,2,0,4,1012,0.33,1.0,1.0,0.58,0,0,2,0,1016,0,1.0,0.0,0
PF07810,PF13890:PF14959:PF15627:PF08216:PF12333,11,14,4,7,10,997,0.29,0.98,0.36,0.31,1,1,10,0,1007,1.0,0.99,0.09,0.3
PF10197,PF16944:PF00649:PF05508:PF08634:PF08630,21,15,2,19,13,984,0.13,0.97,0.1,0.1,0,0,21,0,997,0,0.98,0.0,0
PF04986,PF03050:PF15186:PF10974:PF03243:PF03406,2,4,0,2,4,1012,0.0,0.99,0.0,-0.0,0,0,2,0,1016,0,1.0,0.0,0
PF15837,PF06681:PF13094:PF15555:PF15192:PF15088,0,2,0,0,2,1016,0.0,1.0,0,0,0,0,0,0,1018,0,1.0,0,0
PF07814,PF10188:PF09808:PF09816:PF05182:PF13002,12,25,3,9,22,984,0.12,0.97,0.25,0.16,1,1,11,0,1006,1.0,0.99,0.08,0.29
PF10600,PF10608:PF09058:PF04629:PF09007:PF16667,2,9,1,1,8,1008,0.11,0.99,0.5,0.23,1,1,1,0,1016,1.0,1.0,0.5,0.71
PF01274,PF00463:PF12150:PF08925:PF04952:PF00821,9,19,5,4,14,995,0.26,0.98,0.56,0.37,0,0,9,0,1009,0,0.99,0.0,0
PF03090,PF11751:PF13722:PF03241:PF07157:PF15518,0,1,0,0,1,1017,0.0,1.0,0,0,0,0,0,0,1018,0,1.0,0,0
PF06021,PF08444:PF08445:PF02482:PF01114:PF14654,4,14,4,0,10,1004,0.29,0.99,1.0,0.53,0,0,4,0,1014,0,1.0,0.0,0
PF00763,PF01268:PF02882:PF01014:PF17135:PF06298,24,38,24,0,14,980,0.63,0.99,1.0,0.79,6,6,18,0,994,1.0,0.98,0.25,0.5
PF14764,PF09822:PF15296:PF09759:PF06662:PF01285,5,20,2,3,18,995,0.1,0.98,0.4,0.19,2,1,4,1,1012,0.5,1.0,0.2,0.31
PF08449,PF00827:PF05510:PF15388:PF03096:PF09384,29,24,12,17,12,977,0.5,0.97,0.41,0.44,2,2,27,0,989,1.0,0.97,0.07,0.26
PF02830,PF08274:PF17092:PF10139:PF09611:PF15529,0,1,0,0,1,1017,0.0,1.0,0,0,0,0,0,0,1018,0,1.0,0,0
PF09753,PF09341:PF14802:PF09814:PF01730:PF05051,10,21,3,7,18,990,0.14,0.98,0.3,0.2,2,2,8,0,1008,1.0,0.99,0.2,0.45
PF15148,PF15293:PF02305:PF08964:PF06429:PF11035,1,5,0,1,5,1012,0.0,0.99,0.0,-0.0,0,0,1,0,1017,0,1.0,0.0,0
PF16086,PF04845:PF04063:PF03219:PF03103:PF09305,0,17,0,0,17,1001,0.0,0.98,0,0,1,0,0,1,1017,0.0,1.0,0,0
PF01661,PF13716:PF12174:PF00125:PF00644:PF16211,30,88,22,8,66,922,0.25,0.93,0.73,0.4,16,12,18,4,984,0.75,0.98,0.4,0.54
PF02463,PF06470:PF01641:PF10211:PF08172:PF10269,48,34,18,30,16,954,0.53,0.95,0.38,0.42,1,1,47,0,970,1.0,0.95,0.02,0.14
PF13532,PF05050:PF08498:PF12589:PF12923:PF04098,44,41,14,30,27,947,0.34,0.94,0.32,0.3,4,4,40,0,974,1.0,0.96,0.09,0.3
PF04307,PF14985:PF15832:PF07209:PF15023:PF15047,1,3,0,1,3,1014,0.0,1.0,0.0,-0.0,0,0,1,0,1017,0,1.0,0.0,0
PF15834,PF08411:PF00419:PF06890:PF02277:PF11751,0,5,0,0,5,1013,0.0,1.0,0,0,0,0,0,0,1018,0,1.0,0,0
PF02417,PF05422:PF04425:PF10287:PF04426:PF08124,7,8,1,6,7,1004,0.12,0.99,0.14,0.13,0,0,7,0,1011,0,0.99,0.0,0
PF11885,PF03085:PF02112:PF15067:PF04189:PF09804,8,21,0,8,21,989,0.0,0.97,0.0,-0.01,0,0,8,0,1010,0,0.99,0.0,0
PF14075,PF14383:PF15778:PF08729:PF12552:PF09469,3,14,2,1,12,1003,0.14,0.99,0.67,0.3,0,0,3,0,1015,0,1.0,0.0,0
PF17208,PF12140:PF02820:PF12618:PF01530:PF09246,3,27,2,1,25,990,0.07,0.97,0.67,0.22,4,1,2,3,1012,0.25,1.0,0.33,0.29
PF12609,PF15060:PF01701:PF03842:PF01387:PF02106,1,1,0,1,1,1016,0.0,1.0,0.0,-0.0,0,0,1,0,1017,0,1.0,0.0,0
PF15559,PF02448:PF15109:PF00714:PF15173:PF02427,0,1,0,0,1,1017,0.0,1.0,0,0,0,0,0,0,1018,0,1.0,0,0
PF15499,PF15255:PF08630:PF10522:PF15923:PF15996,5,16,1,4,15,998,0.06,0.98,0.2,0.1,0,0,5,0,1013,0,1.0,0.0,0
PF10615,PF10590:PF02132:PF10785:PF05977:PF07828,5,18,3,2,15,998,0.17,0.98,0.6,0.31,0,0,5,0,1013,0,1.0,0.0,0
PF02170,PF08699:PF16486:PF02171:PF00636:PF16488,44,61,43,1,18,956,0.7,0.98,0.98,0.82,35,33,11,2,972,0.94,0.99,0.75,0.83
PF15707,PF05418:PF12724:PF08497:PF05151:PF11697,0,1,0,0,1,1017,0.0,1.0,0,0,0,0,0,0,1018,0,1.0,0,0
PF09302,PF04004:PF04090:PF09816:PF06365:PF07223,4,18,1,3,17,997,0.06,0.98,0.25,0.11,2,0,4,2,1012,0.0,0.99,0.0,-0.0
PF09007,PF04629:PF09060:PF09045:PF10608:PF06456,2,14,1,1,13,1003,0.07,0.99,0.5,0.19,1,1,1,0,1016,1.0,1.0,0.5,0.71
PF04606,PF12843:PF10279:PF15168:PF02217:PF04965,0,5,0,0,5,1013,0.0,1.0,0,0,0,0,0,0,1018,0,1.0,0,0
PF04574,PF02146:PF16815:PF08157:PF16118:PF11976,6,66,6,0,60,952,0.09,0.94,1.0,0.29,3,1,5,2,1010,0.33,0.99,0.17,0.23
PF12580,PF12583:PF01483:PF12245:PF06280:PF16470,4,26,2,2,24,990,0.08,0.97,0.5,0.19,2,1,3,1,1013,0.5,1.0,0.25,0.35
PF04982,PF02033:PF06271:PF02683:PF12926:PF02427,7,11,0,7,11,1000,0.0,0.98,0.0,-0.01,0,0,7,0,1011,0,0.99,0.0,0
PF15476,PF09327:PF01660:PF12256:PF04917:PF04196,0,6,0,0,6,1012,0.0,0.99,0,0,0,0,0,0,1018,0,1.0,0,0
PF04122,PF08310:PF10139:PF07520:PF11614:PF17092,0,6,0,0,6,1012,0.0,0.99,0,0,0,0,0,0,1018,0,1.0,0,0
PF04463,PF06403:PF13995:PF01752:PF06798:PF02277,2,6,1,1,5,1011,0.17,0.99,0.5,0.29,0,0,2,0,1016,0,1.0,0.0,0
PF16868,PF12477:PF14690:PF08334:PF02211:PF11130,2,4,0,2,4,1012,0.0,0.99,0.0,-0.0,0,0,2,0,1016,0,1.0,0.0,0
PF07452,PF00093:PF00007:PF09206:PF05735:PF01391,1,84,1,0,83,934,0.01,0.92,1.0,0.1,8,1,0,7,1010,0.12,0.99,1.0,0.35
PF02135,PF08214:PF09030:PF06001:PF09494:PF00569,21,52,19,2,33,964,0.37,0.97,0.9,0.56,13,13,8,0,997,1.0,0.99,0.62,0.78
PF00261,PF12718:PF13851:PF03285:PF14802:PF02374,7,14,2,5,12,999,0.14,0.98,0.29,0.19,0,0,7,0,1011,0,0.99,0.0,0
PF13441,PF06547:PF15419:PF13705:PF13436:PF05495,2,14,2,0,12,1004,0.14,0.99,1.0,0.38,2,2,0,0,1016,1.0,1.0,1.0,1.0
PF09912,PF11128:PF05463:PF11750:PF06073:PF01371,0,2,0,0,2,1016,0.0,1.0,0,0,0,0,0,0,1018,0,1.0,0,0
PF10532,PF00872:PF03108:PF04434:PF03101:PF01610,3,43,3,0,40,975,0.07,0.96,1.0,0.26,8,2,1,6,1009,0.25,0.99,0.67,0.41
PF07767,PF09751:PF03239:PF16969:PF05693:PF01199,12,35,7,5,28,978,0.2,0.97,0.58,0.33,3,3,9,0,1006,1.0,0.99,0.25,0.5
PF05818,PF13802:PF16863:PF17137:PF16338:PF01814,0,38,0,0,38,980,0.0,0.96,0,0,5,0,0,5,1013,0.0,1.0,0,0
PF02335,PF00079:PF13532:PF06075:PF12213:PF01554,1,82,0,1,82,935,0.0,0.92,0.0,-0.01,9,0,1,9,1008,0.0,0.99,0.0,-0.0
PF02244,PF00246:PF09759:PF00393:PF00016:PF09822,21,58,21,0,37,960,0.36,0.96,1.0,0.59,5,3,18,2,995,0.6,0.98,0.14,0.29
PF00150,PF10503:PF01341:PF02013:PF00457:PF00734,49,44,22,27,22,947,0.5,0.95,0.45,0.45,3,3,46,0,969,1.0,0.95,0.06,0.24
PF12783,PF16213:PF09324:PF16206:PF01369:PF16453,24,54,24,0,30,964,0.44,0.97,1.0,0.66,14,14,10,0,994,1.0,0.99,0.58,0.76
PF16546,PF07219:PF11998:PF04049:PF14280:PF15867,12,19,4,8,15,991,0.21,0.98,0.33,0.25,1,1,11,0,1006,1.0,0.99,0.08,0.29
PF15798,PF15089:PF02655:PF04349:PF05787:PF08795,0,2,0,0,2,1016,0.0,1.0,0,0,0,0,0,0,1018,0,1.0,0,0
PF14612,PF04148:PF12223:PF03162:PF03718:PF07582,1,9,0,1,9,1008,0.0,0.99,0.0,-0.0,0,0,1,0,1017,0,1.0,0.0,0
PF02538,PF05378:PF01968:PF06032:PF00745:PF05201,26,35,26,0,9,983,0.74,0.99,1.0,0.86,9,7,19,2,990,0.78,0.98,0.27,0.45
PF13844,PF13414:PF14260:PF16197:PF04049:PF14280,13,79,12,1,67,938,0.15,0.93,0.92,0.36,6,2,11,4,1001,0.33,0.99,0.15,0.22
PF09220,PF07409:PF14690:PF04865:PF15708:PF07833,0,6,0,0,6,1012,0.0,0.99,0,0,0,0,0,0,1018,0,1.0,0,0
PF16335,PF17168:PF08760:PF16334:PF09363:PF09364,4,7,4,0,3,1011,0.57,1.0,1.0,0.75,1,1,3,0,1014,1.0,1.0,0.25,0.5
PF08005,PF08239:PF09494:PF03256:PF14647:PF14648,4,28,4,0,24,990,0.14,0.98,1.0,0.37,4,2,2,2,1012,0.5,1.0,0.5,0.5
PF08518,PF16559:PF12205:PF03259:PF01412:PF16553,8,50,5,3,45,965,0.1,0.95,0.62,0.24,3,3,5,0,1010,1.0,1.0,0.38,0.61
PF10036,PF15374:PF14713:PF02106:PF07956:PF15398,7,10,2,5,8,1003,0.2,0.99,0.29,0.23,0,0,7,0,1011,0,0.99,0.0,0
PF10508,PF16689:PF05956:PF03130:PF05924:PF00514,10,65,7,3,58,950,0.11,0.94,0.7,0.26,3,1,9,2,1006,0.33,0.99,0.1,0.18
PF07492,PF01204:PF02268:PF02751:PF02363:PF15690,9,36,9,0,27,982,0.25,0.97,1.0,0.49,5,3,6,2,1007,0.6,0.99,0.33,0.44
PF07773,PF07162:PF04991:PF14868:PF10156:PF12018,10,28,4,6,24,984,0.14,0.97,0.4,0.23,1,1,9,0,1008,1.0,0.99,0.1,0.31
PF00827,PF08449:PF05180:PF05019:PF03096:PF05282,14,41,7,7,34,970,0.17,0.96,0.5,0.28,5,4,10,1,1003,0.8,0.99,0.29,0.47
PF12258,PF16892:PF16893:PF09309:PF11626:PF16770,0,19,0,0,19,999,0.0,0.98,0,0,0,0,0,0,1018,0,1.0,0,0
PF16658,PF09173:PF09107:PF14492:PF08364:PF16004,1,42,1,0,41,976,0.02,0.96,1.0,0.15,5,1,0,4,1013,0.2,1.0,1.0,0.45
PF04572,PF04488:PF09296:PF15916:PF09297:PF12326,2,36,2,0,34,982,0.06,0.97,1.0,0.23,4,1,1,3,1013,0.25,1.0,0.5,0.35
PF16533,PF14847:PF09246:PF12485:PF07710:PF14360,2,17,1,1,16,1000,0.06,0.98,0.5,0.17,1,1,1,0,1016,1.0,1.0,0.5,0.71
PF11172,PF08026:PF15188:PF00796:PF15838:PF09252,0,0,0,0,0,1018,0,1.0,0,0,0,0,0,0,1018,0,1.0,0,0
PF01054,PF08142:PF08169:PF15628:PF08170:PF01502,0,35,0,0,35,983,0.0,0.97,0,0,1,0,0,1,1017,0.0,1.0,0,0
PF04862,PF14365:PF04127:PF02773:PF00438:PF02772,7,14,3,4,11,1000,0.21,0.99,0.43,0.3,4,1,6,3,1008,0.25,0.99,0.14,0.18
PF12812,PF13180:PF06241:PF12844:PF04842:PF06662,1,37,1,0,36,981,0.03,0.96,1.0,0.16,1,0,1,1,1016,0.0,1.0,0.0,-0.0
PF02338,PF01754:PF01428:PF08123:PF14722:PF08325,42,44,14,28,30,946,0.32,0.94,0.33,0.3,4,4,38,0,976,1.0,0.96,0.1,0.3
PF12204,PF17062:PF17056:PF12724:PF15050:PF10664,2,3,0,2,3,1013,0.0,1.0,0.0,-0.0,0,0,2,0,1016,0,1.0,0.0,0
PF07593,PF10393:PF09064:PF10912:PF16754:PF03415,1,4,1,0,3,1014,0.25,1.0,1.0,0.5,1,1,0,0,1017,1.0,1.0,1.0,1.0
PF11218,PF02554:PF03831:PF17164:PF04351:PF15529,1,0,0,1,0,1017,0,1.0,0.0,0,0,0,1,0,1017,0,1.0,0.0,0
PF09040,PF12515:PF12409:PF02130:PF08282:PF02348,5,40,4,1,36,977,0.1,0.96,0.8,0.28,5,3,2,2,1011,0.6,1.0,0.6,0.6
PF13537,PF00733:PF06075:PF00215:PF02922:PF07159,11,52,10,1,42,965,0.19,0.96,0.91,0.41,3,2,9,1,1006,0.67,0.99,0.18,0.34
PF08326,PF00289:PF02785:PF02436:PF08502:PF01039,12,55,12,0,43,963,0.22,0.96,1.0,0.46,18,12,0,6,1000,0.67,0.99,1.0,0.81
PF00873,PF13953:PF13954:PF00345:PF15060:PF00816,7,6,3,4,3,1008,0.5,0.99,0.43,0.46,3,2,5,1,1010,0.67,0.99,0.29,0.43
PF02768,PF02767:PF00712:PF08918:PF08805:PF08461,7,10,7,0,3,1008,0.7,1.0,1.0,0.84,1,1,6,0,1011,1.0,0.99,0.14,0.38
PF08016,PF02010:PF01477:PF00151:PF00305:PF00059,28,105,18,10,87,903,0.17,0.9,0.64,0.3,19,8,20,11,979,0.42,0.97,0.29,0.33
PF13352,PF14922:PF04880:PF15007:PF10226:PF12948,2,7,0,2,7,1009,0.0,0.99,0.0,-0.0,1,0,2,1,1015,0.0,1.0,0.0,-0.0
PF12566,PF04052:PF11379:PF11870:PF11880:PF13809,2,4,0,2,4,1012,0.0,0.99,0.0,-0.0,0,0,2,0,1016,0,1.0,0.0,0
PF15314,PF15863:PF14877:PF08945:PF11210:PF15125,0,7,0,0,7,1011,0.0,0.99,0,0,0,0,0,0,1018,0,1.0,0,0
PF03389,PF04740:PF02217:PF04965:PF05939:PF04234,0,4,0,0,4,1014,0.0,1.0,0,0,0,0,0,0,1018,0,1.0,0,0
PF09270,PF09271:PF16422:PF16423:PF03859:PF03120,13,22,13,0,9,996,0.59,0.99,1.0,0.77,3,2,11,1,1004,0.67,0.99,0.15,0.32
PF12733,PF06662:PF02408:PF15995:PF04704:PF13251,1,9,1,0,8,1009,0.11,0.99,1.0,0.33,0,0,1,0,1017,0,1.0,0.0,0
PF08148,PF15790:PF16739:PF02559:PF09369:PF16204,9,18,4,5,14,995,0.22,0.98,0.44,0.31,3,2,7,1,1008,0.67,0.99,0.22,0.38
PF03043,PF17188:PF01752:PF01514:PF07505:PF11130,0,2,0,0,2,1016,0.0,1.0,0,0,0,0,0,0,1018,0,1.0,0,0
PF00443,PF06337:PF14836:PF14533:PF02148:PF00850,115,80,53,62,27,876,0.66,0.91,0.46,0.51,11,11,104,0,903,1.0,0.9,0.1,0.29
PF10296,PF10186:PF05640:PF05997:PF02208:PF16944,10,20,3,7,17,991,0.15,0.98,0.3,0.2,2,1,9,1,1007,0.5,0.99,0.1,0.22
PF13371,PF08755:PF08495:PF09346:PF07219:PF09698,1,15,1,0,14,1003,0.07,0.99,1.0,0.26,1,1,0,0,1017,1.0,1.0,1.0,1.0
PF15547,PF11402:PF15207:PF15085:PF15680:PF14866,0,3,0,0,3,1015,0.0,1.0,0,0,0,0,0,0,1018,0,1.0,0,0
PF03378,PF08767:PF08506:PF08389:PF03810:PF11865,12,69,12,0,57,949,0.17,0.94,1.0,0.41,16,7,5,9,997,0.44,0.99,0.58,0.5
PF02141,PF03456:PF12335:PF03455:PF02893:PF10240,36,62,32,4,30,952,0.52,0.97,0.89,0.66,10,10,26,0,982,1.0,0.97,0.28,0.52
PF05185,PF11531:PF00111:PF03473:PF00941:PF04088,22,51,13,9,38,958,0.25,0.95,0.59,0.37,6,4,18,2,994,0.67,0.98,0.18,0.34
PF04879,PF01568:PF09326:PF00384:PF10588:PF14710,4,26,4,0,22,992,0.15,0.98,1.0,0.39,15,2,2,13,1001,0.13,0.99,0.5,0.25
PF16997,PF08497:PF03525:PF17206:PF03406:PF03743,0,7,0,0,7,1011,0.0,0.99,0,0,0,0,0,0,1018,0,1.0,0,0
PF08270,PF13610:PF08751:PF09365:PF09904:PF15155,0,11,0,0,11,1007,0.0,0.99,0,0,0,0,0,0,1018,0,1.0,0,0
PF15845,PF15483:PF14328:PF11211:PF15355:PF03613,0,1,0,0,1,1017,0.0,1.0,0,0,0,0,0,0,1018,0,1.0,0,0
PF00985,PF12782:PF00229:PF02401:PF14735:PF00340,0,18,0,0,18,1000,0.0,0.98,0,0,0,0,0,0,1018,0,1.0,0,0
PF08132,PF01536:PF03858:PF11693:PF00799:PF06449,2,16,1,1,15,1001,0.06,0.98,0.5,0.17,0,0,2,0,1016,0,1.0,0.0,0
PF15324,PF07260:PF15274:PF15806:PF15803:PF05483,3,7,0,3,7,1008,0.0,0.99,0.0,-0.0,0,0,3,0,1015,0,1.0,0.0,0
PF15786,PF13933:PF15831:PF02202:PF06907:PF08228,1,5,0,1,5,1012,0.0,0.99,0.0,-0.0,0,0,1,0,1017,0,1.0,0.0,0
PF10129,PF10423:PF16259:PF09698:PF15716:PF13313,0,1,0,0,1,1017,0.0,1.0,0,0,0,0,0,0,1018,0,1.0,0,0
PF01805,PF04818:PF09750:PF12230:PF16566:PF08312,32,55,25,7,30,956,0.45,0.96,0.78,0.58,9,7,25,2,984,0.78,0.97,0.22,0.4
PF16171,PF05604:PF15669:PF15553:PF15045:PF10104,0,8,0,0,8,1010,0.0,0.99,0,0,0,0,0,0,1018,0,1.0,0,0
PF08910,PF03479:PF15242:PF15397:PF12298:PF02186,0,25,0,0,25,993,0.0,0.98,0,0,1,0,0,1,1017,0.0,1.0,0,0
PF11104,PF01292:PF07075:PF06355:PF10863:PF03238,0,10,0,0,10,1008,0.0,0.99,0,0,0,0,0,0,1018,0,1.0,0,0
PF04940,PF08376:PF07700:PF16214:PF06327:PF07701,4,25,1,3,24,990,0.04,0.97,0.25,0.09,4,1,3,3,1011,0.25,0.99,0.25,0.25
PF05466,PF15128:PF07804:PF13995:PF01752:PF07157,0,3,0,0,3,1015,0.0,1.0,0,0,0,0,0,0,1018,0,1.0,0,0
PF06253,PF09261:PF01074:PF07748:PF13243:PF09260,1,40,0,1,40,977,0.0,0.96,0.0,-0.01,20,0,1,20,997,0.0,0.98,0.0,-0.0
PF12693,PF00813:PF01313:PF14842:PF08361:PF07499,2,3,1,1,2,1014,0.33,1.0,0.5,0.41,0,0,2,0,1016,0,1.0,0.0,0
PF04820,PF05390:PF08221:PF08631:PF11919:PF11915,9,36,4,5,32,977,0.11,0.96,0.44,0.21,3,1,8,2,1007,0.33,0.99,0.11,0.19
PF06032,PF05378:PF02538:PF01968:PF00745:PF05201,8,35,8,0,27,983,0.23,0.97,1.0,0.47,26,6,2,20,990,0.23,0.98,0.75,0.41
PF15766,PF15052:PF12488:PF03588:PF15832:PF17078,0,6,0,0,6,1012,0.0,0.99,0,0,0,0,0,0,1018,0,1.0,0,0
PF12170,PF03525:PF04965:PF08795:PF09109:PF10279,1,0,0,1,0,1017,0,1.0,0.0,0,0,0,1,0,1017,0,1.0,0.0,0
PF02508,PF03831:PF10554:PF03865:PF07409:PF04738,2,0,0,2,0,1016,0,1.0,0.0,0,0,0,2,0,1016,0,1.0,0.0,0
PF04083,PF08386:PF06441:PF09822:PF01285:PF06423,28,41,6,22,35,955,0.15,0.94,0.21,0.15,4,2,26,2,988,0.5,0.97,0.07,0.18
PF15234,PF15851:PF15079:PF01254:PF03058:PF15096,0,1,0,0,1,1017,0.0,1.0,0,0,0,0,0,0,1018,0,1.0,0,0
PF12519,PF16871:PF11958:PF06838:PF09770:PF17085,5,9,0,5,9,1004,0.0,0.99,0.0,-0.01,0,0,5,0,1013,0,1.0,0.0,0
PF17102,PF17101:PF11380:PF17103:PF00066:PF05572,8,26,8,0,18,992,0.31,0.98,1.0,0.55,4,4,4,0,1010,1.0,1.0,0.5,0.71
PF02160,PF05869:PF10917:PF03539:PF15435:PF13326,1,6,1,0,5,1012,0.17,1.0,1.0,0.41,0,0,1,0,1017,0,1.0,0.0,0
PF10418,PF02898:PF00970:PF01855:PF17147:PF00175,1,68,1,0,67,950,0.01,0.93,1.0,0.12,13,1,0,12,1005,0.08,0.99,1.0,0.28
PF06614,PF10580:PF13178:PF15157:PF16735:PF00612,1,64,1,0,63,954,0.02,0.94,1.0,0.12,2,1,0,1,1016,0.5,1.0,1.0,0.71
PF16053,PF01097:PF00159:PF06446:PF05039:PF06232,9,9,1,8,8,1001,0.11,0.98,0.11,0.1,0,0,9,0,1009,0,0.99,0.0,0
PF05261,PF12827:PF03065:PF08026:PF09252:PF11493,1,1,0,1,1,1016,0.0,1.0,0.0,-0.0,0,0,1,0,1017,0,1.0,0.0,0
PF02502,PF05899:PF06249:PF07883:PF02311:PF04229,7,42,4,3,38,973,0.1,0.96,0.57,0.22,1,1,6,0,1011,1.0,0.99,0.14,0.38
PF03699,PF08681:PF05874:PF06681:PF15443:PF15553,0,3,0,0,3,1015,0.0,1.0,0,0,0,0,0,0,1018,0,1.0,0,0
PF13601,PF04014:PF01021:PF11124:PF02456:PF02669,0,3,0,0,3,1015,0.0,1.0,0,0,0,0,0,0,1018,0,1.0,0,0
PF00321,PF06232:PF05479:PF06376:PF06697:PF01716,0,9,0,0,9,1009,0.0,0.99,0,0,0,0,0,0,1018,0,1.0,0,0
PF03869,PF04363:PF15167:PF15842:PF02086:PF15419,3,3,2,1,1,1014,0.67,1.0,0.67,0.67,2,2,1,0,1015,1.0,1.0,0.67,0.82
PF11734,PF09179:PF06041:PF05280:PF16822:PF07261,3,14,3,0,11,1004,0.21,0.99,1.0,0.46,0,0,3,0,1015,0,1.0,0.0,0
PF01193,PF01066:PF03118:PF13344:PF02709:PF00891,16,80,13,3,67,935,0.16,0.93,0.81,0.34,12,7,9,5,997,0.58,0.99,0.44,0.5
PF12867,PF10017:PF03781:PF03102:PF04775:PF00463,6,26,5,1,21,991,0.19,0.98,0.83,0.39,2,1,5,1,1011,0.5,0.99,0.17,0.29
PF13733,PF02709:PF06309:PF07258:PF02866:PF13506,19,59,19,0,40,959,0.32,0.96,1.0,0.56,4,3,16,1,998,0.75,0.98,0.16,0.34
PF08801,PF03177:PF15979:PF08631:PF11915:PF05183,17,52,14,3,38,963,0.27,0.96,0.82,0.46,7,7,10,0,1001,1.0,0.99,0.41,0.64
PF05247,PF15859:PF04023:PF05701:PF09106:PF17011,0,11,0,0,11,1007,0.0,0.99,0,0,0,0,0,0,1018,0,1.0,0,0
PF10522,PF05716:PF15499:PF14644:PF11265:PF15274,5,16,2,3,14,999,0.12,0.98,0.4,0.22,0,0,5,0,1013,0,1.0,0.0,0
PF04821,PF09743:PF15917:PF06972:PF04118:PF08638,5,22,3,2,19,994,0.14,0.98,0.6,0.28,0,0,5,0,1013,0,1.0,0.0,0
PF00725,PF02737:PF00378:PF14779:PF16113:PF02803,27,94,27,0,67,924,0.29,0.93,1.0,0.52,19,17,10,2,989,0.89,0.99,0.63,0.75
PF13876,PF07505:PF04963:PF07523:PF15150:PF10554,1,1,0,1,1,1016,0.0,1.0,0.0,-0.0,0,0,1,0,1017,0,1.0,0.0,0
PF12763,PF12761:PF16880:PF16652:PF16056:PF11618,35,26,17,18,9,974,0.65,0.97,0.49,0.55,2,2,33,0,983,1.0,0.97,0.06,0.24
PF05712,PF01853:PF08169:PF08474:PF01530:PF11717,22,46,12,10,34,962,0.26,0.96,0.55,0.36,9,5,17,4,992,0.56,0.98,0.23,0.35
PF14695,PF04412:PF03709:PF03413:PF16655:PF07024,2,9,0,2,9,1007,0.0,0.99,0.0,-0.0,0,0,2,0,1016,0,1.0,0.0,0
PF05144,PF16888:PF15029:PF17206:PF05913:PF05509,0,2,0,0,2,1016,0.0,1.0,0,0,0,0,0,0,1018,0,1.0,0,0
PF02096,PF01245:PF12298:PF11250:PF11911:PF05678,23,21,4,19,17,978,0.19,0.96,0.17,0.16,2,2,21,0,995,1.0,0.98,0.09,0.29
PF03554,PF01303:PF09252:PF15848:PF13013:PF03749,0,3,0,0,3,1015,0.0,1.0,0,0,0,0,0,0,1018,0,1.0,0,0
PF13588,PF06798:PF03090:PF07157:PF11751:PF03963,2,1,0,2,1,1015,0.0,1.0,0.0,-0.0,0,0,2,0,1016,0,1.0,0.0,0
PF00267,PF08093:PF15482:PF17006:PF07022:PF09365,1,4,0,1,4,1013,0.0,1.0,0.0,-0.0,0,0,1,0,1017,0,1.0,0.0,0
PF15085,PF14866:PF09252:PF03379:PF15680:PF15107,2,1,0,2,1,1015,0.0,1.0,0.0,-0.0,0,0,2,0,1016,0,1.0,0.0,0
PF08438,PF09269:PF05128:PF15086:PF01018:PF06780,5,12,4,1,8,1005,0.33,0.99,0.8,0.51,1,1,4,0,1013,1.0,1.0,0.2,0.45
PF01300,PF01184:PF12867:PF02487:PF10017:PF03781,17,41,11,6,30,971,0.27,0.96,0.65,0.4,3,2,15,1,1000,0.67,0.98,0.12,0.28
PF08111,PF16041:PF11852:PF10084:PF14438:PF06176,1,18,0,1,18,999,0.0,0.98,0.0,-0.0,0,0,1,0,1017,0,1.0,0.0,0
PF16979,PF05422:PF16978:PF12448:PF15705:PF10355,12,22,12,0,10,996,0.55,0.99,1.0,0.73,1,1,11,0,1006,1.0,0.99,0.08,0.29
PF05017,PF02057:PF15467:PF10578:PF08027:PF12904,0,2,0,0,2,1016,0.0,1.0,0,0,0,0,0,0,1018,0,1.0,0,0
PF12141,PF09775:PF08600:PF14831:PF09804:PF10311,1,12,0,1,12,1005,0.0,0.99,0.0,-0.0,1,0,1,1,1016,0.0,1.0,0.0,-0.0
PF02452,PF16997:PF08345:PF03428:PF08274:PF12241,2,2,0,2,2,1014,0.0,1.0,0.0,-0.0,0,0,2,0,1016,0,1.0,0.0,0
PF13198,PF01283:PF07046:PF01491:PF06888:PF06172,0,22,0,0,22,996,0.0,0.98,0,0,2,0,0,2,1016,0.0,1.0,0,0
PF15001,PF15312:PF10951:PF05448:PF04445:PF05939,1,4,0,1,4,1013,0.0,1.0,0.0,-0.0,0,0,1,0,1017,0,1.0,0.0,0
PF00057,PF16472:PF07593:PF07679:PF00058:PF02233,74,104,48,26,56,888,0.46,0.92,0.65,0.51,6,6,68,0,944,1.0,0.93,0.08,0.28
PF04260,PF07399:PF10694:PF07706:PF07883:PF05724,3,38,1,2,37,978,0.03,0.96,0.33,0.08,1,0,3,1,1014,0.0,1.0,0.0,-0.0
PF02368,PF17034:PF10441:PF07539:PF15027:PF10350,4,27,3,1,24,990,0.11,0.98,0.75,0.28,2,1,3,1,1013,0.5,1.0,0.25,0.35
PF08691,PF06681:PF08708:PF06745:PF15485:PF04174,0,0,0,0,0,1018,0,1.0,0,0,0,0,0,0,1018,0,1.0,0,0
PF10743,PF12790:PF02742:PF14290:PF06162:PF15667,0,3,0,0,3,1015,0.0,1.0,0,0,0,0,0,0,1018,0,1.0,0,0
PF01417,PF14661:PF09429:PF08733:PF13836:PF16797,26,14,4,22,10,982,0.29,0.97,0.15,0.19,0,0,26,0,992,0,0.97,0.0,0
PF01458,PF06830:PF12579:PF07786:PF10672:PF04646,2,15,1,1,14,1002,0.07,0.99,0.5,0.18,0,0,2,0,1016,0,1.0,0.0,0
PF13643,PF15861:PF12220:PF16842:PF15519:PF10378,1,18,1,0,17,1000,0.06,0.98,1.0,0.23,1,1,0,0,1017,1.0,1.0,1.0,1.0
PF09951,PF08453:PF03241:PF07805:PF17206:PF11775,0,4,0,0,4,1014,0.0,1.0,0,0,0,0,0,0,1018,0,1.0,0,0
PF13783,PF00827:PF08449:PF08069:PF08806:PF05180,0,48,0,0,48,970,0.0,0.95,0,0,6,0,0,6,1012,0.0,0.99,0,0
PF02265,PF06404:PF04690:PF06749:PF04720:PF06206,7,16,2,5,14,997,0.12,0.98,0.29,0.18,0,0,7,0,1011,0,0.99,0.0,0
PF01041,PF08635:PF09166:PF02311:PF11803:PF00908,11,18,4,7,14,993,0.22,0.98,0.36,0.27,1,1,10,0,1007,1.0,0.99,0.09,0.3
PF11690,PF12855:PF08653:PF15863:PF06485:PF14877,0,11,0,0,11,1007,0.0,0.99,0,0,0,0,0,0,1018,0,1.0,0,0
PF12179,PF14593:PF11629:PF12063:PF08311:PF08826,3,16,2,1,14,1001,0.12,0.99,0.67,0.28,4,2,1,2,1013,0.5,1.0,0.67,0.58
PF16652,PF12763:PF08165:PF16165:PF16562:PF12761,8,44,6,2,38,972,0.14,0.96,0.75,0.31,4,1,7,3,1007,0.25,0.99,0.12,0.17
PF13811,PF08610:PF01744:PF09396:PF02751:PF15494,0,30,0,0,30,988,0.0,0.97,0,0,2,0,0,2,1016,0.0,1.0,0,0
PF00912,PF13699:PF09867:PF06737:PF02624:PF03374,9,1,0,9,1,1008,0.0,0.99,0.0,-0.0,0,0,9,0,1009,0,0.99,0.0,0
PF11264,PF07333:PF06351:PF06232:PF11029:PF00537,1,9,0,1,9,1008,0.0,0.99,0.0,-0.0,0,0,1,0,1017,0,1.0,0.0,0
PF15025,PF15146:PF12432:PF15016:PF15620:PF12169,3,6,2,1,4,1011,0.33,1.0,0.67,0.47,0,0,3,0,1015,0,1.0,0.0,0
PF08472,PF05116:PF00534:PF14306:PF09164:PF09328,2,63,1,1,62,954,0.02,0.94,0.5,0.08,0,0,2,0,1016,0,1.0,0.0,0
PF08159,PF12490:PF11540:PF08596:PF03451:PF13890,12,19,5,7,14,992,0.26,0.98,0.42,0.32,4,3,9,1,1005,0.75,0.99,0.25,0.43
PF03649,PF03459:PF09383:PF00471:PF09821:PF01032,4,8,2,2,6,1008,0.25,0.99,0.5,0.35,2,2,2,0,1014,1.0,1.0,0.5,0.71
PF00825,PF08795:PF05962:PF04451:PF06724:PF11259,2,2,0,2,2,1014,0.0,1.0,0.0,-0.0,0,0,2,0,1016,0,1.0,0.0,0
PF04908,PF07797:PF08528:PF16072:PF09816:PF08209,10,22,3,7,19,989,0.14,0.97,0.3,0.19,1,0,10,1,1007,0.0,0.99,0.0,-0.0
PF03198,PF00332:PF00154:PF07983:PF04788:PF03537,18,40,6,12,34,966,0.15,0.95,0.33,0.2,6,3,15,3,997,0.5,0.98,0.17,0.28
PF09731,PF08704:PF05871:PF10275:PF13339:PF06625,10,31,6,4,25,983,0.19,0.97,0.6,0.33,3,1,9,2,1006,0.33,0.99,0.1,0.18
PF13301,PF16218:PF15062:PF11016:PF06695:PF03907,2,1,0,2,1,1015,0.0,1.0,0.0,-0.0,0,0,2,0,1016,0,1.0,0.0,0
PF06760,PF14786:PF08917:PF02019:PF09027:PF03623,2,8,2,0,6,1010,0.25,0.99,1.0,0.5,2,2,0,0,1016,1.0,1.0,1.0,1.0
PF03791,PF03790:PF12737:PF16493:PF07526:PF05722,3,4,1,2,3,1012,0.25,1.0,0.33,0.29,1,1,2,0,1015,1.0,1.0,0.33,0.58
PF15982,PF14360:PF09822:PF10022:PF04515:PF05978,2,40,1,1,39,977,0.03,0.96,0.5,0.11,2,0,2,2,1014,0.0,1.0,0.0,-0.0
PF03203,PF15713:PF14877:PF17015:PF10563:PF15175,0,7,0,0,7,1011,0.0,0.99,0,0,0,0,0,0,1018,0,1.0,0,0
PF02898,PF09791:PF09045:PF01613:PF01855:PF00258,10,48,7,3,41,967,0.15,0.96,0.7,0.31,5,2,8,3,1005,0.4,0.99,0.2,0.28
PF05903,PF15928:PF06201:PF09070:PF10961:PF00462,19,68,7,12,61,938,0.1,0.93,0.37,0.17,4,3,16,1,998,0.75,0.98,0.16,0.34
PF10529,PF14920:PF10488:PF14918:PF10472:PF14919,1,1,0,1,1,1016,0.0,1.0,0.0,-0.0,0,0,1,0,1017,0,1.0,0.0,0
PF01106,PF08712:PF10561:PF11069:PF01281:PF02777,18,47,16,2,31,969,0.34,0.97,0.89,0.54,2,2,16,0,1000,1.0,0.98,0.11,0.33
PF08063,PF00645:PF05406:PF02877:PF03119:PF11411,7,39,5,2,34,977,0.13,0.96,0.71,0.29,10,5,2,5,1006,0.5,0.99,0.71,0.59
PF07839,PF15235:PF12178:PF15997:PF07891:PF01057,3,4,0,3,4,1011,0.0,0.99,0.0,-0.0,0,0,3,0,1015,0,1.0,0.0,0
PF03740,PF04539:PF04542:PF04545:PF08281:PF00140,6,29,6,0,23,989,0.21,0.98,1.0,0.45,12,6,0,6,1006,0.5,0.99,1.0,0.71
PF09543,PF14280:PF13464:PF12835:PF02388:PF00114,1,3,1,0,2,1015,0.33,1.0,1.0,0.58,1,1,0,0,1017,1.0,1.0,1.0,1.0
PF14881,PF10644:PF08631:PF00940:PF12108:PF05645,10,28,7,3,21,987,0.25,0.98,0.7,0.41,3,0,10,3,1005,0.0,0.99,0.0,-0.01
PF08559,PF04367:PF04839:PF07939:PF10018:PF07809,2,18,2,0,16,1000,0.11,0.98,1.0,0.33,1,0,2,1,1015,0.0,1.0,0.0,-0.0
PF00312,PF05180:PF05019:PF08069:PF04440:PF13718,21,29,12,9,17,980,0.41,0.97,0.57,0.47,3,3,18,0,997,1.0,0.98,0.14,0.37
PF07324,PF02126:PF10251:PF15087:PF14941:PF14931,3,11,1,2,10,1005,0.09,0.99,0.33,0.17,1,0,3,1,1014,0.0,1.0,0.0,-0.0
PF06662,PF15296:PF14764:PF12733:PF08161:PF08640,3,20,1,2,19,996,0.05,0.98,0.33,0.12,2,1,2,1,1014,0.5,1.0,0.33,0.41
PF11608,PF01936:PF14418:PF17182:PF12872:PF10599,3,22,3,0,19,996,0.14,0.98,1.0,0.37,3,0,3,3,1012,0.0,0.99,0.0,-0.0
PF07142,PF09462:PF04001:PF14886:PF15373:PF15392,4,5,2,2,3,1011,0.4,1.0,0.5,0.44,0,0,4,0,1014,0,1.0,0.0,0
PF05336,PF06711:PF06718:PF03323:PF16966:PF14616,2,13,0,2,13,1003,0.0,0.99,0.0,-0.01,0,0,2,0,1016,0,1.0,0.0,0
PF08637,PF10022:PF14764:PF09822:PF01285:PF06662,8,21,2,6,19,991,0.1,0.98,0.25,0.14,0,0,8,0,1010,0,0.99,0.0,0
PF07576,PF13436:PF13441:PF06547:PF13705:PF15419,10,7,3,7,4,1004,0.43,0.99,0.3,0.35,2,2,8,0,1008,1.0,0.99,0.2,0.45
PF07289,PF13299:PF07521:PF10996:PF11718:PF16661,3,41,1,2,40,975,0.02,0.96,0.33,0.08,27,1,2,26,989,0.04,0.97,0.33,0.1
PF01207,PF00035:PF10192:PF14622:PF06859:PF07528,35,68,17,18,51,932,0.25,0.93,0.49,0.32,5,4,31,1,982,0.8,0.97,0.11,0.3
PF07449,PF15928:PF14283:PF10961:PF13098:PF06961,0,12,0,0,12,1006,0.0,0.99,0,0,0,0,0,0,1018,0,1.0,0,0
PF07574,PF08746:PF01091:PF00244:PF10483:PF05196,13,30,10,3,20,985,0.33,0.98,0.77,0.5,2,2,11,0,1005,1.0,0.99,0.15,0.39
PF04876,PF03178:PF10062:PF04976:PF07993:PF00342,0,77,0,0,77,941,0.0,0.92,0,0,4,0,0,4,1014,0.0,1.0,0,0
PF15696,PF10295:PF15774:PF15337:PF15391:PF05841,0,5,0,0,5,1013,0.0,1.0,0,0,0,0,0,0,1018,0,1.0,0,0
PF01602,PF06375:PF14797:PF09066:PF02296:PF08752,41,16,13,28,3,974,0.81,0.97,0.32,0.5,1,1,40,0,977,1.0,0.96,0.02,0.15
PF05943,PF03428:PF05947:PF05591:PF03241:PF02465,0,0,0,0,0,1018,0,1.0,0,0,0,0,0,0,1018,0,1.0,0,0
PF15448,PF15447:PF05104:PF07133:PF07926:PF15445,1,10,1,0,9,1008,0.1,0.99,1.0,0.31,1,1,0,0,1017,1.0,1.0,1.0,1.0
PF01909,PF03828:PF10421:PF13427:PF14392:PF01805,22,66,20,2,46,950,0.3,0.95,0.91,0.51,7,6,16,1,995,0.86,0.98,0.27,0.48
PF16489,PF02793:PF01825:PF00002:PF00028:PF00053,17,96,17,0,79,922,0.18,0.92,1.0,0.4,27,14,3,13,988,0.52,0.98,0.82,0.65
PF07751,PF14866:PF04532:PF00770:PF09252:PF15085,0,4,0,0,4,1014,0.0,1.0,0,0,0,0,0,0,1018,0,1.0,0,0
PF08416,PF08919:PF12162:PF12610:PF09267:PF12026,12,14,2,10,12,994,0.14,0.98,0.17,0.14,0,0,12,0,1006,0,0.99,0.0,0
PF11635,PF09737:PF12350:PF12243:PF15183:PF11069,7,11,1,6,10,1001,0.09,0.98,0.14,0.11,0,0,7,0,1011,0,0.99,0.0,0
PF10153,PF11291:PF15122:PF07197:PF00524:PF14107,5,5,0,5,5,1008,0.0,0.99,0.0,-0.0,0,0,5,0,1013,0,1.0,0.0,0
PF00616,PF00779:PF12004:PF03836:PF06101:PF00621,20,90,13,7,77,921,0.14,0.92,0.65,0.28,2,2,18,0,998,1.0,0.98,0.1,0.31
PF15961,PF14664:PF14663:PF14666:PF14761:PF00680,1,25,1,0,24,993,0.04,0.98,1.0,0.2,10,0,1,10,1007,0.0,0.99,0.0,-0.0
PF16711,PF16709:PF16712:PF02065:PF16874:PF16875,1,8,1,0,7,1010,0.12,0.99,1.0,0.35,1,0,1,1,1016,0.0,1.0,0.0,-0.0
PF02011,PF15143:PF02543:PF07411:PF07149:PF03640,2,3,0,2,3,1013,0.0,1.0,0.0,-0.0,0,0,2,0,1016,0,1.0,0.0,0
PF15196,PF07227:PF10591:PF13417:PF13813:PF00549,0,83,0,0,83,935,0.0,0.92,0,0,5,0,0,5,1013,0.0,1.0,0,0
PF15464,PF17049:PF17188:PF00381:PF03548:PF15856,0,5,0,0,5,1013,0.0,1.0,0,0,0,0,0,0,1018,0,1.0,0,0
PF12416,PF16056:PF15625:PF16562:PF09457:PF11618,3,19,1,2,18,997,0.05,0.98,0.33,0.13,1,1,2,0,1015,1.0,1.0,0.33,0.58
PF08773,PF08127:PF12131:PF08246:PF15371:PF00112,1,65,1,0,64,953,0.02,0.94,1.0,0.12,4,1,0,3,1014,0.25,1.0,1.0,0.5
PF03800,PF15066:PF17045:PF11496:PF09762:PF15905,3,12,1,2,11,1004,0.08,0.99,0.33,0.16,0,0,3,0,1015,0,1.0,0.0,0
PF07793,PF12385:PF07799:PF02425:PF08291:PF06744,0,0,0,0,0,1018,0,1.0,0,0,0,0,0,0,1018,0,1.0,0,0
PF14719,PF13908:PF09783:PF11527:PF08265:PF06365,4,34,1,3,33,981,0.03,0.96,0.25,0.08,2,1,3,1,1013,0.5,1.0,0.25,0.35
PF04228,PF05509:PF01752:PF13753:PF08497:PF11863,0,3,0,0,3,1015,0.0,1.0,0,0,0,0,0,0,1018,0,1.0,0,0
PF15952,PF08730:PF09690:PF07359:PF14290:PF15667,0,0,0,0,0,1018,0,1.0,0,0,0,0,0,0,1018,0,1.0,0,0
PF11581,PF13367:PF06695:PF11341:PF02070:PF12646,0,5,0,0,5,1013,0.0,1.0,0,0,0,0,0,0,1018,0,1.0,0,0
PF16044,PF09784:PF05512:PF02101:PF06907:PF06825,4,13,1,3,12,1002,0.08,0.99,0.25,0.13,1,0,4,1,1013,0.0,1.0,0.0,-0.0
PF08660,PF06925:PF08127:PF05216:PF03301:PF11937,9,22,6,3,16,993,0.27,0.98,0.67,0.42,0,0,9,0,1009,0,0.99,0.0,0
PF03711,PF01276:PF03709:PF14008:PF16656:PF14807,7,31,7,0,24,987,0.23,0.98,1.0,0.47,4,4,3,0,1011,1.0,1.0,0.57,0.75
PF03476,PF03473:PF00266:PF03475:PF13840:PF06041,13,65,13,0,52,953,0.2,0.95,1.0,0.44,7,5,8,2,1003,0.71,0.99,0.38,0.52
PF02229,PF02201:PF08766:PF13178:PF03126:PF07223,14,49,11,3,38,966,0.22,0.96,0.79,0.41,9,5,9,4,1000,0.56,0.99,0.36,0.44
PF00519,PF15856:PF08026:PF17076:PF17014:PF15775,5,1,0,5,1,1012,0.0,0.99,0.0,-0.0,0,0,5,0,1013,0,1.0,0.0,0
PF10214,PF08639:PF11489:PF14342:PF06485:PF04934,6,22,1,5,21,991,0.05,0.97,0.17,0.08,0,0,6,0,1012,0,0.99,0.0,0
PF00327,PF01281:PF04819:PF01159:PF01896:PF14735,16,35,7,9,28,974,0.2,0.96,0.44,0.28,3,3,13,0,1002,1.0,0.99,0.19,0.43
PF02014,PF06468:PF04526:PF03188:PF03351:PF10223,14,45,11,3,34,970,0.24,0.96,0.79,0.43,3,3,11,0,1004,1.0,0.99,0.21,0.46
PF14443,PF14444:PF16294:PF15273:PF02037:PF14722,4,67,3,1,64,950,0.04,0.94,0.75,0.17,1,1,3,0,1014,1.0,1.0,0.25,0.5
PF10293,PF10305:PF10344:PF10359:PF10351:PF10347,5,8,5,0,3,1010,0.62,1.0,1.0,0.79,4,4,1,0,1013,1.0,1.0,0.8,0.89
PF05008,PF01980:PF04706:PF03908:PF07039:PF12483,5,22,1,4,21,992,0.05,0.98,0.2,0.09,3,0,5,3,1010,0.0,0.99,0.0,-0.0
PF15558,PF10506:PF15877:PF11831:PF14775:PF15066,1,17,0,1,17,1000,0.0,0.98,0.0,-0.0,0,0,1,0,1017,0,1.0,0.0,0
PF11124,PF15775:PF09461:PF06890:PF02277:PF04848,0,6,0,0,6,1012,0.0,0.99,0,0,0,0,0,0,1018,0,1.0,0,0
PF08939,PF10161:PF12006:PF15054:PF15173:PF15370,7,15,3,4,12,999,0.2,0.98,0.43,0.29,0,0,7,0,1011,0,0.99,0.0,0
PF05233,PF07879:PF15546:PF17192:PF00381:PF03882,1,1,1,0,0,1017,1.0,1.0,1.0,1.0,0,0,1,0,1017,0,1.0,0.0,0
PF03415,PF15888:PF15082:PF15094:PF10056:PF15392,1,5,0,1,5,1012,0.0,0.99,0.0,-0.0,0,0,1,0,1017,0,1.0,0.0,0
PF03467,PF04098:PF16131:PF04146:PF08081:PF14327,11,48,7,4,41,966,0.15,0.96,0.64,0.29,3,2,9,1,1006,0.67,0.99,0.18,0.34
PF11711,PF10775:PF13741:PF15910:PF11947:PF13933,1,5,0,1,5,1012,0.0,0.99,0.0,-0.0,0,0,1,0,1017,0,1.0,0.0,0
PF11517,PF04001:PF10933:PF15082:PF08183:PF16071,0,3,0,0,3,1015,0.0,1.0,0,0,0,0,0,0,1018,0,1.0,0,0
PF08560,PF10212:PF15246:PF16704:PF14644:PF15908,4,10,2,2,8,1006,0.2,0.99,0.5,0.31,1,1,3,0,1014,1.0,1.0,0.25,0.5
PF15145,PF05115:PF06651:PF07068:PF15763:PF17076,0,2,0,0,2,1016,0.0,1.0,0,0,0,0,0,0,1018,0,1.0,0,0
PF10315,PF15097:PF15085:PF03819:PF00770:PF14865,0,5,0,0,5,1013,0.0,1.0,0,0,0,0,0,0,1018,0,1.0,0,0
PF06357,PF09904:PF04264:PF09826:PF14251:PF14512,1,4,0,1,4,1013,0.0,1.0,0.0,-0.0,0,0,1,0,1017,0,1.0,0.0,0
PF15684,PF14653:PF15071:PF11029:PF10868:PF15171,0,3,0,0,3,1015,0.0,1.0,0,0,0,0,0,0,1018,0,1.0,0,0
PF07707,PF00016:PF02788:PF09494:PF02214:PF09237,63,53,23,40,30,925,0.43,0.93,0.37,0.36,2,2,61,0,955,1.0,0.94,0.03,0.17
PF07684,PF06816:PF11936:PF16553:PF15898:PF09372,7,10,5,2,5,1006,0.5,0.99,0.71,0.59,1,1,6,0,1011,1.0,0.99,0.14,0.38
PF14932,PF04869:PF11496:PF03800:PF15066:PF09762,4,23,3,1,20,994,0.13,0.98,0.75,0.31,1,1,3,0,1014,1.0,1.0,0.25,0.5
PF09138,PF08228:PF15180:PF15158:PF01809:PF08193,8,6,3,5,3,1007,0.5,0.99,0.38,0.43,0,0,8,0,1010,0,0.99,0.0,0
PF12345,PF13597:PF10105:PF06969:PF11842:PF06962,2,4,2,0,2,1014,0.5,1.0,1.0,0.71,2,2,0,0,1016,1.0,1.0,1.0,1.0
PF05230,PF02277:PF11363:PF03241:PF08453:PF11019,0,5,0,0,5,1013,0.0,1.0,0,0,0,0,0,0,1018,0,1.0,0,0
PF04180,PF07093:PF00864:PF09803:PF12141:PF12949,8,29,3,5,26,984,0.1,0.97,0.38,0.19,2,2,6,0,1010,1.0,0.99,0.25,0.5
PF01813,PF16054:PF03874:PF12271:PF01779:PF04418,7,27,1,6,26,985,0.04,0.97,0.14,0.06,3,0,7,3,1008,0.0,0.99,0.0,-0.0
PF02577,PF13474:PF02151:PF02861:PF05496:PF16193,2,36,2,0,34,982,0.06,0.97,1.0,0.23,3,1,1,2,1014,0.33,1.0,0.5,0.41
PF13859,PF16692:PF10699:PF12928:PF15862:PF10198,0,18,0,0,18,1000,0.0,0.98,0,0,1,0,0,1,1017,0.0,1.0,0,0
PF07937,PF09611:PF02119:PF01292:PF05673:PF16967,0,8,0,0,8,1010,0.0,0.99,0,0,0,0,0,0,1018,0,1.0,0,0
PF11857,PF08924:PF03734:PF16210:PF04431:PF16004,3,16,1,2,15,1000,0.06,0.98,0.33,0.14,0,0,3,0,1015,0,1.0,0.0,0
PF14046,PF12743:PF12577:PF02161:PF02155:PF02159,0,12,0,0,12,1006,0.0,0.99,0,0,5,0,0,5,1013,0.0,1.0,0,0
PF07365,PF06227:PF04233:PF15482:PF15848:PF06651,1,0,0,1,0,1017,0,1.0,0.0,0,0,0,1,0,1017,0,1.0,0.0,0
PF01267,PF16720:PF03437:PF03784:PF05300:PF02870,9,11,3,6,8,1001,0.27,0.99,0.33,0.29,0,0,9,0,1009,0,0.99,0.0,0
PF07575,PF14778:PF05719:PF01756:PF01198:PF14943,10,49,9,1,40,968,0.18,0.96,0.9,0.4,3,2,8,1,1007,0.67,0.99,0.2,0.36
PF03321,PF04398:PF06749:PF00197:PF12734:PF11744,6,19,2,4,17,995,0.11,0.98,0.33,0.18,1,1,5,0,1012,1.0,1.0,0.17,0.41
PF01405,PF02119:PF16824:PF08497:PF06934:PF16822,0,2,0,0,2,1016,0.0,1.0,0,0,0,0,0,0,1018,0,1.0,0,0
PF14232,PF14231:PF08283:PF01228:PF00577:PF00345,0,8,0,0,8,1010,0.0,0.99,0,0,0,0,0,0,1018,0,1.0,0,0
PF00831,PF00159:PF01279:PF05676:PF08315:PF01907,10,29,5,5,24,984,0.17,0.97,0.5,0.28,2,1,9,1,1007,0.5,0.99,0.1,0.22
PF11427,PF13936:PF16087:PF09339:PF02796:PF01710,10,32,7,3,25,983,0.22,0.97,0.7,0.38,2,1,9,1,1007,0.5,0.99,0.1,0.22
PF00297,PF01012:PF00252:PF00203:PF02585:PF00766,17,57,9,8,48,953,0.16,0.94,0.53,0.27,8,5,12,3,998,0.62,0.99,0.29,0.42
PF08402,PF08352:PF12399:PF13732:PF09383:PF00528,7,40,6,1,34,977,0.15,0.97,0.86,0.35,3,3,4,0,1011,1.0,1.0,0.43,0.65
PF08610,PF02983:PF09272:PF06417:PF12032:PF04923,9,21,3,6,18,991,0.14,0.98,0.33,0.21,1,1,8,0,1009,1.0,0.99,0.11,0.33
PF00016,PF02788:PF01328:PF02244:PF03952:PF01764,5,77,3,2,74,939,0.04,0.93,0.6,0.14,7,0,5,7,1006,0.0,0.99,0.0,-0.01
PF00733,PF13537:PF02922:PF12481:PF10155:PF00156,17,56,9,8,47,954,0.16,0.95,0.53,0.27,3,2,15,1,1000,0.67,0.98,0.12,0.28
PF04954,PF11751:PF14690:PF07157:PF08021:PF03831,0,0,0,0,0,1018,0,1.0,0,0,0,0,0,0,1018,0,1.0,0,0
PF02586,PF03479:PF04139:PF08552:PF06730:PF04934,10,36,6,4,30,978,0.17,0.97,0.6,0.3,2,1,9,1,1007,0.5,0.99,0.1,0.22
PF13374,PF01048:PF12807:PF05303:PF13236:PF07721,52,44,27,25,17,949,0.61,0.96,0.52,0.54,3,3,49,0,966,1.0,0.95,0.06,0.23
PF12768,PF12026:PF06920:PF16172:PF07815:PF03983,1,27,1,0,26,991,0.04,0.97,1.0,0.19,2,1,0,1,1016,0.5,1.0,1.0,0.71
PF05979,PF07301:PF05474:PF06286:PF06670:PF15726,0,0,0,0,0,1018,0,1.0,0,0,0,0,0,0,1018,0,1.0,0,0
PF02541,PF01966:PF06237:PF06880:PF04616:PF03074,6,53,5,1,48,964,0.09,0.95,0.83,0.27,3,2,4,1,1011,0.67,1.0,0.33,0.47
PF15512,PF14077:PF13925:PF11816:PF09453:PF13271,2,34,2,0,32,984,0.06,0.97,1.0,0.24,3,1,1,2,1014,0.33,1.0,0.5,0.41
PF05175,PF00155:PF13847:PF01040:PF01063:PF07896,27,143,14,13,129,862,0.1,0.86,0.52,0.18,14,8,19,6,985,0.57,0.98,0.3,0.4
PF07127,PF16029:PF16594:PF01291:PF17032:PF14986,8,7,3,5,4,1006,0.43,0.99,0.38,0.4,0,0,8,0,1010,0,0.99,0.0,0
PF01910,PF15744:PF13933:PF06907:PF15003:PF10310,1,3,0,1,3,1014,0.0,1.0,0.0,-0.0,0,0,1,0,1017,0,1.0,0.0,0
PF09496,PF05837:PF02083:PF06211:PF13096:PF00835,4,6,0,4,6,1008,0.0,0.99,0.0,-0.0,0,0,4,0,1014,0,1.0,0.0,0
PF15241,PF15259:PF15082:PF09322:PF14465:PF12443,0,5,0,0,5,1013,0.0,1.0,0,0,0,0,0,0,1018,0,1.0,0,0
PF16780,PF02798:PF00647:PF13417:PF08505:PF08647,1,85,1,0,84,933,0.01,0.92,1.0,0.1,8,0,1,8,1009,0.0,0.99,0.0,-0.0
PF03441,PF00875:PF10155:PF01755:PF04258:PF13886,11,54,10,1,44,963,0.19,0.96,0.91,0.4,6,4,7,2,1005,0.67,0.99,0.36,0.49
PF13862,PF16053:PF09419:PF00902:PF01097:PF09631,6,37,2,4,35,977,0.05,0.96,0.33,0.12,1,0,6,1,1011,0.0,0.99,0.0,-0.0
PF15073,PF12600:PF06493:PF04428:PF15093:PF07282,1,6,0,1,6,1011,0.0,0.99,0.0,-0.0,0,0,1,0,1017,0,1.0,0.0,0
PF13855,PF00560:PF13306:PF12799:PF01462:PF01463,149,87,79,70,8,861,0.91,0.92,0.53,0.66,13,13,136,0,869,1.0,0.87,0.09,0.27
PF10438,PF09087:PF11941:PF09154:PF05400:PF16657,1,3,1,0,2,1015,0.33,1.0,1.0,0.58,1,1,0,0,1017,1.0,1.0,1.0,1.0
PF11017,PF15053:PF08730:PF15952:PF10994:PF01959,0,5,0,0,5,1013,0.0,1.0,0,0,0,0,0,0,1018,0,1.0,0,0
PF09774,PF02569:PF09781:PF02101:PF10994:PF06342,8,18,1,7,17,993,0.06,0.98,0.12,0.07,0,0,8,0,1010,0,0.99,0.0,0
PF14923,PF02187:PF08976:PF06039:PF12999:PF08580,2,31,2,0,29,987,0.06,0.97,1.0,0.25,2,1,1,1,1015,0.5,1.0,0.5,0.5
PF08746,PF05129:PF03298:PF07574:PF01910:PF10483,8,26,8,0,18,992,0.31,0.98,1.0,0.55,1,1,7,0,1010,1.0,0.99,0.12,0.35
PF00704,PF14856:PF03427:PF05938:PF08329:PF00187,58,25,22,36,3,957,0.88,0.96,0.38,0.56,2,2,56,0,960,1.0,0.94,0.03,0.18
PF02911,PF00551:PF00171:PF00465:PF00586:PF02774,11,127,10,1,117,890,0.08,0.88,0.91,0.25,10,4,7,6,1001,0.4,0.99,0.36,0.37
PF13775,PF09667:PF12336:PF12067:PF14887:PF16090,1,11,0,1,11,1006,0.0,0.99,0.0,-0.0,1,0,1,1,1016,0.0,1.0,0.0,-0.0
PF04822,PF04423:PF06294:PF07989:PF16531:PF05046,1,29,1,0,28,989,0.03,0.97,1.0,0.18,1,0,1,1,1016,0.0,1.0,0.0,-0.0
PF01241,PF06351:PF00537:PF00236:PF15370:PF01716,0,8,0,0,8,1010,0.0,0.99,0,0,0,0,0,0,1018,0,1.0,0,0
PF14576,PF14577:PF14767:PF04927:PF14766:PF14768,0,5,0,0,5,1013,0.0,1.0,0,0,1,0,0,1,1017,0.0,1.0,0,0
PF15316,PF12328:PF14653:PF06351:PF14473:PF00727,2,10,0,2,10,1006,0.0,0.99,0.0,-0.0,0,0,2,0,1016,0,1.0,0.0,0
PF04758,PF01020:PF16843:PF09055:PF05162:PF16455,11,24,3,8,21,986,0.12,0.97,0.27,0.17,1,1,10,0,1007,1.0,0.99,0.09,0.3
PF01091,PF05196:PF06540:PF01296:PF08523:PF09363,2,10,1,1,9,1007,0.1,0.99,0.5,0.22,0,0,2,0,1016,0,1.0,0.0,0
PF13796,PF08260:PF12016:PF01855:PF08104:PF12660,0,18,0,0,18,1000,0.0,0.98,0,0,0,0,0,0,1018,0,1.0,0,0
PF13768,PF08487:PF08473:PF08399:PF06668:PF15057,21,23,16,5,7,990,0.7,0.99,0.76,0.72,4,4,17,0,997,1.0,0.98,0.19,0.43
PF10839,PF00537:PF06541:PF14473:PF16716:PF00236,0,2,0,0,2,1016,0.0,1.0,0,0,0,0,0,0,1018,0,1.0,0,0
PF14534,PF17050:PF00770:PF05355:PF15555:PF15825,0,6,0,0,6,1012,0.0,0.99,0,0,0,0,0,0,1018,0,1.0,0,0
PF04402,PF00727:PF02024:PF06541:PF15071:PF04856,6,5,1,5,4,1008,0.2,0.99,0.17,0.18,0,0,6,0,1012,0,0.99,0.0,0
PF15258,PF12519:PF15961:PF15509:PF06838:PF15376,2,10,0,2,10,1006,0.0,0.99,0.0,-0.0,0,0,2,0,1016,0,1.0,0.0,0
PF15380,PF05418:PF06393:PF15186:PF15085:PF01316,0,7,0,0,7,1011,0.0,0.99,0,0,0,0,0,0,1018,0,1.0,0,0
PF03839,PF05046:PF07787:PF05361:PF03045:PF09696,9,29,6,3,23,986,0.21,0.97,0.67,0.36,2,2,7,0,1009,1.0,0.99,0.22,0.47
PF10268,PF10712:PF00012:PF06723:PF10629:PF05835,6,75,5,1,70,942,0.07,0.93,0.83,0.22,3,3,3,0,1012,1.0,1.0,0.5,0.71
PF02015,PF03664:PF01341:PF00457:PF01083:PF10503,7,29,5,2,24,987,0.17,0.97,0.71,0.34,4,2,5,2,1009,0.5,0.99,0.29,0.37
PF03935,PF14240:PF12751:PF10236:PF08784:PF05636,8,22,4,4,18,992,0.18,0.98,0.5,0.29,1,0,8,1,1009,0.0,0.99,0.0,-0.0
PF12869,PF04122:PF09397:PF10043:PF12461:PF08310,3,6,2,1,4,1011,0.33,1.0,0.67,0.47,0,0,3,0,1015,0,1.0,0.0,0
PF15619,PF06637:PF16043:PF15257:PF14922:PF05337,4,9,0,4,9,1005,0.0,0.99,0.0,-0.01,0,0,4,0,1014,0,1.0,0.0,0
PF00410,PF09341:PF06842:PF09495:PF01984:PF02115,20,29,6,14,23,975,0.21,0.96,0.3,0.23,3,2,18,1,997,0.67,0.98,0.1,0.25
PF10335,PF05103:PF08437:PF00909:PF06689:PF15870,2,38,2,0,36,980,0.05,0.96,1.0,0.23,1,0,2,1,1015,0.0,1.0,0.0,-0.0
PF00250,PF16159:PF02701:PF04109:PF00853:PF09816,45,25,11,34,14,959,0.44,0.95,0.24,0.31,2,2,43,0,973,1.0,0.96,0.04,0.21
PF02392,PF03040:PF10322:PF10285:PF05238:PF05111,8,7,6,2,1,1009,0.86,1.0,0.75,0.8,0,0,8,0,1010,0,0.99,0.0,0
PF03178,PF07035:PF14498:PF12036:PF14432:PF14649,29,51,14,15,37,952,0.27,0.95,0.48,0.34,2,2,27,0,989,1.0,0.97,0.07,0.26
PF05005,PF15884:PF14935:PF02195:PF16089:PF11029,11,12,2,9,10,997,0.17,0.98,0.18,0.16,1,0,11,1,1006,0.0,0.99,0.0,-0.0
PF15152,PF15107:PF15173:PF17124:PF08847:PF09252,1,0,0,1,0,1017,0,1.0,0.0,0,0,0,1,0,1017,0,1.0,0.0,0
PF09514,PF12417:PF02023:PF09607:PF04508:PF03716,3,24,2,1,22,993,0.08,0.98,0.67,0.23,1,1,2,0,1015,1.0,1.0,0.33,0.58
PF04969,PF04968:PF14050:PF05002:PF16273:PF09032,48,30,25,23,5,965,0.83,0.97,0.52,0.65,0,0,48,0,970,0,0.95,0.0,0
PF13116,PF00116:PF05735:PF02790:PF02075:PF06481,9,20,8,1,12,997,0.4,0.99,0.89,0.59,3,2,7,1,1008,0.67,0.99,0.22,0.38
PF04756,PF05434:PF00143:PF11779:PF02284:PF00277,11,14,4,7,10,997,0.29,0.98,0.36,0.31,1,1,10,0,1007,1.0,0.99,0.09,0.3
PF04080,PF07712:PF09778:PF06172:PF05724:PF05995,10,16,3,7,13,995,0.19,0.98,0.3,0.23,1,0,10,1,1007,0.0,0.99,0.0,-0.0
PF00385,PF17218:PF13907:PF09337:PF01393:PF03078,68,30,23,45,7,943,0.77,0.95,0.34,0.49,3,3,65,0,950,1.0,0.94,0.04,0.2
PF05022,PF08640:PF08161:PF12169:PF14952:PF14973,11,19,4,7,15,992,0.21,0.98,0.36,0.27,1,1,10,0,1007,1.0,0.99,0.09,0.3
PF06853,PF12147:PF08321:PF04152:PF14803:PF05011,1,32,1,0,31,986,0.03,0.97,1.0,0.17,5,1,0,4,1013,0.2,1.0,1.0,0.45
PF04457,PF10470:PF16274:PF16568:PF16544:PF08067,9,8,1,8,7,1002,0.12,0.99,0.11,0.11,1,0,9,1,1008,0.0,0.99,0.0,-0.0
PF01358,PF03618:PF17078:PF17017:PF15379:PF05874,1,4,0,1,4,1013,0.0,1.0,0.0,-0.0,0,0,1,0,1017,0,1.0,0.0,0
PF06689,PF00574:PF10335:PF01346:PF06476:PF07724,3,41,3,0,38,977,0.07,0.96,1.0,0.27,1,0,3,1,1014,0.0,1.0,0.0,-0.0
PF00747,PF11819:PF03568:PF00003:PF13305:PF05781,1,42,0,1,42,975,0.0,0.96,0.0,-0.01,3,0,1,3,1014,0.0,1.0,0.0,-0.0
PF13293,PF04617:PF12413:PF10525:PF03867:PF12407,1,4,1,0,3,1014,0.25,1.0,1.0,0.5,1,1,0,0,1017,1.0,1.0,1.0,1.0
PF14621,PF11522:PF11640:PF15785:PF08163:PF08064,2,27,2,0,25,991,0.07,0.98,1.0,0.27,3,1,1,2,1014,0.33,1.0,0.5,0.41
PF00705,PF02747:PF08523:PF01643:PF09284:PF12338,10,25,9,1,16,992,0.36,0.98,0.9,0.56,1,0,10,1,1007,0.0,0.99,0.0,-0.0
PF09377,PF01172:PF13506:PF12243:PF02537:PF15374,8,27,8,0,19,991,0.3,0.98,1.0,0.54,0,0,8,0,1010,0,0.99,0.0,0
PF08913,PF09141:PF01608:PF16511:PF05902:PF04382,4,33,4,0,29,985,0.12,0.97,1.0,0.34,9,4,0,5,1009,0.44,1.0,1.0,0.67
PF01610,PF14690:PF02211:PF13861:PF03831:PF04963,2,4,0,2,4,1012,0.0,0.99,0.0,-0.0,0,0,2,0,1016,0,1.0,0.0,0
PF03328,PF06172:PF03972:PF12311:PF14027:PF12296,17,26,11,6,15,986,0.42,0.98,0.65,0.51,1,1,16,0,1001,1.0,0.98,0.06,0.24
PF08203,PF01316:PF15212:PF03050:PF17112:PF17015,1,2,0,1,2,1015,0.0,1.0,0.0,-0.0,0,0,1,0,1017,0,1.0,0.0,0
PF03994,PF11751:PF08479:PF01136:PF03729:PF03605,1,2,0,1,2,1015,0.0,1.0,0.0,-0.0,0,0,1,0,1017,0,1.0,0.0,0
PF01855,PF17147:PF01558:PF10371:PF01077:PF03460,14,19,11,3,8,996,0.58,0.99,0.79,0.67,7,7,7,0,1004,1.0,0.99,0.5,0.7
PF00962,PF08451:PF06237:PF01757:PF02219:PF16953,22,54,11,11,43,953,0.2,0.95,0.5,0.3,2,2,20,0,996,1.0,0.98,0.09,0.3
PF07947,PF04241:PF00210:PF00143:PF12020:PF02284,5,27,2,3,25,988,0.07,0.97,0.4,0.16,1,0,5,1,1012,0.0,0.99,0.0,-0.0
PF16011,PF08708:PF01668:PF02554:PF07021:PF03406,2,3,0,2,3,1013,0.0,1.0,0.0,-0.0,0,0,2,0,1016,0,1.0,0.0,0
PF09832,PF05611:PF08093:PF07353:PF15207:PF15754,0,4,0,0,4,1014,0.0,1.0,0,0,0,0,0,0,1018,0,1.0,0,0
PF01010,PF06455:PF00662:PF12612:PF14959:PF13910,1,18,1,0,17,1000,0.06,0.98,1.0,0.23,0,0,1,0,1017,0,1.0,0.0,0
PF02760,PF13553:PF02758:PF05132:PF09346:PF15486,1,23,1,0,22,995,0.04,0.98,1.0,0.21,1,0,1,1,1016,0.0,1.0,0.0,-0.0
PF08279,PF02912:PF03147:PF13280:PF09012:PF01409,10,25,5,5,20,988,0.2,0.98,0.5,0.31,5,4,6,1,1007,0.8,0.99,0.4,0.56
PF00451,PF09232:PF08576:PF17124:PF09252:PF15550,1,3,0,1,3,1014,0.0,1.0,0.0,-0.0,0,0,1,0,1017,0,1.0,0.0,0
PF16689,PF05956:PF05924:PF05937:PF10508:PF05923,3,17,3,0,14,1001,0.18,0.99,1.0,0.42,4,3,0,1,1014,0.75,1.0,1.0,0.87
PF10469,PF10470:PF16568:PF16544:PF16274:PF08067,17,8,4,13,4,997,0.5,0.98,0.24,0.34,1,1,16,0,1001,1.0,0.98,0.06,0.24
PF15051,PF06702:PF15067:PF03085:PF02112:PF04910,1,22,0,1,22,995,0.0,0.98,0.0,-0.0,0,0,1,0,1017,0,1.0,0.0,0
PF08925,PF00821:PF05884:PF16720:PF04710:PF16954,6,10,2,4,8,1004,0.2,0.99,0.33,0.25,0,0,6,0,1012,0,0.99,0.0,0
PF12490,PF08159:PF13925:PF11540:PF08596:PF03451,5,26,4,1,22,991,0.15,0.98,0.8,0.34,3,2,3,1,1012,0.67,1.0,0.4,0.51
PF08121,PF07277:PF03594:PF08547:PF15191:PF08285,1,18,0,1,18,999,0.0,0.98,0.0,-0.0,0,0,1,0,1017,0,1.0,0.0,0
PF14226,PF03171:PF01066:PF13344:PF06414:PF08652,39,86,38,1,48,931,0.44,0.95,0.97,0.64,8,6,33,2,977,0.75,0.97,0.15,0.33
PF15735,PF11502:PF15997:PF15793:PF15491:PF15082,5,4,0,5,4,1009,0.0,0.99,0.0,-0.0,0,0,5,0,1013,0,1.0,0.0,0
PF01060,PF00213:PF01775:PF10190:PF02284:PF05823,31,29,9,22,20,967,0.31,0.96,0.29,0.28,3,3,28,0,987,1.0,0.97,0.1,0.31
PF16193,PF12002:PF05496:PF16565:PF06480:PF16725,14,31,14,0,17,987,0.45,0.98,1.0,0.67,2,2,12,0,1004,1.0,0.99,0.14,0.38
PF06247,PF14911:PF12350:PF12853:PF00502:PF03769,0,10,0,0,10,1008,0.0,0.99,0,0,0,0,0,0,1018,0,1.0,0,0
PF04014,PF09074:PF05666:PF08361:PF10459:PF00813,1,3,1,0,2,1015,0.33,1.0,1.0,0.58,0,0,1,0,1017,0,1.0,0.0,0
PF12603,PF15518:PF14842:PF04196:PF01580:PF02399,1,7,1,0,6,1011,0.14,0.99,1.0,0.38,0,0,1,0,1017,0,1.0,0.0,0
PF01008,PF00293:PF01725:PF09297:PF12051:PF09296,29,90,19,10,71,918,0.21,0.92,0.66,0.34,6,4,25,2,987,0.67,0.97,0.14,0.3
PF00137,PF07687:PF12406:PF04145:PF03417:PF08633,23,35,10,13,25,970,0.29,0.96,0.43,0.33,1,1,22,0,995,1.0,0.98,0.04,0.21
PF05592,PF08531:PF14200:PF00754:PF09458:PF09118,20,64,20,0,44,954,0.31,0.96,1.0,0.55,4,3,17,1,997,0.75,0.98,0.15,0.33
PF08524,PF01416:PF09789:PF02940:PF04000:PF08528,6,44,5,1,39,973,0.11,0.96,0.83,0.3,1,1,5,0,1012,1.0,1.0,0.17,0.41
PF00345,PF13954:PF02056:PF08461:PF02107:PF13953,3,14,3,0,11,1004,0.21,0.99,1.0,0.46,1,1,2,0,1015,1.0,1.0,0.33,0.58
PF06022,PF07418:PF09592:PF05042:PF08534:PF01627,0,31,0,0,31,987,0.0,0.97,0,0,1,0,0,1,1017,0.0,1.0,0,0
PF00588,PF08032:PF12105:PF00383:PF12850:PF17191,25,62,18,7,44,949,0.29,0.95,0.72,0.44,4,4,21,0,993,1.0,0.98,0.16,0.4
PF05525,PF00240:PF08096:PF02182:PF05709:PF10408,1,95,0,1,95,922,0.0,0.91,0.0,-0.01,4,0,1,4,1013,0.0,1.0,0.0,-0.0
PF05693,PF16969:PF07767:PF09751:PF04006:PF14798,9,27,3,6,24,985,0.11,0.97,0.33,0.18,6,2,7,4,1005,0.33,0.99,0.22,0.27
PF13592,PF01668:PF17050:PF15106:PF08040:PF15478,0,6,0,0,6,1012,0.0,0.99,0,0,0,0,0,0,1018,0,1.0,0,0
PF04911,PF02565:PF14885:PF04355:PF15184:PF13247,2,2,0,2,2,1014,0.0,1.0,0.0,-0.0,0,0,2,0,1016,0,1.0,0.0,0
PF00251,PF08244:PF11837:PF16352:PF16346:PF02018,16,20,14,2,6,996,0.7,0.99,0.88,0.78,0,0,16,0,1002,0,0.98,0.0,0
PF08364,PF16658:PF11987:PF14492:PF09173:PF06421,5,66,5,0,61,952,0.08,0.94,1.0,0.27,7,2,3,5,1008,0.29,0.99,0.4,0.33
PF09004,PF08284:PF12384:PF00077:PF05869:PF06817,14,34,4,10,30,974,0.12,0.96,0.29,0.17,2,1,13,1,1003,0.5,0.99,0.07,0.19
PF04722,PF10166:PF10376:PF09367:PF05458:PF05831,10,9,2,8,7,1001,0.22,0.99,0.2,0.2,0,0,10,0,1008,0,0.99,0.0,0
PF00869,PF08393:PF08326:PF03836:PF00662:PF08385,1,50,1,0,49,968,0.02,0.95,1.0,0.14,5,0,1,5,1012,0.0,0.99,0.0,-0.0
PF02358,PF00982:PF12036:PF12460:PF07562:PF04841,28,45,25,3,20,970,0.56,0.98,0.89,0.69,2,2,26,0,990,1.0,0.97,0.07,0.26
PF11955,PF02431:PF14368:PF04690:PF03386:PF01907,7,21,4,3,17,994,0.19,0.98,0.57,0.32,1,1,6,0,1011,1.0,0.99,0.14,0.38
PF16116,PF16173:PF08283:PF14232:PF07085:PF11958,0,11,0,0,11,1007,0.0,0.99,0,0,0,0,0,0,1018,0,1.0,0,0
PF10674,PF06581:PF11264:PF02943:PF12046:PF06351,1,4,1,0,3,1014,0.25,1.0,1.0,0.5,0,0,1,0,1017,0,1.0,0.0,0
PF10524,PF00859:PF03166:PF03165:PF07923:PF08762,4,26,4,0,22,992,0.15,0.98,1.0,0.39,2,2,2,0,1014,1.0,1.0,0.5,0.71
PF02184,PF17004:PF10383:PF05843:PF08161:PF12569,4,42,2,2,40,974,0.05,0.96,0.5,0.14,5,1,3,4,1010,0.2,0.99,0.25,0.22
PF15338,PF00721:PF13471:PF04335:PF12883:PF06147,0,9,0,0,9,1009,0.0,0.99,0,0,2,0,0,2,1016,0.0,1.0,0,0
PF00664,PF06472:PF02769:PF13304:PF12848:PF01061,105,77,42,63,35,878,0.55,0.9,0.4,0.42,6,6,99,0,913,1.0,0.9,0.06,0.23
PF04573,PF09297:PF09296:PF11788:PF15916:PF16113,11,34,4,7,30,977,0.12,0.96,0.36,0.19,8,4,7,4,1003,0.5,0.99,0.36,0.42
PF02450,PF09767:PF01546:PF13813:PF07687:PF00291,21,89,15,6,74,923,0.17,0.92,0.71,0.32,9,4,17,5,992,0.44,0.98,0.19,0.28
PF03635,PF02990:PF00793:PF07096:PF01294:PF14033,12,51,7,5,44,962,0.14,0.95,0.58,0.27,4,2,10,2,1004,0.5,0.99,0.17,0.28
PF03600,PF00939:PF03124:PF02656:PF09359:PF03105,6,48,4,2,44,968,0.08,0.95,0.67,0.23,12,2,4,10,1002,0.17,0.99,0.33,0.23
PF05021,PF05020:PF11543:PF05340:PF12029:PF00833,10,27,10,0,17,991,0.37,0.98,1.0,0.6,3,3,7,0,1008,1.0,0.99,0.3,0.55
PF10553,PF03943:PF04926:PF09162:PF06057:PF16176,0,20,0,0,20,998,0.0,0.98,0,0,2,0,0,2,1016,0.0,1.0,0,0
PF13184,PF08529:PF08206:PF09876:PF08461:PF11612,4,6,4,0,2,1012,0.67,1.0,1.0,0.82,1,1,3,0,1014,1.0,1.0,0.25,0.5
PF09344,PF01303:PF14251:PF05962:PF08093:PF15775,0,4,0,0,4,1014,0.0,1.0,0,0,0,0,0,0,1018,0,1.0,0,0
PF03798,PF03826:PF02183:PF16878:PF00157:PF07911,36,26,10,26,16,966,0.38,0.96,0.28,0.31,3,3,33,0,982,1.0,0.97,0.08,0.28
PF08172,PF15908:PF03801:PF07989:PF15905:PF10481,3,24,0,3,24,991,0.0,0.97,0.0,-0.01,2,0,3,2,1013,0.0,1.0,0.0,-0.0
PF10022,PF16401:PF16692:PF09797:PF09949:PF09822,7,22,1,6,21,990,0.05,0.97,0.14,0.07,2,0,7,2,1009,0.0,0.99,0.0,-0.0
PF09041,PF15557:PF02213:PF07001:PF09429:PF10482,3,24,2,1,22,993,0.08,0.98,0.67,0.23,1,0,3,1,1014,0.0,1.0,0.0,-0.0
PF02540,PF00977:PF04715:PF01177:PF00425:PF00795,22,63,11,11,52,944,0.17,0.94,0.5,0.27,9,4,18,5,991,0.44,0.98,0.18,0.27
PF06243,PF07858:PF02466:PF02446:PF03092:PF06703,0,41,0,0,41,977,0.0,0.96,0,0,1,0,0,1,1017,0.0,1.0,0,0
PF04589,PF12031:PF12145:PF14638:PF02257:PF11597,1,30,1,0,29,988,0.03,0.97,1.0,0.18,4,1,0,3,1014,0.25,1.0,1.0,0.5
PF00114,PF01580:PF06070:PF10995:PF04671:PF07494,0,8,0,0,8,1010,0.0,0.99,0,0,0,0,0,0,1018,0,1.0,0,0
PF15260,PF06679:PF15475:PF05825:PF04538:PF14473,2,3,0,2,3,1013,0.0,1.0,0.0,-0.0,0,0,2,0,1016,0,1.0,0.0,0
PF09187,PF06890:PF15817:PF02955:PF13753:PF13995,0,5,0,0,5,1013,0.0,1.0,0,0,0,0,0,0,1018,0,1.0,0,0
PF16130,PF17070:PF06651:PF04296:PF12856:PF09722,0,1,0,0,1,1017,0.0,1.0,0,0,0,0,0,0,1018,0,1.0,0,0
PF11339,PF14344:PF07503:PF12531:PF17013:PF12843,0,1,0,0,1,1017,0.0,1.0,0,0,0,0,0,0,1018,0,1.0,0,0
PF14649,PF04048:PF08638:PF10441:PF12372:PF17034,4,28,0,4,28,986,0.0,0.97,0.0,-0.01,3,0,4,3,1011,0.0,0.99,0.0,-0.0
PF07175,PF11510:PF04988:PF15337:PF15553:PF15774,0,10,0,0,10,1008,0.0,0.99,0,0,1,0,0,1,1017,0.0,1.0,0,0
PF04218,PF03221:PF04236:PF03184:PF09607:PF09026,14,79,14,0,65,939,0.18,0.94,1.0,0.41,9,6,8,3,1001,0.67,0.99,0.43,0.53
PF02489,PF13414:PF09295:PF01408:PF16546:PF07219,0,78,0,0,78,940,0.0,0.92,0,0,3,0,0,3,1015,0.0,1.0,0,0
PF01667,PF04667:PF03942:PF11326:PF03980:PF10780,9,25,6,3,19,990,0.24,0.98,0.67,0.39,0,0,9,0,1009,0,0.99,0.0,0
PF11786,PF11787:PF11785:PF12498:PF08601:PF03957,4,7,4,0,3,1011,0.57,1.0,1.0,0.75,2,2,2,0,1014,1.0,1.0,0.5,0.71
PF00172,PF12013:PF03902:PF11951:PF11374:PF06985,139,113,72,67,41,838,0.64,0.89,0.52,0.52,15,14,125,1,878,0.93,0.88,0.1,0.28
PF00378,PF00725:PF02737:PF16113:PF14779:PF00682,62,51,24,38,27,929,0.47,0.94,0.39,0.39,14,13,49,1,955,0.93,0.95,0.21,0.43
PF03196,PF11860:PF06744:PF13421:PF07833:PF02501,0,8,0,0,8,1010,0.0,0.99,0,0,0,0,0,0,1018,0,1.0,0,0
PF02422,PF00074:PF13841:PF06404:PF00048:PF05498,2,18,0,2,18,998,0.0,0.98,0.0,-0.01,1,0,2,1,1015,0.0,1.0,0.0,-0.0
PF16060,PF03703:PF06485:PF12855:PF04359:PF08653,5,9,2,3,7,1006,0.22,0.99,0.4,0.29,0,0,5,0,1013,0,1.0,0.0,0
PF02008,PF16866:PF12047:PF12269:PF02928:PF00145,17,39,11,6,28,973,0.28,0.97,0.65,0.41,5,4,13,1,1000,0.8,0.99,0.24,0.43
PF13915,PF16788:PF12885:PF12830:PF15509:PF15966,6,18,4,2,14,998,0.22,0.98,0.67,0.38,1,1,5,0,1012,1.0,1.0,0.17,0.41
PF11418,PF10649:PF04924:PF09987:PF03426:PF15844,0,0,0,0,0,1018,0,1.0,0,0,0,0,0,0,1018,0,1.0,0,0
PF11913,PF07816:PF06244:PF09754:PF07896:PF00301,17,21,4,13,17,984,0.19,0.97,0.24,0.2,1,1,16,0,1001,1.0,0.98,0.06,0.24
PF06163,PF02342:PF14435:PF12399:PF12857:PF00530,0,48,0,0,48,970,0.0,0.95,0,0,2,0,0,2,1016,0.0,1.0,0,0
PF11123,PF09699:PF16217:PF10994:PF15843:PF04892,0,0,0,0,0,1018,0,1.0,0,0,0,0,0,0,1018,0,1.0,0,0
PF10417,PF05421:PF14289:PF00578:PF15985:PF01090,32,58,32,0,26,960,0.55,0.97,1.0,0.73,3,3,29,0,986,1.0,0.97,0.09,0.3
PF16401,PF16692:PF09949:PF10022:PF14022:PF12600,1,18,0,1,18,999,0.0,0.98,0.0,-0.0,1,0,1,1,1016,0.0,1.0,0.0,-0.0
PF08596,PF12490:PF08159:PF03451:PF09453:PF08366,7,38,5,2,33,978,0.13,0.97,0.71,0.3,5,3,4,2,1009,0.6,0.99,0.43,0.5
PF06514,PF14866:PF15041:PF02531:PF05151:PF15333,0,3,0,0,3,1015,0.0,1.0,0,0,0,0,0,0,1018,0,1.0,0,0
PF10567,PF01580:PF06505:PF07805:PF12080:PF07505,1,6,0,1,6,1011,0.0,0.99,0.0,-0.0,0,0,1,0,1017,0,1.0,0.0,0
PF00472,PF03462:PF04095:PF00984:PF10426:PF01193,38,48,26,12,22,958,0.54,0.97,0.68,0.59,2,2,36,0,980,1.0,0.96,0.05,0.23
PF15990,PF15820:PF05099:PF00684:PF14901:PF05981,4,8,1,3,7,1007,0.12,0.99,0.25,0.17,0,0,4,0,1014,0,1.0,0.0,0
PF03988,PF00865:PF15710:PF15467:PF16829:PF15234,0,0,0,0,0,1018,0,1.0,0,0,0,0,0,0,1018,0,1.0,0,0
PF04345,PF15674:PF09259:PF04586:PF11055:PF12919,2,6,1,1,5,1011,0.17,0.99,0.5,0.29,0,0,2,0,1016,0,1.0,0.0,0
PF15687,PF15688:PF15690:PF15689:PF09049:PF09051,0,0,0,0,0,1018,0,1.0,0,0,0,0,0,0,1018,0,1.0,0,0
PF04724,PF07816:PF07896:PF01871:PF03045:PF00436,6,31,4,2,27,985,0.13,0.97,0.67,0.29,2,1,5,1,1011,0.5,0.99,0.17,0.29
PF12428,PF02622:PF06454:PF09425:PF11623:PF08781,3,27,2,1,25,990,0.07,0.97,0.67,0.22,2,1,2,1,1014,0.5,1.0,0.33,0.41
PF14750,PF09797:PF08568:PF10221:PF04147:PF12463,10,28,5,5,23,985,0.18,0.97,0.5,0.29,2,2,8,0,1008,1.0,0.99,0.2,0.45
PF05623,PF06404:PF00280:PF02590:PF00216:PF16974,5,19,3,2,16,997,0.16,0.98,0.6,0.3,0,0,5,0,1013,0,1.0,0.0,0
PF11002,PF12188:PF09418:PF04308:PF15486:PF16973,2,5,1,1,4,1012,0.2,1.0,0.5,0.31,0,0,2,0,1016,0,1.0,0.0,0
PF03432,PF13750:PF10618:PF01913:PF12615:PF06805,0,1,0,0,1,1017,0.0,1.0,0,0,0,0,0,0,1018,0,1.0,0,0
PF15122,PF06210:PF01051:PF05065:PF00524:PF13362,0,6,0,0,6,1012,0.0,0.99,0,0,0,0,0,0,1018,0,1.0,0,0
PF16674,PF14836:PF11522:PF09247:PF14533:PF12030,1,19,1,0,18,999,0.05,0.98,1.0,0.23,2,1,0,1,1016,0.5,1.0,1.0,0.71
PF01593,PF02353:PF04433:PF02027:PF07103:PF01042,63,43,20,43,23,932,0.47,0.94,0.32,0.35,6,6,57,0,955,1.0,0.94,0.1,0.3
PF00657,PF10604:PF00141:PF03489:PF04398:PF13472,39,71,26,13,45,934,0.37,0.94,0.67,0.47,11,10,29,1,978,0.91,0.97,0.26,0.47
PF12796,PF00023:PF13606:PF00710:PF16553:PF03859,246,124,116,130,8,764,0.94,0.86,0.47,0.6,8,8,238,0,772,1.0,0.77,0.03,0.16
PF14065,PF11743:PF01540:PF09643:PF08096:PF05999,0,0,0,0,0,1018,0,1.0,0,0,0,0,0,0,1018,0,1.0,0,0
PF10168,PF16840:PF15318:PF00022:PF15994:PF09440,2,62,1,1,61,955,0.02,0.94,0.5,0.08,0,0,2,0,1016,0,1.0,0.0,0
PF06271,PF15305:PF13270:PF12926:PF15344:PF12855,2,7,1,1,6,1010,0.14,0.99,0.5,0.26,0,0,2,0,1016,0,1.0,0.0,0
PF16670,PF03601:PF15460:PF01051:PF01430:PF13559,1,4,0,1,4,1013,0.0,1.0,0.0,-0.0,0,0,1,0,1017,0,1.0,0.0,0
PF15067,PF12527:PF10361:PF08014:PF14531:PF03085,4,2,0,4,2,1012,0.0,0.99,0.0,-0.0,0,0,4,0,1014,0,1.0,0.0,0
PF12051,PF10276:PF09805:PF09340:PF01250:PF03754,6,30,0,6,30,982,0.0,0.96,0.0,-0.01,1,0,6,1,1011,0.0,0.99,0.0,-0.0
PF00795,PF01177:PF02540:PF01230:PF00117:PF00958,46,89,26,20,63,909,0.29,0.92,0.57,0.37,17,9,37,8,964,0.53,0.96,0.2,0.3
PF03184,PF03221:PF04218:PF05225:PF09607:PF04236,59,67,44,15,23,936,0.66,0.96,0.75,0.68,9,9,50,0,959,1.0,0.95,0.15,0.38
PF01551,PF01476:PF03427:PF05938:PF09835:PF14856,14,45,6,8,39,965,0.13,0.95,0.43,0.22,4,1,13,3,1001,0.25,0.98,0.07,0.13
PF09876,PF08206:PF13184:PF08529:PF09371:PF03613,1,6,1,0,5,1012,0.17,1.0,1.0,0.41,1,1,0,0,1017,1.0,1.0,1.0,1.0
PF04583,PF07927:PF11862:PF05947:PF08453:PF15483,1,6,0,1,6,1011,0.0,0.99,0.0,-0.0,0,0,1,0,1017,0,1.0,0.0,0
PF03169,PF07969:PF04979:PF01738:PF11578:PF00724,36,64,26,10,38,944,0.41,0.95,0.72,0.52,14,10,26,4,978,0.71,0.97,0.28,0.43
PF07974,PF02333:PF08725:PF01457:PF07965:PF17205,34,22,11,23,11,973,0.5,0.97,0.32,0.39,4,4,30,0,984,1.0,0.97,0.12,0.34
PF05153,PF05995:PF15161:PF12296:PF00810:PF04520,13,26,6,7,20,985,0.23,0.97,0.46,0.31,1,1,12,0,1005,1.0,0.99,0.08,0.28
PF12804,PF04613:PF06426:PF13720:PF01050:PF12464,9,34,4,5,30,979,0.12,0.97,0.44,0.22,2,1,8,1,1008,0.5,0.99,0.11,0.23
PF14629,PF08740:PF08542:PF14363:PF09079:PF16725,8,38,4,4,34,976,0.11,0.96,0.5,0.22,5,2,6,3,1007,0.4,0.99,0.25,0.31
PF03729,PF03090:PF04717:PF11751:PF07409:PF02741,0,1,0,0,1,1017,0.0,1.0,0,0,0,0,0,0,1018,0,1.0,0,0
PF00884,PF12548:PF01663:PF16347:PF12411:PF00474,46,70,25,21,45,927,0.36,0.94,0.54,0.41,3,3,43,0,972,1.0,0.96,0.07,0.25
PF11910,PF15334:PF05151:PF08092:PF05418:PF15770,3,2,0,3,2,1013,0.0,1.0,0.0,-0.0,0,0,3,0,1015,0,1.0,0.0,0
PF16471,PF04388:PF01465:PF10377:PF15908:PF09744,2,31,2,0,29,987,0.06,0.97,1.0,0.25,3,1,1,2,1014,0.33,1.0,0.5,0.41
PF11467,PF10513:PF00855:PF12064:PF07496:PF08429,7,63,6,1,57,954,0.1,0.94,0.86,0.27,8,2,5,6,1005,0.25,0.99,0.29,0.26
PF16704,PF10212:PF16766:PF15964:PF15908:PF16768,1,9,1,0,8,1009,0.11,0.99,1.0,0.33,0,0,1,0,1017,0,1.0,0.0,0
PF14308,PF14901:PF00684:PF09350:PF05207:PF09976,11,25,4,7,21,986,0.16,0.97,0.36,0.23,1,0,11,1,1006,0.0,0.99,0.0,-0.0
PF08302,PF09511:PF08303:PF06165:PF17167:PF05285,4,26,4,0,22,992,0.15,0.98,1.0,0.39,1,1,3,0,1014,1.0,1.0,0.25,0.5
PF02811,PF09587:PF03576:PF00545:PF09056:PF06369,12,12,1,11,11,995,0.08,0.98,0.08,0.07,0,0,12,0,1006,0,0.99,0.0,0
PF15008,PF05497:PF14935:PF12020:PF00143:PF04901,0,10,0,0,10,1008,0.0,0.99,0,0,0,0,0,0,1018,0,1.0,0,0
PF16692,PF16401:PF14022:PF09949:PF07282:PF08297,4,13,2,2,11,1003,0.15,0.99,0.5,0.27,1,1,3,0,1014,1.0,1.0,0.25,0.5
PF11807,PF04199:PF14027:PF12311:PF12296:PF04479,12,41,9,3,32,974,0.22,0.97,0.75,0.39,11,7,5,4,1002,0.64,0.99,0.58,0.6
PF00633,PF10576:PF07934:PF11995:PF14815:PF08580,6,23,5,1,18,994,0.22,0.98,0.83,0.42,1,1,5,0,1012,1.0,1.0,0.17,0.41
PF16088,PF07914:PF04277:PF03718:PF15431:PF03882,1,11,1,0,10,1007,0.09,0.99,1.0,0.3,0,0,1,0,1017,0,1.0,0.0,0
PF02377,PF12316:PF00778:PF09007:PF08833:PF04629,4,14,3,1,11,1003,0.21,0.99,0.75,0.4,2,1,3,1,1013,0.5,1.0,0.25,0.35
PF15685,PF10856:PF15231:PF01840:PF04624:PF02951,0,5,0,0,5,1013,0.0,1.0,0,0,0,0,0,0,1018,0,1.0,0,0
PF09380,PF09379:PF08736:PF04382:PF05902:PF11819,32,43,32,0,11,975,0.74,0.99,1.0,0.86,10,10,22,0,986,1.0,0.98,0.31,0.55
PF00514,PF16689:PF01749:PF05956:PF10508:PF05536,63,32,26,37,6,949,0.81,0.96,0.41,0.56,1,1,62,0,955,1.0,0.94,0.02,0.12
PF15985,PF10447:PF12260:PF14382:PF02275:PF02585,12,30,8,4,22,984,0.27,0.97,0.67,0.41,5,4,8,1,1005,0.8,0.99,0.33,0.51
PF16491,PF01435:PF12735:PF00273:PF04526:PF06880,17,26,15,2,11,990,0.58,0.99,0.88,0.71,0,0,17,0,1001,0,0.98,0.0,0
PF07722,PF06083:PF08561:PF10218:PF05915:PF04716,3,19,2,1,17,998,0.11,0.98,0.67,0.26,1,0,3,1,1014,0.0,1.0,0.0,-0.0
PF15081,PF01110:PF15132:PF15754:PF07243:PF09256,2,1,0,2,1,1015,0.0,1.0,0.0,-0.0,0,0,2,0,1016,0,1.0,0.0,0
PF01379,PF03900:PF00148:PF03894:PF01643:PF09363,15,19,15,0,4,999,0.79,1.0,1.0,0.89,0,0,15,0,1003,0,0.99,0.0,0
PF09263,PF09262:PF16725:PF09247:PF10056:PF14818,3,20,3,0,17,998,0.15,0.98,1.0,0.38,2,1,2,1,1014,0.5,1.0,0.33,0.41
PF07693,PF00710:PF15898:PF09310:PF16553:PF09372,7,18,3,4,15,996,0.17,0.98,0.43,0.26,1,1,6,0,1011,1.0,0.99,0.14,0.38
PF07334,PF07292:PF08961:PF08564:PF14767:PF09775,1,11,1,0,10,1007,0.09,0.99,1.0,0.3,0,0,1,0,1017,0,1.0,0.0,0
PF12008,PF04313:PF06114:PF01863:PF13749:PF00529,4,11,4,0,7,1007,0.36,0.99,1.0,0.6,4,4,0,0,1014,1.0,1.0,1.0,1.0
PF15450,PF14615:PF12376:PF07458:PF15549:PF15046,1,11,0,1,11,1006,0.0,0.99,0.0,-0.0,0,0,1,0,1017,0,1.0,0.0,0
PF13953,PF13954:PF00345:PF00577:PF17085:PF06670,5,5,5,0,0,1013,1.0,1.0,1.0,1.0,3,3,2,0,1013,1.0,1.0,0.6,0.77
PF06292,PF10540:PF15625:PF01735:PF08150:PF00614,13,39,9,4,30,975,0.23,0.97,0.69,0.39,3,3,10,0,1005,1.0,0.99,0.23,0.48
PF10229,PF15008:PF15260:PF15065:PF14954:PF05497,11,15,2,9,13,994,0.13,0.98,0.18,0.14,0,0,11,0,1007,0,0.99,0.0,0
PF12584,PF12742:PF14649:PF11028:PF08638:PF17034,11,20,3,8,17,990,0.15,0.98,0.27,0.19,0,0,11,0,1007,0,0.99,0.0,0
PF15966,PF15965:PF12366:PF05454:PF12166:PF00680,4,25,4,0,21,993,0.16,0.98,1.0,0.4,1,1,3,0,1014,1.0,1.0,0.25,0.5
PF04824,PF05029:PF12166:PF04054:PF16418:PF16876,8,32,6,2,26,984,0.19,0.97,0.75,0.37,2,1,7,1,1009,0.5,0.99,0.12,0.25
PF05488,PF17188:PF07434:PF10988:PF13722:PF08707,0,1,0,0,1,1017,0.0,1.0,0,0,0,0,0,0,1018,0,1.0,0,0
PF05163,PF09798:PF11214:PF04196:PF05947:PF05167,0,2,0,0,2,1016,0.0,1.0,0,0,0,0,0,0,1018,0,1.0,0,0
PF01380,PF01418:PF00571:PF08603:PF04227:PF02449,14,70,7,7,63,941,0.1,0.93,0.5,0.2,4,2,12,2,1002,0.5,0.99,0.14,0.26
PF08381,PF13713:PF11464:PF04366:PF11979:PF16696,8,28,7,1,21,989,0.25,0.98,0.88,0.46,2,2,6,0,1010,1.0,0.99,0.25,0.5
PF11410,PF08668:PF08310:PF17092:PF15203:PF04345,1,9,1,0,8,1009,0.11,0.99,1.0,0.33,0,0,1,0,1017,0,1.0,0.0,0
PF08579,PF15491:PF16014:PF16756:PF07610:PF09249,1,3,0,1,3,1014,0.0,1.0,0.0,-0.0,0,0,1,0,1017,0,1.0,0.0,0
PF13366,PF15547:PF17112:PF14539:PF11402:PF04370,0,0,0,0,0,1018,0,1.0,0,0,0,0,0,0,1018,0,1.0,0,0
PF16454,PF12162:PF08947:PF01991:PF09267:PF14596,7,10,2,5,8,1003,0.2,0.99,0.29,0.23,1,0,7,1,1010,0.0,0.99,0.0,-0.0
PF14107,PF11291:PF00524:PF16872:PF05164:PF02108,0,4,0,0,4,1014,0.0,1.0,0,0,0,0,0,0,1018,0,1.0,0,0
PF08149,PF08145:PF04003:PF10313:PF08614:PF12490,7,21,2,5,19,992,0.1,0.98,0.29,0.16,3,1,6,2,1009,0.33,0.99,0.14,0.21
PF12968,PF05979:PF12188:PF04529:PF03923:PF02570,3,7,1,2,6,1009,0.14,0.99,0.33,0.21,0,0,3,0,1015,0,1.0,0.0,0
PF00416,PF00411:PF03973:PF09749:PF02681:PF05996,20,36,10,10,26,972,0.28,0.96,0.5,0.36,1,1,19,0,998,1.0,0.98,0.05,0.22
PF09772,PF15390:PF06382:PF14822:PF02404:PF09305,6,4,0,6,4,1008,0.0,0.99,0.0,-0.0,0,0,6,0,1012,0,0.99,0.0,0
PF15366,PF08404:PF10106:PF13247:PF13753:PF05840,0,1,0,0,1,1017,0.0,1.0,0,0,0,0,0,0,1018,0,1.0,0,0
PF15451,PF10631:PF06803:PF12126:PF06739:PF08941,2,16,2,0,14,1002,0.12,0.99,1.0,0.35,3,2,0,1,1015,0.67,1.0,1.0,0.82
PF05002,PF09032:PF16273:PF14050:PF04968:PF04969,20,52,19,1,33,965,0.37,0.97,0.95,0.58,0,0,20,0,998,0,0.98,0.0,0
PF13307,PF06733:PF06777:PF07422:PF08621:PF08689,21,29,21,0,8,989,0.72,0.99,1.0,0.85,1,1,20,0,997,1.0,0.98,0.05,0.22
PF15613,PF02791:PF10537:PF15612:PF12157:PF09247,19,29,19,0,10,989,0.66,0.99,1.0,0.81,9,8,11,1,998,0.89,0.99,0.42,0.61
PF08753,PF02951:PF14258:PF04865:PF01514:PF06251,0,4,0,0,4,1014,0.0,1.0,0,0,0,0,0,0,1018,0,1.0,0,0
PF16278,PF04592:PF09830:PF04000:PF08655:PF05508,9,29,3,6,26,983,0.1,0.97,0.33,0.17,0,0,9,0,1009,0,0.99,0.0,0
PF03726,PF16097:PF16098:PF01138:PF16096:PF12235,9,62,9,0,53,956,0.15,0.95,1.0,0.37,4,1,8,3,1006,0.25,0.99,0.11,0.16
PF00750,PF03485:PF05746:PF12739:PF08146:PF04898,28,45,26,2,19,971,0.58,0.98,0.93,0.72,5,5,23,0,990,1.0,0.98,0.18,0.42
PF15782,PF00680:PF14961:PF02106:PF12530:PF15818,3,14,1,2,13,1002,0.07,0.99,0.33,0.15,0,0,3,0,1015,0,1.0,0.0,0
PF04142,PF14975:PF01126:PF00638:PF03298:PF05078,21,41,13,8,28,969,0.32,0.96,0.62,0.43,1,1,20,0,997,1.0,0.98,0.05,0.22
PF03695,PF12019:PF13588:PF03831:PF05943:PF14841,2,4,0,2,4,1012,0.0,0.99,0.0,-0.0,0,0,2,0,1016,0,1.0,0.0,0
PF09429,PF00649:PF14661:PF15678:PF13836:PF11261,9,14,2,7,12,997,0.14,0.98,0.22,0.17,0,0,9,0,1009,0,0.99,0.0,0
PF04406,PF01066:PF07786:PF04833:PF10156:PF01925,17,41,7,10,34,967,0.17,0.96,0.41,0.25,2,2,15,0,1001,1.0,0.99,0.12,0.34
PF02771,PF00441:PF02770:PF08028:PF09317:PF12806,58,69,58,0,11,949,0.84,0.99,1.0,0.91,3,3,55,0,960,1.0,0.95,0.05,0.22
PF02416,PF09419:PF11264:PF00236:PF00214:PF16716,9,13,3,6,10,999,0.23,0.98,0.33,0.27,0,0,9,0,1009,0,0.99,0.0,0
PF16528,PF10699:PF14611:PF15862:PF05030:PF00649,17,20,4,13,16,985,0.2,0.97,0.24,0.2,0,0,17,0,1001,0,0.98,0.0,0
PF06371,PF06367:PF06346:PF06345:PF02181:PF04108,23,42,23,0,19,976,0.55,0.98,1.0,0.73,4,4,19,0,995,1.0,0.98,0.17,0.41
PF14316,PF08093:PF07192:PF08291:PF15355:PF05962,0,2,0,0,2,1016,0.0,1.0,0,0,0,0,0,0,1018,0,1.0,0,0
PF00929,PF15870:PF13423:PF00641:PF16764:PF06839,50,75,24,26,51,917,0.32,0.92,0.48,0.35,4,4,46,0,968,1.0,0.95,0.08,0.28
PF05049,PF14946:PF15020:PF04598:PF09806:PF03409,8,17,1,7,16,994,0.06,0.98,0.12,0.08,0,0,8,0,1010,0,0.99,0.0,0
PF04541,PF15091:PF10116:PF12318:PF13103:PF12331,0,7,0,0,7,1011,0.0,0.99,0,0,0,0,0,0,1018,0,1.0,0,0
PF00687,PF15998:PF00301:PF01786:PF05301:PF01923,19,26,5,14,21,978,0.19,0.97,0.26,0.21,1,1,18,0,999,1.0,0.98,0.05,0.23
PF12618,PF12140:PF17208:PF02820:PF01530:PF12012,3,33,3,0,30,985,0.09,0.97,1.0,0.3,5,1,2,4,1011,0.2,0.99,0.33,0.26
PF07980,PF10618:PF01580:PF03428:PF05943:PF02554,0,5,0,0,5,1013,0.0,1.0,0,0,0,0,0,0,1018,0,1.0,0,0
PF03137,PF06342:PF14798:PF05197:PF15388:PF17065,12,17,6,6,11,995,0.35,0.98,0.5,0.41,1,1,11,0,1006,1.0,0.99,0.08,0.29
PF02175,PF03488:PF14747:PF09057:PF11105:PF07464,1,3,0,1,3,1014,0.0,1.0,0.0,-0.0,0,0,1,0,1017,0,1.0,0.0,0
PF10618,PF10109:PF04392:PF01580:PF06805:PF13750,0,7,0,0,7,1011,0.0,0.99,0,0,0,0,0,0,1018,0,1.0,0,0
PF03727,PF00349:PF09764:PF04833:PF06880:PF05023,22,31,20,2,11,985,0.65,0.99,0.91,0.76,1,1,21,0,996,1.0,0.98,0.05,0.21
PF02419,PF00284:PF03023:PF09044:PF03150:PF11802,1,18,1,0,17,1000,0.06,0.98,1.0,0.23,0,0,1,0,1017,0,1.0,0.0,0
PF02042,PF04576:PF16043:PF05997:PF15275:PF11881,9,25,3,6,22,987,0.12,0.97,0.33,0.19,1,1,8,0,1009,1.0,0.99,0.11,0.33
PF17015,PF14877:PF17062:PF03749:PF15207:PF03203,0,7,0,0,7,1011,0.0,0.99,0,0,0,0,0,0,1018,0,1.0,0,0
PF01764,PF04577:PF07810:PF03109:PF13679:PF05024,55,73,32,23,41,922,0.44,0.94,0.58,0.47,9,9,46,0,963,1.0,0.95,0.16,0.4
PF03534,PF12256:PF12255:PF04196:PF09327:PF15518,0,1,0,0,1,1017,0.0,1.0,0,0,0,0,0,0,1018,0,1.0,0,0
PF03264,PF02217:PF13753:PF13742:PF11196:PF04569,0,5,0,0,5,1013,0.0,1.0,0,0,0,0,0,0,1018,0,1.0,0,0
PF12420,PF10218:PF10252:PF01632:PF07787:PF13092,1,15,1,0,14,1003,0.07,0.99,1.0,0.26,1,1,0,0,1017,1.0,1.0,1.0,1.0
PF15361,PF10357:PF11187:PF14722:PF00022:PF16043,3,67,3,0,64,951,0.04,0.94,1.0,0.2,2,0,3,2,1013,0.0,1.0,0.0,-0.0
PF12327,PF02491:PF03953:PF15245:PF15744:PF16545,5,54,2,3,52,961,0.04,0.95,0.4,0.11,0,0,5,0,1013,0,1.0,0.0,0
PF01833,PF08337:PF10162:PF03859:PF01403:PF16422,37,32,18,19,14,967,0.56,0.97,0.49,0.51,5,5,32,0,981,1.0,0.97,0.14,0.36
PF00553,PF09478:PF16030:PF02927:PF00759:PF00942,3,27,3,0,24,991,0.11,0.98,1.0,0.33,3,3,0,0,1015,1.0,1.0,1.0,1.0
PF03522,PF08403:PF00324:PF07875:PF10791:PF03726,17,56,16,1,40,961,0.29,0.96,0.94,0.51,0,0,17,0,1001,0,0.98,0.0,0
PF10699,PF14611:PF11331:PF15862:PF13859:PF10177,1,9,0,1,9,1008,0.0,0.99,0.0,-0.0,0,0,1,0,1017,0,1.0,0.0,0
PF06595,PF03155:PF04493:PF14281:PF05327:PF01722,0,40,0,0,40,978,0.0,0.96,0,0,3,0,0,3,1015,0.0,1.0,0,0
PF10030,PF02413:PF10906:PF04451:PF10412:PF06724,0,3,0,0,3,1015,0.0,1.0,0,0,0,0,0,0,1018,0,1.0,0,0
PF10659,PF13206:PF00913:PF03409:PF10322:PF08102,1,2,0,1,2,1015,0.0,1.0,0.0,-0.0,0,0,1,0,1017,0,1.0,0.0,0
PF14206,PF04261:PF10401:PF11879:PF11628:PF10637,0,35,0,0,35,983,0.0,0.97,0,0,0,0,0,0,1018,0,1.0,0,0
